202007,11110,서울특별시,종로구,0-4세,3315,1678,1637
202008,11110,서울특별시,종로구,0-4세,3258,1648,1610
202009,11110,서울특별시,종로구,0-4세,3221,1623,1598
202010,11110,서울특별시,종로구,0-4세,3171,1596,1575
202011,11110,서울특별시,종로구,0-4세,3133,1589,1544
202012,11110,서울특별시,종로구,0-4세,3080,1558,1522
202101,11110,서울특별시,종로구,0-4세,3040,1537,1503
202102,11110,서울특별시,종로구,0-4세,3018,1525,1493
202103,11110,서울특별시,종로구,0-4세,2980,1504,1476
202104,11110,서울특별시,종로구,0-4세,2966,1481,1485
202105,11110,서울특별시,종로구,0-4세,2952,1480,1472
202106,11110,서울특별시,종로구,0-4세,2937,1464,1473
202007,11110,서울특별시,종로구,5-9세,4510,2295,2215
202008,11110,서울특별시,종로구,5-9세,4490,2283,2207
202009,11110,서울특별시,종로구,5-9세,4479,2273,2206
202010,11110,서울특별시,종로구,5-9세,4490,2279,2211
202011,11110,서울특별시,종로구,5-9세,4457,2252,2205
202012,11110,서울특별시,종로구,5-9세,4447,2245,2202
202101,11110,서울특별시,종로구,5-9세,4409,2230,2179
202102,11110,서울특별시,종로구,5-9세,4371,2197,2174
202103,11110,서울특별시,종로구,5-9세,4336,2170,2166
202104,11110,서울특별시,종로구,5-9세,4340,2174,2166
202105,11110,서울특별시,종로구,5-9세,4326,2171,2155
202106,11110,서울특별시,종로구,5-9세,4338,2187,2151
202007,11110,서울특별시,종로구,10-14세,5104,2576,2528
202008,11110,서울특별시,종로구,10-14세,5105,2583,2522
202009,11110,서울특별시,종로구,10-14세,5117,2585,2532
202010,11110,서울특별시,종로구,10-14세,5121,2566,2555
202011,11110,서울특별시,종로구,10-14세,5137,2567,2570
202012,11110,서울특별시,종로구,10-14세,5152,2567,2585
202101,11110,서울특별시,종로구,10-14세,5149,2576,2573
202102,11110,서울특별시,종로구,10-14세,5115,2568,2547
202103,11110,서울특별시,종로구,10-14세,5054,2530,2524
202104,11110,서울특별시,종로구,10-14세,5025,2519,2506
202105,11110,서울특별시,종로구,10-14세,5013,2500,2513
202106,11110,서울특별시,종로구,10-14세,4996,2494,2502
202007,11110,서울특별시,종로구,15-19세,6142,3092,3050
202008,11110,서울특별시,종로구,15-19세,6056,3035,3021
202009,11110,서울특별시,종로구,15-19세,6069,3036,3033
202010,11110,서울특별시,종로구,15-19세,5994,2988,3006
202011,11110,서울특별시,종로구,15-19세,5929,2961,2968
202012,11110,서울특별시,종로구,15-19세,5861,2928,2933
202101,11110,서울특별시,종로구,15-19세,5788,2867,2921
202102,11110,서울특별시,종로구,15-19세,5798,2890,2908
202103,11110,서울특별시,종로구,15-19세,5892,2907,2985
202104,11110,서울특별시,종로구,15-19세,5834,2882,2952
202105,11110,서울특별시,종로구,15-19세,5778,2854,2924
202106,11110,서울특별시,종로구,15-19세,5688,2817,2871
202007,11110,서울특별시,종로구,20-24세,10670,5009,5661
202008,11110,서울특별시,종로구,20-24세,10654,4990,5664
202009,11110,서울특별시,종로구,20-24세,10559,4934,5625
202010,11110,서울특별시,종로구,20-24세,10517,4902,5615
202011,11110,서울특별시,종로구,20-24세,10489,4881,5608
202012,11110,서울특별시,종로구,20-24세,10474,4852,5622
202101,11110,서울특별시,종로구,20-24세,10373,4811,5562
202102,11110,서울특별시,종로구,20-24세,10359,4813,5546
202103,11110,서울특별시,종로구,20-24세,10379,4829,5550
202104,11110,서울특별시,종로구,20-24세,10328,4779,5549
202105,11110,서울특별시,종로구,20-24세,10260,4762,5498
202106,11110,서울특별시,종로구,20-24세,10179,4711,5468
202007,11110,서울특별시,종로구,25-29세,12766,6559,6207
202008,11110,서울특별시,종로구,25-29세,12781,6576,6205
202009,11110,서울특별시,종로구,25-29세,12860,6614,6246
202010,11110,서울특별시,종로구,25-29세,12849,6596,6253
202011,11110,서울특별시,종로구,25-29세,12897,6634,6263
202012,11110,서울특별시,종로구,25-29세,12942,6653,6289
202101,11110,서울특별시,종로구,25-29세,12958,6682,6276
202102,11110,서울특별시,종로구,25-29세,12889,6613,6276
202103,11110,서울특별시,종로구,25-29세,12896,6587,6309
202104,11110,서울특별시,종로구,25-29세,12912,6596,6316
202105,11110,서울특별시,종로구,25-29세,12959,6581,6378
202106,11110,서울특별시,종로구,25-29세,12968,6544,6424
202007,11110,서울특별시,종로구,30-34세,10111,5077,5034
202008,11110,서울특별시,종로구,30-34세,10094,5065,5029
202009,11110,서울특별시,종로구,30-34세,10093,5067,5026
202010,11110,서울특별시,종로구,30-34세,10083,5043,5040
202011,11110,서울특별시,종로구,30-34세,10082,5038,5044
202012,11110,서울특별시,종로구,30-34세,10084,5055,5029
202101,11110,서울특별시,종로구,30-34세,10147,5091,5056
202102,11110,서울특별시,종로구,30-34세,10100,5046,5054
202103,11110,서울특별시,종로구,30-34세,10107,5052,5055
202104,11110,서울특별시,종로구,30-34세,10144,5105,5039
202105,11110,서울특별시,종로구,30-34세,10149,5114,5035
202106,11110,서울특별시,종로구,30-34세,10171,5136,5035
202007,11110,서울특별시,종로구,35-39세,10014,4960,5054
202008,11110,서울특별시,종로구,35-39세,9993,4951,5042
202009,11110,서울특별시,종로구,35-39세,9984,4936,5048
202010,11110,서울특별시,종로구,35-39세,9952,4914,5038
202011,11110,서울특별시,종로구,35-39세,9900,4870,5030
202012,11110,서울특별시,종로구,35-39세,9859,4855,5004
202101,11110,서울특별시,종로구,35-39세,9770,4792,4978
202102,11110,서울특별시,종로구,35-39세,9731,4774,4957
202103,11110,서울특별시,종로구,35-39세,9633,4712,4921
202104,11110,서울특별시,종로구,35-39세,9585,4681,4904
202105,11110,서울특별시,종로구,35-39세,9488,4646,4842
202106,11110,서울특별시,종로구,35-39세,9424,4607,4817
202007,11110,서울특별시,종로구,40-44세,9929,4750,5179
202008,11110,서울특별시,종로구,40-44세,9906,4733,5173
202009,11110,서울특별시,종로구,40-44세,9922,4759,5163
202010,11110,서울특별시,종로구,40-44세,9933,4782,5151
202011,11110,서울특별시,종로구,40-44세,9941,4786,5155
202012,11110,서울특별시,종로구,40-44세,9949,4795,5154
202101,11110,서울특별시,종로구,40-44세,9972,4809,5163
202102,11110,서울특별시,종로구,40-44세,9999,4828,5171
202103,11110,서울특별시,종로구,40-44세,9924,4798,5126
202104,11110,서울특별시,종로구,40-44세,9910,4801,5109
202105,11110,서울특별시,종로구,40-44세,9935,4799,5136
202106,11110,서울특별시,종로구,40-44세,9930,4810,5120
202007,11110,서울특별시,종로구,45-49세,12640,6239,6401
202008,11110,서울특별시,종로구,45-49세,12554,6204,6350
202009,11110,서울특별시,종로구,45-49세,12472,6146,6326
202010,11110,서울특별시,종로구,45-49세,12384,6089,6295
202011,11110,서울특별시,종로구,45-49세,12304,6041,6263
202012,11110,서울특별시,종로구,45-49세,12282,6039,6243
202101,11110,서울특별시,종로구,45-49세,12160,5991,6169
202102,11110,서울특별시,종로구,45-49세,12048,5903,6145
202103,11110,서울특별시,종로구,45-49세,11851,5805,6046
202104,11110,서울특별시,종로구,45-49세,11780,5777,6003
202105,11110,서울특별시,종로구,45-49세,11565,5677,5888
202106,11110,서울특별시,종로구,45-49세,11503,5640,5863
202007,11110,서울특별시,종로구,50-54세,12909,6370,6539
202008,11110,서울특별시,종로구,50-54세,12919,6353,6566
202009,11110,서울특별시,종로구,50-54세,12945,6360,6585
202010,11110,서울특별시,종로구,50-54세,12937,6366,6571
202011,11110,서울특별시,종로구,50-54세,12941,6356,6585
202012,11110,서울특별시,종로구,50-54세,12892,6341,6551
202101,11110,서울특별시,종로구,50-54세,13007,6410,6597
202102,11110,서울특별시,종로구,50-54세,13050,6451,6599
202103,11110,서울특별시,종로구,50-54세,12925,6410,6515
202104,11110,서울특별시,종로구,50-54세,12927,6416,6511
202105,11110,서울특별시,종로구,50-54세,12944,6420,6524
202106,11110,서울특별시,종로구,50-54세,12961,6428,6533
202007,11110,서울특별시,종로구,55-59세,12736,6498,6238
202008,11110,서울특별시,종로구,55-59세,12721,6503,6218
202009,11110,서울특별시,종로구,55-59세,12664,6482,6182
202010,11110,서울특별시,종로구,55-59세,12634,6469,6165
202011,11110,서울특별시,종로구,55-59세,12570,6456,6114
202012,11110,서울특별시,종로구,55-59세,12567,6443,6124
202101,11110,서울특별시,종로구,55-59세,12403,6355,6048
202102,11110,서울특별시,종로구,55-59세,12368,6342,6026
202103,11110,서울특별시,종로구,55-59세,12241,6292,5949
202104,11110,서울특별시,종로구,55-59세,12198,6269,5929
202105,11110,서울특별시,종로구,55-59세,12088,6212,5876
202106,11110,서울특별시,종로구,55-59세,11978,6151,5827
202007,11110,서울특별시,종로구,60-64세,11317,5706,5611
202008,11110,서울특별시,종로구,60-64세,11329,5702,5627
202009,11110,서울특별시,종로구,60-64세,11374,5711,5663
202010,11110,서울특별시,종로구,60-64세,11390,5727,5663
202011,11110,서울특별시,종로구,60-64세,11484,5784,5700
202012,11110,서울특별시,종로구,60-64세,11484,5768,5716
202101,11110,서울특별시,종로구,60-64세,11544,5788,5756
202102,11110,서울특별시,종로구,60-64세,11610,5808,5802
202103,11110,서울특별시,종로구,60-64세,11524,5766,5758
202104,11110,서울특별시,종로구,60-64세,11562,5772,5790
202105,11110,서울특별시,종로구,60-64세,11544,5772,5772
202106,11110,서울특별시,종로구,60-64세,11570,5790,5780
202007,11110,서울특별시,종로구,65-69세,8291,4015,4276
202008,11110,서울특별시,종로구,65-69세,8337,4048,4289
202009,11110,서울특별시,종로구,65-69세,8386,4090,4296
202010,11110,서울특별시,종로구,65-69세,8433,4120,4313
202011,11110,서울특별시,종로구,65-69세,8454,4122,4332
202012,11110,서울특별시,종로구,65-69세,8464,4135,4329
202101,11110,서울특별시,종로구,65-69세,8525,4191,4334
202102,11110,서울특별시,종로구,65-69세,8560,4223,4337
202103,11110,서울특별시,종로구,65-69세,8518,4218,4300
202104,11110,서울특별시,종로구,65-69세,8591,4264,4327
202105,11110,서울특별시,종로구,65-69세,8579,4253,4326
202106,11110,서울특별시,종로구,65-69세,8622,4265,4357
202007,11110,서울특별시,종로구,70-74세,6655,3001,3654
202008,11110,서울특별시,종로구,70-74세,6656,2998,3658
202009,11110,서울특별시,종로구,70-74세,6684,3009,3675
202010,11110,서울특별시,종로구,70-74세,6701,3031,3670
202011,11110,서울특별시,종로구,70-74세,6697,3023,3674
202012,11110,서울특별시,종로구,70-74세,6732,3035,3697
202101,11110,서울특별시,종로구,70-74세,6740,3017,3723
202102,11110,서울특별시,종로구,70-74세,6737,3027,3710
202103,11110,서울특별시,종로구,70-74세,6558,2967,3591
202104,11110,서울특별시,종로구,70-74세,6508,2947,3561
202105,11110,서울특별시,종로구,70-74세,6385,2899,3486
202106,11110,서울특별시,종로구,70-74세,6356,2884,3472
202007,11110,서울특별시,종로구,75-79세,5909,2594,3315
202008,11110,서울특별시,종로구,75-79세,5915,2581,3334
202009,11110,서울특별시,종로구,75-79세,5872,2560,3312
202010,11110,서울특별시,종로구,75-79세,5834,2531,3303
202011,11110,서울특별시,종로구,75-79세,5816,2515,3301
202012,11110,서울특별시,종로구,75-79세,5768,2483,3285
202101,11110,서울특별시,종로구,75-79세,5745,2478,3267
202102,11110,서울특별시,종로구,75-79세,5690,2442,3248
202103,11110,서울특별시,종로구,75-79세,5517,2376,3141
202104,11110,서울특별시,종로구,75-79세,5498,2371,3127
202105,11110,서울특별시,종로구,75-79세,5439,2345,3094
202106,11110,서울특별시,종로구,75-79세,5435,2340,3095
202007,11110,서울특별시,종로구,80-84세,3919,1623,2296
202008,11110,서울특별시,종로구,80-84세,3918,1625,2293
202009,11110,서울특별시,종로구,80-84세,3935,1635,2300
202010,11110,서울특별시,종로구,80-84세,3967,1652,2315
202011,11110,서울특별시,종로구,80-84세,3977,1651,2326
202012,11110,서울특별시,종로구,80-84세,3999,1665,2334
202101,11110,서울특별시,종로구,80-84세,4024,1677,2347
202102,11110,서울특별시,종로구,80-84세,4053,1695,2358
202103,11110,서울특별시,종로구,80-84세,4002,1666,2336
202104,11110,서울특별시,종로구,80-84세,4017,1660,2357
202105,11110,서울특별시,종로구,80-84세,3986,1646,2340
202106,11110,서울특별시,종로구,80-84세,3998,1657,2341
202007,11110,서울특별시,종로구,85-89세,1916,708,1208
202008,11110,서울특별시,종로구,85-89세,1948,719,1229
202009,11110,서울특별시,종로구,85-89세,1972,734,1238
202010,11110,서울특별시,종로구,85-89세,1965,730,1235
202011,11110,서울특별시,종로구,85-89세,1973,743,1230
202012,11110,서울특별시,종로구,85-89세,1979,750,1229
202101,11110,서울특별시,종로구,85-89세,1992,757,1235
202102,11110,서울특별시,종로구,85-89세,2007,762,1245
202103,11110,서울특별시,종로구,85-89세,1947,744,1203
202104,11110,서울특별시,종로구,85-89세,1973,757,1216
202105,11110,서울특별시,종로구,85-89세,1978,759,1219
202106,11110,서울특별시,종로구,85-89세,1987,756,1231
202007,11110,서울특별시,종로구,90-94세,776,258,518
202008,11110,서울특별시,종로구,90-94세,776,260,516
202009,11110,서울특별시,종로구,90-94세,784,259,525
202010,11110,서울특별시,종로구,90-94세,785,256,529
202011,11110,서울특별시,종로구,90-94세,806,263,543
202012,11110,서울특별시,종로구,90-94세,802,256,546
202101,11110,서울특별시,종로구,90-94세,807,254,553
202102,11110,서울특별시,종로구,90-94세,811,253,558
202103,11110,서울특별시,종로구,90-94세,733,216,517
202104,11110,서울특별시,종로구,90-94세,738,220,518
202105,11110,서울특별시,종로구,90-94세,739,221,518
202106,11110,서울특별시,종로구,90-94세,730,217,513
202007,11110,서울특별시,종로구,95-99세,287,117,170
202008,11110,서울특별시,종로구,95-99세,282,114,168
202009,11110,서울특별시,종로구,95-99세,289,118,171
202010,11110,서울특별시,종로구,95-99세,291,117,174
202011,11110,서울특별시,종로구,95-99세,290,115,175
202012,11110,서울특별시,종로구,95-99세,291,115,176
202101,11110,서울특별시,종로구,95-99세,296,118,178
202102,11110,서울특별시,종로구,95-99세,292,116,176
202103,11110,서울특별시,종로구,95-99세,213,74,139
202104,11110,서울특별시,종로구,95-99세,213,75,138
202105,11110,서울특별시,종로구,95-99세,210,74,136
202106,11110,서울특별시,종로구,95-99세,206,71,135
202007,11110,서울특별시,종로구,100+,267,89,178
202008,11110,서울특별시,종로구,100+,270,91,179
202009,11110,서울특별시,종로구,100+,271,93,178
202010,11110,서울특별시,종로구,100+,272,93,179
202011,11110,서울특별시,종로구,100+,272,94,178
202012,11110,서울특별시,종로구,100+,276,97,179
202101,11110,서울특별시,종로구,100+,276,97,179
202102,11110,서울특별시,종로구,100+,278,96,182
202103,11110,서울특별시,종로구,100+,66,21,45
202104,11110,서울특별시,종로구,100+,64,21,43
202105,11110,서울특별시,종로구,100+,60,19,41
202106,11110,서울특별시,종로구,100+,52,16,36
202007,11140,서울특별시,중구,0-4세,3445,1740,1705
202008,11140,서울특별시,중구,0-4세,3437,1745,1692
202009,11140,서울특별시,중구,0-4세,3393,1718,1675
202010,11140,서울특별시,중구,0-4세,3369,1717,1652
202011,11140,서울특별시,중구,0-4세,3342,1702,1640
202012,11140,서울특별시,중구,0-4세,3281,1671,1610
202101,11140,서울특별시,중구,0-4세,3227,1650,1577
202102,11140,서울특별시,중구,0-4세,3172,1634,1538
202103,11140,서울특별시,중구,0-4세,3164,1628,1536
202104,11140,서울특별시,중구,0-4세,3124,1603,1521
202105,11140,서울특별시,중구,0-4세,3111,1601,1510
202106,11140,서울특별시,중구,0-4세,3091,1584,1507
202007,11140,서울특별시,중구,5-9세,3634,1851,1783
202008,11140,서울특별시,중구,5-9세,3624,1850,1774
202009,11140,서울특별시,중구,5-9세,3609,1852,1757
202010,11140,서울특별시,중구,5-9세,3581,1840,1741
202011,11140,서울특별시,중구,5-9세,3544,1830,1714
202012,11140,서울특별시,중구,5-9세,3555,1834,1721
202101,11140,서울특별시,중구,5-9세,3513,1817,1696
202102,11140,서울특별시,중구,5-9세,3481,1797,1684
202103,11140,서울특별시,중구,5-9세,3447,1790,1657
202104,11140,서울특별시,중구,5-9세,3464,1796,1668
202105,11140,서울특별시,중구,5-9세,3428,1778,1650
202106,11140,서울특별시,중구,5-9세,3414,1779,1635
202007,11140,서울특별시,중구,10-14세,3109,1550,1559
202008,11140,서울특별시,중구,10-14세,3108,1556,1552
202009,11140,서울특별시,중구,10-14세,3091,1545,1546
202010,11140,서울특별시,중구,10-14세,3100,1557,1543
202011,11140,서울특별시,중구,10-14세,3104,1557,1547
202012,11140,서울특별시,중구,10-14세,3092,1554,1538
202101,11140,서울특별시,중구,10-14세,3118,1576,1542
202102,11140,서울특별시,중구,10-14세,3101,1556,1545
202103,11140,서울특별시,중구,10-14세,3093,1539,1554
202104,11140,서울특별시,중구,10-14세,3089,1534,1555
202105,11140,서울특별시,중구,10-14세,3106,1544,1562
202106,11140,서울특별시,중구,10-14세,3119,1548,1571
202007,11140,서울특별시,중구,15-19세,3988,2005,1983
202008,11140,서울특별시,중구,15-19세,3933,1973,1960
202009,11140,서울특별시,중구,15-19세,3862,1949,1913
202010,11140,서울특별시,중구,15-19세,3823,1926,1897
202011,11140,서울특별시,중구,15-19세,3750,1895,1855
202012,11140,서울특별시,중구,15-19세,3681,1854,1827
202101,11140,서울특별시,중구,15-19세,3648,1824,1824
202102,11140,서울특별시,중구,15-19세,3636,1805,1831
202103,11140,서울특별시,중구,15-19세,3636,1802,1834
202104,11140,서울특별시,중구,15-19세,3610,1800,1810
202105,11140,서울특별시,중구,15-19세,3558,1779,1779
202106,11140,서울특별시,중구,15-19세,3544,1772,1772
202007,11140,서울특별시,중구,20-24세,7774,3592,4182
202008,11140,서울특별시,중구,20-24세,7768,3574,4194
202009,11140,서울특별시,중구,20-24세,7762,3580,4182
202010,11140,서울특별시,중구,20-24세,7707,3552,4155
202011,11140,서울특별시,중구,20-24세,7701,3539,4162
202012,11140,서울특별시,중구,20-24세,7654,3531,4123
202101,11140,서울특별시,중구,20-24세,7586,3486,4100
202102,11140,서울특별시,중구,20-24세,7577,3477,4100
202103,11140,서울특별시,중구,20-24세,7546,3454,4092
202104,11140,서울특별시,중구,20-24세,7487,3419,4068
202105,11140,서울특별시,중구,20-24세,7454,3383,4071
202106,11140,서울특별시,중구,20-24세,7412,3351,4061
202007,11140,서울특별시,중구,25-29세,10796,5311,5485
202008,11140,서울특별시,중구,25-29세,10804,5315,5489
202009,11140,서울특별시,중구,25-29세,10813,5317,5496
202010,11140,서울특별시,중구,25-29세,10883,5315,5568
202011,11140,서울특별시,중구,25-29세,10933,5338,5595
202012,11140,서울특별시,중구,25-29세,10932,5320,5612
202101,11140,서울특별시,중구,25-29세,10908,5300,5608
202102,11140,서울특별시,중구,25-29세,10873,5263,5610
202103,11140,서울특별시,중구,25-29세,10904,5255,5649
202104,11140,서울특별시,중구,25-29세,10889,5233,5656
202105,11140,서울특별시,중구,25-29세,10910,5228,5682
202106,11140,서울특별시,중구,25-29세,10911,5224,5687
202007,11140,서울특별시,중구,30-34세,10145,5050,5095
202008,11140,서울특별시,중구,30-34세,10178,5048,5130
202009,11140,서울특별시,중구,30-34세,10191,5020,5171
202010,11140,서울특별시,중구,30-34세,10140,5010,5130
202011,11140,서울특별시,중구,30-34세,10133,4999,5134
202012,11140,서울특별시,중구,30-34세,10131,4999,5132
202101,11140,서울특별시,중구,30-34세,10092,4985,5107
202102,11140,서울특별시,중구,30-34세,10086,4998,5088
202103,11140,서울특별시,중구,30-34세,10078,4992,5086
202104,11140,서울특별시,중구,30-34세,10134,5021,5113
202105,11140,서울특별시,중구,30-34세,10155,5021,5134
202106,11140,서울특별시,중구,30-34세,10154,5029,5125
202007,11140,서울특별시,중구,35-39세,10178,5131,5047
202008,11140,서울특별시,중구,35-39세,10154,5125,5029
202009,11140,서울특별시,중구,35-39세,10071,5078,4993
202010,11140,서울특별시,중구,35-39세,10032,5048,4984
202011,11140,서울특별시,중구,35-39세,9984,5038,4946
202012,11140,서울특별시,중구,35-39세,9976,5028,4948
202101,11140,서울특별시,중구,35-39세,9942,5008,4934
202102,11140,서울특별시,중구,35-39세,9878,4980,4898
202103,11140,서울특별시,중구,35-39세,9796,4949,4847
202104,11140,서울특별시,중구,35-39세,9803,4949,4854
202105,11140,서울특별시,중구,35-39세,9781,4921,4860
202106,11140,서울특별시,중구,35-39세,9727,4905,4822
202007,11140,서울특별시,중구,40-44세,8739,4509,4230
202008,11140,서울특별시,중구,40-44세,8728,4516,4212
202009,11140,서울특별시,중구,40-44세,8760,4545,4215
202010,11140,서울특별시,중구,40-44세,8761,4538,4223
202011,11140,서울특별시,중구,40-44세,8787,4546,4241
202012,11140,서울특별시,중구,40-44세,8735,4531,4204
202101,11140,서울특별시,중구,40-44세,8751,4532,4219
202102,11140,서울특별시,중구,40-44세,8787,4556,4231
202103,11140,서울특별시,중구,40-44세,8790,4549,4241
202104,11140,서울특별시,중구,40-44세,8798,4549,4249
202105,11140,서울특별시,중구,40-44세,8787,4538,4249
202106,11140,서울특별시,중구,40-44세,8845,4549,4296
202007,11140,서울특별시,중구,45-49세,9624,4845,4779
202008,11140,서울특별시,중구,45-49세,9570,4817,4753
202009,11140,서울특별시,중구,45-49세,9501,4778,4723
202010,11140,서울특별시,중구,45-49세,9407,4729,4678
202011,11140,서울특별시,중구,45-49세,9332,4706,4626
202012,11140,서울특별시,중구,45-49세,9276,4691,4585
202101,11140,서울특별시,중구,45-49세,9209,4651,4558
202102,11140,서울특별시,중구,45-49세,9138,4627,4511
202103,11140,서울특별시,중구,45-49세,9056,4607,4449
202104,11140,서울특별시,중구,45-49세,9040,4597,4443
202105,11140,서울특별시,중구,45-49세,8931,4548,4383
202106,11140,서울특별시,중구,45-49세,8893,4516,4377
202007,11140,서울특별시,중구,50-54세,10348,5295,5053
202008,11140,서울특별시,중구,50-54세,10357,5292,5065
202009,11140,서울특별시,중구,50-54세,10333,5274,5059
202010,11140,서울특별시,중구,50-54세,10366,5282,5084
202011,11140,서울특별시,중구,50-54세,10348,5278,5070
202012,11140,서울특별시,중구,50-54세,10331,5257,5074
202101,11140,서울특별시,중구,50-54세,10393,5292,5101
202102,11140,서울특별시,중구,50-54세,10373,5270,5103
202103,11140,서울특별시,중구,50-54세,10318,5228,5090
202104,11140,서울특별시,중구,50-54세,10299,5226,5073
202105,11140,서울특별시,중구,50-54세,10257,5190,5067
202106,11140,서울특별시,중구,50-54세,10258,5190,5068
202007,11140,서울특별시,중구,55-59세,10574,5351,5223
202008,11140,서울특별시,중구,55-59세,10523,5329,5194
202009,11140,서울특별시,중구,55-59세,10509,5311,5198
202010,11140,서울특별시,중구,55-59세,10430,5289,5141
202011,11140,서울특별시,중구,55-59세,10396,5275,5121
202012,11140,서울특별시,중구,55-59세,10371,5251,5120
202101,11140,서울특별시,중구,55-59세,10304,5217,5087
202102,11140,서울특별시,중구,55-59세,10246,5175,5071
202103,11140,서울특별시,중구,55-59세,10184,5145,5039
202104,11140,서울특별시,중구,55-59세,10158,5136,5022
202105,11140,서울특별시,중구,55-59세,10033,5097,4936
202106,11140,서울특별시,중구,55-59세,9945,5053,4892
202007,11140,서울특별시,중구,60-64세,9881,4973,4908
202008,11140,서울특별시,중구,60-64세,9953,5004,4949
202009,11140,서울특별시,중구,60-64세,9968,5023,4945
202010,11140,서울특별시,중구,60-64세,10029,5059,4970
202011,11140,서울특별시,중구,60-64세,10063,5057,5006
202012,11140,서울특별시,중구,60-64세,10051,5049,5002
202101,11140,서울특별시,중구,60-64세,10079,5087,4992
202102,11140,서울특별시,중구,60-64세,10108,5122,4986
202103,11140,서울특별시,중구,60-64세,10140,5143,4997
202104,11140,서울특별시,중구,60-64세,10137,5127,5010
202105,11140,서울특별시,중구,60-64세,10060,5088,4972
202106,11140,서울특별시,중구,60-64세,10082,5111,4971
202007,11140,서울특별시,중구,65-69세,7340,3600,3740
202008,11140,서울특별시,중구,65-69세,7384,3622,3762
202009,11140,서울특별시,중구,65-69세,7408,3634,3774
202010,11140,서울특별시,중구,65-69세,7428,3634,3794
202011,11140,서울특별시,중구,65-69세,7449,3633,3816
202012,11140,서울특별시,중구,65-69세,7500,3665,3835
202101,11140,서울특별시,중구,65-69세,7569,3686,3883
202102,11140,서울특별시,중구,65-69세,7649,3727,3922
202103,11140,서울특별시,중구,65-69세,7695,3747,3948
202104,11140,서울특별시,중구,65-69세,7744,3789,3955
202105,11140,서울특별시,중구,65-69세,7622,3749,3873
202106,11140,서울특별시,중구,65-69세,7674,3762,3912
202007,11140,서울특별시,중구,70-74세,5762,2613,3149
202008,11140,서울특별시,중구,70-74세,5781,2634,3147
202009,11140,서울특별시,중구,70-74세,5825,2644,3181
202010,11140,서울특별시,중구,70-74세,5848,2667,3181
202011,11140,서울특별시,중구,70-74세,5901,2702,3199
202012,11140,서울특별시,중구,70-74세,5918,2721,3197
202101,11140,서울특별시,중구,70-74세,5938,2737,3201
202102,11140,서울특별시,중구,70-74세,5922,2740,3182
202103,11140,서울특별시,중구,70-74세,5907,2741,3166
202104,11140,서울특별시,중구,70-74세,5898,2731,3167
202105,11140,서울특별시,중구,70-74세,5705,2649,3056
202106,11140,서울특별시,중구,70-74세,5690,2648,3042
202007,11140,서울특별시,중구,75-79세,4863,2158,2705
202008,11140,서울특별시,중구,75-79세,4869,2155,2714
202009,11140,서울특별시,중구,75-79세,4840,2142,2698
202010,11140,서울특별시,중구,75-79세,4835,2125,2710
202011,11140,서울특별시,중구,75-79세,4827,2130,2697
202012,11140,서울특별시,중구,75-79세,4815,2118,2697
202101,11140,서울특별시,중구,75-79세,4792,2107,2685
202102,11140,서울특별시,중구,75-79세,4787,2092,2695
202103,11140,서울특별시,중구,75-79세,4774,2084,2690
202104,11140,서울특별시,중구,75-79세,4741,2062,2679
202105,11140,서울특별시,중구,75-79세,4622,1993,2629
202106,11140,서울특별시,중구,75-79세,4630,2004,2626
202007,11140,서울특별시,중구,80-84세,3145,1245,1900
202008,11140,서울특별시,중구,80-84세,3168,1264,1904
202009,11140,서울특별시,중구,80-84세,3175,1275,1900
202010,11140,서울특별시,중구,80-84세,3195,1288,1907
202011,11140,서울특별시,중구,80-84세,3191,1275,1916
202012,11140,서울특별시,중구,80-84세,3180,1275,1905
202101,11140,서울특별시,중구,80-84세,3193,1289,1904
202102,11140,서울특별시,중구,80-84세,3222,1310,1912
202103,11140,서울특별시,중구,80-84세,3201,1293,1908
202104,11140,서울특별시,중구,80-84세,3219,1305,1914
202105,11140,서울특별시,중구,80-84세,3116,1245,1871
202106,11140,서울특별시,중구,80-84세,3134,1246,1888
202007,11140,서울특별시,중구,85-89세,1565,499,1066
202008,11140,서울특별시,중구,85-89세,1580,502,1078
202009,11140,서울특별시,중구,85-89세,1595,504,1091
202010,11140,서울특별시,중구,85-89세,1611,514,1097
202011,11140,서울특별시,중구,85-89세,1618,518,1100
202012,11140,서울특별시,중구,85-89세,1656,525,1131
202101,11140,서울특별시,중구,85-89세,1672,528,1144
202102,11140,서울특별시,중구,85-89세,1690,535,1155
202103,11140,서울특별시,중구,85-89세,1735,555,1180
202104,11140,서울특별시,중구,85-89세,1742,562,1180
202105,11140,서울특별시,중구,85-89세,1642,516,1126
202106,11140,서울특별시,중구,85-89세,1635,510,1125
202007,11140,서울특별시,중구,90-94세,663,206,457
202008,11140,서울특별시,중구,90-94세,667,207,460
202009,11140,서울특별시,중구,90-94세,687,214,473
202010,11140,서울특별시,중구,90-94세,689,219,470
202011,11140,서울특별시,중구,90-94세,695,222,473
202012,11140,서울특별시,중구,90-94세,697,223,474
202101,11140,서울특별시,중구,90-94세,698,225,473
202102,11140,서울특별시,중구,90-94세,702,229,473
202103,11140,서울특별시,중구,90-94세,703,228,475
202104,11140,서울특별시,중구,90-94세,713,226,487
202105,11140,서울특별시,중구,90-94세,646,184,462
202106,11140,서울특별시,중구,90-94세,650,187,463
202007,11140,서울특별시,중구,95-99세,198,56,142
202008,11140,서울특별시,중구,95-99세,204,58,146
202009,11140,서울특별시,중구,95-99세,206,58,148
202010,11140,서울특별시,중구,95-99세,207,58,149
202011,11140,서울특별시,중구,95-99세,205,58,147
202012,11140,서울특별시,중구,95-99세,203,60,143
202101,11140,서울특별시,중구,95-99세,200,60,140
202102,11140,서울특별시,중구,95-99세,200,59,141
202103,11140,서울특별시,중구,95-99세,196,56,140
202104,11140,서울특별시,중구,95-99세,197,55,142
202105,11140,서울특별시,중구,95-99세,149,38,111
202106,11140,서울특별시,중구,95-99세,149,35,114
202007,11140,서울특별시,중구,100+,199,64,135
202008,11140,서울특별시,중구,100+,200,65,135
202009,11140,서울특별시,중구,100+,201,65,136
202010,11140,서울특별시,중구,100+,200,65,135
202011,11140,서울특별시,중구,100+,202,65,137
202012,11140,서울특별시,중구,100+,205,65,140
202101,11140,서울특별시,중구,100+,206,65,141
202102,11140,서울특별시,중구,100+,208,66,142
202103,11140,서울특별시,중구,100+,189,66,123
202104,11140,서울특별시,중구,100+,191,67,124
202105,11140,서울특별시,중구,100+,60,16,44
202106,11140,서울특별시,중구,100+,59,16,43
202007,11170,서울특별시,용산구,0-4세,6529,3397,3132
202008,11170,서울특별시,용산구,0-4세,6457,3341,3116
202009,11170,서울특별시,용산구,0-4세,6416,3328,3088
202010,11170,서울특별시,용산구,0-4세,6372,3286,3086
202011,11170,서울특별시,용산구,0-4세,6324,3271,3053
202012,11170,서울특별시,용산구,0-4세,6298,3248,3050
202101,11170,서울특별시,용산구,0-4세,6247,3227,3020
202102,11170,서울특별시,용산구,0-4세,6183,3180,3003
202103,11170,서울특별시,용산구,0-4세,6192,3176,3016
202104,11170,서울특별시,용산구,0-4세,6136,3147,2989
202105,11170,서울특별시,용산구,0-4세,6083,3133,2950
202106,11170,서울특별시,용산구,0-4세,6081,3132,2949
202007,11170,서울특별시,용산구,5-9세,7329,3770,3559
202008,11170,서울특별시,용산구,5-9세,7297,3775,3522
202009,11170,서울특별시,용산구,5-9세,7270,3749,3521
202010,11170,서울특별시,용산구,5-9세,7249,3758,3491
202011,11170,서울특별시,용산구,5-9세,7246,3740,3506
202012,11170,서울특별시,용산구,5-9세,7198,3722,3476
202101,11170,서울특별시,용산구,5-9세,7164,3701,3463
202102,11170,서울특별시,용산구,5-9세,7152,3677,3475
202103,11170,서울특별시,용산구,5-9세,7168,3670,3498
202104,11170,서울특별시,용산구,5-9세,7134,3656,3478
202105,11170,서울특별시,용산구,5-9세,7116,3636,3480
202106,11170,서울특별시,용산구,5-9세,7076,3633,3443
202007,11170,서울특별시,용산구,10-14세,7185,3612,3573
202008,11170,서울특별시,용산구,10-14세,7177,3606,3571
202009,11170,서울특별시,용산구,10-14세,7209,3619,3590
202010,11170,서울특별시,용산구,10-14세,7212,3622,3590
202011,11170,서울특별시,용산구,10-14세,7203,3629,3574
202012,11170,서울특별시,용산구,10-14세,7192,3614,3578
202101,11170,서울특별시,용산구,10-14세,7206,3629,3577
202102,11170,서울특별시,용산구,10-14세,7187,3617,3570
202103,11170,서울특별시,용산구,10-14세,7144,3607,3537
202104,11170,서울특별시,용산구,10-14세,7135,3597,3538
202105,11170,서울특별시,용산구,10-14세,7116,3590,3526
202106,11170,서울특별시,용산구,10-14세,7091,3565,3526
202007,11170,서울특별시,용산구,15-19세,8712,4476,4236
202008,11170,서울특별시,용산구,15-19세,8677,4457,4220
202009,11170,서울특별시,용산구,15-19세,8653,4454,4199
202010,11170,서울특별시,용산구,15-19세,8573,4411,4162
202011,11170,서울특별시,용산구,15-19세,8502,4362,4140
202012,11170,서울특별시,용산구,15-19세,8417,4318,4099
202101,11170,서울특별시,용산구,15-19세,8357,4282,4075
202102,11170,서울특별시,용산구,15-19세,8301,4254,4047
202103,11170,서울특별시,용산구,15-19세,8233,4190,4043
202104,11170,서울특별시,용산구,15-19세,8155,4157,3998
202105,11170,서울특별시,용산구,15-19세,8090,4107,3983
202106,11170,서울특별시,용산구,15-19세,8053,4095,3958
202007,11170,서울특별시,용산구,20-24세,13755,6457,7298
202008,11170,서울특별시,용산구,20-24세,13734,6429,7305
202009,11170,서울특별시,용산구,20-24세,13771,6420,7351
202010,11170,서울특별시,용산구,20-24세,13791,6466,7325
202011,11170,서울특별시,용산구,20-24세,13805,6489,7316
202012,11170,서울특별시,용산구,20-24세,13757,6444,7313
202101,11170,서울특별시,용산구,20-24세,13724,6453,7271
202102,11170,서울특별시,용산구,20-24세,13734,6443,7291
202103,11170,서울특별시,용산구,20-24세,13729,6450,7279
202104,11170,서울특별시,용산구,20-24세,13711,6434,7277
202105,11170,서울특별시,용산구,20-24세,13676,6418,7258
202106,11170,서울특별시,용산구,20-24세,13646,6371,7275
202007,11170,서울특별시,용산구,25-29세,19507,9385,10122
202008,11170,서울특별시,용산구,25-29세,19495,9416,10079
202009,11170,서울특별시,용산구,25-29세,19542,9442,10100
202010,11170,서울특별시,용산구,25-29세,19572,9437,10135
202011,11170,서울특별시,용산구,25-29세,19623,9431,10192
202012,11170,서울특별시,용산구,25-29세,19728,9481,10247
202101,11170,서울특별시,용산구,25-29세,19681,9438,10243
202102,11170,서울특별시,용산구,25-29세,19707,9430,10277
202103,11170,서울특별시,용산구,25-29세,20058,9554,10504
202104,11170,서울특별시,용산구,25-29세,20041,9532,10509
202105,11170,서울특별시,용산구,25-29세,19999,9483,10516
202106,11170,서울특별시,용산구,25-29세,19959,9470,10489
202007,11170,서울특별시,용산구,30-34세,18898,9377,9521
202008,11170,서울특별시,용산구,30-34세,18887,9344,9543
202009,11170,서울특별시,용산구,30-34세,18965,9402,9563
202010,11170,서울특별시,용산구,30-34세,19050,9460,9590
202011,11170,서울특별시,용산구,30-34세,19011,9466,9545
202012,11170,서울특별시,용산구,30-34세,19058,9532,9526
202101,11170,서울특별시,용산구,30-34세,19136,9555,9581
202102,11170,서울특별시,용산구,30-34세,19251,9612,9639
202103,11170,서울특별시,용산구,30-34세,19497,9721,9776
202104,11170,서울특별시,용산구,30-34세,19593,9762,9831
202105,11170,서울특별시,용산구,30-34세,19598,9754,9844
202106,11170,서울특별시,용산구,30-34세,19596,9733,9863
202007,11170,서울특별시,용산구,35-39세,19198,9629,9569
202008,11170,서울특별시,용산구,35-39세,19156,9614,9542
202009,11170,서울특별시,용산구,35-39세,19105,9570,9535
202010,11170,서울특별시,용산구,35-39세,19066,9534,9532
202011,11170,서울특별시,용산구,35-39세,19092,9551,9541
202012,11170,서울특별시,용산구,35-39세,19011,9500,9511
202101,11170,서울특별시,용산구,35-39세,18962,9442,9520
202102,11170,서울특별시,용산구,35-39세,18886,9395,9491
202103,11170,서울특별시,용산구,35-39세,18855,9376,9479
202104,11170,서울특별시,용산구,35-39세,18752,9347,9405
202105,11170,서울특별시,용산구,35-39세,18639,9276,9363
202106,11170,서울특별시,용산구,35-39세,18565,9243,9322
202007,11170,서울특별시,용산구,40-44세,16717,8187,8530
202008,11170,서울특별시,용산구,40-44세,16761,8212,8549
202009,11170,서울특별시,용산구,40-44세,16881,8280,8601
202010,11170,서울특별시,용산구,40-44세,16925,8316,8609
202011,11170,서울특별시,용산구,40-44세,17009,8350,8659
202012,11170,서울특별시,용산구,40-44세,16998,8356,8642
202101,11170,서울특별시,용산구,40-44세,17013,8385,8628
202102,11170,서울특별시,용산구,40-44세,17094,8419,8675
202103,11170,서울특별시,용산구,40-44세,17020,8375,8645
202104,11170,서울특별시,용산구,40-44세,17018,8368,8650
202105,11170,서울특별시,용산구,40-44세,16989,8393,8596
202106,11170,서울특별시,용산구,40-44세,16991,8403,8588
202007,11170,서울특별시,용산구,45-49세,19166,9416,9750
202008,11170,서울특별시,용산구,45-49세,19103,9385,9718
202009,11170,서울특별시,용산구,45-49세,18959,9311,9648
202010,11170,서울특별시,용산구,45-49세,18874,9272,9602
202011,11170,서울특별시,용산구,45-49세,18731,9187,9544
202012,11170,서울특별시,용산구,45-49세,18700,9173,9527
202101,11170,서울특별시,용산구,45-49세,18599,9152,9447
202102,11170,서울특별시,용산구,45-49세,18529,9124,9405
202103,11170,서울특별시,용산구,45-49세,18300,8992,9308
202104,11170,서울특별시,용산구,45-49세,18241,8969,9272
202105,11170,서울특별시,용산구,45-49세,18021,8845,9176
202106,11170,서울특별시,용산구,45-49세,17781,8724,9057
202007,11170,서울특별시,용산구,50-54세,18764,9249,9515
202008,11170,서울특별시,용산구,50-54세,18855,9290,9565
202009,11170,서울특별시,용산구,50-54세,18970,9352,9618
202010,11170,서울특별시,용산구,50-54세,19049,9369,9680
202011,11170,서울특별시,용산구,50-54세,19104,9396,9708
202012,11170,서울특별시,용산구,50-54세,19133,9413,9720
202101,11170,서울특별시,용산구,50-54세,19254,9441,9813
202102,11170,서울특별시,용산구,50-54세,19264,9434,9830
202103,11170,서울특별시,용산구,50-54세,19175,9400,9775
202104,11170,서울특별시,용산구,50-54세,19155,9388,9767
202105,11170,서울특별시,용산구,50-54세,19157,9388,9769
202106,11170,서울특별시,용산구,50-54세,19141,9359,9782
202007,11170,서울특별시,용산구,55-59세,17904,8906,8998
202008,11170,서울특별시,용산구,55-59세,17847,8893,8954
202009,11170,서울특별시,용산구,55-59세,17900,8907,8993
202010,11170,서울특별시,용산구,55-59세,17946,8927,9019
202011,11170,서울특별시,용산구,55-59세,17953,8936,9017
202012,11170,서울특별시,용산구,55-59세,17937,8931,9006
202101,11170,서울특별시,용산구,55-59세,17852,8897,8955
202102,11170,서울특별시,용산구,55-59세,17808,8875,8933
202103,11170,서울특별시,용산구,55-59세,17674,8810,8864
202104,11170,서울특별시,용산구,55-59세,17616,8763,8853
202105,11170,서울특별시,용산구,55-59세,17458,8691,8767
202106,11170,서울특별시,용산구,55-59세,17291,8626,8665
202007,11170,서울특별시,용산구,60-64세,16450,7943,8507
202008,11170,서울특별시,용산구,60-64세,16509,7969,8540
202009,11170,서울특별시,용산구,60-64세,16621,8048,8573
202010,11170,서울특별시,용산구,60-64세,16700,8101,8599
202011,11170,서울특별시,용산구,60-64세,16799,8155,8644
202012,11170,서울특별시,용산구,60-64세,16834,8157,8677
202101,11170,서울특별시,용산구,60-64세,16887,8173,8714
202102,11170,서울특별시,용산구,60-64세,16939,8195,8744
202103,11170,서울특별시,용산구,60-64세,16920,8191,8729
202104,11170,서울특별시,용산구,60-64세,16930,8207,8723
202105,11170,서울특별시,용산구,60-64세,16827,8179,8648
202106,11170,서울특별시,용산구,60-64세,16732,8152,8580
202007,11170,서울특별시,용산구,65-69세,11717,5426,6291
202008,11170,서울특별시,용산구,65-69세,11772,5458,6314
202009,11170,서울특별시,용산구,65-69세,11835,5499,6336
202010,11170,서울특별시,용산구,65-69세,11921,5549,6372
202011,11170,서울특별시,용산구,65-69세,11955,5550,6405
202012,11170,서울특별시,용산구,65-69세,12006,5603,6403
202101,11170,서울특별시,용산구,65-69세,12072,5646,6426
202102,11170,서울특별시,용산구,65-69세,12179,5700,6479
202103,11170,서울특별시,용산구,65-69세,12075,5685,6390
202104,11170,서울특별시,용산구,65-69세,12143,5711,6432
202105,11170,서울특별시,용산구,65-69세,12118,5713,6405
202106,11170,서울특별시,용산구,65-69세,12123,5723,6400
202007,11170,서울특별시,용산구,70-74세,9333,4108,5225
202008,11170,서울특별시,용산구,70-74세,9302,4080,5222
202009,11170,서울특별시,용산구,70-74세,9316,4074,5242
202010,11170,서울특별시,용산구,70-74세,9376,4106,5270
202011,11170,서울특별시,용산구,70-74세,9409,4134,5275
202012,11170,서울특별시,용산구,70-74세,9415,4126,5289
202101,11170,서울특별시,용산구,70-74세,9478,4169,5309
202102,11170,서울특별시,용산구,70-74세,9481,4171,5310
202103,11170,서울특별시,용산구,70-74세,9302,4149,5153
202104,11170,서울특별시,용산구,70-74세,9269,4133,5136
202105,11170,서울특별시,용산구,70-74세,9159,4108,5051
202106,11170,서울특별시,용산구,70-74세,9011,4059,4952
202007,11170,서울특별시,용산구,75-79세,7911,3372,4539
202008,11170,서울특별시,용산구,75-79세,7946,3385,4561
202009,11170,서울특별시,용산구,75-79세,7939,3373,4566
202010,11170,서울특별시,용산구,75-79세,7881,3332,4549
202011,11170,서울특별시,용산구,75-79세,7839,3306,4533
202012,11170,서울특별시,용산구,75-79세,7788,3275,4513
202101,11170,서울특별시,용산구,75-79세,7771,3257,4514
202102,11170,서울특별시,용산구,75-79세,7704,3236,4468
202103,11170,서울특별시,용산구,75-79세,7537,3154,4383
202104,11170,서울특별시,용산구,75-79세,7542,3170,4372
202105,11170,서울특별시,용산구,75-79세,7423,3120,4303
202106,11170,서울특별시,용산구,75-79세,7319,3066,4253
202007,11170,서울특별시,용산구,80-84세,5583,2128,3455
202008,11170,서울특별시,용산구,80-84세,5587,2134,3453
202009,11170,서울특별시,용산구,80-84세,5600,2153,3447
202010,11170,서울특별시,용산구,80-84세,5622,2177,3445
202011,11170,서울특별시,용산구,80-84세,5632,2184,3448
202012,11170,서울특별시,용산구,80-84세,5640,2183,3457
202101,11170,서울특별시,용산구,80-84세,5662,2195,3467
202102,11170,서울특별시,용산구,80-84세,5688,2207,3481
202103,11170,서울특별시,용산구,80-84세,5595,2185,3410
202104,11170,서울특별시,용산구,80-84세,5598,2184,3414
202105,11170,서울특별시,용산구,80-84세,5541,2176,3365
202106,11170,서울특별시,용산구,80-84세,5499,2158,3341
202007,11170,서울특별시,용산구,85-89세,2813,992,1821
202008,11170,서울특별시,용산구,85-89세,2833,1003,1830
202009,11170,서울특별시,용산구,85-89세,2852,1010,1842
202010,11170,서울특별시,용산구,85-89세,2878,1014,1864
202011,11170,서울특별시,용산구,85-89세,2912,1025,1887
202012,11170,서울특별시,용산구,85-89세,2932,1036,1896
202101,11170,서울특별시,용산구,85-89세,2975,1040,1935
202102,11170,서울특별시,용산구,85-89세,3030,1060,1970
202103,11170,서울특별시,용산구,85-89세,3003,1038,1965
202104,11170,서울특별시,용산구,85-89세,3032,1047,1985
202105,11170,서울특별시,용산구,85-89세,2998,1030,1968
202106,11170,서울특별시,용산구,85-89세,2958,1005,1953
202007,11170,서울특별시,용산구,90-94세,1175,342,833
202008,11170,서울특별시,용산구,90-94세,1177,345,832
202009,11170,서울특별시,용산구,90-94세,1190,349,841
202010,11170,서울특별시,용산구,90-94세,1194,353,841
202011,11170,서울특별시,용산구,90-94세,1200,348,852
202012,11170,서울특별시,용산구,90-94세,1193,346,847
202101,11170,서울특별시,용산구,90-94세,1201,356,845
202102,11170,서울특별시,용산구,90-94세,1190,355,835
202103,11170,서울특별시,용산구,90-94세,1101,323,778
202104,11170,서울특별시,용산구,90-94세,1112,328,784
202105,11170,서울특별시,용산구,90-94세,1093,323,770
202106,11170,서울특별시,용산구,90-94세,1072,312,760
202007,11170,서울특별시,용산구,95-99세,421,160,261
202008,11170,서울특별시,용산구,95-99세,422,161,261
202009,11170,서울특별시,용산구,95-99세,425,160,265
202010,11170,서울특별시,용산구,95-99세,426,159,267
202011,11170,서울특별시,용산구,95-99세,432,159,273
202012,11170,서울특별시,용산구,95-99세,434,157,277
202101,11170,서울특별시,용산구,95-99세,430,152,278
202102,11170,서울특별시,용산구,95-99세,433,149,284
202103,11170,서울특별시,용산구,95-99세,324,101,223
202104,11170,서울특별시,용산구,95-99세,328,103,225
202105,11170,서울특별시,용산구,95-99세,311,99,212
202106,11170,서울특별시,용산구,95-99세,302,92,210
202007,11170,서울특별시,용산구,100+,365,106,259
202008,11170,서울특별시,용산구,100+,368,106,262
202009,11170,서울특별시,용산구,100+,367,104,263
202010,11170,서울특별시,용산구,100+,367,105,262
202011,11170,서울특별시,용산구,100+,370,107,263
202012,11170,서울특별시,용산구,100+,371,107,264
202101,11170,서울특별시,용산구,100+,374,110,264
202102,11170,서울특별시,용산구,100+,373,113,260
202103,11170,서울특별시,용산구,100+,111,34,77
202104,11170,서울특별시,용산구,100+,114,35,79
202105,11170,서울특별시,용산구,100+,103,32,71
202106,11170,서울특별시,용산구,100+,91,27,64
202007,11200,서울특별시,성동구,0-4세,10435,5378,5057
202008,11200,서울특별시,성동구,0-4세,10306,5316,4990
202009,11200,서울특별시,성동구,0-4세,10255,5293,4962
202010,11200,서울특별시,성동구,0-4세,10180,5257,4923
202011,11200,서울특별시,성동구,0-4세,10144,5229,4915
202012,11200,서울특별시,성동구,0-4세,10061,5191,4870
202101,11200,서울특별시,성동구,0-4세,9979,5150,4829
202102,11200,서울특별시,성동구,0-4세,9905,5113,4792
202103,11200,서울특별시,성동구,0-4세,9796,5026,4770
202104,11200,서울특별시,성동구,0-4세,9784,5015,4769
202105,11200,서울특별시,성동구,0-4세,9738,4990,4748
202106,11200,서울특별시,성동구,0-4세,9683,4965,4718
202007,11200,서울특별시,성동구,5-9세,10603,5382,5221
202008,11200,서울특별시,성동구,5-9세,10595,5395,5200
202009,11200,서울특별시,성동구,5-9세,10564,5371,5193
202010,11200,서울특별시,성동구,5-9세,10491,5336,5155
202011,11200,서울특별시,성동구,5-9세,10441,5300,5141
202012,11200,서울특별시,성동구,5-9세,10388,5278,5110
202101,11200,서울특별시,성동구,5-9세,10318,5238,5080
202102,11200,서울특별시,성동구,5-9세,10217,5187,5030
202103,11200,서울특별시,성동구,5-9세,10161,5157,5004
202104,11200,서울특별시,성동구,5-9세,10156,5155,5001
202105,11200,서울특별시,성동구,5-9세,10149,5154,4995
202106,11200,서울특별시,성동구,5-9세,10159,5155,5004
202007,11200,서울특별시,성동구,10-14세,9322,4788,4534
202008,11200,서울특별시,성동구,10-14세,9270,4745,4525
202009,11200,서울특별시,성동구,10-14세,9241,4719,4522
202010,11200,서울특별시,성동구,10-14세,9210,4699,4511
202011,11200,서울특별시,성동구,10-14세,9175,4665,4510
202012,11200,서울특별시,성동구,10-14세,9117,4629,4488
202101,11200,서울특별시,성동구,10-14세,9112,4627,4485
202102,11200,서울특별시,성동구,10-14세,9057,4610,4447
202103,11200,서울특별시,성동구,10-14세,9070,4625,4445
202104,11200,서울특별시,성동구,10-14세,9074,4626,4448
202105,11200,서울특별시,성동구,10-14세,9053,4627,4426
202106,11200,서울특별시,성동구,10-14세,9064,4642,4422
202007,11200,서울특별시,성동구,15-19세,11337,5558,5779
202008,11200,서울특별시,성동구,15-19세,11217,5489,5728
202009,11200,서울특별시,성동구,15-19세,11109,5452,5657
202010,11200,서울특별시,성동구,15-19세,10927,5351,5576
202011,11200,서울특별시,성동구,15-19세,10795,5293,5502
202012,11200,서울특별시,성동구,15-19세,10698,5262,5436
202101,11200,서울특별시,성동구,15-19세,10567,5188,5379
202102,11200,서울특별시,성동구,15-19세,10576,5213,5363
202103,11200,서울특별시,성동구,15-19세,10599,5195,5404
202104,11200,서울특별시,성동구,15-19세,10502,5140,5362
202105,11200,서울특별시,성동구,15-19세,10426,5088,5338
202106,11200,서울특별시,성동구,15-19세,10349,5047,5302
202007,11200,서울특별시,성동구,20-24세,20069,9700,10369
202008,11200,서울특별시,성동구,20-24세,19983,9665,10318
202009,11200,서울특별시,성동구,20-24세,19854,9615,10239
202010,11200,서울특별시,성동구,20-24세,19792,9572,10220
202011,11200,서울특별시,성동구,20-24세,19676,9522,10154
202012,11200,서울특별시,성동구,20-24세,19590,9447,10143
202101,11200,서울특별시,성동구,20-24세,19492,9413,10079
202102,11200,서울특별시,성동구,20-24세,19382,9374,10008
202103,11200,서울특별시,성동구,20-24세,19393,9370,10023
202104,11200,서울특별시,성동구,20-24세,19336,9323,10013
202105,11200,서울특별시,성동구,20-24세,19250,9280,9970
202106,11200,서울특별시,성동구,20-24세,19169,9216,9953
202007,11200,서울특별시,성동구,25-29세,25528,12844,12684
202008,11200,서울특별시,성동구,25-29세,25478,12827,12651
202009,11200,서울특별시,성동구,25-29세,25466,12829,12637
202010,11200,서울특별시,성동구,25-29세,25482,12809,12673
202011,11200,서울특별시,성동구,25-29세,25469,12806,12663
202012,11200,서울특별시,성동구,25-29세,25453,12824,12629
202101,11200,서울특별시,성동구,25-29세,25331,12772,12559
202102,11200,서울특별시,성동구,25-29세,25144,12658,12486
202103,11200,서울특별시,성동구,25-29세,25276,12689,12587
202104,11200,서울특별시,성동구,25-29세,25264,12700,12564
202105,11200,서울특별시,성동구,25-29세,25238,12655,12583
202106,11200,서울특별시,성동구,25-29세,25205,12647,12558
202007,11200,서울특별시,성동구,30-34세,24074,11527,12547
202008,11200,서울특별시,성동구,30-34세,23995,11515,12480
202009,11200,서울특별시,성동구,30-34세,23916,11465,12451
202010,11200,서울특별시,성동구,30-34세,23790,11406,12384
202011,11200,서울특별시,성동구,30-34세,23772,11402,12370
202012,11200,서울특별시,성동구,30-34세,23676,11327,12349
202101,11200,서울특별시,성동구,30-34세,23660,11316,12344
202102,11200,서울특별시,성동구,30-34세,23575,11271,12304
202103,11200,서울특별시,성동구,30-34세,23475,11228,12247
202104,11200,서울특별시,성동구,30-34세,23520,11252,12268
202105,11200,서울특별시,성동구,30-34세,23426,11191,12235
202106,11200,서울특별시,성동구,30-34세,23425,11174,12251
202007,11200,서울특별시,성동구,35-39세,25686,12920,12766
202008,11200,서울특별시,성동구,35-39세,25563,12838,12725
202009,11200,서울특별시,성동구,35-39세,25483,12839,12644
202010,11200,서울특별시,성동구,35-39세,25451,12813,12638
202011,11200,서울특별시,성동구,35-39세,25366,12766,12600
202012,11200,서울특별시,성동구,35-39세,25229,12705,12524
202101,11200,서울특별시,성동구,35-39세,25070,12596,12474
202102,11200,서울특별시,성동구,35-39세,24949,12582,12367
202103,11200,서울특별시,성동구,35-39세,24775,12494,12281
202104,11200,서울특별시,성동구,35-39세,24612,12387,12225
202105,11200,서울특별시,성동구,35-39세,24402,12298,12104
202106,11200,서울특별시,성동구,35-39세,24281,12224,12057
202007,11200,서울특별시,성동구,40-44세,21978,11138,10840
202008,11200,서울특별시,성동구,40-44세,21989,11154,10835
202009,11200,서울특별시,성동구,40-44세,22031,11166,10865
202010,11200,서울특별시,성동구,40-44세,22056,11208,10848
202011,11200,서울특별시,성동구,40-44세,22050,11218,10832
202012,11200,서울특별시,성동구,40-44세,21994,11224,10770
202101,11200,서울특별시,성동구,40-44세,22054,11259,10795
202102,11200,서울특별시,성동구,40-44세,22064,11258,10806
202103,11200,서울특별시,성동구,40-44세,21941,11157,10784
202104,11200,서울특별시,성동구,40-44세,21921,11151,10770
202105,11200,서울특별시,성동구,40-44세,21881,11129,10752
202106,11200,서울특별시,성동구,40-44세,21965,11174,10791
202007,11200,서울특별시,성동구,45-49세,23868,11851,12017
202008,11200,서울특별시,성동구,45-49세,23734,11780,11954
202009,11200,서울특별시,성동구,45-49세,23533,11666,11867
202010,11200,서울특별시,성동구,45-49세,23301,11536,11765
202011,11200,서울특별시,성동구,45-49세,23179,11462,11717
202012,11200,서울특별시,성동구,45-49세,23026,11351,11675
202101,11200,서울특별시,성동구,45-49세,22889,11278,11611
202102,11200,서울특별시,성동구,45-49세,22762,11211,11551
202103,11200,서울특별시,성동구,45-49세,22634,11168,11466
202104,11200,서울특별시,성동구,45-49세,22512,11107,11405
202105,11200,서울특별시,성동구,45-49세,22180,10964,11216
202106,11200,서울특별시,성동구,45-49세,22023,10883,11140
202007,11200,서울특별시,성동구,50-54세,24188,11947,12241
202008,11200,서울특별시,성동구,50-54세,24082,11914,12168
202009,11200,서울특별시,성동구,50-54세,24108,11954,12154
202010,11200,서울특별시,성동구,50-54세,24131,11979,12152
202011,11200,서울특별시,성동구,50-54세,24066,11952,12114
202012,11200,서울특별시,성동구,50-54세,23919,11896,12023
202101,11200,서울특별시,성동구,50-54세,24043,11945,12098
202102,11200,서울특별시,성동구,50-54세,24122,11947,12175
202103,11200,서울특별시,성동구,50-54세,24072,11933,12139
202104,11200,서울특별시,성동구,50-54세,24058,11914,12144
202105,11200,서울특별시,성동구,50-54세,24019,11858,12161
202106,11200,서울특별시,성동구,50-54세,24038,11837,12201
202007,11200,서울특별시,성동구,55-59세,23577,11885,11692
202008,11200,서울특별시,성동구,55-59세,23503,11819,11684
202009,11200,서울특별시,성동구,55-59세,23393,11744,11649
202010,11200,서울특별시,성동구,55-59세,23328,11706,11622
202011,11200,서울특별시,성동구,55-59세,23281,11690,11591
202012,11200,서울특별시,성동구,55-59세,23329,11686,11643
202101,11200,서울특별시,성동구,55-59세,23205,11639,11566
202102,11200,서울특별시,성동구,55-59세,23125,11594,11531
202103,11200,서울특별시,성동구,55-59세,23044,11540,11504
202104,11200,서울특별시,성동구,55-59세,22958,11519,11439
202105,11200,서울특별시,성동구,55-59세,22693,11407,11286
202106,11200,서울특별시,성동구,55-59세,22476,11314,11162
202007,11200,서울특별시,성동구,60-64세,21279,10514,10765
202008,11200,서울특별시,성동구,60-64세,21356,10583,10773
202009,11200,서울특별시,성동구,60-64세,21439,10633,10806
202010,11200,서울특별시,성동구,60-64세,21496,10673,10823
202011,11200,서울특별시,성동구,60-64세,21569,10710,10859
202012,11200,서울특별시,성동구,60-64세,21641,10757,10884
202101,11200,서울특별시,성동구,60-64세,21709,10796,10913
202102,11200,서울특별시,성동구,60-64세,21822,10859,10963
202103,11200,서울특별시,성동구,60-64세,21887,10898,10989
202104,11200,서울특별시,성동구,60-64세,21923,10921,11002
202105,11200,서울특별시,성동구,60-64세,21847,10890,10957
202106,11200,서울특별시,성동구,60-64세,21915,10916,10999
202007,11200,서울특별시,성동구,65-69세,14607,6887,7720
202008,11200,서울특별시,성동구,65-69세,14700,6939,7761
202009,11200,서울특별시,성동구,65-69세,14774,6990,7784
202010,11200,서울특별시,성동구,65-69세,14813,7001,7812
202011,11200,서울특별시,성동구,65-69세,14824,7017,7807
202012,11200,서울특별시,성동구,65-69세,14893,7052,7841
202101,11200,서울특별시,성동구,65-69세,14988,7114,7874
202102,11200,서울특별시,성동구,65-69세,15086,7180,7906
202103,11200,서울특별시,성동구,65-69세,15224,7239,7985
202104,11200,서울특별시,성동구,65-69세,15307,7266,8041
202105,11200,서울특별시,성동구,65-69세,15161,7194,7967
202106,11200,서울특별시,성동구,65-69세,15217,7228,7989
202007,11200,서울특별시,성동구,70-74세,11372,5155,6217
202008,11200,서울특별시,성동구,70-74세,11375,5160,6215
202009,11200,서울특별시,성동구,70-74세,11377,5150,6227
202010,11200,서울특별시,성동구,70-74세,11425,5168,6257
202011,11200,서울특별시,성동구,70-74세,11472,5187,6285
202012,11200,서울특별시,성동구,70-74세,11533,5225,6308
202101,11200,서울특별시,성동구,70-74세,11606,5257,6349
202102,11200,서울특별시,성동구,70-74세,11636,5275,6361
202103,11200,서울특별시,성동구,70-74세,11641,5286,6355
202104,11200,서울특별시,성동구,70-74세,11648,5286,6362
202105,11200,서울특별시,성동구,70-74세,11460,5225,6235
202106,11200,서울특별시,성동구,70-74세,11412,5199,6213
202007,11200,서울특별시,성동구,75-79세,9249,4049,5200
202008,11200,서울특별시,성동구,75-79세,9261,4048,5213
202009,11200,서울특별시,성동구,75-79세,9242,4026,5216
202010,11200,서울특별시,성동구,75-79세,9162,3994,5168
202011,11200,서울특별시,성동구,75-79세,9115,3964,5151
202012,11200,서울특별시,성동구,75-79세,9053,3945,5108
202101,11200,서울특별시,성동구,75-79세,9021,3933,5088
202102,11200,서울특별시,성동구,75-79세,8978,3905,5073
202103,11200,서울특별시,성동구,75-79세,9000,3897,5103
202104,11200,서울특별시,성동구,75-79세,8974,3892,5082
202105,11200,서울특별시,성동구,75-79세,8811,3810,5001
202106,11200,서울특별시,성동구,75-79세,8818,3822,4996
202007,11200,서울특별시,성동구,80-84세,5723,2245,3478
202008,11200,서울특별시,성동구,80-84세,5755,2247,3508
202009,11200,서울특별시,성동구,80-84세,5776,2260,3516
202010,11200,서울특별시,성동구,80-84세,5816,2278,3538
202011,11200,서울특별시,성동구,80-84세,5823,2283,3540
202012,11200,서울특별시,성동구,80-84세,5871,2297,3574
202101,11200,서울특별시,성동구,80-84세,5913,2316,3597
202102,11200,서울특별시,성동구,80-84세,5940,2345,3595
202103,11200,서울특별시,성동구,80-84세,5900,2335,3565
202104,11200,서울특별시,성동구,80-84세,5938,2348,3590
202105,11200,서울특별시,성동구,80-84세,5934,2346,3588
202106,11200,서울특별시,성동구,80-84세,5966,2356,3610
202007,11200,서울특별시,성동구,85-89세,2609,878,1731
202008,11200,서울특별시,성동구,85-89세,2614,879,1735
202009,11200,서울특별시,성동구,85-89세,2607,880,1727
202010,11200,서울특별시,성동구,85-89세,2618,880,1738
202011,11200,서울특별시,성동구,85-89세,2627,887,1740
202012,11200,서울특별시,성동구,85-89세,2649,888,1761
202101,11200,서울특별시,성동구,85-89세,2704,908,1796
202102,11200,서울특별시,성동구,85-89세,2739,917,1822
202103,11200,서울특별시,성동구,85-89세,2780,932,1848
202104,11200,서울특별시,성동구,85-89세,2810,939,1871
202105,11200,서울특별시,성동구,85-89세,2787,933,1854
202106,11200,서울특별시,성동구,85-89세,2794,929,1865
202007,11200,서울특별시,성동구,90-94세,914,245,669
202008,11200,서울특별시,성동구,90-94세,922,247,675
202009,11200,서울특별시,성동구,90-94세,930,246,684
202010,11200,서울특별시,성동구,90-94세,928,247,681
202011,11200,서울특별시,성동구,90-94세,932,246,686
202012,11200,서울특별시,성동구,90-94세,933,256,677
202101,11200,서울특별시,성동구,90-94세,936,260,676
202102,11200,서울특별시,성동구,90-94세,957,264,693
202103,11200,서울특별시,성동구,90-94세,919,246,673
202104,11200,서울특별시,성동구,90-94세,927,247,680
202105,11200,서울특별시,성동구,90-94세,927,242,685
202106,11200,서울특별시,성동구,90-94세,927,239,688
202007,11200,서울특별시,성동구,95-99세,239,70,169
202008,11200,서울특별시,성동구,95-99세,242,72,170
202009,11200,서울특별시,성동구,95-99세,249,77,172
202010,11200,서울특별시,성동구,95-99세,250,77,173
202011,11200,서울특별시,성동구,95-99세,249,76,173
202012,11200,서울특별시,성동구,95-99세,252,75,177
202101,11200,서울특별시,성동구,95-99세,253,74,179
202102,11200,서울특별시,성동구,95-99세,248,69,179
202103,11200,서울특별시,성동구,95-99세,218,57,161
202104,11200,서울특별시,성동구,95-99세,208,55,153
202105,11200,서울특별시,성동구,95-99세,196,48,148
202106,11200,서울특별시,성동구,95-99세,195,46,149
202007,11200,서울특별시,성동구,100+,239,69,170
202008,11200,서울특별시,성동구,100+,243,69,174
202009,11200,서울특별시,성동구,100+,244,69,175
202010,11200,서울특별시,성동구,100+,248,69,179
202011,11200,서울특별시,성동구,100+,247,70,177
202012,11200,서울특별시,성동구,100+,251,72,179
202101,11200,서울특별시,성동구,100+,253,72,181
202102,11200,서울특별시,성동구,100+,253,72,181
202103,11200,서울특별시,성동구,100+,101,34,67
202104,11200,서울특별시,성동구,100+,102,34,68
202105,11200,서울특별시,성동구,100+,78,29,49
202106,11200,서울특별시,성동구,100+,81,29,52
202007,11215,서울특별시,광진구,0-4세,8965,4588,4377
202008,11215,서울특별시,광진구,0-4세,8832,4514,4318
202009,11215,서울특별시,광진구,0-4세,8703,4453,4250
202010,11215,서울특별시,광진구,0-4세,8573,4388,4185
202011,11215,서울특별시,광진구,0-4세,8452,4328,4124
202012,11215,서울특별시,광진구,0-4세,8351,4268,4083
202101,11215,서울특별시,광진구,0-4세,8214,4175,4039
202102,11215,서울특별시,광진구,0-4세,8095,4100,3995
202103,11215,서울특별시,광진구,0-4세,7957,4036,3921
202104,11215,서울특별시,광진구,0-4세,7902,4003,3899
202105,11215,서울특별시,광진구,0-4세,7837,3979,3858
202106,11215,서울특별시,광진구,0-4세,7788,3963,3825
202007,11215,서울특별시,광진구,5-9세,11521,5862,5659
202008,11215,서울특별시,광진구,5-9세,11455,5835,5620
202009,11215,서울특별시,광진구,5-9세,11382,5785,5597
202010,11215,서울특별시,광진구,5-9세,11331,5759,5572
202011,11215,서울특별시,광진구,5-9세,11247,5722,5525
202012,11215,서울특별시,광진구,5-9세,11221,5709,5512
202101,11215,서울특별시,광진구,5-9세,11114,5683,5431
202102,11215,서울특별시,광진구,5-9세,10965,5621,5344
202103,11215,서울특별시,광진구,5-9세,10925,5587,5338
202104,11215,서울특별시,광진구,5-9세,10831,5535,5296
202105,11215,서울특별시,광진구,5-9세,10805,5527,5278
202106,11215,서울특별시,광진구,5-9세,10788,5524,5264
202007,11215,서울특별시,광진구,10-14세,12191,6270,5921
202008,11215,서울특별시,광진구,10-14세,12191,6266,5925
202009,11215,서울특별시,광진구,10-14세,12200,6272,5928
202010,11215,서울특별시,광진구,10-14세,12222,6282,5940
202011,11215,서울특별시,광진구,10-14세,12263,6319,5944
202012,11215,서울특별시,광진구,10-14세,12237,6297,5940
202101,11215,서울특별시,광진구,10-14세,12225,6272,5953
202102,11215,서울특별시,광진구,10-14세,12160,6219,5941
202103,11215,서울특별시,광진구,10-14세,12123,6199,5924
202104,11215,서울특별시,광진구,10-14세,12095,6192,5903
202105,11215,서울특별시,광진구,10-14세,12103,6190,5913
202106,11215,서울특별시,광진구,10-14세,12061,6149,5912
202007,11215,서울특별시,광진구,15-19세,14364,7246,7118
202008,11215,서울특별시,광진구,15-19세,14246,7184,7062
202009,11215,서울특별시,광진구,15-19세,14150,7142,7008
202010,11215,서울특별시,광진구,15-19세,13990,7080,6910
202011,11215,서울특별시,광진구,15-19세,13869,6996,6873
202012,11215,서울특별시,광진구,15-19세,13694,6922,6772
202101,11215,서울특별시,광진구,15-19세,13549,6844,6705
202102,11215,서울특별시,광진구,15-19세,13479,6811,6668
202103,11215,서울특별시,광진구,15-19세,13418,6766,6652
202104,11215,서울특별시,광진구,15-19세,13335,6711,6624
202105,11215,서울특별시,광진구,15-19세,13259,6669,6590
202106,11215,서울특별시,광진구,15-19세,13259,6668,6591
202007,11215,서울특별시,광진구,20-24세,26539,12199,14340
202008,11215,서울특별시,광진구,20-24세,26535,12216,14319
202009,11215,서울특별시,광진구,20-24세,26455,12135,14320
202010,11215,서울특별시,광진구,20-24세,26330,12030,14300
202011,11215,서울특별시,광진구,20-24세,26241,11974,14267
202012,11215,서울특별시,광진구,20-24세,26193,11935,14258
202101,11215,서울특별시,광진구,20-24세,26032,11862,14170
202102,11215,서울특별시,광진구,20-24세,26039,11857,14182
202103,11215,서울특별시,광진구,20-24세,26006,11820,14186
202104,11215,서울특별시,광진구,20-24세,25905,11743,14162
202105,11215,서울특별시,광진구,20-24세,25806,11680,14126
202106,11215,서울특별시,광진구,20-24세,25671,11631,14040
202007,11215,서울특별시,광진구,25-29세,36085,17376,18709
202008,11215,서울특별시,광진구,25-29세,36172,17415,18757
202009,11215,서울특별시,광진구,25-29세,36271,17435,18836
202010,11215,서울특별시,광진구,25-29세,36454,17477,18977
202011,11215,서울특별시,광진구,25-29세,36572,17542,19030
202012,11215,서울특별시,광진구,25-29세,36747,17586,19161
202101,11215,서울특별시,광진구,25-29세,36698,17525,19173
202102,11215,서울특별시,광진구,25-29세,36413,17388,19025
202103,11215,서울특별시,광진구,25-29세,36490,17439,19051
202104,11215,서울특별시,광진구,25-29세,36591,17512,19079
202105,11215,서울특별시,광진구,25-29세,36621,17549,19072
202106,11215,서울특별시,광진구,25-29세,36681,17565,19116
202007,11215,서울특별시,광진구,30-34세,29537,14535,15002
202008,11215,서울특별시,광진구,30-34세,29466,14511,14955
202009,11215,서울특별시,광진구,30-34세,29332,14469,14863
202010,11215,서울특별시,광진구,30-34세,29223,14409,14814
202011,11215,서울특별시,광진구,30-34세,29183,14410,14773
202012,11215,서울특별시,광진구,30-34세,29113,14410,14703
202101,11215,서울특별시,광진구,30-34세,29165,14441,14724
202102,11215,서울특별시,광진구,30-34세,29145,14438,14707
202103,11215,서울특별시,광진구,30-34세,29110,14421,14689
202104,11215,서울특별시,광진구,30-34세,29124,14422,14702
202105,11215,서울특별시,광진구,30-34세,29202,14476,14726
202106,11215,서울특별시,광진구,30-34세,29172,14456,14716
202007,11215,서울특별시,광진구,35-39세,27430,13589,13841
202008,11215,서울특별시,광진구,35-39세,27233,13488,13745
202009,11215,서울특별시,광진구,35-39세,27123,13394,13729
202010,11215,서울특별시,광진구,35-39세,26985,13355,13630
202011,11215,서울특별시,광진구,35-39세,26933,13316,13617
202012,11215,서울특별시,광진구,35-39세,26870,13286,13584
202101,11215,서울특별시,광진구,35-39세,26737,13212,13525
202102,11215,서울특별시,광진구,35-39세,26565,13159,13406
202103,11215,서울특별시,광진구,35-39세,26322,13042,13280
202104,11215,서울특별시,광진구,35-39세,26200,12986,13214
202105,11215,서울특별시,광진구,35-39세,26041,12897,13144
202106,11215,서울특별시,광진구,35-39세,25956,12859,13097
202007,11215,서울특별시,광진구,40-44세,25101,12442,12659
202008,11215,서울특별시,광진구,40-44세,25089,12428,12661
202009,11215,서울특별시,광진구,40-44세,25010,12386,12624
202010,11215,서울특별시,광진구,40-44세,25051,12400,12651
202011,11215,서울특별시,광진구,40-44세,25002,12378,12624
202012,11215,서울특별시,광진구,40-44세,24874,12287,12587
202101,11215,서울특별시,광진구,40-44세,24869,12285,12584
202102,11215,서울특별시,광진구,40-44세,24845,12266,12579
202103,11215,서울특별시,광진구,40-44세,24716,12200,12516
202104,11215,서울특별시,광진구,40-44세,24777,12232,12545
202105,11215,서울특별시,광진구,40-44세,24834,12254,12580
202106,11215,서울특별시,광진구,40-44세,24825,12241,12584
202007,11215,서울특별시,광진구,45-49세,28391,13986,14405
202008,11215,서울특별시,광진구,45-49세,28171,13882,14289
202009,11215,서울특별시,광진구,45-49세,27987,13789,14198
202010,11215,서울특별시,광진구,45-49세,27815,13685,14130
202011,11215,서울특별시,광진구,45-49세,27716,13637,14079
202012,11215,서울특별시,광진구,45-49세,27608,13596,14012
202101,11215,서울특별시,광진구,45-49세,27462,13531,13931
202102,11215,서울특별시,광진구,45-49세,27328,13455,13873
202103,11215,서울특별시,광진구,45-49세,27032,13313,13719
202104,11215,서울특별시,광진구,45-49세,26882,13246,13636
202105,11215,서울특별시,광진구,45-49세,26622,13105,13517
202106,11215,서울특별시,광진구,45-49세,26451,13015,13436
202007,11215,서울특별시,광진구,50-54세,28234,13617,14617
202008,11215,서울특별시,광진구,50-54세,28169,13602,14567
202009,11215,서울특별시,광진구,50-54세,28233,13643,14590
202010,11215,서울특별시,광진구,50-54세,28254,13661,14593
202011,11215,서울특별시,광진구,50-54세,28214,13660,14554
202012,11215,서울특별시,광진구,50-54세,28122,13619,14503
202101,11215,서울특별시,광진구,50-54세,28235,13660,14575
202102,11215,서울특별시,광진구,50-54세,28266,13682,14584
202103,11215,서울특별시,광진구,50-54세,28085,13611,14474
202104,11215,서울특별시,광진구,50-54세,28026,13601,14425
202105,11215,서울특별시,광진구,50-54세,28175,13690,14485
202106,11215,서울특별시,광진구,50-54세,28218,13675,14543
202007,11215,서울특별시,광진구,55-59세,26771,13199,13572
202008,11215,서울특별시,광진구,55-59세,26757,13189,13568
202009,11215,서울특별시,광진구,55-59세,26637,13124,13513
202010,11215,서울특별시,광진구,55-59세,26614,13123,13491
202011,11215,서울특별시,광진구,55-59세,26528,13048,13480
202012,11215,서울특별시,광진구,55-59세,26419,12981,13438
202101,11215,서울특별시,광진구,55-59세,26223,12908,13315
202102,11215,서울특별시,광진구,55-59세,26125,12889,13236
202103,11215,서울특별시,광진구,55-59세,26033,12861,13172
202104,11215,서울특별시,광진구,55-59세,25948,12820,13128
202105,11215,서울특별시,광진구,55-59세,25794,12743,13051
202106,11215,서울특별시,광진구,55-59세,25612,12679,12933
202007,11215,서울특별시,광진구,60-64세,24722,11814,12908
202008,11215,서울특별시,광진구,60-64세,24732,11815,12917
202009,11215,서울특별시,광진구,60-64세,24788,11842,12946
202010,11215,서울특별시,광진구,60-64세,24830,11831,12999
202011,11215,서울특별시,광진구,60-64세,24888,11870,13018
202012,11215,서울특별시,광진구,60-64세,24922,11914,13008
202101,11215,서울특별시,광진구,60-64세,25013,11950,13063
202102,11215,서울특별시,광진구,60-64세,25102,11985,13117
202103,11215,서울특별시,광진구,60-64세,25097,11965,13132
202104,11215,서울특별시,광진구,60-64세,25170,12014,13156
202105,11215,서울특별시,광진구,60-64세,25314,12081,13233
202106,11215,서울특별시,광진구,60-64세,25466,12152,13314
202007,11215,서울특별시,광진구,65-69세,16962,8009,8953
202008,11215,서울특별시,광진구,65-69세,17099,8078,9021
202009,11215,서울특별시,광진구,65-69세,17243,8142,9101
202010,11215,서울특별시,광진구,65-69세,17332,8200,9132
202011,11215,서울특별시,광진구,65-69세,17447,8268,9179
202012,11215,서울특별시,광진구,65-69세,17538,8305,9233
202101,11215,서울특별시,광진구,65-69세,17672,8365,9307
202102,11215,서울특별시,광진구,65-69세,17785,8407,9378
202103,11215,서울특별시,광진구,65-69세,17817,8448,9369
202104,11215,서울특별시,광진구,65-69세,17866,8474,9392
202105,11215,서울특별시,광진구,65-69세,17960,8539,9421
202106,11215,서울특별시,광진구,65-69세,18065,8577,9488
202007,11215,서울특별시,광진구,70-74세,12638,5816,6822
202008,11215,서울특별시,광진구,70-74세,12638,5811,6827
202009,11215,서울특별시,광진구,70-74세,12694,5841,6853
202010,11215,서울특별시,광진구,70-74세,12737,5859,6878
202011,11215,서울특별시,광진구,70-74세,12797,5884,6913
202012,11215,서울특별시,광진구,70-74세,12852,5939,6913
202101,11215,서울특별시,광진구,70-74세,12870,5948,6922
202102,11215,서울특별시,광진구,70-74세,12881,5950,6931
202103,11215,서울특별시,광진구,70-74세,12665,5869,6796
202104,11215,서울특별시,광진구,70-74세,12707,5873,6834
202105,11215,서울특별시,광진구,70-74세,12725,5850,6875
202106,11215,서울특별시,광진구,70-74세,12710,5840,6870
202007,11215,서울특별시,광진구,75-79세,9706,4445,5261
202008,11215,서울특별시,광진구,75-79세,9722,4447,5275
202009,11215,서울특별시,광진구,75-79세,9678,4435,5243
202010,11215,서울특별시,광진구,75-79세,9665,4425,5240
202011,11215,서울특별시,광진구,75-79세,9622,4400,5222
202012,11215,서울특별시,광진구,75-79세,9576,4375,5201
202101,11215,서울특별시,광진구,75-79세,9545,4367,5178
202102,11215,서울특별시,광진구,75-79세,9526,4339,5187
202103,11215,서울특별시,광진구,75-79세,9389,4292,5097
202104,11215,서울특별시,광진구,75-79세,9365,4274,5091
202105,11215,서울특별시,광진구,75-79세,9342,4268,5074
202106,11215,서울특별시,광진구,75-79세,9347,4263,5084
202007,11215,서울특별시,광진구,80-84세,6006,2496,3510
202008,11215,서울특별시,광진구,80-84세,6016,2515,3501
202009,11215,서울특별시,광진구,80-84세,6007,2519,3488
202010,11215,서울특별시,광진구,80-84세,6021,2527,3494
202011,11215,서울특별시,광진구,80-84세,6091,2558,3533
202012,11215,서울특별시,광진구,80-84세,6105,2563,3542
202101,11215,서울특별시,광진구,80-84세,6169,2606,3563
202102,11215,서울특별시,광진구,80-84세,6203,2626,3577
202103,11215,서울특별시,광진구,80-84세,6151,2608,3543
202104,11215,서울특별시,광진구,80-84세,6181,2630,3551
202105,11215,서울특별시,광진구,80-84세,6242,2667,3575
202106,11215,서울특별시,광진구,80-84세,6272,2675,3597
202007,11215,서울특별시,광진구,85-89세,2613,872,1741
202008,11215,서울특별시,광진구,85-89세,2639,871,1768
202009,11215,서울특별시,광진구,85-89세,2691,888,1803
202010,11215,서울특별시,광진구,85-89세,2707,899,1808
202011,11215,서울특별시,광진구,85-89세,2734,906,1828
202012,11215,서울특별시,광진구,85-89세,2745,903,1842
202101,11215,서울특별시,광진구,85-89세,2763,906,1857
202102,11215,서울특별시,광진구,85-89세,2807,918,1889
202103,11215,서울특별시,광진구,85-89세,2803,922,1881
202104,11215,서울특별시,광진구,85-89세,2843,941,1902
202105,11215,서울특별시,광진구,85-89세,2861,945,1916
202106,11215,서울특별시,광진구,85-89세,2872,951,1921
202007,11215,서울특별시,광진구,90-94세,989,282,707
202008,11215,서울특별시,광진구,90-94세,986,280,706
202009,11215,서울특별시,광진구,90-94세,976,277,699
202010,11215,서울특별시,광진구,90-94세,979,280,699
202011,11215,서울특별시,광진구,90-94세,985,286,699
202012,11215,서울특별시,광진구,90-94세,990,290,700
202101,11215,서울특별시,광진구,90-94세,1006,299,707
202102,11215,서울특별시,광진구,90-94세,1012,298,714
202103,11215,서울특별시,광진구,90-94세,940,270,670
202104,11215,서울특별시,광진구,90-94세,942,267,675
202105,11215,서울특별시,광진구,90-94세,950,272,678
202106,11215,서울특별시,광진구,90-94세,954,272,682
202007,11215,서울특별시,광진구,95-99세,280,72,208
202008,11215,서울특별시,광진구,95-99세,283,73,210
202009,11215,서울특별시,광진구,95-99세,283,70,213
202010,11215,서울특별시,광진구,95-99세,282,69,213
202011,11215,서울특별시,광진구,95-99세,281,70,211
202012,11215,서울특별시,광진구,95-99세,287,71,216
202101,11215,서울특별시,광진구,95-99세,290,70,220
202102,11215,서울특별시,광진구,95-99세,288,72,216
202103,11215,서울특별시,광진구,95-99세,242,59,183
202104,11215,서울특별시,광진구,95-99세,243,60,183
202105,11215,서울특별시,광진구,95-99세,247,61,186
202106,11215,서울특별시,광진구,95-99세,242,60,182
202007,11215,서울특별시,광진구,100+,213,51,162
202008,11215,서울특별시,광진구,100+,216,52,164
202009,11215,서울특별시,광진구,100+,221,54,167
202010,11215,서울특별시,광진구,100+,220,55,165
202011,11215,서울특별시,광진구,100+,220,54,166
202012,11215,서울특별시,광진구,100+,218,54,164
202101,11215,서울특별시,광진구,100+,216,55,161
202102,11215,서울특별시,광진구,100+,219,55,164
202103,11215,서울특별시,광진구,100+,71,19,52
202104,11215,서울특별시,광진구,100+,73,19,54
202105,11215,서울특별시,광진구,100+,72,19,53
202106,11215,서울특별시,광진구,100+,71,18,53
202007,11230,서울특별시,동대문구,0-4세,9872,5052,4820
202008,11230,서울특별시,동대문구,0-4세,9785,5005,4780
202009,11230,서울특별시,동대문구,0-4세,9748,4988,4760
202010,11230,서울특별시,동대문구,0-4세,9654,4925,4729
202011,11230,서울특별시,동대문구,0-4세,9598,4900,4698
202012,11230,서울특별시,동대문구,0-4세,9517,4853,4664
202101,11230,서울특별시,동대문구,0-4세,9367,4764,4603
202102,11230,서울특별시,동대문구,0-4세,9240,4711,4529
202103,11230,서울특별시,동대문구,0-4세,9174,4668,4506
202104,11230,서울특별시,동대문구,0-4세,9106,4643,4463
202105,11230,서울특별시,동대문구,0-4세,9045,4602,4443
202106,11230,서울특별시,동대문구,0-4세,9007,4572,4435
202007,11230,서울특별시,동대문구,5-9세,11507,5877,5630
202008,11230,서울특별시,동대문구,5-9세,11440,5847,5593
202009,11230,서울특별시,동대문구,5-9세,11402,5857,5545
202010,11230,서울특별시,동대문구,5-9세,11356,5842,5514
202011,11230,서울특별시,동대문구,5-9세,11318,5825,5493
202012,11230,서울특별시,동대문구,5-9세,11271,5809,5462
202101,11230,서울특별시,동대문구,5-9세,11186,5787,5399
202102,11230,서울특별시,동대문구,5-9세,11098,5732,5366
202103,11230,서울특별시,동대문구,5-9세,11045,5715,5330
202104,11230,서울특별시,동대문구,5-9세,11021,5688,5333
202105,11230,서울특별시,동대문구,5-9세,11027,5715,5312
202106,11230,서울특별시,동대문구,5-9세,10975,5690,5285
202007,11230,서울특별시,동대문구,10-14세,11059,5661,5398
202008,11230,서울특별시,동대문구,10-14세,11050,5656,5394
202009,11230,서울특별시,동대문구,10-14세,11071,5660,5411
202010,11230,서울특별시,동대문구,10-14세,11052,5660,5392
202011,11230,서울특별시,동대문구,10-14세,11035,5630,5405
202012,11230,서울특별시,동대문구,10-14세,11058,5661,5397
202101,11230,서울특별시,동대문구,10-14세,11099,5667,5432
202102,11230,서울특별시,동대문구,10-14세,11048,5647,5401
202103,11230,서울특별시,동대문구,10-14세,11038,5647,5391
202104,11230,서울특별시,동대문구,10-14세,11031,5647,5384
202105,11230,서울특별시,동대문구,10-14세,11006,5620,5386
202106,11230,서울특별시,동대문구,10-14세,11021,5622,5399
202007,11230,서울특별시,동대문구,15-19세,13389,6690,6699
202008,11230,서울특별시,동대문구,15-19세,13258,6648,6610
202009,11230,서울특별시,동대문구,15-19세,13086,6555,6531
202010,11230,서울특별시,동대문구,15-19세,12908,6470,6438
202011,11230,서울특별시,동대문구,15-19세,12723,6388,6335
202012,11230,서울특별시,동대문구,15-19세,12589,6305,6284
202101,11230,서울특별시,동대문구,15-19세,12415,6227,6188
202102,11230,서울특별시,동대문구,15-19세,12462,6228,6234
202103,11230,서울특별시,동대문구,15-19세,12496,6247,6249
202104,11230,서울특별시,동대문구,15-19세,12393,6191,6202
202105,11230,서울특별시,동대문구,15-19세,12279,6144,6135
202106,11230,서울특별시,동대문구,15-19세,12224,6132,6092
202007,11230,서울특별시,동대문구,20-24세,26180,12246,13934
202008,11230,서울특별시,동대문구,20-24세,26237,12286,13951
202009,11230,서울특별시,동대문구,20-24세,26207,12244,13963
202010,11230,서울특별시,동대문구,20-24세,26205,12196,14009
202011,11230,서울특별시,동대문구,20-24세,26127,12131,13996
202012,11230,서울특별시,동대문구,20-24세,26031,12053,13978
202101,11230,서울특별시,동대문구,20-24세,25829,11952,13877
202102,11230,서울특별시,동대문구,20-24세,25914,11992,13922
202103,11230,서울특별시,동대문구,20-24세,26000,11987,14013
202104,11230,서울특별시,동대문구,20-24세,25891,11877,14014
202105,11230,서울특별시,동대문구,20-24세,25825,11855,13970
202106,11230,서울특별시,동대문구,20-24세,25736,11786,13950
202007,11230,서울특별시,동대문구,25-29세,30006,15806,14200
202008,11230,서울특별시,동대문구,25-29세,30048,15854,14194
202009,11230,서울특별시,동대문구,25-29세,30153,15889,14264
202010,11230,서울특별시,동대문구,25-29세,30178,15913,14265
202011,11230,서울특별시,동대문구,25-29세,30247,15949,14298
202012,11230,서울특별시,동대문구,25-29세,30300,15925,14375
202101,11230,서울특별시,동대문구,25-29세,30256,15868,14388
202102,11230,서울특별시,동대문구,25-29세,30123,15796,14327
202103,11230,서울특별시,동대문구,25-29세,30228,15868,14360
202104,11230,서울특별시,동대문구,25-29세,30253,15876,14377
202105,11230,서울특별시,동대문구,25-29세,30344,15861,14483
202106,11230,서울특별시,동대문구,25-29세,30422,15895,14527
202007,11230,서울특별시,동대문구,30-34세,24422,12695,11727
202008,11230,서울특별시,동대문구,30-34세,24392,12654,11738
202009,11230,서울특별시,동대문구,30-34세,24405,12641,11764
202010,11230,서울특별시,동대문구,30-34세,24388,12584,11804
202011,11230,서울특별시,동대문구,30-34세,24407,12625,11782
202012,11230,서울특별시,동대문구,30-34세,24435,12658,11777
202101,11230,서울특별시,동대문구,30-34세,24431,12616,11815
202102,11230,서울특별시,동대문구,30-34세,24455,12586,11869
202103,11230,서울특별시,동대문구,30-34세,24466,12603,11863
202104,11230,서울특별시,동대문구,30-34세,24448,12594,11854
202105,11230,서울특별시,동대문구,30-34세,24446,12596,11850
202106,11230,서울특별시,동대문구,30-34세,24469,12580,11889
202007,11230,서울특별시,동대문구,35-39세,26386,13592,12794
202008,11230,서울특별시,동대문구,35-39세,26217,13525,12692
202009,11230,서울특별시,동대문구,35-39세,26093,13453,12640
202010,11230,서울특별시,동대문구,35-39세,25909,13361,12548
202011,11230,서울특별시,동대문구,35-39세,25844,13323,12521
202012,11230,서울특별시,동대문구,35-39세,25740,13259,12481
202101,11230,서울특별시,동대문구,35-39세,25513,13161,12352
202102,11230,서울특별시,동대문구,35-39세,25325,13081,12244
202103,11230,서울특별시,동대문구,35-39세,25078,12944,12134
202104,11230,서울특별시,동대문구,35-39세,25028,12921,12107
202105,11230,서울특별시,동대문구,35-39세,24886,12871,12015
202106,11230,서울특별시,동대문구,35-39세,24793,12848,11945
202007,11230,서울특별시,동대문구,40-44세,24375,12648,11727
202008,11230,서울특별시,동대문구,40-44세,24329,12613,11716
202009,11230,서울특별시,동대문구,40-44세,24380,12650,11730
202010,11230,서울특별시,동대문구,40-44세,24432,12665,11767
202011,11230,서울특별시,동대문구,40-44세,24376,12620,11756
202012,11230,서울특별시,동대문구,40-44세,24284,12588,11696
202101,11230,서울특별시,동대문구,40-44세,24264,12590,11674
202102,11230,서울특별시,동대문구,40-44세,24298,12618,11680
202103,11230,서울특별시,동대문구,40-44세,24181,12591,11590
202104,11230,서울특별시,동대문구,40-44세,24174,12569,11605
202105,11230,서울특별시,동대문구,40-44세,24230,12553,11677
202106,11230,서울특별시,동대문구,40-44세,24272,12527,11745
202007,11230,서울특별시,동대문구,45-49세,27172,13976,13196
202008,11230,서울특별시,동대문구,45-49세,27040,13932,13108
202009,11230,서울특별시,동대문구,45-49세,26781,13793,12988
202010,11230,서울특별시,동대문구,45-49세,26573,13684,12889
202011,11230,서울특별시,동대문구,45-49세,26460,13616,12844
202012,11230,서울특별시,동대문구,45-49세,26346,13536,12810
202101,11230,서울특별시,동대문구,45-49세,26177,13449,12728
202102,11230,서울특별시,동대문구,45-49세,26057,13375,12682
202103,11230,서울특별시,동대문구,45-49세,25656,13170,12486
202104,11230,서울특별시,동대문구,45-49세,25536,13110,12426
202105,11230,서울특별시,동대문구,45-49세,25327,13016,12311
202106,11230,서울특별시,동대문구,45-49세,25203,12966,12237
202007,11230,서울특별시,동대문구,50-54세,27131,13733,13398
202008,11230,서울특별시,동대문구,50-54세,27086,13688,13398
202009,11230,서울특별시,동대문구,50-54세,27198,13755,13443
202010,11230,서울특별시,동대문구,50-54세,27167,13733,13434
202011,11230,서울특별시,동대문구,50-54세,27216,13776,13440
202012,11230,서울특별시,동대문구,50-54세,27119,13733,13386
202101,11230,서울특별시,동대문구,50-54세,27265,13799,13466
202102,11230,서울특별시,동대문구,50-54세,27344,13870,13474
202103,11230,서울특별시,동대문구,50-54세,27051,13755,13296
202104,11230,서울특별시,동대문구,50-54세,27018,13721,13297
202105,11230,서울특별시,동대문구,50-54세,27096,13761,13335
202106,11230,서울특별시,동대문구,50-54세,27149,13770,13379
202007,11230,서울특별시,동대문구,55-59세,26677,13329,13348
202008,11230,서울특별시,동대문구,55-59세,26546,13263,13283
202009,11230,서울특별시,동대문구,55-59세,26406,13195,13211
202010,11230,서울특별시,동대문구,55-59세,26298,13147,13151
202011,11230,서울특별시,동대문구,55-59세,26161,13090,13071
202012,11230,서울특별시,동대문구,55-59세,26143,13121,13022
202101,11230,서울특별시,동대문구,55-59세,25956,13067,12889
202102,11230,서울특별시,동대문구,55-59세,25851,13000,12851
202103,11230,서울특별시,동대문구,55-59세,25598,12900,12698
202104,11230,서울특별시,동대문구,55-59세,25504,12883,12621
202105,11230,서울특별시,동대문구,55-59세,25331,12805,12526
202106,11230,서울특별시,동대문구,55-59세,25148,12762,12386
202007,11230,서울특별시,동대문구,60-64세,26186,12785,13401
202008,11230,서울특별시,동대문구,60-64세,26224,12812,13412
202009,11230,서울특별시,동대문구,60-64세,26271,12844,13427
202010,11230,서울특별시,동대문구,60-64세,26328,12851,13477
202011,11230,서울특별시,동대문구,60-64세,26395,12878,13517
202012,11230,서울특별시,동대문구,60-64세,26392,12870,13522
202101,11230,서울특별시,동대문구,60-64세,26385,12862,13523
202102,11230,서울특별시,동대문구,60-64세,26468,12887,13581
202103,11230,서울특별시,동대문구,60-64세,26212,12767,13445
202104,11230,서울특별시,동대문구,60-64세,26343,12849,13494
202105,11230,서울특별시,동대문구,60-64세,26474,12924,13550
202106,11230,서울특별시,동대문구,60-64세,26570,12979,13591
202007,11230,서울특별시,동대문구,65-69세,19516,9303,10213
202008,11230,서울특별시,동대문구,65-69세,19652,9372,10280
202009,11230,서울특별시,동대문구,65-69세,19782,9415,10367
202010,11230,서울특별시,동대문구,65-69세,19893,9475,10418
202011,11230,서울특별시,동대문구,65-69세,19950,9506,10444
202012,11230,서울특별시,동대문구,65-69세,20001,9530,10471
202101,11230,서울특별시,동대문구,65-69세,20182,9614,10568
202102,11230,서울특별시,동대문구,65-69세,20258,9667,10591
202103,11230,서울특별시,동대문구,65-69세,20135,9649,10486
202104,11230,서울특별시,동대문구,65-69세,20205,9688,10517
202105,11230,서울특별시,동대문구,65-69세,20288,9732,10556
202106,11230,서울특별시,동대문구,65-69세,20401,9770,10631
202007,11230,서울특별시,동대문구,70-74세,15369,7016,8353
202008,11230,서울특별시,동대문구,70-74세,15363,7018,8345
202009,11230,서울특별시,동대문구,70-74세,15394,7035,8359
202010,11230,서울특별시,동대문구,70-74세,15450,7053,8397
202011,11230,서울특별시,동대문구,70-74세,15518,7099,8419
202012,11230,서울특별시,동대문구,70-74세,15615,7148,8467
202101,11230,서울특별시,동대문구,70-74세,15617,7147,8470
202102,11230,서울특별시,동대문구,70-74세,15638,7161,8477
202103,11230,서울특별시,동대문구,70-74세,15287,7028,8259
202104,11230,서울특별시,동대문구,70-74세,15301,7026,8275
202105,11230,서울특별시,동대문구,70-74세,15308,7022,8286
202106,11230,서울특별시,동대문구,70-74세,15258,7007,8251
202007,11230,서울특별시,동대문구,75-79세,12839,5745,7094
202008,11230,서울특별시,동대문구,75-79세,12836,5737,7099
202009,11230,서울특별시,동대문구,75-79세,12804,5727,7077
202010,11230,서울특별시,동대문구,75-79세,12720,5692,7028
202011,11230,서울특별시,동대문구,75-79세,12637,5640,6997
202012,11230,서울특별시,동대문구,75-79세,12580,5589,6991
202101,11230,서울특별시,동대문구,75-79세,12570,5589,6981
202102,11230,서울특별시,동대문구,75-79세,12520,5552,6968
202103,11230,서울특별시,동대문구,75-79세,12281,5458,6823
202104,11230,서울특별시,동대문구,75-79세,12204,5426,6778
202105,11230,서울특별시,동대문구,75-79세,12181,5412,6769
202106,11230,서울특별시,동대문구,75-79세,12207,5427,6780
202007,11230,서울특별시,동대문구,80-84세,7696,3214,4482
202008,11230,서울특별시,동대문구,80-84세,7702,3224,4478
202009,11230,서울특별시,동대문구,80-84세,7753,3243,4510
202010,11230,서울특별시,동대문구,80-84세,7814,3262,4552
202011,11230,서울특별시,동대문구,80-84세,7829,3271,4558
202012,11230,서울특별시,동대문구,80-84세,7851,3287,4564
202101,11230,서울특별시,동대문구,80-84세,7900,3320,4580
202102,11230,서울특별시,동대문구,80-84세,7975,3354,4621
202103,11230,서울특별시,동대문구,80-84세,7816,3225,4591
202104,11230,서울특별시,동대문구,80-84세,7878,3254,4624
202105,11230,서울특별시,동대문구,80-84세,7937,3272,4665
202106,11230,서울특별시,동대문구,80-84세,7992,3299,4693
202007,11230,서울특별시,동대문구,85-89세,3492,1219,2273
202008,11230,서울특별시,동대문구,85-89세,3555,1239,2316
202009,11230,서울특별시,동대문구,85-89세,3575,1248,2327
202010,11230,서울특별시,동대문구,85-89세,3609,1257,2352
202011,11230,서울특별시,동대문구,85-89세,3656,1272,2384
202012,11230,서울특별시,동대문구,85-89세,3670,1287,2383
202101,11230,서울특별시,동대문구,85-89세,3703,1295,2408
202102,11230,서울특별시,동대문구,85-89세,3753,1317,2436
202103,11230,서울특별시,동대문구,85-89세,3641,1262,2379
202104,11230,서울특별시,동대문구,85-89세,3655,1269,2386
202105,11230,서울특별시,동대문구,85-89세,3694,1292,2402
202106,11230,서울특별시,동대문구,85-89세,3686,1295,2391
202007,11230,서울특별시,동대문구,90-94세,1211,331,880
202008,11230,서울특별시,동대문구,90-94세,1209,335,874
202009,11230,서울특별시,동대문구,90-94세,1229,339,890
202010,11230,서울특별시,동대문구,90-94세,1211,334,877
202011,11230,서울특별시,동대문구,90-94세,1203,331,872
202012,11230,서울특별시,동대문구,90-94세,1220,339,881
202101,11230,서울특별시,동대문구,90-94세,1234,343,891
202102,11230,서울특별시,동대문구,90-94세,1244,345,899
202103,11230,서울특별시,동대문구,90-94세,1143,311,832
202104,11230,서울특별시,동대문구,90-94세,1143,314,829
202105,11230,서울특별시,동대문구,90-94세,1159,314,845
202106,11230,서울특별시,동대문구,90-94세,1155,309,846
202007,11230,서울특별시,동대문구,95-99세,368,125,243
202008,11230,서울특별시,동대문구,95-99세,376,127,249
202009,11230,서울특별시,동대문구,95-99세,371,124,247
202010,11230,서울특별시,동대문구,95-99세,366,123,243
202011,11230,서울특별시,동대문구,95-99세,367,124,243
202012,11230,서울특별시,동대문구,95-99세,362,124,238
202101,11230,서울특별시,동대문구,95-99세,369,126,243
202102,11230,서울특별시,동대문구,95-99세,362,124,238
202103,11230,서울특별시,동대문구,95-99세,274,80,194
202104,11230,서울특별시,동대문구,95-99세,271,76,195
202105,11230,서울특별시,동대문구,95-99세,272,76,196
202106,11230,서울특별시,동대문구,95-99세,272,79,193
202007,11230,서울특별시,동대문구,100+,303,91,212
202008,11230,서울특별시,동대문구,100+,305,91,214
202009,11230,서울특별시,동대문구,100+,307,93,214
202010,11230,서울특별시,동대문구,100+,308,93,215
202011,11230,서울특별시,동대문구,100+,310,94,216
202012,11230,서울특별시,동대문구,100+,313,94,219
202101,11230,서울특별시,동대문구,100+,316,94,222
202102,11230,서울특별시,동대문구,100+,323,96,227
202103,11230,서울특별시,동대문구,100+,75,20,55
202104,11230,서울특별시,동대문구,100+,77,21,56
202105,11230,서울특별시,동대문구,100+,78,20,58
202106,11230,서울특별시,동대문구,100+,80,20,60
202007,11260,서울특별시,중랑구,0-4세,10885,5625,5260
202008,11260,서울특별시,중랑구,0-4세,10965,5660,5305
202009,11260,서울특별시,중랑구,0-4세,10891,5625,5266
202010,11260,서울특별시,중랑구,0-4세,10725,5530,5195
202011,11260,서울특별시,중랑구,0-4세,10629,5489,5140
202012,11260,서울특별시,중랑구,0-4세,10531,5434,5097
202101,11260,서울특별시,중랑구,0-4세,10433,5373,5060
202102,11260,서울특별시,중랑구,0-4세,10274,5270,5004
202103,11260,서울특별시,중랑구,0-4세,10110,5190,4920
202104,11260,서울특별시,중랑구,0-4세,10045,5154,4891
202105,11260,서울특별시,중랑구,0-4세,9950,5115,4835
202106,11260,서울특별시,중랑구,0-4세,9902,5107,4795
202007,11260,서울특별시,중랑구,5-9세,12689,6563,6126
202008,11260,서울특별시,중랑구,5-9세,12788,6607,6181
202009,11260,서울특별시,중랑구,5-9세,12737,6569,6168
202010,11260,서울특별시,중랑구,5-9세,12678,6553,6125
202011,11260,서울특별시,중랑구,5-9세,12592,6520,6072
202012,11260,서울특별시,중랑구,5-9세,12533,6487,6046
202101,11260,서울특별시,중랑구,5-9세,12455,6467,5988
202102,11260,서울특별시,중랑구,5-9세,12361,6427,5934
202103,11260,서울특별시,중랑구,5-9세,12303,6395,5908
202104,11260,서울특별시,중랑구,5-9세,12244,6366,5878
202105,11260,서울특별시,중랑구,5-9세,12197,6327,5870
202106,11260,서울특별시,중랑구,5-9세,12127,6285,5842
202007,11260,서울특별시,중랑구,10-14세,12396,6345,6051
202008,11260,서울특별시,중랑구,10-14세,12377,6323,6054
202009,11260,서울특별시,중랑구,10-14세,12391,6354,6037
202010,11260,서울특별시,중랑구,10-14세,12398,6349,6049
202011,11260,서울특별시,중랑구,10-14세,12403,6336,6067
202012,11260,서울특별시,중랑구,10-14세,12380,6307,6073
202101,11260,서울특별시,중랑구,10-14세,12377,6290,6087
202102,11260,서울특별시,중랑구,10-14세,12340,6281,6059
202103,11260,서울특별시,중랑구,10-14세,12306,6239,6067
202104,11260,서울특별시,중랑구,10-14세,12255,6215,6040
202105,11260,서울특별시,중랑구,10-14세,12248,6223,6025
202106,11260,서울특별시,중랑구,10-14세,12200,6202,5998
202007,11260,서울특별시,중랑구,15-19세,15018,7648,7370
202008,11260,서울특별시,중랑구,15-19세,14968,7645,7323
202009,11260,서울특별시,중랑구,15-19세,14901,7614,7287
202010,11260,서울특별시,중랑구,15-19세,14699,7495,7204
202011,11260,서울특별시,중랑구,15-19세,14539,7413,7126
202012,11260,서울특별시,중랑구,15-19세,14379,7336,7043
202101,11260,서울특별시,중랑구,15-19세,14240,7254,6986
202102,11260,서울특별시,중랑구,15-19세,14124,7184,6940
202103,11260,서울특별시,중랑구,15-19세,13982,7106,6876
202104,11260,서울특별시,중랑구,15-19세,13899,7055,6844
202105,11260,서울특별시,중랑구,15-19세,13795,7001,6794
202106,11260,서울특별시,중랑구,15-19세,13752,6969,6783
202007,11260,서울특별시,중랑구,20-24세,24072,12053,12019
202008,11260,서울특별시,중랑구,20-24세,24099,12038,12061
202009,11260,서울특별시,중랑구,20-24세,24020,11968,12052
202010,11260,서울특별시,중랑구,20-24세,23909,11892,12017
202011,11260,서울특별시,중랑구,20-24세,23773,11826,11947
202012,11260,서울특별시,중랑구,20-24세,23622,11758,11864
202101,11260,서울특별시,중랑구,20-24세,23492,11678,11814
202102,11260,서울특별시,중랑구,20-24세,23408,11636,11772
202103,11260,서울특별시,중랑구,20-24세,23304,11557,11747
202104,11260,서울특별시,중랑구,20-24세,23196,11518,11678
202105,11260,서울특별시,중랑구,20-24세,23070,11461,11609
202106,11260,서울특별시,중랑구,20-24세,22958,11411,11547
202007,11260,서울특별시,중랑구,25-29세,31911,15829,16082
202008,11260,서울특별시,중랑구,25-29세,32063,15927,16136
202009,11260,서울특별시,중랑구,25-29세,32166,15943,16223
202010,11260,서울특별시,중랑구,25-29세,32277,15987,16290
202011,11260,서울특별시,중랑구,25-29세,32360,16001,16359
202012,11260,서울특별시,중랑구,25-29세,32490,16035,16455
202101,11260,서울특별시,중랑구,25-29세,32553,16069,16484
202102,11260,서울특별시,중랑구,25-29세,32516,16057,16459
202103,11260,서울특별시,중랑구,25-29세,32634,16118,16516
202104,11260,서울특별시,중랑구,25-29세,32615,16095,16520
202105,11260,서울특별시,중랑구,25-29세,32581,16072,16509
202106,11260,서울특별시,중랑구,25-29세,32522,16034,16488
202007,11260,서울특별시,중랑구,30-34세,28466,14523,13943
202008,11260,서울특별시,중랑구,30-34세,28651,14601,14050
202009,11260,서울특별시,중랑구,30-34세,28763,14666,14097
202010,11260,서울특별시,중랑구,30-34세,28743,14663,14080
202011,11260,서울특별시,중랑구,30-34세,28784,14687,14097
202012,11260,서울특별시,중랑구,30-34세,28753,14674,14079
202101,11260,서울특별시,중랑구,30-34세,28742,14676,14066
202102,11260,서울특별시,중랑구,30-34세,28709,14653,14056
202103,11260,서울특별시,중랑구,30-34세,28701,14679,14022
202104,11260,서울특별시,중랑구,30-34세,28740,14708,14032
202105,11260,서울특별시,중랑구,30-34세,28773,14656,14117
202106,11260,서울특별시,중랑구,30-34세,28811,14677,14134
202007,11260,서울특별시,중랑구,35-39세,29825,15579,14246
202008,11260,서울특별시,중랑구,35-39세,29959,15645,14314
202009,11260,서울특별시,중랑구,35-39세,29786,15529,14257
202010,11260,서울특별시,중랑구,35-39세,29636,15447,14189
202011,11260,서울특별시,중랑구,35-39세,29478,15355,14123
202012,11260,서울특별시,중랑구,35-39세,29371,15282,14089
202101,11260,서울특별시,중랑구,35-39세,29237,15219,14018
202102,11260,서울특별시,중랑구,35-39세,29040,15112,13928
202103,11260,서울특별시,중랑구,35-39세,28743,14949,13794
202104,11260,서울특별시,중랑구,35-39세,28597,14850,13747
202105,11260,서울특별시,중랑구,35-39세,28350,14744,13606
202106,11260,서울특별시,중랑구,35-39세,28239,14683,13556
202007,11260,서울특별시,중랑구,40-44세,27256,14316,12940
202008,11260,서울특별시,중랑구,40-44세,27457,14424,13033
202009,11260,서울특별시,중랑구,40-44세,27536,14478,13058
202010,11260,서울특별시,중랑구,40-44세,27619,14491,13128
202011,11260,서울특별시,중랑구,40-44세,27673,14563,13110
202012,11260,서울특별시,중랑구,40-44세,27583,14562,13021
202101,11260,서울특별시,중랑구,40-44세,27594,14526,13068
202102,11260,서울특별시,중랑구,40-44세,27605,14566,13039
202103,11260,서울특별시,중랑구,40-44세,27459,14480,12979
202104,11260,서울특별시,중랑구,40-44세,27437,14452,12985
202105,11260,서울특별시,중랑구,40-44세,27478,14480,12998
202106,11260,서울특별시,중랑구,40-44세,27554,14532,13022
202007,11260,서울특별시,중랑구,45-49세,30983,15745,15238
202008,11260,서울특별시,중랑구,45-49세,30907,15720,15187
202009,11260,서울특별시,중랑구,45-49세,30771,15625,15146
202010,11260,서울특별시,중랑구,45-49세,30550,15539,15011
202011,11260,서울특별시,중랑구,45-49세,30355,15414,14941
202012,11260,서울특별시,중랑구,45-49세,30300,15389,14911
202101,11260,서울특별시,중랑구,45-49세,30146,15295,14851
202102,11260,서울특별시,중랑구,45-49세,29971,15176,14795
202103,11260,서울특별시,중랑구,45-49세,29684,15030,14654
202104,11260,서울특별시,중랑구,45-49세,29492,14950,14542
202105,11260,서울특별시,중랑구,45-49세,29154,14776,14378
202106,11260,서울특별시,중랑구,45-49세,28939,14671,14268
202007,11260,서울특별시,중랑구,50-54세,34234,16872,17362
202008,11260,서울특별시,중랑구,50-54세,34357,16887,17470
202009,11260,서울특별시,중랑구,50-54세,34449,16955,17494
202010,11260,서울특별시,중랑구,50-54세,34434,16949,17485
202011,11260,서울특별시,중랑구,50-54세,34329,16879,17450
202012,11260,서울특별시,중랑구,50-54세,34175,16811,17364
202101,11260,서울특별시,중랑구,50-54세,34354,16878,17476
202102,11260,서울특별시,중랑구,50-54세,34381,16909,17472
202103,11260,서울특별시,중랑구,50-54세,34136,16782,17354
202104,11260,서울특별시,중랑구,50-54세,34146,16785,17361
202105,11260,서울특별시,중랑구,50-54세,34192,16855,17337
202106,11260,서울특별시,중랑구,50-54세,34217,16849,17368
202007,11260,서울특별시,중랑구,55-59세,35627,17626,18001
202008,11260,서울특별시,중랑구,55-59세,35624,17639,17985
202009,11260,서울특별시,중랑구,55-59세,35523,17555,17968
202010,11260,서울특별시,중랑구,55-59세,35451,17527,17924
202011,11260,서울특별시,중랑구,55-59세,35387,17501,17886
202012,11260,서울특별시,중랑구,55-59세,35353,17456,17897
202101,11260,서울특별시,중랑구,55-59세,35082,17359,17723
202102,11260,서울특별시,중랑구,55-59세,34921,17283,17638
202103,11260,서울특별시,중랑구,55-59세,34676,17212,17464
202104,11260,서울특별시,중랑구,55-59세,34470,17094,17376
202105,11260,서울특별시,중랑구,55-59세,34252,16989,17263
202106,11260,서울특별시,중랑구,55-59세,34005,16904,17101
202007,11260,서울특별시,중랑구,60-64세,33127,16158,16969
202008,11260,서울특별시,중랑구,60-64세,33385,16309,17076
202009,11260,서울특별시,중랑구,60-64세,33516,16418,17098
202010,11260,서울특별시,중랑구,60-64세,33596,16458,17138
202011,11260,서울특별시,중랑구,60-64세,33768,16536,17232
202012,11260,서울특별시,중랑구,60-64세,33891,16585,17306
202101,11260,서울특별시,중랑구,60-64세,34065,16652,17413
202102,11260,서울특별시,중랑구,60-64세,34247,16751,17496
202103,11260,서울특별시,중랑구,60-64세,34294,16746,17548
202104,11260,서울특별시,중랑구,60-64세,34433,16820,17613
202105,11260,서울특별시,중랑구,60-64세,34513,16831,17682
202106,11260,서울특별시,중랑구,60-64세,34701,16937,17764
202007,11260,서울특별시,중랑구,65-69세,23558,11342,12216
202008,11260,서울특별시,중랑구,65-69세,23762,11423,12339
202009,11260,서울특별시,중랑구,65-69세,23965,11499,12466
202010,11260,서울특별시,중랑구,65-69세,24110,11568,12542
202011,11260,서울특별시,중랑구,65-69세,24252,11640,12612
202012,11260,서울특별시,중랑구,65-69세,24331,11669,12662
202101,11260,서울특별시,중랑구,65-69세,24523,11778,12745
202102,11260,서울특별시,중랑구,65-69세,24695,11846,12849
202103,11260,서울특별시,중랑구,65-69세,24813,11931,12882
202104,11260,서울특별시,중랑구,65-69세,24956,12016,12940
202105,11260,서울특별시,중랑구,65-69세,25068,12079,12989
202106,11260,서울특별시,중랑구,65-69세,25112,12073,13039
202007,11260,서울특별시,중랑구,70-74세,17684,8169,9515
202008,11260,서울특별시,중랑구,70-74세,17692,8181,9511
202009,11260,서울특별시,중랑구,70-74세,17763,8236,9527
202010,11260,서울특별시,중랑구,70-74세,17881,8292,9589
202011,11260,서울특별시,중랑구,70-74세,17973,8316,9657
202012,11260,서울특별시,중랑구,70-74세,18085,8373,9712
202101,11260,서울특별시,중랑구,70-74세,18253,8461,9792
202102,11260,서울특별시,중랑구,70-74세,18257,8467,9790
202103,11260,서울특별시,중랑구,70-74세,18050,8378,9672
202104,11260,서울특별시,중랑구,70-74세,18040,8370,9670
202105,11260,서울특별시,중랑구,70-74세,17963,8336,9627
202106,11260,서울특별시,중랑구,70-74세,17932,8322,9610
202007,11260,서울특별시,중랑구,75-79세,13400,6018,7382
202008,11260,서울특별시,중랑구,75-79세,13484,6057,7427
202009,11260,서울특별시,중랑구,75-79세,13463,6052,7411
202010,11260,서울특별시,중랑구,75-79세,13449,6045,7404
202011,11260,서울특별시,중랑구,75-79세,13410,6031,7379
202012,11260,서울특별시,중랑구,75-79세,13360,6011,7349
202101,11260,서울특별시,중랑구,75-79세,13298,5961,7337
202102,11260,서울특별시,중랑구,75-79세,13295,5955,7340
202103,11260,서울특별시,중랑구,75-79세,13220,5922,7298
202104,11260,서울특별시,중랑구,75-79세,13208,5910,7298
202105,11260,서울특별시,중랑구,75-79세,13159,5879,7280
202106,11260,서울특별시,중랑구,75-79세,13191,5904,7287
202007,11260,서울특별시,중랑구,80-84세,7915,3289,4626
202008,11260,서울특별시,중랑구,80-84세,7958,3303,4655
202009,11260,서울특별시,중랑구,80-84세,8019,3330,4689
202010,11260,서울특별시,중랑구,80-84세,8061,3363,4698
202011,11260,서울특별시,중랑구,80-84세,8068,3372,4696
202012,11260,서울특별시,중랑구,80-84세,8097,3386,4711
202101,11260,서울특별시,중랑구,80-84세,8184,3440,4744
202102,11260,서울특별시,중랑구,80-84세,8236,3460,4776
202103,11260,서울특별시,중랑구,80-84세,8232,3454,4778
202104,11260,서울특별시,중랑구,80-84세,8271,3480,4791
202105,11260,서울특별시,중랑구,80-84세,8330,3495,4835
202106,11260,서울특별시,중랑구,80-84세,8400,3523,4877
202007,11260,서울특별시,중랑구,85-89세,3476,1118,2358
202008,11260,서울특별시,중랑구,85-89세,3499,1132,2367
202009,11260,서울특별시,중랑구,85-89세,3539,1148,2391
202010,11260,서울특별시,중랑구,85-89세,3567,1156,2411
202011,11260,서울특별시,중랑구,85-89세,3612,1177,2435
202012,11260,서울특별시,중랑구,85-89세,3661,1196,2465
202101,11260,서울특별시,중랑구,85-89세,3666,1190,2476
202102,11260,서울특별시,중랑구,85-89세,3686,1205,2481
202103,11260,서울특별시,중랑구,85-89세,3672,1201,2471
202104,11260,서울특별시,중랑구,85-89세,3725,1219,2506
202105,11260,서울특별시,중랑구,85-89세,3744,1235,2509
202106,11260,서울특별시,중랑구,85-89세,3746,1234,2512
202007,11260,서울특별시,중랑구,90-94세,1241,283,958
202008,11260,서울특별시,중랑구,90-94세,1258,285,973
202009,11260,서울특별시,중랑구,90-94세,1258,292,966
202010,11260,서울특별시,중랑구,90-94세,1257,291,966
202011,11260,서울특별시,중랑구,90-94세,1272,291,981
202012,11260,서울특별시,중랑구,90-94세,1274,293,981
202101,11260,서울특별시,중랑구,90-94세,1297,302,995
202102,11260,서울특별시,중랑구,90-94세,1318,303,1015
202103,11260,서울특별시,중랑구,90-94세,1295,293,1002
202104,11260,서울특별시,중랑구,90-94세,1311,299,1012
202105,11260,서울특별시,중랑구,90-94세,1283,291,992
202106,11260,서울특별시,중랑구,90-94세,1287,290,997
202007,11260,서울특별시,중랑구,95-99세,328,81,247
202008,11260,서울특별시,중랑구,95-99세,329,80,249
202009,11260,서울특별시,중랑구,95-99세,332,79,253
202010,11260,서울특별시,중랑구,95-99세,328,77,251
202011,11260,서울특별시,중랑구,95-99세,329,73,256
202012,11260,서울특별시,중랑구,95-99세,327,72,255
202101,11260,서울특별시,중랑구,95-99세,338,74,264
202102,11260,서울특별시,중랑구,95-99세,346,75,271
202103,11260,서울특별시,중랑구,95-99세,319,63,256
202104,11260,서울특별시,중랑구,95-99세,315,60,255
202105,11260,서울특별시,중랑구,95-99세,299,57,242
202106,11260,서울특별시,중랑구,95-99세,300,61,239
202007,11260,서울특별시,중랑구,100+,202,45,157
202008,11260,서울특별시,중랑구,100+,206,45,161
202009,11260,서울특별시,중랑구,100+,208,46,162
202010,11260,서울특별시,중랑구,100+,204,46,158
202011,11260,서울특별시,중랑구,100+,208,49,159
202012,11260,서울특별시,중랑구,100+,206,49,157
202101,11260,서울특별시,중랑구,100+,203,48,155
202102,11260,서울특별시,중랑구,100+,203,49,154
202103,11260,서울특별시,중랑구,100+,108,27,81
202104,11260,서울특별시,중랑구,100+,107,28,79
202105,11260,서울특별시,중랑구,100+,77,21,56
202106,11260,서울특별시,중랑구,100+,77,20,57
202007,11290,서울특별시,성북구,0-4세,12882,6610,6272
202008,11290,서울특별시,성북구,0-4세,12728,6544,6184
202009,11290,서울특별시,성북구,0-4세,12609,6459,6150
202010,11290,서울특별시,성북구,0-4세,12474,6395,6079
202011,11290,서울특별시,성북구,0-4세,12348,6319,6029
202012,11290,서울특별시,성북구,0-4세,12220,6257,5963
202101,11290,서울특별시,성북구,0-4세,12206,6254,5952
202102,11290,서울특별시,성북구,0-4세,12260,6287,5973
202103,11290,서울특별시,성북구,0-4세,12110,6218,5892
202104,11290,서울특별시,성북구,0-4세,12006,6162,5844
202105,11290,서울특별시,성북구,0-4세,11923,6125,5798
202106,11290,서울특별시,성북구,0-4세,11838,6102,5736
202007,11290,서울특별시,성북구,5-9세,16999,8633,8366
202008,11290,서울특별시,성북구,5-9세,16899,8599,8300
202009,11290,서울특별시,성북구,5-9세,16819,8567,8252
202010,11290,서울특별시,성북구,5-9세,16766,8535,8231
202011,11290,서울특별시,성북구,5-9세,16687,8507,8180
202012,11290,서울특별시,성북구,5-9세,16602,8466,8136
202101,11290,서울특별시,성북구,5-9세,16649,8493,8156
202102,11290,서울특별시,성북구,5-9세,16721,8506,8215
202103,11290,서울특별시,성북구,5-9세,16664,8476,8188
202104,11290,서울특별시,성북구,5-9세,16607,8442,8165
202105,11290,서울특별시,성북구,5-9세,16585,8422,8163
202106,11290,서울특별시,성북구,5-9세,16530,8381,8149
202007,11290,서울특별시,성북구,10-14세,17351,8933,8418
202008,11290,서울특별시,성북구,10-14세,17351,8913,8438
202009,11290,서울특별시,성북구,10-14세,17344,8884,8460
202010,11290,서울특별시,성북구,10-14세,17328,8869,8459
202011,11290,서울특별시,성북구,10-14세,17336,8882,8454
202012,11290,서울특별시,성북구,10-14세,17340,8869,8471
202101,11290,서울특별시,성북구,10-14세,17436,8908,8528
202102,11290,서울특별시,성북구,10-14세,17463,8913,8550
202103,11290,서울특별시,성북구,10-14세,17445,8891,8554
202104,11290,서울특별시,성북구,10-14세,17434,8897,8537
202105,11290,서울특별시,성북구,10-14세,17421,8912,8509
202106,11290,서울특별시,성북구,10-14세,17444,8934,8510
202007,11290,서울특별시,성북구,15-19세,20864,10482,10382
202008,11290,서울특별시,성북구,15-19세,20660,10372,10288
202009,11290,서울특별시,성북구,15-19세,20425,10287,10138
202010,11290,서울특별시,성북구,15-19세,20197,10199,9998
202011,11290,서울특별시,성북구,15-19세,19970,10096,9874
202012,11290,서울특별시,성북구,15-19세,19805,10049,9756
202101,11290,서울특별시,성북구,15-19세,19692,10020,9672
202102,11290,서울특별시,성북구,15-19세,19638,9965,9673
202103,11290,서울특별시,성북구,15-19세,19632,9923,9709
202104,11290,서울특별시,성북구,15-19세,19467,9834,9633
202105,11290,서울특별시,성북구,15-19세,19307,9745,9562
202106,11290,서울특별시,성북구,15-19세,19225,9698,9527
202007,11290,서울특별시,성북구,20-24세,32738,14984,17754
202008,11290,서울특별시,성북구,20-24세,32740,14954,17786
202009,11290,서울특별시,성북구,20-24세,32653,14896,17757
202010,11290,서울특별시,성북구,20-24세,32530,14846,17684
202011,11290,서울특별시,성북구,20-24세,32471,14785,17686
202012,11290,서울특별시,성북구,20-24세,32361,14718,17643
202101,11290,서울특별시,성북구,20-24세,32208,14673,17535
202102,11290,서울특별시,성북구,20-24세,32115,14663,17452
202103,11290,서울특별시,성북구,20-24세,32159,14662,17497
202104,11290,서울특별시,성북구,20-24세,32153,14651,17502
202105,11290,서울특별시,성북구,20-24세,32050,14599,17451
202106,11290,서울특별시,성북구,20-24세,31977,14571,17406
202007,11290,서울특별시,성북구,25-29세,34330,17465,16865
202008,11290,서울특별시,성북구,25-29세,34420,17491,16929
202009,11290,서울특별시,성북구,25-29세,34498,17526,16972
202010,11290,서울특별시,성북구,25-29세,34516,17505,17011
202011,11290,서울특별시,성북구,25-29세,34507,17490,17017
202012,11290,서울특별시,성북구,25-29세,34611,17501,17110
202101,11290,서울특별시,성북구,25-29세,34471,17430,17041
202102,11290,서울특별시,성북구,25-29세,34242,17342,16900
202103,11290,서울특별시,성북구,25-29세,34244,17306,16938
202104,11290,서울특별시,성북구,25-29세,34267,17279,16988
202105,11290,서울특별시,성북구,25-29세,34226,17239,16987
202106,11290,서울특별시,성북구,25-29세,34206,17188,17018
202007,11290,서울특별시,성북구,30-34세,28584,14282,14302
202008,11290,서울특별시,성북구,30-34세,28529,14242,14287
202009,11290,서울특별시,성북구,30-34세,28543,14233,14310
202010,11290,서울특별시,성북구,30-34세,28475,14192,14283
202011,11290,서울특별시,성북구,30-34세,28447,14195,14252
202012,11290,서울특별시,성북구,30-34세,28291,14144,14147
202101,11290,서울특별시,성북구,30-34세,28327,14136,14191
202102,11290,서울특별시,성북구,30-34세,28315,14144,14171
202103,11290,서울특별시,성북구,30-34세,28186,14082,14104
202104,11290,서울특별시,성북구,30-34세,28247,14154,14093
202105,11290,서울특별시,성북구,30-34세,28339,14213,14126
202106,11290,서울특별시,성북구,30-34세,28401,14246,14155
202007,11290,서울특별시,성북구,35-39세,32460,16173,16287
202008,11290,서울특별시,성북구,35-39세,32197,16018,16179
202009,11290,서울특별시,성북구,35-39세,32009,15892,16117
202010,11290,서울특별시,성북구,35-39세,31898,15842,16056
202011,11290,서울특별시,성북구,35-39세,31657,15713,15944
202012,11290,서울특별시,성북구,35-39세,31552,15629,15923
202101,11290,서울특별시,성북구,35-39세,31650,15687,15963
202102,11290,서울특별시,성북구,35-39세,31599,15672,15927
202103,11290,서울특별시,성북구,35-39세,31300,15552,15748
202104,11290,서울특별시,성북구,35-39세,31179,15501,15678
202105,11290,서울특별시,성북구,35-39세,31006,15389,15617
202106,11290,서울특별시,성북구,35-39세,30848,15330,15518
202007,11290,서울특별시,성북구,40-44세,32106,15734,16372
202008,11290,서울특별시,성북구,40-44세,32057,15726,16331
202009,11290,서울특별시,성북구,40-44세,32032,15740,16292
202010,11290,서울특별시,성북구,40-44세,32016,15758,16258
202011,11290,서울특별시,성북구,40-44세,32081,15802,16279
202012,11290,서울특별시,성북구,40-44세,31950,15774,16176
202101,11290,서울특별시,성북구,40-44세,32049,15831,16218
202102,11290,서울특별시,성북구,40-44세,32271,15933,16338
202103,11290,서울특별시,성북구,40-44세,32008,15820,16188
202104,11290,서울특별시,성북구,40-44세,31981,15801,16180
202105,11290,서울특별시,성북구,40-44세,32084,15876,16208
202106,11290,서울특별시,성북구,40-44세,32169,15925,16244
202007,11290,서울특별시,성북구,45-49세,39093,19307,19786
202008,11290,서울특별시,성북구,45-49세,38819,19154,19665
202009,11290,서울특별시,성북구,45-49세,38500,18991,19509
202010,11290,서울특별시,성북구,45-49세,38217,18827,19390
202011,11290,서울특별시,성북구,45-49세,38023,18748,19275
202012,11290,서울특별시,성북구,45-49세,37889,18650,19239
202101,11290,서울특별시,성북구,45-49세,37818,18633,19185
202102,11290,서울특별시,성북구,45-49세,37692,18575,19117
202103,11290,서울특별시,성북구,45-49세,37256,18357,18899
202104,11290,서울특별시,성북구,45-49세,37111,18263,18848
202105,11290,서울특별시,성북구,45-49세,36812,18095,18717
202106,11290,서울특별시,성북구,45-49세,36568,17960,18608
202007,11290,서울특별시,성북구,50-54세,36467,18165,18302
202008,11290,서울특별시,성북구,50-54세,36547,18199,18348
202009,11290,서울특별시,성북구,50-54세,36732,18271,18461
202010,11290,서울특별시,성북구,50-54세,36799,18312,18487
202011,11290,서울특별시,성북구,50-54세,36819,18291,18528
202012,11290,서울특별시,성북구,50-54세,36742,18241,18501
202101,11290,서울특별시,성북구,50-54세,37090,18403,18687
202102,11290,서울특별시,성북구,50-54세,37244,18465,18779
202103,11290,서울특별시,성북구,50-54세,37063,18416,18647
202104,11290,서울특별시,성북구,50-54세,37110,18462,18648
202105,11290,서울특별시,성북구,50-54세,37268,18517,18751
202106,11290,서울특별시,성북구,50-54세,37413,18569,18844
202007,11290,서울특별시,성북구,55-59세,33183,16120,17063
202008,11290,서울특별시,성북구,55-59세,33039,16077,16962
202009,11290,서울특별시,성북구,55-59세,32905,16014,16891
202010,11290,서울특별시,성북구,55-59세,32791,16001,16790
202011,11290,서울특별시,성북구,55-59세,32689,15986,16703
202012,11290,서울특별시,성북구,55-59세,32639,15966,16673
202101,11290,서울특별시,성북구,55-59세,32451,15862,16589
202102,11290,서울특별시,성북구,55-59세,32305,15791,16514
202103,11290,서울특별시,성북구,55-59세,32096,15688,16408
202104,11290,서울특별시,성북구,55-59세,31993,15643,16350
202105,11290,서울특별시,성북구,55-59세,31825,15575,16250
202106,11290,서울특별시,성북구,55-59세,31620,15486,16134
202007,11290,서울특별시,성북구,60-64세,31326,14869,16457
202008,11290,서울특별시,성북구,60-64세,31404,14890,16514
202009,11290,서울특별시,성북구,60-64세,31448,14911,16537
202010,11290,서울특별시,성북구,60-64세,31531,14922,16609
202011,11290,서울특별시,성북구,60-64세,31509,14894,16615
202012,11290,서울특별시,성북구,60-64세,31538,14895,16643
202101,11290,서울특별시,성북구,60-64세,31674,14970,16704
202102,11290,서울특별시,성북구,60-64세,31846,15061,16785
202103,11290,서울특별시,성북구,60-64세,31689,15021,16668
202104,11290,서울특별시,성북구,60-64세,31748,15050,16698
202105,11290,서울특별시,성북구,60-64세,31854,15086,16768
202106,11290,서울특별시,성북구,60-64세,32026,15151,16875
202007,11290,서울특별시,성북구,65-69세,22788,10593,12195
202008,11290,서울특별시,성북구,65-69세,22951,10670,12281
202009,11290,서울특별시,성북구,65-69세,23080,10733,12347
202010,11290,서울특별시,성북구,65-69세,23187,10785,12402
202011,11290,서울특별시,성북구,65-69세,23276,10806,12470
202012,11290,서울특별시,성북구,65-69세,23359,10852,12507
202101,11290,서울특별시,성북구,65-69세,23515,10931,12584
202102,11290,서울특별시,성북구,65-69세,23645,11007,12638
202103,11290,서울특별시,성북구,65-69세,23627,11022,12605
202104,11290,서울특별시,성북구,65-69세,23757,11067,12690
202105,11290,서울특별시,성북구,65-69세,23915,11155,12760
202106,11290,서울특별시,성북구,65-69세,24001,11196,12805
202007,11290,서울특별시,성북구,70-74세,18451,8059,10392
202008,11290,서울특별시,성북구,70-74세,18411,8029,10382
202009,11290,서울특별시,성북구,70-74세,18440,8052,10388
202010,11290,서울특별시,성북구,70-74세,18518,8067,10451
202011,11290,서울특별시,성북구,70-74세,18509,8064,10445
202012,11290,서울특별시,성북구,70-74세,18564,8102,10462
202101,11290,서울특별시,성북구,70-74세,18691,8160,10531
202102,11290,서울특별시,성북구,70-74세,18757,8181,10576
202103,11290,서울특별시,성북구,70-74세,18354,8053,10301
202104,11290,서울특별시,성북구,70-74세,18283,8039,10244
202105,11290,서울특별시,성북구,70-74세,18217,8000,10217
202106,11290,서울특별시,성북구,70-74세,18163,7980,10183
202007,11290,서울특별시,성북구,75-79세,15308,6676,8632
202008,11290,서울특별시,성북구,75-79세,15292,6693,8599
202009,11290,서울특별시,성북구,75-79세,15241,6675,8566
202010,11290,서울특별시,성북구,75-79세,15189,6663,8526
202011,11290,서울특별시,성북구,75-79세,15119,6629,8490
202012,11290,서울특별시,성북구,75-79세,15004,6560,8444
202101,11290,서울특별시,성북구,75-79세,14969,6548,8421
202102,11290,서울특별시,성북구,75-79세,14900,6502,8398
202103,11290,서울특별시,성북구,75-79세,14660,6355,8305
202104,11290,서울특별시,성북구,75-79세,14617,6328,8289
202105,11290,서울특별시,성북구,75-79세,14609,6322,8287
202106,11290,서울특별시,성북구,75-79세,14613,6330,8283
202007,11290,서울특별시,성북구,80-84세,9610,3883,5727
202008,11290,서울특별시,성북구,80-84세,9649,3890,5759
202009,11290,서울특별시,성북구,80-84세,9683,3887,5796
202010,11290,서울특별시,성북구,80-84세,9728,3898,5830
202011,11290,서울특별시,성북구,80-84세,9726,3908,5818
202012,11290,서울특별시,성북구,80-84세,9746,3934,5812
202101,11290,서울특별시,성북구,80-84세,9768,3958,5810
202102,11290,서울특별시,성북구,80-84세,9862,4018,5844
202103,11290,서울특별시,성북구,80-84세,9750,3967,5783
202104,11290,서울특별시,성북구,80-84세,9811,3987,5824
202105,11290,서울특별시,성북구,80-84세,9876,4006,5870
202106,11290,서울특별시,성북구,80-84세,9922,4035,5887
202007,11290,서울특별시,성북구,85-89세,4279,1467,2812
202008,11290,서울특별시,성북구,85-89세,4302,1494,2808
202009,11290,서울특별시,성북구,85-89세,4349,1521,2828
202010,11290,서울특별시,성북구,85-89세,4393,1544,2849
202011,11290,서울특별시,성북구,85-89세,4441,1551,2890
202012,11290,서울특별시,성북구,85-89세,4483,1576,2907
202101,11290,서울특별시,성북구,85-89세,4533,1589,2944
202102,11290,서울특별시,성북구,85-89세,4577,1614,2963
202103,11290,서울특별시,성북구,85-89세,4533,1592,2941
202104,11290,서울특별시,성북구,85-89세,4560,1601,2959
202105,11290,서울특별시,성북구,85-89세,4596,1621,2975
202106,11290,서울특별시,성북구,85-89세,4606,1616,2990
202007,11290,서울특별시,성북구,90-94세,1592,408,1184
202008,11290,서울특별시,성북구,90-94세,1619,414,1205
202009,11290,서울특별시,성북구,90-94세,1631,423,1208
202010,11290,서울특별시,성북구,90-94세,1635,427,1208
202011,11290,서울특별시,성북구,90-94세,1639,432,1207
202012,11290,서울특별시,성북구,90-94세,1658,437,1221
202101,11290,서울특별시,성북구,90-94세,1683,446,1237
202102,11290,서울특별시,성북구,90-94세,1693,448,1245
202103,11290,서울특별시,성북구,90-94세,1605,404,1201
202104,11290,서울특별시,성북구,90-94세,1603,406,1197
202105,11290,서울특별시,성북구,90-94세,1621,408,1213
202106,11290,서울특별시,성북구,90-94세,1632,411,1221
202007,11290,서울특별시,성북구,95-99세,399,96,303
202008,11290,서울특별시,성북구,95-99세,399,94,305
202009,11290,서울특별시,성북구,95-99세,398,93,305
202010,11290,서울특별시,성북구,95-99세,405,97,308
202011,11290,서울특별시,성북구,95-99세,418,96,322
202012,11290,서울특별시,성북구,95-99세,415,94,321
202101,11290,서울특별시,성북구,95-99세,411,92,319
202102,11290,서울특별시,성북구,95-99세,424,97,327
202103,11290,서울특별시,성북구,95-99세,344,71,273
202104,11290,서울특별시,성북구,95-99세,347,74,273
202105,11290,서울특별시,성북구,95-99세,349,76,273
202106,11290,서울특별시,성북구,95-99세,351,74,277
202007,11290,서울특별시,성북구,100+,378,94,284
202008,11290,서울특별시,성북구,100+,382,96,286
202009,11290,서울특별시,성북구,100+,380,96,284
202010,11290,서울특별시,성북구,100+,380,96,284
202011,11290,서울특별시,성북구,100+,379,95,284
202012,11290,서울특별시,성북구,100+,384,96,288
202101,11290,서울특별시,성북구,100+,393,99,294
202102,11290,서울특별시,성북구,100+,392,99,293
202103,11290,서울특별시,성북구,100+,101,26,75
202104,11290,서울특별시,성북구,100+,102,26,76
202105,11290,서울특별시,성북구,100+,105,26,79
202106,11290,서울특별시,성북구,100+,105,27,78
202007,11305,서울특별시,강북구,0-4세,7051,3639,3412
202008,11305,서울특별시,강북구,0-4세,6979,3607,3372
202009,11305,서울특별시,강북구,0-4세,6911,3571,3340
202010,11305,서울특별시,강북구,0-4세,6789,3511,3278
202011,11305,서울특별시,강북구,0-4세,6694,3463,3231
202012,11305,서울특별시,강북구,0-4세,6615,3426,3189
202101,11305,서울특별시,강북구,0-4세,6505,3363,3142
202102,11305,서울특별시,강북구,0-4세,6412,3322,3090
202103,11305,서울특별시,강북구,0-4세,6301,3258,3043
202104,11305,서울특별시,강북구,0-4세,6226,3233,2993
202105,11305,서울특별시,강북구,0-4세,6164,3192,2972
202106,11305,서울특별시,강북구,0-4세,6090,3136,2954
202007,11305,서울특별시,강북구,5-9세,9501,4920,4581
202008,11305,서울특별시,강북구,5-9세,9416,4873,4543
202009,11305,서울특별시,강북구,5-9세,9361,4845,4516
202010,11305,서울특별시,강북구,5-9세,9275,4807,4468
202011,11305,서울특별시,강북구,5-9세,9168,4771,4397
202012,11305,서울특별시,강북구,5-9세,9099,4736,4363
202101,11305,서울특별시,강북구,5-9세,9034,4698,4336
202102,11305,서울특별시,강북구,5-9세,8954,4648,4306
202103,11305,서울특별시,강북구,5-9세,8889,4615,4274
202104,11305,서울특별시,강북구,5-9세,8866,4586,4280
202105,11305,서울특별시,강북구,5-9세,8854,4585,4269
202106,11305,서울특별시,강북구,5-9세,8816,4566,4250
202007,11305,서울특별시,강북구,10-14세,10119,5222,4897
202008,11305,서울특별시,강북구,10-14세,10117,5226,4891
202009,11305,서울특별시,강북구,10-14세,10103,5214,4889
202010,11305,서울특별시,강북구,10-14세,10080,5203,4877
202011,11305,서울특별시,강북구,10-14세,10082,5203,4879
202012,11305,서울특별시,강북구,10-14세,10048,5183,4865
202101,11305,서울특별시,강북구,10-14세,10045,5195,4850
202102,11305,서울특별시,강북구,10-14세,9959,5141,4818
202103,11305,서울특별시,강북구,10-14세,9930,5128,4802
202104,11305,서울특별시,강북구,10-14세,9904,5110,4794
202105,11305,서울특별시,강북구,10-14세,9853,5077,4776
202106,11305,서울특별시,강북구,10-14세,9833,5069,4764
202007,11305,서울특별시,강북구,15-19세,12542,6445,6097
202008,11305,서울특별시,강북구,15-19세,12421,6391,6030
202009,11305,서울특별시,강북구,15-19세,12341,6350,5991
202010,11305,서울특별시,강북구,15-19세,12235,6278,5957
202011,11305,서울특별시,강북구,15-19세,12121,6210,5911
202012,11305,서울특별시,강북구,15-19세,11979,6136,5843
202101,11305,서울특별시,강북구,15-19세,11870,6068,5802
202102,11305,서울특별시,강북구,15-19세,11742,6009,5733
202103,11305,서울특별시,강북구,15-19세,11650,5942,5708
202104,11305,서울특별시,강북구,15-19세,11615,5919,5696
202105,11305,서울특별시,강북구,15-19세,11521,5872,5649
202106,11305,서울특별시,강북구,15-19세,11477,5843,5634
202007,11305,서울특별시,강북구,20-24세,20132,9519,10613
202008,11305,서울특별시,강북구,20-24세,20047,9469,10578
202009,11305,서울특별시,강북구,20-24세,19946,9410,10536
202010,11305,서울특별시,강북구,20-24세,19796,9325,10471
202011,11305,서울특별시,강북구,20-24세,19679,9290,10389
202012,11305,서울특별시,강북구,20-24세,19671,9290,10381
202101,11305,서울특별시,강북구,20-24세,19564,9241,10323
202102,11305,서울특별시,강북구,20-24세,19439,9174,10265
202103,11305,서울특별시,강북구,20-24세,19355,9127,10228
202104,11305,서울특별시,강북구,20-24세,19254,9058,10196
202105,11305,서울특별시,강북구,20-24세,19172,9034,10138
202106,11305,서울특별시,강북구,20-24세,19012,8963,10049
202007,11305,서울특별시,강북구,25-29세,23093,11679,11414
202008,11305,서울특별시,강북구,25-29세,23056,11650,11406
202009,11305,서울특별시,강북구,25-29세,23124,11694,11430
202010,11305,서울특별시,강북구,25-29세,23140,11715,11425
202011,11305,서울특별시,강북구,25-29세,23176,11723,11453
202012,11305,서울특별시,강북구,25-29세,23273,11754,11519
202101,11305,서울특별시,강북구,25-29세,23193,11722,11471
202102,11305,서울특별시,강북구,25-29세,23102,11704,11398
202103,11305,서울특별시,강북구,25-29세,23065,11725,11340
202104,11305,서울특별시,강북구,25-29세,23053,11723,11330
202105,11305,서울특별시,강북구,25-29세,22987,11715,11272
202106,11305,서울특별시,강북구,25-29세,22983,11725,11258
202007,11305,서울특별시,강북구,30-34세,18724,9794,8930
202008,11305,서울특별시,강북구,30-34세,18739,9801,8938
202009,11305,서울특별시,강북구,30-34세,18674,9780,8894
202010,11305,서울특별시,강북구,30-34세,18632,9767,8865
202011,11305,서울특별시,강북구,30-34세,18556,9726,8830
202012,11305,서울특별시,강북구,30-34세,18553,9727,8826
202101,11305,서울특별시,강북구,30-34세,18523,9680,8843
202102,11305,서울특별시,강북구,30-34세,18482,9636,8846
202103,11305,서울특별시,강북구,30-34세,18382,9599,8783
202104,11305,서울특별시,강북구,30-34세,18411,9601,8810
202105,11305,서울특별시,강북구,30-34세,18434,9588,8846
202106,11305,서울특별시,강북구,30-34세,18444,9576,8868
202007,11305,서울특별시,강북구,35-39세,20870,11024,9846
202008,11305,서울특별시,강북구,35-39세,20698,10934,9764
202009,11305,서울특별시,강북구,35-39세,20574,10873,9701
202010,11305,서울특별시,강북구,35-39세,20424,10783,9641
202011,11305,서울특별시,강북구,35-39세,20295,10712,9583
202012,11305,서울특별시,강북구,35-39세,20204,10630,9574
202101,11305,서울특별시,강북구,35-39세,19995,10529,9466
202102,11305,서울특별시,강북구,35-39세,19830,10458,9372
202103,11305,서울특별시,강북구,35-39세,19636,10354,9282
202104,11305,서울특별시,강북구,35-39세,19466,10274,9192
202105,11305,서울특별시,강북구,35-39세,19377,10229,9148
202106,11305,서울특별시,강북구,35-39세,19258,10157,9101
202007,11305,서울특별시,강북구,40-44세,21496,11116,10380
202008,11305,서울특별시,강북구,40-44세,21419,11075,10344
202009,11305,서울특별시,강북구,40-44세,21356,11053,10303
202010,11305,서울특별시,강북구,40-44세,21373,11076,10297
202011,11305,서울특별시,강북구,40-44세,21291,11032,10259
202012,11305,서울특별시,강북구,40-44세,21169,11010,10159
202101,11305,서울특별시,강북구,40-44세,21140,11034,10106
202102,11305,서울특별시,강북구,40-44세,21083,11010,10073
202103,11305,서울특별시,강북구,40-44세,20923,10928,9995
202104,11305,서울특별시,강북구,40-44세,20841,10879,9962
202105,11305,서울특별시,강북구,40-44세,20866,10906,9960
202106,11305,서울특별시,강북구,40-44세,20876,10907,9969
202007,11305,서울특별시,강북구,45-49세,26409,13393,13016
202008,11305,서울특별시,강북구,45-49세,26221,13297,12924
202009,11305,서울특별시,강북구,45-49세,26017,13182,12835
202010,11305,서울특별시,강북구,45-49세,25790,13070,12720
202011,11305,서울특별시,강북구,45-49세,25673,13007,12666
202012,11305,서울특별시,강북구,45-49세,25549,12926,12623
202101,11305,서울특별시,강북구,45-49세,25390,12817,12573
202102,11305,서울특별시,강북구,45-49세,25225,12732,12493
202103,11305,서울특별시,강북구,45-49세,24940,12618,12322
202104,11305,서울특별시,강북구,45-49세,24829,12563,12266
202105,11305,서울특별시,강북구,45-49세,24556,12432,12124
202106,11305,서울특별시,강북구,45-49세,24381,12338,12043
202007,11305,서울특별시,강북구,50-54세,26643,13073,13570
202008,11305,서울특별시,강북구,50-54세,26615,13085,13530
202009,11305,서울특별시,강북구,50-54세,26586,13087,13499
202010,11305,서울특별시,강북구,50-54세,26576,13089,13487
202011,11305,서울특별시,강북구,50-54세,26564,13087,13477
202012,11305,서울특별시,강북구,50-54세,26491,13044,13447
202101,11305,서울특별시,강북구,50-54세,26650,13121,13529
202102,11305,서울특별시,강북구,50-54세,26679,13166,13513
202103,11305,서울특별시,강북구,50-54세,26493,13069,13424
202104,11305,서울특별시,강북구,50-54세,26479,13066,13413
202105,11305,서울특별시,강북구,50-54세,26579,13130,13449
202106,11305,서울특별시,강북구,50-54세,26652,13153,13499
202007,11305,서울특별시,강북구,55-59세,26490,12876,13614
202008,11305,서울특별시,강북구,55-59세,26437,12837,13600
202009,11305,서울특별시,강북구,55-59세,26324,12785,13539
202010,11305,서울특별시,강북구,55-59세,26228,12748,13480
202011,11305,서울특별시,강북구,55-59세,26147,12738,13409
202012,11305,서울특별시,강북구,55-59세,26151,12749,13402
202101,11305,서울특별시,강북구,55-59세,25963,12683,13280
202102,11305,서울특별시,강북구,55-59세,25858,12673,13185
202103,11305,서울특별시,강북구,55-59세,25678,12584,13094
202104,11305,서울특별시,강북구,55-59세,25563,12542,13021
202105,11305,서울특별시,강북구,55-59세,25353,12445,12908
202106,11305,서울특별시,강북구,55-59세,25088,12341,12747
202007,11305,서울특별시,강북구,60-64세,25695,12181,13514
202008,11305,서울특별시,강북구,60-64세,25754,12228,13526
202009,11305,서울특별시,강북구,60-64세,25840,12263,13577
202010,11305,서울특별시,강북구,60-64세,25907,12285,13622
202011,11305,서울특별시,강북구,60-64세,25970,12303,13667
202012,11305,서울특별시,강북구,60-64세,25940,12307,13633
202101,11305,서울특별시,강북구,60-64세,25996,12314,13682
202102,11305,서울특별시,강북구,60-64세,26081,12316,13765
202103,11305,서울특별시,강북구,60-64세,26059,12323,13736
202104,11305,서울특별시,강북구,60-64세,26191,12381,13810
202105,11305,서울특별시,강북구,60-64세,26309,12437,13872
202106,11305,서울특별시,강북구,60-64세,26467,12510,13957
202007,11305,서울특별시,강북구,65-69세,19507,8843,10664
202008,11305,서울특별시,강북구,65-69세,19588,8897,10691
202009,11305,서울특별시,강북구,65-69세,19716,8980,10736
202010,11305,서울특별시,강북구,65-69세,19788,9038,10750
202011,11305,서울특별시,강북구,65-69세,19840,9080,10760
202012,11305,서울특별시,강북구,65-69세,19952,9124,10828
202101,11305,서울특별시,강북구,65-69세,20066,9191,10875
202102,11305,서울특별시,강북구,65-69세,20165,9233,10932
202103,11305,서울특별시,강북구,65-69세,20074,9193,10881
202104,11305,서울특별시,강북구,65-69세,20153,9246,10907
202105,11305,서울특별시,강북구,65-69세,20264,9289,10975
202106,11305,서울특별시,강북구,65-69세,20349,9337,11012
202007,11305,서울특별시,강북구,70-74세,16318,7101,9217
202008,11305,서울특별시,강북구,70-74세,16340,7085,9255
202009,11305,서울특별시,강북구,70-74세,16377,7092,9285
202010,11305,서울특별시,강북구,70-74세,16438,7109,9329
202011,11305,서울특별시,강북구,70-74세,16520,7145,9375
202012,11305,서울특별시,강북구,70-74세,16545,7157,9388
202101,11305,서울특별시,강북구,70-74세,16653,7199,9454
202102,11305,서울특별시,강북구,70-74세,16647,7197,9450
202103,11305,서울특별시,강북구,70-74세,16407,7152,9255
202104,11305,서울특별시,강북구,70-74세,16424,7151,9273
202105,11305,서울특별시,강북구,70-74세,16391,7137,9254
202106,11305,서울특별시,강북구,70-74세,16338,7131,9207
202007,11305,서울특별시,강북구,75-79세,13700,5970,7730
202008,11305,서울특별시,강북구,75-79세,13721,5983,7738
202009,11305,서울특별시,강북구,75-79세,13658,5946,7712
202010,11305,서울특별시,강북구,75-79세,13621,5911,7710
202011,11305,서울특별시,강북구,75-79세,13577,5879,7698
202012,11305,서울특별시,강북구,75-79세,13542,5848,7694
202101,11305,서울특별시,강북구,75-79세,13522,5828,7694
202102,11305,서울특별시,강북구,75-79세,13429,5794,7635
202103,11305,서울특별시,강북구,75-79세,13163,5665,7498
202104,11305,서울특별시,강북구,75-79세,13107,5630,7477
202105,11305,서울특별시,강북구,75-79세,13100,5615,7485
202106,11305,서울특별시,강북구,75-79세,13114,5608,7506
202007,11305,서울특별시,강북구,80-84세,7994,3313,4681
202008,11305,서울특별시,강북구,80-84세,8013,3316,4697
202009,11305,서울특별시,강북구,80-84세,8060,3343,4717
202010,11305,서울특별시,강북구,80-84세,8110,3368,4742
202011,11305,서울특별시,강북구,80-84세,8116,3372,4744
202012,11305,서울특별시,강북구,80-84세,8102,3371,4731
202101,11305,서울특별시,강북구,80-84세,8139,3383,4756
202102,11305,서울특별시,강북구,80-84세,8251,3440,4811
202103,11305,서울특별시,강북구,80-84세,8189,3380,4809
202104,11305,서울특별시,강북구,80-84세,8230,3395,4835
202105,11305,서울특별시,강북구,80-84세,8312,3438,4874
202106,11305,서울특별시,강북구,80-84세,8378,3473,4905
202007,11305,서울특별시,강북구,85-89세,3196,1128,2068
202008,11305,서울특별시,강북구,85-89세,3231,1146,2085
202009,11305,서울특별시,강북구,85-89세,3277,1169,2108
202010,11305,서울특별시,강북구,85-89세,3298,1182,2116
202011,11305,서울특별시,강북구,85-89세,3346,1200,2146
202012,11305,서울특별시,강북구,85-89세,3414,1240,2174
202101,11305,서울특별시,강북구,85-89세,3469,1270,2199
202102,11305,서울특별시,강북구,85-89세,3524,1285,2239
202103,11305,서울특별시,강북구,85-89세,3483,1252,2231
202104,11305,서울특별시,강북구,85-89세,3547,1285,2262
202105,11305,서울특별시,강북구,85-89세,3592,1311,2281
202106,11305,서울특별시,강북구,85-89세,3618,1316,2302
202007,11305,서울특별시,강북구,90-94세,1137,320,817
202008,11305,서울특별시,강북구,90-94세,1158,324,834
202009,11305,서울특별시,강북구,90-94세,1162,325,837
202010,11305,서울특별시,강북구,90-94세,1157,326,831
202011,11305,서울특별시,강북구,90-94세,1165,328,837
202012,11305,서울특별시,강북구,90-94세,1173,333,840
202101,11305,서울특별시,강북구,90-94세,1183,336,847
202102,11305,서울특별시,강북구,90-94세,1188,333,855
202103,11305,서울특별시,강북구,90-94세,1136,313,823
202104,11305,서울특별시,강북구,90-94세,1135,308,827
202105,11305,서울특별시,강북구,90-94세,1138,309,829
202106,11305,서울특별시,강북구,90-94세,1141,312,829
202007,11305,서울특별시,강북구,95-99세,337,90,247
202008,11305,서울특별시,강북구,95-99세,338,91,247
202009,11305,서울특별시,강북구,95-99세,344,94,250
202010,11305,서울특별시,강북구,95-99세,344,92,252
202011,11305,서울특별시,강북구,95-99세,342,93,249
202012,11305,서울특별시,강북구,95-99세,336,90,246
202101,11305,서울특별시,강북구,95-99세,334,86,248
202102,11305,서울특별시,강북구,95-99세,336,90,246
202103,11305,서울특별시,강북구,95-99세,278,67,211
202104,11305,서울특별시,강북구,95-99세,280,69,211
202105,11305,서울특별시,강북구,95-99세,283,69,214
202106,11305,서울특별시,강북구,95-99세,282,67,215
202007,11305,서울특별시,강북구,100+,244,61,183
202008,11305,서울특별시,강북구,100+,247,61,186
202009,11305,서울특별시,강북구,100+,245,61,184
202010,11305,서울특별시,강북구,100+,244,61,183
202011,11305,서울특별시,강북구,100+,247,61,186
202012,11305,서울특별시,강북구,100+,249,62,187
202101,11305,서울특별시,강북구,100+,253,64,189
202102,11305,서울특별시,강북구,100+,253,66,187
202103,11305,서울특별시,강북구,100+,47,14,33
202104,11305,서울특별시,강북구,100+,48,14,34
202105,11305,서울특별시,강북구,100+,49,14,35
202106,11305,서울특별시,강북구,100+,48,14,34
202007,11320,서울특별시,도봉구,0-4세,8349,4318,4031
202008,11320,서울특별시,도봉구,0-4세,8233,4266,3967
202009,11320,서울특별시,도봉구,0-4세,8185,4242,3943
202010,11320,서울특별시,도봉구,0-4세,8084,4205,3879
202011,11320,서울특별시,도봉구,0-4세,7997,4165,3832
202012,11320,서울특별시,도봉구,0-4세,7915,4143,3772
202101,11320,서울특별시,도봉구,0-4세,7750,4077,3673
202102,11320,서울특별시,도봉구,0-4세,7595,3988,3607
202103,11320,서울특별시,도봉구,0-4세,7480,3918,3562
202104,11320,서울특별시,도봉구,0-4세,7405,3861,3544
202105,11320,서울특별시,도봉구,0-4세,7341,3829,3512
202106,11320,서울특별시,도봉구,0-4세,7286,3788,3498
202007,11320,서울특별시,도봉구,5-9세,11216,5775,5441
202008,11320,서울특별시,도봉구,5-9세,11160,5742,5418
202009,11320,서울특별시,도봉구,5-9세,11080,5709,5371
202010,11320,서울특별시,도봉구,5-9세,11009,5658,5351
202011,11320,서울특별시,도봉구,5-9세,10944,5626,5318
202012,11320,서울특별시,도봉구,5-9세,10860,5577,5283
202101,11320,서울특별시,도봉구,5-9세,10750,5503,5247
202102,11320,서울특별시,도봉구,5-9세,10713,5492,5221
202103,11320,서울특별시,도봉구,5-9세,10655,5480,5175
202104,11320,서울특별시,도봉구,5-9세,10608,5466,5142
202105,11320,서울특별시,도봉구,5-9세,10581,5466,5115
202106,11320,서울특별시,도봉구,5-9세,10555,5466,5089
202007,11320,서울특별시,도봉구,10-14세,11738,6030,5708
202008,11320,서울특별시,도봉구,10-14세,11741,6043,5698
202009,11320,서울특별시,도봉구,10-14세,11737,6047,5690
202010,11320,서울특별시,도봉구,10-14세,11699,6022,5677
202011,11320,서울특별시,도봉구,10-14세,11727,6028,5699
202012,11320,서울특별시,도봉구,10-14세,11703,6021,5682
202101,11320,서울특별시,도봉구,10-14세,11691,6036,5655
202102,11320,서울특별시,도봉구,10-14세,11610,6000,5610
202103,11320,서울특별시,도봉구,10-14세,11598,6007,5591
202104,11320,서울특별시,도봉구,10-14세,11572,5987,5585
202105,11320,서울특별시,도봉구,10-14세,11552,5964,5588
202106,11320,서울특별시,도봉구,10-14세,11518,5934,5584
202007,11320,서울특별시,도봉구,15-19세,14639,7545,7094
202008,11320,서울특별시,도봉구,15-19세,14511,7494,7017
202009,11320,서울특별시,도봉구,15-19세,14352,7407,6945
202010,11320,서울특별시,도봉구,15-19세,14237,7337,6900
202011,11320,서울특별시,도봉구,15-19세,14097,7290,6807
202012,11320,서울특별시,도봉구,15-19세,13924,7188,6736
202101,11320,서울특별시,도봉구,15-19세,13802,7106,6696
202102,11320,서울특별시,도봉구,15-19세,13726,7055,6671
202103,11320,서울특별시,도봉구,15-19세,13617,6976,6641
202104,11320,서울특별시,도봉구,15-19세,13515,6936,6579
202105,11320,서울특별시,도봉구,15-19세,13411,6868,6543
202106,11320,서울특별시,도봉구,15-19세,13301,6816,6485
202007,11320,서울특별시,도봉구,20-24세,21076,10666,10410
202008,11320,서울특별시,도봉구,20-24세,20944,10575,10369
202009,11320,서울특별시,도봉구,20-24세,20779,10474,10305
202010,11320,서울특별시,도봉구,20-24세,20672,10430,10242
202011,11320,서울특별시,도봉구,20-24세,20543,10374,10169
202012,11320,서울특별시,도봉구,20-24세,20408,10296,10112
202101,11320,서울특별시,도봉구,20-24세,20290,10247,10043
202102,11320,서울특별시,도봉구,20-24세,20152,10187,9965
202103,11320,서울특별시,도봉구,20-24세,20052,10116,9936
202104,11320,서울특별시,도봉구,20-24세,19982,10112,9870
202105,11320,서울특별시,도봉구,20-24세,19858,10059,9799
202106,11320,서울특별시,도봉구,20-24세,19846,10054,9792
202007,11320,서울특별시,도봉구,25-29세,23142,11859,11283
202008,11320,서울특별시,도봉구,25-29세,23117,11860,11257
202009,11320,서울특별시,도봉구,25-29세,23121,11898,11223
202010,11320,서울특별시,도봉구,25-29세,23019,11857,11162
202011,11320,서울특별시,도봉구,25-29세,23029,11843,11186
202012,11320,서울특별시,도봉구,25-29세,23004,11814,11190
202101,11320,서울특별시,도봉구,25-29세,22880,11716,11164
202102,11320,서울특별시,도봉구,25-29세,22768,11629,11139
202103,11320,서울특별시,도봉구,25-29세,22755,11633,11122
202104,11320,서울특별시,도봉구,25-29세,22735,11615,11120
202105,11320,서울특별시,도봉구,25-29세,22725,11610,11115
202106,11320,서울특별시,도봉구,25-29세,22674,11578,11096
202007,11320,서울특별시,도봉구,30-34세,19500,9990,9510
202008,11320,서울특별시,도봉구,30-34세,19400,9945,9455
202009,11320,서울특별시,도봉구,30-34세,19338,9907,9431
202010,11320,서울특별시,도봉구,30-34세,19355,9900,9455
202011,11320,서울특별시,도봉구,30-34세,19309,9875,9434
202012,11320,서울특별시,도봉구,30-34세,19259,9887,9372
202101,11320,서울특별시,도봉구,30-34세,19165,9824,9341
202102,11320,서울특별시,도봉구,30-34세,19075,9766,9309
202103,11320,서울특별시,도봉구,30-34세,19016,9728,9288
202104,11320,서울특별시,도봉구,30-34세,19025,9726,9299
202105,11320,서울특별시,도봉구,30-34세,19045,9704,9341
202106,11320,서울특별시,도봉구,30-34세,19075,9713,9362
202007,11320,서울특별시,도봉구,35-39세,22454,11454,11000
202008,11320,서울특별시,도봉구,35-39세,22308,11374,10934
202009,11320,서울특별시,도봉구,35-39세,22105,11281,10824
202010,11320,서울특별시,도봉구,35-39세,21931,11185,10746
202011,11320,서울특별시,도봉구,35-39세,21857,11166,10691
202012,11320,서울특별시,도봉구,35-39세,21734,11086,10648
202101,11320,서울특별시,도봉구,35-39세,21556,11000,10556
202102,11320,서울특별시,도봉구,35-39세,21367,10898,10469
202103,11320,서울특별시,도봉구,35-39세,21138,10815,10323
202104,11320,서울특별시,도봉구,35-39세,20998,10764,10234
202105,11320,서울특별시,도봉구,35-39세,20854,10712,10142
202106,11320,서울특별시,도봉구,35-39세,20753,10660,10093
202007,11320,서울특별시,도봉구,40-44세,22080,11096,10984
202008,11320,서울특별시,도봉구,40-44세,22023,11077,10946
202009,11320,서울특별시,도봉구,40-44세,22037,11087,10950
202010,11320,서울특별시,도봉구,40-44세,22044,11103,10941
202011,11320,서울특별시,도봉구,40-44세,22065,11089,10976
202012,11320,서울특별시,도봉구,40-44세,21965,11069,10896
202101,11320,서울특별시,도봉구,40-44세,21863,11029,10834
202102,11320,서울특별시,도봉구,40-44세,21827,11025,10802
202103,11320,서울특별시,도봉구,40-44세,21681,10931,10750
202104,11320,서울특별시,도봉구,40-44세,21725,10963,10762
202105,11320,서울특별시,도봉구,40-44세,21776,10978,10798
202106,11320,서울특별시,도봉구,40-44세,21821,10988,10833
202007,11320,서울특별시,도봉구,45-49세,27443,13414,14029
202008,11320,서울특별시,도봉구,45-49세,27308,13366,13942
202009,11320,서울특별시,도봉구,45-49세,27112,13261,13851
202010,11320,서울특별시,도봉구,45-49세,26880,13131,13749
202011,11320,서울특별시,도봉구,45-49세,26670,13043,13627
202012,11320,서울특별시,도봉구,45-49세,26570,12969,13601
202101,11320,서울특별시,도봉구,45-49세,26412,12908,13504
202102,11320,서울특별시,도봉구,45-49세,26222,12791,13431
202103,11320,서울특별시,도봉구,45-49세,25953,12671,13282
202104,11320,서울특별시,도봉구,45-49세,25770,12591,13179
202105,11320,서울특별시,도봉구,45-49세,25517,12483,13034
202106,11320,서울특별시,도봉구,45-49세,25370,12426,12944
202007,11320,서울특별시,도봉구,50-54세,28885,13805,15080
202008,11320,서울특별시,도봉구,50-54세,28832,13777,15055
202009,11320,서울특별시,도봉구,50-54세,28819,13771,15048
202010,11320,서울특별시,도봉구,50-54세,28844,13772,15072
202011,11320,서울특별시,도봉구,50-54세,28878,13767,15111
202012,11320,서울특별시,도봉구,50-54세,28731,13703,15028
202101,11320,서울특별시,도봉구,50-54세,28796,13709,15087
202102,11320,서울특별시,도봉구,50-54세,28867,13730,15137
202103,11320,서울특별시,도봉구,50-54세,28687,13668,15019
202104,11320,서울특별시,도봉구,50-54세,28687,13658,15029
202105,11320,서울특별시,도봉구,50-54세,28761,13673,15088
202106,11320,서울특별시,도봉구,50-54세,28796,13673,15123
202007,11320,서울특별시,도봉구,55-59세,28799,13715,15084
202008,11320,서울특별시,도봉구,55-59세,28657,13632,15025
202009,11320,서울특별시,도봉구,55-59세,28534,13585,14949
202010,11320,서울특별시,도봉구,55-59세,28439,13545,14894
202011,11320,서울특별시,도봉구,55-59세,28331,13488,14843
202012,11320,서울특별시,도봉구,55-59세,28289,13458,14831
202101,11320,서울특별시,도봉구,55-59세,28041,13368,14673
202102,11320,서울특별시,도봉구,55-59세,27924,13325,14599
202103,11320,서울특별시,도봉구,55-59세,27762,13255,14507
202104,11320,서울특별시,도봉구,55-59세,27657,13209,14448
202105,11320,서울특별시,도봉구,55-59세,27479,13147,14332
202106,11320,서울특별시,도봉구,55-59세,27266,13069,14197
202007,11320,서울특별시,도봉구,60-64세,28618,13584,15034
202008,11320,서울특별시,도봉구,60-64세,28648,13608,15040
202009,11320,서울특별시,도봉구,60-64세,28709,13615,15094
202010,11320,서울특별시,도봉구,60-64세,28767,13654,15113
202011,11320,서울특별시,도봉구,60-64세,28844,13692,15152
202012,11320,서울특별시,도봉구,60-64세,28886,13705,15181
202101,11320,서울특별시,도봉구,60-64세,28971,13714,15257
202102,11320,서울특별시,도봉구,60-64세,29033,13731,15302
202103,11320,서울특별시,도봉구,60-64세,29016,13715,15301
202104,11320,서울특별시,도봉구,60-64세,29031,13693,15338
202105,11320,서울특별시,도봉구,60-64세,29114,13740,15374
202106,11320,서울특별시,도봉구,60-64세,29259,13797,15462
202007,11320,서울특별시,도봉구,65-69세,20201,9771,10430
202008,11320,서울특별시,도봉구,65-69세,20355,9818,10537
202009,11320,서울특별시,도봉구,65-69세,20464,9859,10605
202010,11320,서울특별시,도봉구,65-69세,20634,9928,10706
202011,11320,서울특별시,도봉구,65-69세,20729,9966,10763
202012,11320,서울특별시,도봉구,65-69세,20854,10022,10832
202101,11320,서울특별시,도봉구,65-69세,20997,10090,10907
202102,11320,서울특별시,도봉구,65-69세,21137,10142,10995
202103,11320,서울특별시,도봉구,65-69세,21234,10199,11035
202104,11320,서울특별시,도봉구,65-69세,21342,10239,11103
202105,11320,서울특별시,도봉구,65-69세,21417,10261,11156
202106,11320,서울특별시,도봉구,65-69세,21548,10305,11243
202007,11320,서울특별시,도봉구,70-74세,15317,7119,8198
202008,11320,서울특별시,도봉구,70-74세,15328,7124,8204
202009,11320,서울특별시,도봉구,70-74세,15360,7166,8194
202010,11320,서울특별시,도봉구,70-74세,15409,7194,8215
202011,11320,서울특별시,도봉구,70-74세,15457,7235,8222
202012,11320,서울특별시,도봉구,70-74세,15522,7235,8287
202101,11320,서울특별시,도봉구,70-74세,15631,7303,8328
202102,11320,서울특별시,도봉구,70-74세,15669,7340,8329
202103,11320,서울특별시,도봉구,70-74세,15557,7286,8271
202104,11320,서울특별시,도봉구,70-74세,15575,7282,8293
202105,11320,서울특별시,도봉구,70-74세,15585,7283,8302
202106,11320,서울특별시,도봉구,70-74세,15563,7256,8307
202007,11320,서울특별시,도봉구,75-79세,12278,5535,6743
202008,11320,서울특별시,도봉구,75-79세,12313,5577,6736
202009,11320,서울특별시,도봉구,75-79세,12310,5562,6748
202010,11320,서울특별시,도봉구,75-79세,12277,5533,6744
202011,11320,서울특별시,도봉구,75-79세,12204,5483,6721
202012,11320,서울특별시,도봉구,75-79세,12184,5486,6698
202101,11320,서울특별시,도봉구,75-79세,12178,5489,6689
202102,11320,서울특별시,도봉구,75-79세,12100,5438,6662
202103,11320,서울특별시,도봉구,75-79세,11978,5400,6578
202104,11320,서울특별시,도봉구,75-79세,11931,5404,6527
202105,11320,서울특별시,도봉구,75-79세,11932,5401,6531
202106,11320,서울특별시,도봉구,75-79세,11947,5416,6531
202007,11320,서울특별시,도봉구,80-84세,7709,3130,4579
202008,11320,서울특별시,도봉구,80-84세,7729,3145,4584
202009,11320,서울특별시,도봉구,80-84세,7757,3169,4588
202010,11320,서울특별시,도봉구,80-84세,7832,3202,4630
202011,11320,서울특별시,도봉구,80-84세,7883,3227,4656
202012,11320,서울특별시,도봉구,80-84세,7862,3222,4640
202101,11320,서울특별시,도봉구,80-84세,7867,3207,4660
202102,11320,서울특별시,도봉구,80-84세,7943,3260,4683
202103,11320,서울특별시,도봉구,80-84세,7954,3246,4708
202104,11320,서울특별시,도봉구,80-84세,8036,3287,4749
202105,11320,서울특별시,도봉구,80-84세,8062,3309,4753
202106,11320,서울특별시,도봉구,80-84세,8114,3354,4760
202007,11320,서울특별시,도봉구,85-89세,3597,1177,2420
202008,11320,서울특별시,도봉구,85-89세,3622,1186,2436
202009,11320,서울특별시,도봉구,85-89세,3635,1198,2437
202010,11320,서울특별시,도봉구,85-89세,3666,1206,2460
202011,11320,서울특별시,도봉구,85-89세,3695,1221,2474
202012,11320,서울특별시,도봉구,85-89세,3741,1232,2509
202101,11320,서울특별시,도봉구,85-89세,3785,1262,2523
202102,11320,서울특별시,도봉구,85-89세,3836,1284,2552
202103,11320,서울특별시,도봉구,85-89세,3825,1282,2543
202104,11320,서울특별시,도봉구,85-89세,3852,1288,2564
202105,11320,서울특별시,도봉구,85-89세,3882,1303,2579
202106,11320,서울특별시,도봉구,85-89세,3885,1293,2592
202007,11320,서울특별시,도봉구,90-94세,1301,355,946
202008,11320,서울특별시,도봉구,90-94세,1303,352,951
202009,11320,서울특별시,도봉구,90-94세,1322,355,967
202010,11320,서울특별시,도봉구,90-94세,1321,362,959
202011,11320,서울특별시,도봉구,90-94세,1327,368,959
202012,11320,서울특별시,도봉구,90-94세,1354,377,977
202101,11320,서울특별시,도봉구,90-94세,1353,381,972
202102,11320,서울특별시,도봉구,90-94세,1362,387,975
202103,11320,서울특별시,도봉구,90-94세,1340,377,963
202104,11320,서울특별시,도봉구,90-94세,1359,380,979
202105,11320,서울특별시,도봉구,90-94세,1377,383,994
202106,11320,서울특별시,도봉구,90-94세,1365,385,980
202007,11320,서울특별시,도봉구,95-99세,305,80,225
202008,11320,서울특별시,도봉구,95-99세,307,80,227
202009,11320,서울특별시,도봉구,95-99세,311,81,230
202010,11320,서울특별시,도봉구,95-99세,317,82,235
202011,11320,서울특별시,도봉구,95-99세,316,81,235
202012,11320,서울특별시,도봉구,95-99세,317,82,235
202101,11320,서울특별시,도봉구,95-99세,326,86,240
202102,11320,서울특별시,도봉구,95-99세,329,87,242
202103,11320,서울특별시,도봉구,95-99세,300,72,228
202104,11320,서울특별시,도봉구,95-99세,302,74,228
202105,11320,서울특별시,도봉구,95-99세,296,73,223
202106,11320,서울특별시,도봉구,95-99세,300,73,227
202007,11320,서울특별시,도봉구,100+,175,47,128
202008,11320,서울특별시,도봉구,100+,175,48,127
202009,11320,서울특별시,도봉구,100+,181,49,132
202010,11320,서울특별시,도봉구,100+,181,50,131
202011,11320,서울특별시,도봉구,100+,180,49,131
202012,11320,서울특별시,도봉구,100+,175,48,127
202101,11320,서울특별시,도봉구,100+,177,48,129
202102,11320,서울특별시,도봉구,100+,176,48,128
202103,11320,서울특별시,도봉구,100+,119,35,84
202104,11320,서울특별시,도봉구,100+,120,35,85
202105,11320,서울특별시,도봉구,100+,122,36,86
202106,11320,서울특별시,도봉구,100+,123,36,87
202007,11350,서울특별시,노원구,0-4세,14299,7320,6979
202008,11350,서울특별시,노원구,0-4세,14123,7239,6884
202009,11350,서울특별시,노원구,0-4세,13908,7132,6776
202010,11350,서울특별시,노원구,0-4세,13756,7040,6716
202011,11350,서울특별시,노원구,0-4세,13579,6942,6637
202012,11350,서울특별시,노원구,0-4세,13503,6913,6590
202101,11350,서울특별시,노원구,0-4세,13313,6813,6500
202102,11350,서울특별시,노원구,0-4세,13105,6707,6398
202103,11350,서울특별시,노원구,0-4세,12981,6641,6340
202104,11350,서울특별시,노원구,0-4세,12912,6629,6283
202105,11350,서울특별시,노원구,0-4세,12784,6577,6207
202106,11350,서울특별시,노원구,0-4세,12711,6556,6155
202007,11350,서울특별시,노원구,5-9세,20258,10497,9761
202008,11350,서울특별시,노원구,5-9세,20166,10444,9722
202009,11350,서울특별시,노원구,5-9세,19986,10318,9668
202010,11350,서울특별시,노원구,5-9세,19853,10259,9594
202011,11350,서울특별시,노원구,5-9세,19732,10180,9552
202012,11350,서울특별시,노원구,5-9세,19679,10133,9546
202101,11350,서울특별시,노원구,5-9세,19542,10067,9475
202102,11350,서울특별시,노원구,5-9세,19444,10017,9427
202103,11350,서울특별시,노원구,5-9세,19353,9996,9357
202104,11350,서울특별시,노원구,5-9세,19237,9929,9308
202105,11350,서울특별시,노원구,5-9세,19156,9880,9276
202106,11350,서울특별시,노원구,5-9세,19052,9821,9231
202007,11350,서울특별시,노원구,10-14세,24324,12642,11682
202008,11350,서울특별시,노원구,10-14세,24258,12605,11653
202009,11350,서울특별시,노원구,10-14세,24244,12642,11602
202010,11350,서울특별시,노원구,10-14세,24287,12637,11650
202011,11350,서울특별시,노원구,10-14세,24284,12637,11647
202012,11350,서울특별시,노원구,10-14세,24274,12630,11644
202101,11350,서울특별시,노원구,10-14세,24259,12614,11645
202102,11350,서울특별시,노원구,10-14세,24134,12561,11573
202103,11350,서울특별시,노원구,10-14세,24071,12512,11559
202104,11350,서울특별시,노원구,10-14세,23985,12466,11519
202105,11350,서울특별시,노원구,10-14세,23884,12393,11491
202106,11350,서울특별시,노원구,10-14세,23822,12369,11453
202007,11350,서울특별시,노원구,15-19세,30237,15624,14613
202008,11350,서울특별시,노원구,15-19세,29931,15490,14441
202009,11350,서울특별시,노원구,15-19세,29707,15364,14343
202010,11350,서울특별시,노원구,15-19세,29406,15248,14158
202011,11350,서울특별시,노원구,15-19세,29198,15121,14077
202012,11350,서울특별시,노원구,15-19세,28961,14994,13967
202101,11350,서울특별시,노원구,15-19세,28633,14835,13798
202102,11350,서울특별시,노원구,15-19세,28393,14707,13686
202103,11350,서울특별시,노원구,15-19세,28221,14609,13612
202104,11350,서울특별시,노원구,15-19세,27984,14487,13497
202105,11350,서울특별시,노원구,15-19세,27802,14416,13386
202106,11350,서울특별시,노원구,15-19세,27646,14319,13327
202007,11350,서울특별시,노원구,20-24세,38339,19605,18734
202008,11350,서울특별시,노원구,20-24세,38198,19481,18717
202009,11350,서울특별시,노원구,20-24세,38086,19431,18655
202010,11350,서울특별시,노원구,20-24세,37954,19305,18649
202011,11350,서울특별시,노원구,20-24세,37830,19260,18570
202012,11350,서울특별시,노원구,20-24세,37606,19131,18475
202101,11350,서울특별시,노원구,20-24세,37424,19047,18377
202102,11350,서울특별시,노원구,20-24세,37272,19011,18261
202103,11350,서울특별시,노원구,20-24세,37088,18889,18199
202104,11350,서울특별시,노원구,20-24세,36893,18782,18111
202105,11350,서울특별시,노원구,20-24세,36793,18700,18093
202106,11350,서울특별시,노원구,20-24세,36691,18605,18086
202007,11350,서울특별시,노원구,25-29세,35468,18377,17091
202008,11350,서울특별시,노원구,25-29세,35393,18358,17035
202009,11350,서울특별시,노원구,25-29세,35390,18330,17060
202010,11350,서울특별시,노원구,25-29세,35504,18397,17107
202011,11350,서울특별시,노원구,25-29세,35571,18440,17131
202012,11350,서울특별시,노원구,25-29세,35576,18419,17157
202101,11350,서울특별시,노원구,25-29세,35404,18298,17106
202102,11350,서울특별시,노원구,25-29세,35072,18031,17041
202103,11350,서울특별시,노원구,25-29세,35172,18072,17100
202104,11350,서울특별시,노원구,25-29세,35159,18091,17068
202105,11350,서울특별시,노원구,25-29세,35079,18049,17030
202106,11350,서울특별시,노원구,25-29세,35014,18013,17001
202007,11350,서울특별시,노원구,30-34세,30557,15347,15210
202008,11350,서울특별시,노원구,30-34세,30521,15308,15213
202009,11350,서울특별시,노원구,30-34세,30414,15268,15146
202010,11350,서울특별시,노원구,30-34세,30309,15207,15102
202011,11350,서울특별시,노원구,30-34세,30249,15150,15099
202012,11350,서울특별시,노원구,30-34세,30226,15159,15067
202101,11350,서울특별시,노원구,30-34세,30211,15135,15076
202102,11350,서울특별시,노원구,30-34세,30102,15098,15004
202103,11350,서울특별시,노원구,30-34세,30102,15093,15009
202104,11350,서울특별시,노원구,30-34세,30216,15201,15015
202105,11350,서울특별시,노원구,30-34세,30318,15247,15071
202106,11350,서울특별시,노원구,30-34세,30390,15314,15076
202007,11350,서울특별시,노원구,35-39세,35563,17648,17915
202008,11350,서울특별시,노원구,35-39세,35294,17527,17767
202009,11350,서울특별시,노원구,35-39세,35031,17374,17657
202010,11350,서울특별시,노원구,35-39세,34790,17243,17547
202011,11350,서울특별시,노원구,35-39세,34606,17140,17466
202012,11350,서울특별시,노원구,35-39세,34514,17083,17431
202101,11350,서울특별시,노원구,35-39세,34246,16939,17307
202102,11350,서울특별시,노원구,35-39세,34008,16828,17180
202103,11350,서울특별시,노원구,35-39세,33848,16743,17105
202104,11350,서울특별시,노원구,35-39세,33727,16682,17045
202105,11350,서울특별시,노원구,35-39세,33546,16584,16962
202106,11350,서울특별시,노원구,35-39세,33340,16460,16880
202007,11350,서울특별시,노원구,40-44세,38581,18374,20207
202008,11350,서울특별시,노원구,40-44세,38519,18340,20179
202009,11350,서울특별시,노원구,40-44세,38487,18322,20165
202010,11350,서울특별시,노원구,40-44세,38470,18322,20148
202011,11350,서울특별시,노원구,40-44세,38471,18358,20113
202012,11350,서울특별시,노원구,40-44세,38408,18344,20064
202101,11350,서울특별시,노원구,40-44세,38324,18307,20017
202102,11350,서울특별시,노원구,40-44세,38311,18318,19993
202103,11350,서울특별시,노원구,40-44세,38055,18222,19833
202104,11350,서울특별시,노원구,40-44세,37972,18163,19809
202105,11350,서울특별시,노원구,40-44세,38003,18180,19823
202106,11350,서울특별시,노원구,40-44세,38070,18224,19846
202007,11350,서울특별시,노원구,45-49세,49283,23449,25834
202008,11350,서울특별시,노원구,45-49세,48998,23298,25700
202009,11350,서울특별시,노원구,45-49세,48656,23124,25532
202010,11350,서울특별시,노원구,45-49세,48350,22983,25367
202011,11350,서울특별시,노원구,45-49세,48014,22795,25219
202012,11350,서울특별시,노원구,45-49세,47832,22692,25140
202101,11350,서울특별시,노원구,45-49세,47517,22564,24953
202102,11350,서울특별시,노원구,45-49세,47148,22384,24764
202103,11350,서울특별시,노원구,45-49세,46684,22154,24530
202104,11350,서울특별시,노원구,45-49세,46512,22062,24450
202105,11350,서울특별시,노원구,45-49세,45998,21803,24195
202106,11350,서울특별시,노원구,45-49세,45659,21641,24018
202007,11350,서울특별시,노원구,50-54세,46558,22706,23852
202008,11350,서울특별시,노원구,50-54세,46614,22735,23879
202009,11350,서울특별시,노원구,50-54세,46640,22740,23900
202010,11350,서울특별시,노원구,50-54세,46698,22736,23962
202011,11350,서울특별시,노원구,50-54세,46814,22803,24011
202012,11350,서울특별시,노원구,50-54세,46711,22775,23936
202101,11350,서울특별시,노원구,50-54세,46914,22878,24036
202102,11350,서울특별시,노원구,50-54세,47043,22917,24126
202103,11350,서울특별시,노원구,50-54세,46931,22912,24019
202104,11350,서울특별시,노원구,50-54세,46918,22865,24053
202105,11350,서울특별시,노원구,50-54세,47140,22965,24175
202106,11350,서울특별시,노원구,50-54세,47257,23005,24252
202007,11350,서울특별시,노원구,55-59세,41761,20106,21655
202008,11350,서울특별시,노원구,55-59세,41553,20039,21514
202009,11350,서울특별시,노원구,55-59세,41441,19982,21459
202010,11350,서울특별시,노원구,55-59세,41271,19921,21350
202011,11350,서울특별시,노원구,55-59세,41150,19879,21271
202012,11350,서울특별시,노원구,55-59세,41117,19824,21293
202101,11350,서울특별시,노원구,55-59세,40813,19686,21127
202102,11350,서울특별시,노원구,55-59세,40639,19582,21057
202103,11350,서울특별시,노원구,55-59세,40412,19457,20955
202104,11350,서울특별시,노원구,55-59세,40258,19412,20846
202105,11350,서울특별시,노원구,55-59세,40096,19320,20776
202106,11350,서울특별시,노원구,55-59세,39810,19198,20612
202007,11350,서울특별시,노원구,60-64세,38900,18100,20800
202008,11350,서울특별시,노원구,60-64세,38931,18122,20809
202009,11350,서울특별시,노원구,60-64세,38955,18131,20824
202010,11350,서울특별시,노원구,60-64세,39028,18167,20861
202011,11350,서울특별시,노원구,60-64세,39096,18168,20928
202012,11350,서울특별시,노원구,60-64세,39210,18236,20974
202101,11350,서울특별시,노원구,60-64세,39402,18337,21065
202102,11350,서울특별시,노원구,60-64세,39541,18397,21144
202103,11350,서울특별시,노원구,60-64세,39531,18399,21132
202104,11350,서울특별시,노원구,60-64세,39599,18406,21193
202105,11350,서울특별시,노원구,60-64세,39689,18457,21232
202106,11350,서울특별시,노원구,60-64세,39914,18578,21336
202007,11350,서울특별시,노원구,65-69세,27761,12937,14824
202008,11350,서울특별시,노원구,65-69세,27978,13008,14970
202009,11350,서울특별시,노원구,65-69세,28175,13102,15073
202010,11350,서울특별시,노원구,65-69세,28306,13158,15148
202011,11350,서울특별시,노원구,65-69세,28449,13262,15187
202012,11350,서울특별시,노원구,65-69세,28594,13318,15276
202101,11350,서울특별시,노원구,65-69세,28850,13420,15430
202102,11350,서울특별시,노원구,65-69세,29046,13483,15563
202103,11350,서울특별시,노원구,65-69세,29247,13578,15669
202104,11350,서울특별시,노원구,65-69세,29413,13656,15757
202105,11350,서울특별시,노원구,65-69세,29534,13743,15791
202106,11350,서울특별시,노원구,65-69세,29758,13831,15927
202007,11350,서울특별시,노원구,70-74세,20807,9263,11544
202008,11350,서울특별시,노원구,70-74세,20821,9278,11543
202009,11350,서울특별시,노원구,70-74세,20903,9318,11585
202010,11350,서울특별시,노원구,70-74세,21026,9353,11673
202011,11350,서울특별시,노원구,70-74세,21120,9399,11721
202012,11350,서울특별시,노원구,70-74세,21234,9452,11782
202101,11350,서울특별시,노원구,70-74세,21367,9537,11830
202102,11350,서울특별시,노원구,70-74세,21424,9585,11839
202103,11350,서울특별시,노원구,70-74세,21290,9522,11768
202104,11350,서울특별시,노원구,70-74세,21280,9525,11755
202105,11350,서울특별시,노원구,70-74세,21274,9521,11753
202106,11350,서울특별시,노원구,70-74세,21245,9501,11744
202007,11350,서울특별시,노원구,75-79세,16546,6895,9651
202008,11350,서울특별시,노원구,75-79세,16554,6893,9661
202009,11350,서울특별시,노원구,75-79세,16481,6855,9626
202010,11350,서울특별시,노원구,75-79세,16430,6831,9599
202011,11350,서울특별시,노원구,75-79세,16392,6807,9585
202012,11350,서울특별시,노원구,75-79세,16302,6774,9528
202101,11350,서울특별시,노원구,75-79세,16240,6735,9505
202102,11350,서울특별시,노원구,75-79세,16158,6702,9456
202103,11350,서울특별시,노원구,75-79세,16025,6644,9381
202104,11350,서울특별시,노원구,75-79세,16003,6643,9360
202105,11350,서울특별시,노원구,75-79세,16020,6663,9357
202106,11350,서울특별시,노원구,75-79세,16035,6693,9342
202007,11350,서울특별시,노원구,80-84세,10787,3961,6826
202008,11350,서울특별시,노원구,80-84세,10838,4011,6827
202009,11350,서울특별시,노원구,80-84세,10845,4043,6802
202010,11350,서울특별시,노원구,80-84세,10883,4068,6815
202011,11350,서울특별시,노원구,80-84세,10917,4089,6828
202012,11350,서울특별시,노원구,80-84세,10937,4096,6841
202101,11350,서울특별시,노원구,80-84세,10970,4116,6854
202102,11350,서울특별시,노원구,80-84세,11053,4157,6896
202103,11350,서울특별시,노원구,80-84세,11033,4143,6890
202104,11350,서울특별시,노원구,80-84세,11090,4158,6932
202105,11350,서울특별시,노원구,80-84세,11145,4156,6989
202106,11350,서울특별시,노원구,80-84세,11258,4196,7062
202007,11350,서울특별시,노원구,85-89세,5281,1598,3683
202008,11350,서울특별시,노원구,85-89세,5335,1598,3737
202009,11350,서울특별시,노원구,85-89세,5408,1620,3788
202010,11350,서울특별시,노원구,85-89세,5437,1632,3805
202011,11350,서울특별시,노원구,85-89세,5466,1650,3816
202012,11350,서울특별시,노원구,85-89세,5557,1690,3867
202101,11350,서울특별시,노원구,85-89세,5593,1700,3893
202102,11350,서울특별시,노원구,85-89세,5624,1714,3910
202103,11350,서울특별시,노원구,85-89세,5628,1721,3907
202104,11350,서울특별시,노원구,85-89세,5665,1730,3935
202105,11350,서울특별시,노원구,85-89세,5678,1734,3944
202106,11350,서울특별시,노원구,85-89세,5705,1751,3954
202007,11350,서울특별시,노원구,90-94세,1900,481,1419
202008,11350,서울특별시,노원구,90-94세,1912,493,1419
202009,11350,서울특별시,노원구,90-94세,1941,505,1436
202010,11350,서울특별시,노원구,90-94세,1974,516,1458
202011,11350,서울특별시,노원구,90-94세,1994,515,1479
202012,11350,서울특별시,노원구,90-94세,2012,521,1491
202101,11350,서울특별시,노원구,90-94세,2046,535,1511
202102,11350,서울특별시,노원구,90-94세,2064,533,1531
202103,11350,서울특별시,노원구,90-94세,2040,514,1526
202104,11350,서울특별시,노원구,90-94세,2046,524,1522
202105,11350,서울특별시,노원구,90-94세,2047,524,1523
202106,11350,서울특별시,노원구,90-94세,2049,526,1523
202007,11350,서울특별시,노원구,95-99세,495,113,382
202008,11350,서울특별시,노원구,95-99세,501,111,390
202009,11350,서울특별시,노원구,95-99세,504,109,395
202010,11350,서울특별시,노원구,95-99세,500,111,389
202011,11350,서울특별시,노원구,95-99세,492,112,380
202012,11350,서울특별시,노원구,95-99세,496,114,382
202101,11350,서울특별시,노원구,95-99세,495,114,381
202102,11350,서울특별시,노원구,95-99세,495,111,384
202103,11350,서울특별시,노원구,95-99세,452,97,355
202104,11350,서울특별시,노원구,95-99세,438,92,346
202105,11350,서울특별시,노원구,95-99세,452,98,354
202106,11350,서울특별시,노원구,95-99세,451,98,353
202007,11350,서울특별시,노원구,100+,276,84,192
202008,11350,서울특별시,노원구,100+,280,85,195
202009,11350,서울특별시,노원구,100+,284,87,197
202010,11350,서울특별시,노원구,100+,283,85,198
202011,11350,서울특별시,노원구,100+,284,85,199
202012,11350,서울특별시,노원구,100+,288,85,203
202101,11350,서울특별시,노원구,100+,289,86,203
202102,11350,서울특별시,노원구,100+,290,86,204
202103,11350,서울특별시,노원구,100+,114,24,90
202104,11350,서울특별시,노원구,100+,110,19,91
202105,11350,서울특별시,노원구,100+,114,19,95
202106,11350,서울특별시,노원구,100+,120,20,100
202007,11380,서울특별시,은평구,0-4세,13592,6890,6702
202008,11380,서울특별시,은평구,0-4세,13459,6818,6641
202009,11380,서울특별시,은평구,0-4세,13316,6771,6545
202010,11380,서울특별시,은평구,0-4세,13146,6703,6443
202011,11380,서울특별시,은평구,0-4세,12992,6617,6375
202012,11380,서울특별시,은평구,0-4세,12839,6536,6303
202101,11380,서울특별시,은평구,0-4세,12673,6440,6233
202102,11380,서울특별시,은평구,0-4세,12492,6370,6122
202103,11380,서울특별시,은평구,0-4세,12305,6285,6020
202104,11380,서울특별시,은평구,0-4세,12175,6203,5972
202105,11380,서울특별시,은평구,0-4세,12114,6170,5944
202106,11380,서울특별시,은평구,0-4세,12100,6177,5923
202007,11380,서울특별시,은평구,5-9세,17324,8922,8402
202008,11380,서울특별시,은평구,5-9세,17311,8903,8408
202009,11380,서울특별시,은평구,5-9세,17212,8858,8354
202010,11380,서울특별시,은평구,5-9세,17130,8813,8317
202011,11380,서울특별시,은평구,5-9세,16996,8736,8260
202012,11380,서울특별시,은평구,5-9세,16865,8674,8191
202101,11380,서울특별시,은평구,5-9세,16714,8583,8131
202102,11380,서울특별시,은평구,5-9세,16565,8512,8053
202103,11380,서울특별시,은평구,5-9세,16518,8505,8013
202104,11380,서울특별시,은평구,5-9세,16497,8497,8000
202105,11380,서울특별시,은평구,5-9세,16482,8486,7996
202106,11380,서울특별시,은평구,5-9세,16520,8501,8019
202007,11380,서울특별시,은평구,10-14세,18026,9258,8768
202008,11380,서울특별시,은평구,10-14세,18031,9260,8771
202009,11380,서울특별시,은평구,10-14세,18048,9249,8799
202010,11380,서울특별시,은평구,10-14세,18073,9255,8818
202011,11380,서울특별시,은평구,10-14세,18099,9255,8844
202012,11380,서울특별시,은평구,10-14세,18077,9237,8840
202101,11380,서울특별시,은평구,10-14세,18075,9240,8835
202102,11380,서울특별시,은평구,10-14세,17938,9172,8766
202103,11380,서울특별시,은평구,10-14세,17911,9159,8752
202104,11380,서울특별시,은평구,10-14세,17859,9134,8725
202105,11380,서울특별시,은평구,10-14세,17854,9131,8723
202106,11380,서울특별시,은평구,10-14세,17851,9142,8709
202007,11380,서울특별시,은평구,15-19세,21398,10864,10534
202008,11380,서울특별시,은평구,15-19세,21293,10807,10486
202009,11380,서울특별시,은평구,15-19세,21182,10776,10406
202010,11380,서울특별시,은평구,15-19세,20954,10676,10278
202011,11380,서울특별시,은평구,15-19세,20755,10578,10177
202012,11380,서울특별시,은평구,15-19세,20599,10519,10080
202101,11380,서울특별시,은평구,15-19세,20446,10449,9997
202102,11380,서울특별시,은평구,15-19세,20338,10401,9937
202103,11380,서울특별시,은평구,15-19세,20196,10314,9882
202104,11380,서울특별시,은평구,15-19세,20073,10247,9826
202105,11380,서울특별시,은평구,15-19세,20003,10229,9774
202106,11380,서울특별시,은평구,15-19세,19931,10198,9733
202007,11380,서울특별시,은평구,20-24세,29882,14569,15313
202008,11380,서울특별시,은평구,20-24세,29972,14619,15353
202009,11380,서울특별시,은평구,20-24세,29888,14546,15342
202010,11380,서울특별시,은평구,20-24세,29890,14568,15322
202011,11380,서울특별시,은평구,20-24세,29792,14513,15279
202012,11380,서울특별시,은평구,20-24세,29682,14409,15273
202101,11380,서울특별시,은평구,20-24세,29480,14312,15168
202102,11380,서울특별시,은평구,20-24세,29396,14249,15147
202103,11380,서울특별시,은평구,20-24세,29264,14150,15114
202104,11380,서울특별시,은평구,20-24세,29164,14099,15065
202105,11380,서울특별시,은평구,20-24세,29123,14059,15064
202106,11380,서울특별시,은평구,20-24세,29028,14006,15022
202007,11380,서울특별시,은평구,25-29세,36826,17653,19173
202008,11380,서울특별시,은평구,25-29세,36957,17704,19253
202009,11380,서울특별시,은평구,25-29세,37051,17731,19320
202010,11380,서울특별시,은평구,25-29세,37118,17753,19365
202011,11380,서울특별시,은평구,25-29세,37221,17811,19410
202012,11380,서울특별시,은평구,25-29세,37376,17875,19501
202101,11380,서울특별시,은평구,25-29세,37431,17893,19538
202102,11380,서울특별시,은평구,25-29세,37295,17790,19505
202103,11380,서울특별시,은평구,25-29세,37326,17805,19521
202104,11380,서울특별시,은평구,25-29세,37298,17776,19522
202105,11380,서울특별시,은평구,25-29세,37360,17760,19600
202106,11380,서울특별시,은평구,25-29세,37367,17749,19618
202007,11380,서울특별시,은평구,30-34세,32568,15996,16572
202008,11380,서울특별시,은평구,30-34세,32642,16027,16615
202009,11380,서울특별시,은평구,30-34세,32682,15999,16683
202010,11380,서울특별시,은평구,30-34세,32639,15932,16707
202011,11380,서울특별시,은평구,30-34세,32610,15911,16699
202012,11380,서울특별시,은평구,30-34세,32478,15838,16640
202101,11380,서울특별시,은평구,30-34세,32470,15809,16661
202102,11380,서울특별시,은평구,30-34세,32469,15842,16627
202103,11380,서울특별시,은평구,30-34세,32582,15903,16679
202104,11380,서울특별시,은평구,30-34세,32608,15908,16700
202105,11380,서울특별시,은평구,30-34세,32725,15969,16756
202106,11380,서울특별시,은평구,30-34세,32814,15997,16817
202007,11380,서울특별시,은평구,35-39세,36948,18613,18335
202008,11380,서울특별시,은평구,35-39세,36835,18502,18333
202009,11380,서울특별시,은평구,35-39세,36582,18380,18202
202010,11380,서울특별시,은평구,35-39세,36368,18281,18087
202011,11380,서울특별시,은평구,35-39세,36192,18170,18022
202012,11380,서울특별시,은평구,35-39세,36024,18069,17955
202101,11380,서울특별시,은평구,35-39세,35762,17891,17871
202102,11380,서울특별시,은평구,35-39세,35384,17675,17709
202103,11380,서울특별시,은평구,35-39세,35072,17483,17589
202104,11380,서울특별시,은평구,35-39세,34795,17308,17487
202105,11380,서울특별시,은평구,35-39세,34620,17187,17433
202106,11380,서울특별시,은평구,35-39세,34566,17168,17398
202007,11380,서울특별시,은평구,40-44세,35899,17841,18058
202008,11380,서울특별시,은평구,40-44세,35875,17845,18030
202009,11380,서울특별시,은평구,40-44세,35986,17927,18059
202010,11380,서울특별시,은평구,40-44세,36049,17953,18096
202011,11380,서울특별시,은평구,40-44세,35956,17889,18067
202012,11380,서울특별시,은평구,40-44세,35746,17772,17974
202101,11380,서울특별시,은평구,40-44세,35717,17754,17963
202102,11380,서울특별시,은평구,40-44세,35723,17758,17965
202103,11380,서울특별시,은평구,40-44세,35419,17623,17796
202104,11380,서울특별시,은평구,40-44세,35439,17657,17782
202105,11380,서울특별시,은평구,40-44세,35554,17733,17821
202106,11380,서울특별시,은평구,40-44세,35753,17831,17922
202007,11380,서울특별시,은평구,45-49세,41586,20455,21131
202008,11380,서울특별시,은평구,45-49세,41551,20423,21128
202009,11380,서울특별시,은평구,45-49세,41355,20335,21020
202010,11380,서울특별시,은평구,45-49세,41134,20223,20911
202011,11380,서울특별시,은평구,45-49세,41003,20121,20882
202012,11380,서울특별시,은평구,45-49세,40882,20074,20808
202101,11380,서울특별시,은평구,45-49세,40718,20008,20710
202102,11380,서울특별시,은평구,45-49세,40500,19908,20592
202103,11380,서울특별시,은평구,45-49세,40075,19726,20349
202104,11380,서울특별시,은평구,45-49세,39875,19620,20255
202105,11380,서울특별시,은평구,45-49세,39574,19461,20113
202106,11380,서울특별시,은평구,45-49세,39318,19339,19979
202007,11380,서울특별시,은평구,50-54세,39491,19197,20294
202008,11380,서울특별시,은평구,50-54세,39665,19288,20377
202009,11380,서울특별시,은평구,50-54세,39761,19326,20435
202010,11380,서울특별시,은평구,50-54세,39821,19367,20454
202011,11380,서울특별시,은평구,50-54세,39811,19374,20437
202012,11380,서울특별시,은평구,50-54세,39783,19374,20409
202101,11380,서울특별시,은평구,50-54세,39969,19453,20516
202102,11380,서울특별시,은평구,50-54세,40130,19511,20619
202103,11380,서울특별시,은평구,50-54세,39962,19427,20535
202104,11380,서울특별시,은평구,50-54세,39982,19426,20556
202105,11380,서울특별시,은평구,50-54세,40282,19557,20725
202106,11380,서울특별시,은평구,50-54세,40501,19640,20861
202007,11380,서울특별시,은평구,55-59세,37840,18028,19812
202008,11380,서울특별시,은평구,55-59세,37757,17985,19772
202009,11380,서울특별시,은평구,55-59세,37724,17979,19745
202010,11380,서울특별시,은평구,55-59세,37636,17929,19707
202011,11380,서울특별시,은평구,55-59세,37552,17882,19670
202012,11380,서울특별시,은평구,55-59세,37491,17830,19661
202101,11380,서울특별시,은평구,55-59세,37230,17706,19524
202102,11380,서울특별시,은평구,55-59세,37134,17675,19459
202103,11380,서울특별시,은평구,55-59세,36821,17529,19292
202104,11380,서울특별시,은평구,55-59세,36659,17439,19220
202105,11380,서울특별시,은평구,55-59세,36489,17394,19095
202106,11380,서울특별시,은평구,55-59세,36262,17327,18935
202007,11380,서울특별시,은평구,60-64세,36340,17032,19308
202008,11380,서울특별시,은평구,60-64세,36534,17108,19426
202009,11380,서울특별시,은평구,60-64세,36587,17100,19487
202010,11380,서울특별시,은평구,60-64세,36772,17183,19589
202011,11380,서울특별시,은평구,60-64세,36922,17259,19663
202012,11380,서울특별시,은평구,60-64세,36983,17314,19669
202101,11380,서울특별시,은평구,60-64세,37070,17353,19717
202102,11380,서울특별시,은평구,60-64세,37155,17362,19793
202103,11380,서울특별시,은평구,60-64세,37119,17320,19799
202104,11380,서울특별시,은평구,60-64세,37197,17357,19840
202105,11380,서울특별시,은평구,60-64세,37460,17481,19979
202106,11380,서울특별시,은평구,60-64세,37644,17556,20088
202007,11380,서울특별시,은평구,65-69세,26713,12045,14668
202008,11380,서울특별시,은평구,65-69세,26882,12122,14760
202009,11380,서울특별시,은평구,65-69세,27084,12243,14841
202010,11380,서울특별시,은평구,65-69세,27219,12322,14897
202011,11380,서울특별시,은평구,65-69세,27349,12378,14971
202012,11380,서울특별시,은평구,65-69세,27455,12415,15040
202101,11380,서울특별시,은평구,65-69세,27651,12497,15154
202102,11380,서울특별시,은평구,65-69세,27822,12592,15230
202103,11380,서울특별시,은평구,65-69세,27807,12596,15211
202104,11380,서울특별시,은평구,65-69세,27968,12655,15313
202105,11380,서울특별시,은평구,65-69세,28111,12721,15390
202106,11380,서울특별시,은평구,65-69세,28271,12797,15474
202007,11380,서울특별시,은평구,70-74세,21637,9634,12003
202008,11380,서울특별시,은평구,70-74세,21684,9648,12036
202009,11380,서울특별시,은평구,70-74세,21733,9667,12066
202010,11380,서울특별시,은평구,70-74세,21788,9682,12106
202011,11380,서울특별시,은평구,70-74세,21904,9721,12183
202012,11380,서울특별시,은평구,70-74세,22013,9760,12253
202101,11380,서울특별시,은평구,70-74세,22137,9818,12319
202102,11380,서울특별시,은평구,70-74세,22218,9862,12356
202103,11380,서울특별시,은평구,70-74세,21887,9713,12174
202104,11380,서울특별시,은평구,70-74세,21868,9708,12160
202105,11380,서울특별시,은평구,70-74세,21842,9683,12159
202106,11380,서울특별시,은평구,70-74세,21827,9671,12156
202007,11380,서울특별시,은평구,75-79세,17305,7578,9727
202008,11380,서울특별시,은평구,75-79세,17320,7592,9728
202009,11380,서울특별시,은평구,75-79세,17270,7569,9701
202010,11380,서울특별시,은평구,75-79세,17213,7536,9677
202011,11380,서울특별시,은평구,75-79세,17177,7538,9639
202012,11380,서울특별시,은평구,75-79세,17108,7504,9604
202101,11380,서울특별시,은평구,75-79세,17082,7475,9607
202102,11380,서울특별시,은평구,75-79세,17050,7466,9584
202103,11380,서울특별시,은평구,75-79세,16902,7386,9516
202104,11380,서울특별시,은평구,75-79세,16925,7365,9560
202105,11380,서울특별시,은평구,75-79세,16957,7363,9594
202106,11380,서울특별시,은평구,75-79세,16932,7325,9607
202007,11380,서울특별시,은평구,80-84세,10768,4555,6213
202008,11380,서울특별시,은평구,80-84세,10818,4549,6269
202009,11380,서울특별시,은평구,80-84세,10886,4581,6305
202010,11380,서울특별시,은평구,80-84세,10953,4610,6343
202011,11380,서울특별시,은평구,80-84세,10982,4604,6378
202012,11380,서울특별시,은평구,80-84세,11055,4647,6408
202101,11380,서울특별시,은평구,80-84세,11152,4701,6451
202102,11380,서울특별시,은평구,80-84세,11195,4714,6481
202103,11380,서울특별시,은평구,80-84세,11100,4655,6445
202104,11380,서울특별시,은평구,80-84세,11169,4704,6465
202105,11380,서울특별시,은평구,80-84세,11240,4755,6485
202106,11380,서울특별시,은평구,80-84세,11305,4781,6524
202007,11380,서울특별시,은평구,85-89세,4548,1598,2950
202008,11380,서울특별시,은평구,85-89세,4641,1646,2995
202009,11380,서울특별시,은평구,85-89세,4683,1661,3022
202010,11380,서울특별시,은평구,85-89세,4731,1696,3035
202011,11380,서울특별시,은평구,85-89세,4771,1723,3048
202012,11380,서울특별시,은평구,85-89세,4842,1753,3089
202101,11380,서울특별시,은평구,85-89세,4888,1759,3129
202102,11380,서울특별시,은평구,85-89세,4971,1778,3193
202103,11380,서울특별시,은평구,85-89세,4947,1742,3205
202104,11380,서울특별시,은평구,85-89세,4983,1747,3236
202105,11380,서울특별시,은평구,85-89세,5043,1762,3281
202106,11380,서울특별시,은평구,85-89세,5079,1786,3293
202007,11380,서울특별시,은평구,90-94세,1632,445,1187
202008,11380,서울특별시,은평구,90-94세,1645,451,1194
202009,11380,서울특별시,은평구,90-94세,1637,449,1188
202010,11380,서울특별시,은평구,90-94세,1651,463,1188
202011,11380,서울특별시,은평구,90-94세,1654,468,1186
202012,11380,서울특별시,은평구,90-94세,1658,465,1193
202101,11380,서울특별시,은평구,90-94세,1681,472,1209
202102,11380,서울특별시,은평구,90-94세,1680,470,1210
202103,11380,서울특별시,은평구,90-94세,1610,442,1168
202104,11380,서울특별시,은평구,90-94세,1629,450,1179
202105,11380,서울특별시,은평구,90-94세,1630,451,1179
202106,11380,서울특별시,은평구,90-94세,1630,450,1180
202007,11380,서울특별시,은평구,95-99세,446,132,314
202008,11380,서울특별시,은평구,95-99세,442,130,312
202009,11380,서울특별시,은평구,95-99세,462,136,326
202010,11380,서울특별시,은평구,95-99세,455,135,320
202011,11380,서울특별시,은평구,95-99세,456,134,322
202012,11380,서울특별시,은평구,95-99세,454,132,322
202101,11380,서울특별시,은평구,95-99세,451,131,320
202102,11380,서울특별시,은평구,95-99세,452,128,324
202103,11380,서울특별시,은평구,95-99세,397,105,292
202104,11380,서울특별시,은평구,95-99세,399,105,294
202105,11380,서울특별시,은평구,95-99세,399,103,296
202106,11380,서울특별시,은평구,95-99세,388,101,287
202007,11380,서울특별시,은평구,100+,415,79,336
202008,11380,서울특별시,은평구,100+,415,81,334
202009,11380,서울특별시,은평구,100+,417,81,336
202010,11380,서울특별시,은평구,100+,425,83,342
202011,11380,서울특별시,은평구,100+,423,81,342
202012,11380,서울특별시,은평구,100+,425,82,343
202101,11380,서울특별시,은평구,100+,426,83,343
202102,11380,서울특별시,은평구,100+,429,83,346
202103,11380,서울특별시,은평구,100+,281,42,239
202104,11380,서울특별시,은평구,100+,281,41,240
202105,11380,서울특별시,은평구,100+,281,41,240
202106,11380,서울특별시,은평구,100+,284,42,242
202007,11410,서울특별시,서대문구,0-4세,9263,4850,4413
202008,11410,서울특별시,서대문구,0-4세,9253,4856,4397
202009,11410,서울특별시,서대문구,0-4세,9300,4874,4426
202010,11410,서울특별시,서대문구,0-4세,9191,4822,4369
202011,11410,서울특별시,서대문구,0-4세,9084,4764,4320
202012,11410,서울특별시,서대문구,0-4세,9060,4735,4325
202101,11410,서울특별시,서대문구,0-4세,8940,4681,4259
202102,11410,서울특별시,서대문구,0-4세,8832,4600,4232
202103,11410,서울특별시,서대문구,0-4세,8703,4521,4182
202104,11410,서울특별시,서대문구,0-4세,8619,4472,4147
202105,11410,서울특별시,서대문구,0-4세,8535,4436,4099
202106,11410,서울특별시,서대문구,0-4세,8467,4406,4061
202007,11410,서울특별시,서대문구,5-9세,11105,5578,5527
202008,11410,서울특별시,서대문구,5-9세,11136,5588,5548
202009,11410,서울특별시,서대문구,5-9세,11218,5602,5616
202010,11410,서울특별시,서대문구,5-9세,11170,5562,5608
202011,11410,서울특별시,서대문구,5-9세,11136,5543,5593
202012,11410,서울특별시,서대문구,5-9세,11115,5532,5583
202101,11410,서울특별시,서대문구,5-9세,11099,5505,5594
202102,11410,서울특별시,서대문구,5-9세,11022,5492,5530
202103,11410,서울특별시,서대문구,5-9세,11046,5505,5541
202104,11410,서울특별시,서대문구,5-9세,11010,5508,5502
202105,11410,서울특별시,서대문구,5-9세,10982,5483,5499
202106,11410,서울특별시,서대문구,5-9세,10985,5485,5500
202007,11410,서울특별시,서대문구,10-14세,10915,5498,5417
202008,11410,서울특별시,서대문구,10-14세,10918,5504,5414
202009,11410,서울특별시,서대문구,10-14세,10902,5503,5399
202010,11410,서울특별시,서대문구,10-14세,10917,5525,5392
202011,11410,서울특별시,서대문구,10-14세,10915,5530,5385
202012,11410,서울특별시,서대문구,10-14세,10915,5530,5385
202101,11410,서울특별시,서대문구,10-14세,10913,5531,5382
202102,11410,서울특별시,서대문구,10-14세,10929,5545,5384
202103,11410,서울특별시,서대문구,10-14세,10881,5491,5390
202104,11410,서울특별시,서대문구,10-14세,10857,5460,5397
202105,11410,서울특별시,서대문구,10-14세,10835,5462,5373
202106,11410,서울특별시,서대문구,10-14세,10780,5432,5348
202007,11410,서울특별시,서대문구,15-19세,13289,6605,6684
202008,11410,서울특별시,서대문구,15-19세,13154,6538,6616
202009,11410,서울특별시,서대문구,15-19세,13044,6475,6569
202010,11410,서울특별시,서대문구,15-19세,12910,6420,6490
202011,11410,서울특별시,서대문구,15-19세,12802,6385,6417
202012,11410,서울특별시,서대문구,15-19세,12707,6340,6367
202101,11410,서울특별시,서대문구,15-19세,12589,6296,6293
202102,11410,서울특별시,서대문구,15-19세,12580,6262,6318
202103,11410,서울특별시,서대문구,15-19세,12545,6222,6323
202104,11410,서울특별시,서대문구,15-19세,12436,6166,6270
202105,11410,서울특별시,서대문구,15-19세,12360,6113,6247
202106,11410,서울특별시,서대문구,15-19세,12285,6079,6206
202007,11410,서울특별시,서대문구,20-24세,22885,10499,12386
202008,11410,서울특별시,서대문구,20-24세,22983,10499,12484
202009,11410,서울특별시,서대문구,20-24세,23027,10512,12515
202010,11410,서울특별시,서대문구,20-24세,22889,10476,12413
202011,11410,서울특별시,서대문구,20-24세,22756,10360,12396
202012,11410,서울특별시,서대문구,20-24세,22638,10271,12367
202101,11410,서울특별시,서대문구,20-24세,22447,10211,12236
202102,11410,서울특별시,서대문구,20-24세,22387,10196,12191
202103,11410,서울특별시,서대문구,20-24세,22422,10139,12283
202104,11410,서울특별시,서대문구,20-24세,22314,10074,12240
202105,11410,서울특별시,서대문구,20-24세,22238,10055,12183
202106,11410,서울특별시,서대문구,20-24세,22173,10039,12134
202007,11410,서울특별시,서대문구,25-29세,27215,13651,13564
202008,11410,서울특별시,서대문구,25-29세,27330,13686,13644
202009,11410,서울특별시,서대문구,25-29세,27481,13746,13735
202010,11410,서울특별시,서대문구,25-29세,27548,13748,13800
202011,11410,서울특별시,서대문구,25-29세,27635,13784,13851
202012,11410,서울특별시,서대문구,25-29세,27718,13802,13916
202101,11410,서울특별시,서대문구,25-29세,27584,13742,13842
202102,11410,서울특별시,서대문구,25-29세,27400,13622,13778
202103,11410,서울특별시,서대문구,25-29세,27405,13686,13719
202104,11410,서울특별시,서대문구,25-29세,27362,13647,13715
202105,11410,서울특별시,서대문구,25-29세,27334,13610,13724
202106,11410,서울특별시,서대문구,25-29세,27352,13574,13778
202007,11410,서울특별시,서대문구,30-34세,21895,10848,11047
202008,11410,서울특별시,서대문구,30-34세,21923,10901,11022
202009,11410,서울특별시,서대문구,30-34세,22013,10932,11081
202010,11410,서울특별시,서대문구,30-34세,22025,10921,11104
202011,11410,서울특별시,서대문구,30-34세,22026,10932,11094
202012,11410,서울특별시,서대문구,30-34세,21991,10910,11081
202101,11410,서울특별시,서대문구,30-34세,22079,10901,11178
202102,11410,서울특별시,서대문구,30-34세,22003,10854,11149
202103,11410,서울특별시,서대문구,30-34세,21948,10773,11175
202104,11410,서울특별시,서대문구,30-34세,22067,10831,11236
202105,11410,서울특별시,서대문구,30-34세,22144,10859,11285
202106,11410,서울특별시,서대문구,30-34세,22168,10860,11308
202007,11410,서울특별시,서대문구,35-39세,23231,11550,11681
202008,11410,서울특별시,서대문구,35-39세,23241,11550,11691
202009,11410,서울특별시,서대문구,35-39세,23226,11514,11712
202010,11410,서울특별시,서대문구,35-39세,23207,11531,11676
202011,11410,서울특별시,서대문구,35-39세,23113,11464,11649
202012,11410,서울특별시,서대문구,35-39세,23118,11473,11645
202101,11410,서울특별시,서대문구,35-39세,22978,11442,11536
202102,11410,서울특별시,서대문구,35-39세,22848,11393,11455
202103,11410,서울특별시,서대문구,35-39세,22660,11293,11367
202104,11410,서울특별시,서대문구,35-39세,22527,11197,11330
202105,11410,서울특별시,서대문구,35-39세,22402,11151,11251
202106,11410,서울특별시,서대문구,35-39세,22325,11088,11237
202007,11410,서울특별시,서대문구,40-44세,22025,10908,11117
202008,11410,서울특별시,서대문구,40-44세,22133,10945,11188
202009,11410,서울특별시,서대문구,40-44세,22255,11018,11237
202010,11410,서울특별시,서대문구,40-44세,22285,11001,11284
202011,11410,서울특별시,서대문구,40-44세,22281,11014,11267
202012,11410,서울특별시,서대문구,40-44세,22264,11008,11256
202101,11410,서울특별시,서대문구,40-44세,22250,10985,11265
202102,11410,서울특별시,서대문구,40-44세,22266,10991,11275
202103,11410,서울특별시,서대문구,40-44세,22082,10918,11164
202104,11410,서울특별시,서대문구,40-44세,22034,10901,11133
202105,11410,서울특별시,서대문구,40-44세,22008,10897,11111
202106,11410,서울특별시,서대문구,40-44세,22047,10919,11128
202007,11410,서울특별시,서대문구,45-49세,25821,12732,13089
202008,11410,서울특별시,서대문구,45-49세,25712,12689,13023
202009,11410,서울특별시,서대문구,45-49세,25560,12614,12946
202010,11410,서울특별시,서대문구,45-49세,25364,12514,12850
202011,11410,서울특별시,서대문구,45-49세,25247,12451,12796
202012,11410,서울특별시,서대문구,45-49세,25223,12448,12775
202101,11410,서울특별시,서대문구,45-49세,25071,12383,12688
202102,11410,서울특별시,서대문구,45-49세,24891,12303,12588
202103,11410,서울특별시,서대문구,45-49세,24618,12169,12449
202104,11410,서울특별시,서대문구,45-49세,24492,12095,12397
202105,11410,서울특별시,서대문구,45-49세,24289,11985,12304
202106,11410,서울특별시,서대문구,45-49세,24124,11890,12234
202007,11410,서울특별시,서대문구,50-54세,25491,12428,13063
202008,11410,서울특별시,서대문구,50-54세,25521,12423,13098
202009,11410,서울특별시,서대문구,50-54세,25666,12530,13136
202010,11410,서울특별시,서대문구,50-54세,25699,12555,13144
202011,11410,서울특별시,서대문구,50-54세,25663,12519,13144
202012,11410,서울특별시,서대문구,50-54세,25575,12469,13106
202101,11410,서울특별시,서대문구,50-54세,25732,12548,13184
202102,11410,서울특별시,서대문구,50-54세,25805,12575,13230
202103,11410,서울특별시,서대문구,50-54세,25614,12464,13150
202104,11410,서울특별시,서대문구,50-54세,25591,12438,13153
202105,11410,서울특별시,서대문구,50-54세,25668,12473,13195
202106,11410,서울특별시,서대문구,50-54세,25737,12525,13212
202007,11410,서울특별시,서대문구,55-59세,24039,11591,12448
202008,11410,서울특별시,서대문구,55-59세,23963,11563,12400
202009,11410,서울특별시,서대문구,55-59세,23917,11516,12401
202010,11410,서울특별시,서대문구,55-59세,23827,11457,12370
202011,11410,서울특별시,서대문구,55-59세,23805,11477,12328
202012,11410,서울특별시,서대문구,55-59세,23792,11510,12282
202101,11410,서울특별시,서대문구,55-59세,23630,11468,12162
202102,11410,서울특별시,서대문구,55-59세,23566,11477,12089
202103,11410,서울특별시,서대문구,55-59세,23308,11378,11930
202104,11410,서울특별시,서대문구,55-59세,23179,11344,11835
202105,11410,서울특별시,서대문구,55-59세,23038,11288,11750
202106,11410,서울특별시,서대문구,55-59세,22890,11204,11686
202007,11410,서울특별시,서대문구,60-64세,21970,10426,11544
202008,11410,서울특별시,서대문구,60-64세,22095,10483,11612
202009,11410,서울특별시,서대문구,60-64세,22187,10544,11643
202010,11410,서울특별시,서대문구,60-64세,22218,10596,11622
202011,11410,서울특별시,서대문구,60-64세,22239,10593,11646
202012,11410,서울특별시,서대문구,60-64세,22301,10571,11730
202101,11410,서울특별시,서대문구,60-64세,22387,10599,11788
202102,11410,서울특별시,서대문구,60-64세,22424,10615,11809
202103,11410,서울특별시,서대문구,60-64세,22286,10568,11718
202104,11410,서울특별시,서대문구,60-64세,22390,10627,11763
202105,11410,서울특별시,서대문구,60-64세,22464,10675,11789
202106,11410,서울특별시,서대문구,60-64세,22570,10733,11837
202007,11410,서울특별시,서대문구,65-69세,15797,7341,8456
202008,11410,서울특별시,서대문구,65-69세,15924,7402,8522
202009,11410,서울특별시,서대문구,65-69세,16050,7429,8621
202010,11410,서울특별시,서대문구,65-69세,16120,7458,8662
202011,11410,서울특별시,서대문구,65-69세,16135,7457,8678
202012,11410,서울특별시,서대문구,65-69세,16257,7529,8728
202101,11410,서울특별시,서대문구,65-69세,16402,7612,8790
202102,11410,서울특별시,서대문구,65-69세,16551,7681,8870
202103,11410,서울특별시,서대문구,65-69세,16389,7633,8756
202104,11410,서울특별시,서대문구,65-69세,16409,7631,8778
202105,11410,서울특별시,서대문구,65-69세,16502,7665,8837
202106,11410,서울특별시,서대문구,65-69세,16571,7706,8865
202007,11410,서울특별시,서대문구,70-74세,13205,5640,7565
202008,11410,서울특별시,서대문구,70-74세,13182,5622,7560
202009,11410,서울특별시,서대문구,70-74세,13149,5629,7520
202010,11410,서울특별시,서대문구,70-74세,13165,5642,7523
202011,11410,서울특별시,서대문구,70-74세,13251,5682,7569
202012,11410,서울특별시,서대문구,70-74세,13272,5689,7583
202101,11410,서울특별시,서대문구,70-74세,13315,5710,7605
202102,11410,서울특별시,서대문구,70-74세,13288,5692,7596
202103,11410,서울특별시,서대문구,70-74세,13017,5606,7411
202104,11410,서울특별시,서대문구,70-74세,12972,5587,7385
202105,11410,서울특별시,서대문구,70-74세,12945,5576,7369
202106,11410,서울특별시,서대문구,70-74세,12898,5551,7347
202007,11410,서울특별시,서대문구,75-79세,11276,4808,6468
202008,11410,서울특별시,서대문구,75-79세,11254,4794,6460
202009,11410,서울특별시,서대문구,75-79세,11241,4778,6463
202010,11410,서울특별시,서대문구,75-79세,11173,4749,6424
202011,11410,서울특별시,서대문구,75-79세,11115,4719,6396
202012,11410,서울특별시,서대문구,75-79세,11032,4669,6363
202101,11410,서울특별시,서대문구,75-79세,11002,4676,6326
202102,11410,서울특별시,서대문구,75-79세,10970,4677,6293
202103,11410,서울특별시,서대문구,75-79세,10722,4544,6178
202104,11410,서울특별시,서대문구,75-79세,10669,4506,6163
202105,11410,서울특별시,서대문구,75-79세,10701,4520,6181
202106,11410,서울특별시,서대문구,75-79세,10661,4509,6152
202007,11410,서울특별시,서대문구,80-84세,7593,3048,4545
202008,11410,서울특별시,서대문구,80-84세,7627,3067,4560
202009,11410,서울특별시,서대문구,80-84세,7633,3062,4571
202010,11410,서울특별시,서대문구,80-84세,7659,3067,4592
202011,11410,서울특별시,서대문구,80-84세,7655,3057,4598
202012,11410,서울특별시,서대문구,80-84세,7692,3073,4619
202101,11410,서울특별시,서대문구,80-84세,7718,3076,4642
202102,11410,서울특별시,서대문구,80-84세,7716,3069,4647
202103,11410,서울특별시,서대문구,80-84세,7592,3033,4559
202104,11410,서울특별시,서대문구,80-84세,7607,3054,4553
202105,11410,서울특별시,서대문구,80-84세,7614,3054,4560
202106,11410,서울특별시,서대문구,80-84세,7691,3089,4602
202007,11410,서울특별시,서대문구,85-89세,3354,1142,2212
202008,11410,서울특별시,서대문구,85-89세,3382,1156,2226
202009,11410,서울특별시,서대문구,85-89세,3424,1172,2252
202010,11410,서울특별시,서대문구,85-89세,3479,1202,2277
202011,11410,서울특별시,서대문구,85-89세,3524,1229,2295
202012,11410,서울특별시,서대문구,85-89세,3554,1256,2298
202101,11410,서울특별시,서대문구,85-89세,3620,1292,2328
202102,11410,서울특별시,서대문구,85-89세,3668,1309,2359
202103,11410,서울특별시,서대문구,85-89세,3609,1272,2337
202104,11410,서울특별시,서대문구,85-89세,3652,1286,2366
202105,11410,서울특별시,서대문구,85-89세,3695,1304,2391
202106,11410,서울특별시,서대문구,85-89세,3699,1307,2392
202007,11410,서울특별시,서대문구,90-94세,1252,362,890
202008,11410,서울특별시,서대문구,90-94세,1258,369,889
202009,11410,서울특별시,서대문구,90-94세,1271,376,895
202010,11410,서울특별시,서대문구,90-94세,1280,374,906
202011,11410,서울특별시,서대문구,90-94세,1280,371,909
202012,11410,서울특별시,서대문구,90-94세,1283,372,911
202101,11410,서울특별시,서대문구,90-94세,1296,378,918
202102,11410,서울특별시,서대문구,90-94세,1314,376,938
202103,11410,서울특별시,서대문구,90-94세,1234,341,893
202104,11410,서울특별시,서대문구,90-94세,1232,339,893
202105,11410,서울특별시,서대문구,90-94세,1242,348,894
202106,11410,서울특별시,서대문구,90-94세,1243,345,898
202007,11410,서울특별시,서대문구,95-99세,360,94,266
202008,11410,서울특별시,서대문구,95-99세,359,92,267
202009,11410,서울특별시,서대문구,95-99세,364,91,273
202010,11410,서울특별시,서대문구,95-99세,366,91,275
202011,11410,서울특별시,서대문구,95-99세,368,93,275
202012,11410,서울특별시,서대문구,95-99세,368,92,276
202101,11410,서울특별시,서대문구,95-99세,364,89,275
202102,11410,서울특별시,서대문구,95-99세,366,93,273
202103,11410,서울특별시,서대문구,95-99세,292,67,225
202104,11410,서울특별시,서대문구,95-99세,296,69,227
202105,11410,서울특별시,서대문구,95-99세,298,67,231
202106,11410,서울특별시,서대문구,95-99세,292,68,224
202007,11410,서울특별시,서대문구,100+,283,75,208
202008,11410,서울특별시,서대문구,100+,284,76,208
202009,11410,서울특별시,서대문구,100+,284,76,208
202010,11410,서울특별시,서대문구,100+,289,80,209
202011,11410,서울특별시,서대문구,100+,295,81,214
202012,11410,서울특별시,서대문구,100+,298,81,217
202101,11410,서울특별시,서대문구,100+,304,86,218
202102,11410,서울특별시,서대문구,100+,306,86,220
202103,11410,서울특별시,서대문구,100+,109,32,77
202104,11410,서울특별시,서대문구,100+,110,32,78
202105,11410,서울특별시,서대문구,100+,112,35,77
202106,11410,서울특별시,서대문구,100+,112,35,77
202007,11440,서울특별시,마포구,0-4세,12029,6167,5862
202008,11440,서울특별시,마포구,0-4세,11921,6117,5804
202009,11440,서울특별시,마포구,0-4세,11825,6063,5762
202010,11440,서울특별시,마포구,0-4세,11701,5996,5705
202011,11440,서울특별시,마포구,0-4세,11607,5978,5629
202012,11440,서울특별시,마포구,0-4세,11503,5939,5564
202101,11440,서울특별시,마포구,0-4세,11323,5853,5470
202102,11440,서울특별시,마포구,0-4세,11227,5789,5438
202103,11440,서울특별시,마포구,0-4세,11068,5704,5364
202104,11440,서울특별시,마포구,0-4세,11052,5721,5331
202105,11440,서울특별시,마포구,0-4세,11000,5688,5312
202106,11440,서울특별시,마포구,0-4세,10854,5617,5237
202007,11440,서울특별시,마포구,5-9세,13690,6871,6819
202008,11440,서울특별시,마포구,5-9세,13665,6849,6816
202009,11440,서울특별시,마포구,5-9세,13648,6842,6806
202010,11440,서울특별시,마포구,5-9세,13546,6788,6758
202011,11440,서울특별시,마포구,5-9세,13479,6742,6737
202012,11440,서울특별시,마포구,5-9세,13396,6704,6692
202101,11440,서울특별시,마포구,5-9세,13371,6706,6665
202102,11440,서울특별시,마포구,5-9세,13292,6679,6613
202103,11440,서울특별시,마포구,5-9세,13242,6667,6575
202104,11440,서울특별시,마포구,5-9세,13315,6703,6612
202105,11440,서울특별시,마포구,5-9세,13400,6756,6644
202106,11440,서울특별시,마포구,5-9세,13422,6750,6672
202007,11440,서울특별시,마포구,10-14세,13773,7008,6765
202008,11440,서울특별시,마포구,10-14세,13710,6973,6737
202009,11440,서울특별시,마포구,10-14세,13690,6937,6753
202010,11440,서울특별시,마포구,10-14세,13701,6938,6763
202011,11440,서울특별시,마포구,10-14세,13716,6959,6757
202012,11440,서울특별시,마포구,10-14세,13770,7003,6767
202101,11440,서울특별시,마포구,10-14세,13777,7014,6763
202102,11440,서울특별시,마포구,10-14세,13706,6963,6743
202103,11440,서울특별시,마포구,10-14세,13646,6930,6716
202104,11440,서울특별시,마포구,10-14세,13725,6958,6767
202105,11440,서울특별시,마포구,10-14세,13706,6958,6748
202106,11440,서울특별시,마포구,10-14세,13709,6956,6753
202007,11440,서울특별시,마포구,15-19세,15220,7641,7579
202008,11440,서울특별시,마포구,15-19세,15102,7588,7514
202009,11440,서울특별시,마포구,15-19세,14989,7536,7453
202010,11440,서울특별시,마포구,15-19세,14843,7482,7361
202011,11440,서울특별시,마포구,15-19세,14703,7412,7291
202012,11440,서울특별시,마포구,15-19세,14602,7363,7239
202101,11440,서울특별시,마포구,15-19세,14505,7291,7214
202102,11440,서울특별시,마포구,15-19세,14526,7264,7262
202103,11440,서울특별시,마포구,15-19세,14539,7276,7263
202104,11440,서울특별시,마포구,15-19세,14479,7241,7238
202105,11440,서울특별시,마포구,15-19세,14412,7213,7199
202106,11440,서울특별시,마포구,15-19세,14406,7201,7205
202007,11440,서울특별시,마포구,20-24세,26051,11603,14448
202008,11440,서울특별시,마포구,20-24세,26054,11574,14480
202009,11440,서울특별시,마포구,20-24세,26085,11577,14508
202010,11440,서울특별시,마포구,20-24세,25932,11483,14449
202011,11440,서울특별시,마포구,20-24세,25768,11402,14366
202012,11440,서울특별시,마포구,20-24세,25662,11348,14314
202101,11440,서울특별시,마포구,20-24세,25463,11293,14170
202102,11440,서울특별시,마포구,20-24세,25495,11234,14261
202103,11440,서울특별시,마포구,20-24세,25509,11213,14296
202104,11440,서울특별시,마포구,20-24세,25587,11236,14351
202105,11440,서울특별시,마포구,20-24세,25512,11191,14321
202106,11440,서울특별시,마포구,20-24세,25509,11174,14335
202007,11440,서울특별시,마포구,25-29세,35728,16429,19299
202008,11440,서울특별시,마포구,25-29세,35885,16486,19399
202009,11440,서울특별시,마포구,25-29세,36059,16545,19514
202010,11440,서울특별시,마포구,25-29세,36097,16568,19529
202011,11440,서울특별시,마포구,25-29세,36152,16590,19562
202012,11440,서울특별시,마포구,25-29세,36242,16559,19683
202101,11440,서울특별시,마포구,25-29세,36217,16532,19685
202102,11440,서울특별시,마포구,25-29세,36104,16517,19587
202103,11440,서울특별시,마포구,25-29세,36055,16559,19496
202104,11440,서울특별시,마포구,25-29세,36097,16543,19554
202105,11440,서울특별시,마포구,25-29세,36178,16548,19630
202106,11440,서울특별시,마포구,25-29세,36306,16600,19706
202007,11440,서울특별시,마포구,30-34세,32233,14788,17445
202008,11440,서울특별시,마포구,30-34세,32143,14730,17413
202009,11440,서울특별시,마포구,30-34세,32200,14782,17418
202010,11440,서울특별시,마포구,30-34세,32166,14795,17371
202011,11440,서울특별시,마포구,30-34세,32096,14752,17344
202012,11440,서울특별시,마포구,30-34세,32085,14752,17333
202101,11440,서울특별시,마포구,30-34세,32070,14757,17313
202102,11440,서울특별시,마포구,30-34세,32031,14769,17262
202103,11440,서울특별시,마포구,30-34세,32008,14756,17252
202104,11440,서울특별시,마포구,30-34세,32162,14791,17371
202105,11440,서울특별시,마포구,30-34세,32256,14850,17406
202106,11440,서울특별시,마포구,30-34세,32205,14851,17354
202007,11440,서울특별시,마포구,35-39세,32940,16035,16905
202008,11440,서울특별시,마포구,35-39세,32865,16011,16854
202009,11440,서울특별시,마포구,35-39세,32751,15930,16821
202010,11440,서울특별시,마포구,35-39세,32636,15870,16766
202011,11440,서울특별시,마포구,35-39세,32561,15850,16711
202012,11440,서울특별시,마포구,35-39세,32401,15751,16650
202101,11440,서울특별시,마포구,35-39세,32313,15704,16609
202102,11440,서울특별시,마포구,35-39세,32084,15572,16512
202103,11440,서울특별시,마포구,35-39세,31769,15401,16368
202104,11440,서울특별시,마포구,35-39세,31829,15447,16382
202105,11440,서울특별시,마포구,35-39세,31785,15392,16393
202106,11440,서울특별시,마포구,35-39세,31651,15314,16337
202007,11440,서울특별시,마포구,40-44세,29410,14211,15199
202008,11440,서울특별시,마포구,40-44세,29378,14165,15213
202009,11440,서울특별시,마포구,40-44세,29396,14183,15213
202010,11440,서울특별시,마포구,40-44세,29338,14125,15213
202011,11440,서울특별시,마포구,40-44세,29321,14114,15207
202012,11440,서울특별시,마포구,40-44세,29269,14090,15179
202101,11440,서울특별시,마포구,40-44세,29302,14119,15183
202102,11440,서울특별시,마포구,40-44세,29432,14190,15242
202103,11440,서울특별시,마포구,40-44세,29259,14140,15119
202104,11440,서울특별시,마포구,40-44세,29395,14214,15181
202105,11440,서울특별시,마포구,40-44세,29459,14223,15236
202106,11440,서울특별시,마포구,40-44세,29612,14311,15301
202007,11440,서울특별시,마포구,45-49세,32416,15909,16507
202008,11440,서울특별시,마포구,45-49세,32226,15840,16386
202009,11440,서울특별시,마포구,45-49세,32058,15742,16316
202010,11440,서울특별시,마포구,45-49세,31867,15645,16222
202011,11440,서울특별시,마포구,45-49세,31767,15594,16173
202012,11440,서울특별시,마포구,45-49세,31726,15559,16167
202101,11440,서울특별시,마포구,45-49세,31523,15436,16087
202102,11440,서울특별시,마포구,45-49세,31397,15353,16044
202103,11440,서울특별시,마포구,45-49세,31087,15175,15912
202104,11440,서울특별시,마포구,45-49세,31135,15205,15930
202105,11440,서울특별시,마포구,45-49세,30999,15149,15850
202106,11440,서울특별시,마포구,45-49세,30927,15069,15858
202007,11440,서울특별시,마포구,50-54세,28580,14057,14523
202008,11440,서울특별시,마포구,50-54세,28558,14056,14502
202009,11440,서울특별시,마포구,50-54세,28618,14067,14551
202010,11440,서울특별시,마포구,50-54세,28741,14144,14597
202011,11440,서울특별시,마포구,50-54세,28768,14166,14602
202012,11440,서울특별시,마포구,50-54세,28739,14169,14570
202101,11440,서울특별시,마포구,50-54세,28939,14244,14695
202102,11440,서울특별시,마포구,50-54세,29105,14308,14797
202103,11440,서울특별시,마포구,50-54세,29021,14255,14766
202104,11440,서울특별시,마포구,50-54세,29170,14286,14884
202105,11440,서울특별시,마포구,50-54세,29436,14403,15033
202106,11440,서울특별시,마포구,50-54세,29592,14465,15127
202007,11440,서울특별시,마포구,55-59세,25719,12652,13067
202008,11440,서울특별시,마포구,55-59세,25677,12601,13076
202009,11440,서울특별시,마포구,55-59세,25624,12582,13042
202010,11440,서울특별시,마포구,55-59세,25591,12544,13047
202011,11440,서울특별시,마포구,55-59세,25497,12495,13002
202012,11440,서울특별시,마포구,55-59세,25516,12484,13032
202101,11440,서울특별시,마포구,55-59세,25350,12407,12943
202102,11440,서울특별시,마포구,55-59세,25309,12407,12902
202103,11440,서울특별시,마포구,55-59세,25120,12317,12803
202104,11440,서울특별시,마포구,55-59세,25101,12327,12774
202105,11440,서울특별시,마포구,55-59세,24990,12323,12667
202106,11440,서울특별시,마포구,55-59세,24898,12294,12604
202007,11440,서울특별시,마포구,60-64세,22846,10693,12153
202008,11440,서울특별시,마포구,60-64세,22864,10730,12134
202009,11440,서울특별시,마포구,60-64세,22856,10714,12142
202010,11440,서울특별시,마포구,60-64세,22886,10750,12136
202011,11440,서울특별시,마포구,60-64세,22942,10770,12172
202012,11440,서울특별시,마포구,60-64세,22977,10797,12180
202101,11440,서울특별시,마포구,60-64세,23125,10857,12268
202102,11440,서울특별시,마포구,60-64세,23150,10880,12270
202103,11440,서울특별시,마포구,60-64세,23063,10853,12210
202104,11440,서울특별시,마포구,60-64세,23250,10944,12306
202105,11440,서울특별시,마포구,60-64세,23397,11002,12395
202106,11440,서울특별시,마포구,60-64세,23508,11053,12455
202007,11440,서울특별시,마포구,65-69세,16067,7283,8784
202008,11440,서울특별시,마포구,65-69세,16200,7350,8850
202009,11440,서울특별시,마포구,65-69세,16317,7415,8902
202010,11440,서울특별시,마포구,65-69세,16427,7464,8963
202011,11440,서울특별시,마포구,65-69세,16506,7489,9017
202012,11440,서울특별시,마포구,65-69세,16582,7541,9041
202101,11440,서울특별시,마포구,65-69세,16677,7612,9065
202102,11440,서울특별시,마포구,65-69세,16763,7657,9106
202103,11440,서울특별시,마포구,65-69세,16672,7634,9038
202104,11440,서울특별시,마포구,65-69세,16745,7659,9086
202105,11440,서울특별시,마포구,65-69세,16878,7709,9169
202106,11440,서울특별시,마포구,65-69세,16984,7778,9206
202007,11440,서울특별시,마포구,70-74세,13267,5557,7710
202008,11440,서울특별시,마포구,70-74세,13249,5555,7694
202009,11440,서울특별시,마포구,70-74세,13257,5556,7701
202010,11440,서울특별시,마포구,70-74세,13284,5561,7723
202011,11440,서울특별시,마포구,70-74세,13300,5582,7718
202012,11440,서울특별시,마포구,70-74세,13271,5571,7700
202101,11440,서울특별시,마포구,70-74세,13346,5598,7748
202102,11440,서울특별시,마포구,70-74세,13355,5608,7747
202103,11440,서울특별시,마포구,70-74세,13055,5501,7554
202104,11440,서울특별시,마포구,70-74세,13078,5507,7571
202105,11440,서울특별시,마포구,70-74세,13033,5506,7527
202106,11440,서울특별시,마포구,70-74세,12945,5449,7496
202007,11440,서울특별시,마포구,75-79세,11277,4821,6456
202008,11440,서울특별시,마포구,75-79세,11235,4796,6439
202009,11440,서울특별시,마포구,75-79세,11166,4777,6389
202010,11440,서울특별시,마포구,75-79세,11116,4746,6370
202011,11440,서울특별시,마포구,75-79세,11036,4680,6356
202012,11440,서울특별시,마포구,75-79세,11038,4672,6366
202101,11440,서울특별시,마포구,75-79세,10967,4643,6324
202102,11440,서울특별시,마포구,75-79세,10917,4619,6298
202103,11440,서울특별시,마포구,75-79세,10699,4523,6176
202104,11440,서울특별시,마포구,75-79세,10677,4520,6157
202105,11440,서울특별시,마포구,75-79세,10682,4504,6178
202106,11440,서울특별시,마포구,75-79세,10700,4516,6184
202007,11440,서울특별시,마포구,80-84세,7366,2947,4419
202008,11440,서울특별시,마포구,80-84세,7398,2976,4422
202009,11440,서울특별시,마포구,80-84세,7421,2976,4445
202010,11440,서울특별시,마포구,80-84세,7439,2990,4449
202011,11440,서울특별시,마포구,80-84세,7450,3011,4439
202012,11440,서울특별시,마포구,80-84세,7419,2997,4422
202101,11440,서울특별시,마포구,80-84세,7475,3018,4457
202102,11440,서울특별시,마포구,80-84세,7505,3029,4476
202103,11440,서울특별시,마포구,80-84세,7392,2978,4414
202104,11440,서울특별시,마포구,80-84세,7415,2988,4427
202105,11440,서울특별시,마포구,80-84세,7478,3009,4469
202106,11440,서울특별시,마포구,80-84세,7516,3023,4493
202007,11440,서울특별시,마포구,85-89세,3481,1229,2252
202008,11440,서울특별시,마포구,85-89세,3526,1232,2294
202009,11440,서울특별시,마포구,85-89세,3549,1234,2315
202010,11440,서울특별시,마포구,85-89세,3578,1253,2325
202011,11440,서울특별시,마포구,85-89세,3635,1279,2356
202012,11440,서울특별시,마포구,85-89세,3677,1292,2385
202101,11440,서울특별시,마포구,85-89세,3719,1313,2406
202102,11440,서울특별시,마포구,85-89세,3751,1336,2415
202103,11440,서울특별시,마포구,85-89세,3667,1286,2381
202104,11440,서울특별시,마포구,85-89세,3696,1294,2402
202105,11440,서울특별시,마포구,85-89세,3698,1296,2402
202106,11440,서울특별시,마포구,85-89세,3707,1304,2403
202007,11440,서울특별시,마포구,90-94세,1251,351,900
202008,11440,서울특별시,마포구,90-94세,1266,359,907
202009,11440,서울특별시,마포구,90-94세,1300,372,928
202010,11440,서울특별시,마포구,90-94세,1313,376,937
202011,11440,서울특별시,마포구,90-94세,1308,375,933
202012,11440,서울특별시,마포구,90-94세,1313,373,940
202101,11440,서울특별시,마포구,90-94세,1328,373,955
202102,11440,서울특별시,마포구,90-94세,1344,376,968
202103,11440,서울특별시,마포구,90-94세,1268,350,918
202104,11440,서울특별시,마포구,90-94세,1287,361,926
202105,11440,서울특별시,마포구,90-94세,1292,370,922
202106,11440,서울특별시,마포구,90-94세,1305,373,932
202007,11440,서울특별시,마포구,95-99세,365,105,260
202008,11440,서울특별시,마포구,95-99세,368,106,262
202009,11440,서울특별시,마포구,95-99세,364,100,264
202010,11440,서울특별시,마포구,95-99세,365,100,265
202011,11440,서울특별시,마포구,95-99세,366,103,263
202012,11440,서울특별시,마포구,95-99세,356,104,252
202101,11440,서울특별시,마포구,95-99세,355,104,251
202102,11440,서울특별시,마포구,95-99세,360,103,257
202103,11440,서울특별시,마포구,95-99세,274,72,202
202104,11440,서울특별시,마포구,95-99세,277,71,206
202105,11440,서울특별시,마포구,95-99세,275,69,206
202106,11440,서울특별시,마포구,95-99세,269,66,203
202007,11440,서울특별시,마포구,100+,327,80,247
202008,11440,서울특별시,마포구,100+,330,80,250
202009,11440,서울특별시,마포구,100+,335,81,254
202010,11440,서울특별시,마포구,100+,338,81,257
202011,11440,서울특별시,마포구,100+,342,80,262
202012,11440,서울특별시,마포구,100+,346,82,264
202101,11440,서울특별시,마포구,100+,347,84,263
202102,11440,서울특별시,마포구,100+,347,88,259
202103,11440,서울특별시,마포구,100+,105,34,71
202104,11440,서울특별시,마포구,100+,105,34,71
202105,11440,서울특별시,마포구,100+,104,35,69
202106,11440,서울특별시,마포구,100+,107,36,71
202007,11470,서울특별시,양천구,0-4세,12597,6455,6142
202008,11470,서울특별시,양천구,0-4세,12480,6401,6079
202009,11470,서울특별시,양천구,0-4세,12359,6344,6015
202010,11470,서울특별시,양천구,0-4세,12211,6292,5919
202011,11470,서울특별시,양천구,0-4세,12071,6213,5858
202012,11470,서울특별시,양천구,0-4세,11923,6165,5758
202101,11470,서울특별시,양천구,0-4세,11793,6112,5681
202102,11470,서울특별시,양천구,0-4세,11829,6139,5690
202103,11470,서울특별시,양천구,0-4세,11724,6072,5652
202104,11470,서울특별시,양천구,0-4세,11620,6024,5596
202105,11470,서울특별시,양천구,0-4세,11517,5984,5533
202106,11470,서울특별시,양천구,0-4세,11376,5915,5461
202007,11470,서울특별시,양천구,5-9세,20076,10315,9761
202008,11470,서울특별시,양천구,5-9세,19972,10228,9744
202009,11470,서울특별시,양천구,5-9세,19886,10174,9712
202010,11470,서울특별시,양천구,5-9세,19781,10111,9670
202011,11470,서울특별시,양천구,5-9세,19670,10069,9601
202012,11470,서울특별시,양천구,5-9세,19629,10070,9559
202101,11470,서울특별시,양천구,5-9세,19450,9960,9490
202102,11470,서울특별시,양천구,5-9세,19661,10066,9595
202103,11470,서울특별시,양천구,5-9세,19611,10019,9592
202104,11470,서울특별시,양천구,5-9세,19464,9950,9514
202105,11470,서울특별시,양천구,5-9세,19355,9876,9479
202106,11470,서울특별시,양천구,5-9세,19312,9839,9473
202007,11470,서울특별시,양천구,10-14세,24587,12828,11759
202008,11470,서울특별시,양천구,10-14세,24632,12842,11790
202009,11470,서울특별시,양천구,10-14세,24670,12869,11801
202010,11470,서울특별시,양천구,10-14세,24733,12902,11831
202011,11470,서울특별시,양천구,10-14세,24800,12933,11867
202012,11470,서울특별시,양천구,10-14세,24815,12922,11893
202101,11470,서울특별시,양천구,10-14세,24805,12937,11868
202102,11470,서울특별시,양천구,10-14세,24832,12955,11877
202103,11470,서울특별시,양천구,10-14세,24741,12894,11847
202104,11470,서울특별시,양천구,10-14세,24753,12893,11860
202105,11470,서울특별시,양천구,10-14세,24726,12902,11824
202106,11470,서울특별시,양천구,10-14세,24725,12919,11806
202007,11470,서울특별시,양천구,15-19세,26777,13913,12864
202008,11470,서울특별시,양천구,15-19세,26616,13824,12792
202009,11470,서울특별시,양천구,15-19세,26473,13763,12710
202010,11470,서울특별시,양천구,15-19세,26357,13735,12622
202011,11470,서울특별시,양천구,15-19세,26188,13617,12571
202012,11470,서울특별시,양천구,15-19세,26057,13610,12447
202101,11470,서울특별시,양천구,15-19세,25839,13482,12357
202102,11470,서울특별시,양천구,15-19세,25749,13414,12335
202103,11470,서울특별시,양천구,15-19세,25569,13334,12235
202104,11470,서울특별시,양천구,15-19세,25448,13258,12190
202105,11470,서울특별시,양천구,15-19세,25358,13196,12162
202106,11470,서울특별시,양천구,15-19세,25277,13160,12117
202007,11470,서울특별시,양천구,20-24세,29597,15469,14128
202008,11470,서울특별시,양천구,20-24세,29499,15395,14104
202009,11470,서울특별시,양천구,20-24세,29303,15269,14034
202010,11470,서울특별시,양천구,20-24세,29187,15182,14005
202011,11470,서울특별시,양천구,20-24세,29149,15158,13991
202012,11470,서울특별시,양천구,20-24세,28947,15020,13927
202101,11470,서울특별시,양천구,20-24세,28851,14981,13870
202102,11470,서울특별시,양천구,20-24세,28709,14886,13823
202103,11470,서울특별시,양천구,20-24세,28522,14771,13751
202104,11470,서울특별시,양천구,20-24세,28398,14695,13703
202105,11470,서울특별시,양천구,20-24세,28286,14630,13656
202106,11470,서울특별시,양천구,20-24세,28144,14540,13604
202007,11470,서울특별시,양천구,25-29세,30948,15527,15421
202008,11470,서울특별시,양천구,25-29세,30953,15519,15434
202009,11470,서울특별시,양천구,25-29세,30959,15532,15427
202010,11470,서울특별시,양천구,25-29세,30903,15492,15411
202011,11470,서울특별시,양천구,25-29세,30800,15422,15378
202012,11470,서울특별시,양천구,25-29세,30827,15406,15421
202101,11470,서울특별시,양천구,25-29세,30689,15367,15322
202102,11470,서울특별시,양천구,25-29세,30591,15311,15280
202103,11470,서울특별시,양천구,25-29세,30664,15350,15314
202104,11470,서울특별시,양천구,25-29세,30645,15323,15322
202105,11470,서울특별시,양천구,25-29세,30586,15304,15282
202106,11470,서울특별시,양천구,25-29세,30580,15309,15271
202007,11470,서울특별시,양천구,30-34세,27046,13513,13533
202008,11470,서울특별시,양천구,30-34세,26876,13417,13459
202009,11470,서울특별시,양천구,30-34세,26731,13349,13382
202010,11470,서울특별시,양천구,30-34세,26647,13319,13328
202011,11470,서울특별시,양천구,30-34세,26471,13184,13287
202012,11470,서울특별시,양천구,30-34세,26399,13156,13243
202101,11470,서울특별시,양천구,30-34세,26440,13185,13255
202102,11470,서울특별시,양천구,30-34세,26449,13186,13263
202103,11470,서울특별시,양천구,30-34세,26453,13228,13225
202104,11470,서울특별시,양천구,30-34세,26478,13251,13227
202105,11470,서울특별시,양천구,30-34세,26467,13265,13202
202106,11470,서울특별시,양천구,30-34세,26464,13268,13196
202007,11470,서울특별시,양천구,35-39세,32211,15647,16564
202008,11470,서울특별시,양천구,35-39세,32051,15599,16452
202009,11470,서울특별시,양천구,35-39세,31911,15516,16395
202010,11470,서울특별시,양천구,35-39세,31762,15458,16304
202011,11470,서울특별시,양천구,35-39세,31639,15415,16224
202012,11470,서울특별시,양천구,35-39세,31421,15313,16108
202101,11470,서울특별시,양천구,35-39세,31192,15201,15991
202102,11470,서울특별시,양천구,35-39세,31146,15158,15988
202103,11470,서울특별시,양천구,35-39세,30903,15036,15867
202104,11470,서울특별시,양천구,35-39세,30700,14951,15749
202105,11470,서울특별시,양천구,35-39세,30474,14842,15632
202106,11470,서울특별시,양천구,35-39세,30267,14732,15535
202007,11470,서울특별시,양천구,40-44세,36239,17122,19117
202008,11470,서울특별시,양천구,40-44세,36217,17129,19088
202009,11470,서울특별시,양천구,40-44세,36257,17149,19108
202010,11470,서울특별시,양천구,40-44세,36303,17141,19162
202011,11470,서울특별시,양천구,40-44세,36316,17135,19181
202012,11470,서울특별시,양천구,40-44세,36236,17117,19119
202101,11470,서울특별시,양천구,40-44세,36115,17035,19080
202102,11470,서울특별시,양천구,40-44세,36432,17197,19235
202103,11470,서울특별시,양천구,40-44세,36190,17075,19115
202104,11470,서울특별시,양천구,40-44세,36142,17059,19083
202105,11470,서울특별시,양천구,40-44세,36186,17071,19115
202106,11470,서울특별시,양천구,40-44세,36319,17123,19196
202007,11470,서울특별시,양천구,45-49세,43661,21132,22529
202008,11470,서울특별시,양천구,45-49세,43482,21021,22461
202009,11470,서울특별시,양천구,45-49세,43269,20924,22345
202010,11470,서울특별시,양천구,45-49세,43024,20827,22197
202011,11470,서울특별시,양천구,45-49세,42845,20765,22080
202012,11470,서울특별시,양천구,45-49세,42757,20715,22042
202101,11470,서울특별시,양천구,45-49세,42459,20552,21907
202102,11470,서울특별시,양천구,45-49세,42443,20552,21891
202103,11470,서울특별시,양천구,45-49세,42217,20423,21794
202104,11470,서울특별시,양천구,45-49세,42072,20334,21738
202105,11470,서울특별시,양천구,45-49세,41754,20184,21570
202106,11470,서울특별시,양천구,45-49세,41471,20058,21413
202007,11470,서울특별시,양천구,50-54세,40430,20160,20270
202008,11470,서울특별시,양천구,50-54세,40508,20222,20286
202009,11470,서울특별시,양천구,50-54세,40537,20215,20322
202010,11470,서울특별시,양천구,50-54세,40593,20234,20359
202011,11470,서울특별시,양천구,50-54세,40594,20220,20374
202012,11470,서울특별시,양천구,50-54세,40430,20141,20289
202101,11470,서울특별시,양천구,50-54세,40641,20247,20394
202102,11470,서울특별시,양천구,50-54세,40704,20283,20421
202103,11470,서울특별시,양천구,50-54세,40598,20219,20379
202104,11470,서울특별시,양천구,50-54세,40624,20251,20373
202105,11470,서울특별시,양천구,50-54세,40841,20344,20497
202106,11470,서울특별시,양천구,50-54세,40956,20404,20552
202007,11470,서울특별시,양천구,55-59세,36579,18127,18452
202008,11470,서울특별시,양천구,55-59세,36434,18058,18376
202009,11470,서울특별시,양천구,55-59세,36251,17965,18286
202010,11470,서울특별시,양천구,55-59세,36159,17925,18234
202011,11470,서울특별시,양천구,55-59세,36119,17912,18207
202012,11470,서울특별시,양천구,55-59세,36065,17880,18185
202101,11470,서울특별시,양천구,55-59세,35830,17801,18029
202102,11470,서울특별시,양천구,55-59세,35813,17761,18052
202103,11470,서울특별시,양천구,55-59세,35682,17717,17965
202104,11470,서울특별시,양천구,55-59세,35539,17632,17907
202105,11470,서울특별시,양천구,55-59세,35345,17528,17817
202106,11470,서울특별시,양천구,55-59세,35112,17401,17711
202007,11470,서울특별시,양천구,60-64세,32832,15712,17120
202008,11470,서울특별시,양천구,60-64세,32922,15757,17165
202009,11470,서울특별시,양천구,60-64세,32961,15802,17159
202010,11470,서울특별시,양천구,60-64세,32986,15793,17193
202011,11470,서울특별시,양천구,60-64세,33091,15846,17245
202012,11470,서울특별시,양천구,60-64세,33204,15887,17317
202101,11470,서울특별시,양천구,60-64세,33367,15965,17402
202102,11470,서울특별시,양천구,60-64세,33654,16130,17524
202103,11470,서울특별시,양천구,60-64세,33725,16150,17575
202104,11470,서울특별시,양천구,60-64세,33857,16223,17634
202105,11470,서울특별시,양천구,60-64세,34045,16320,17725
202106,11470,서울특별시,양천구,60-64세,34197,16393,17804
202007,11470,서울특별시,양천구,65-69세,23491,11386,12105
202008,11470,서울특별시,양천구,65-69세,23670,11450,12220
202009,11470,서울특별시,양천구,65-69세,23830,11495,12335
202010,11470,서울특별시,양천구,65-69세,24049,11600,12449
202011,11470,서울특별시,양천구,65-69세,24210,11646,12564
202012,11470,서울특별시,양천구,65-69세,24347,11697,12650
202101,11470,서울특별시,양천구,65-69세,24510,11754,12756
202102,11470,서울특별시,양천구,65-69세,24696,11830,12866
202103,11470,서울특별시,양천구,65-69세,24907,11943,12964
202104,11470,서울특별시,양천구,65-69세,25045,11992,13053
202105,11470,서울특별시,양천구,65-69세,25119,12040,13079
202106,11470,서울특별시,양천구,65-69세,25241,12093,13148
202007,11470,서울특별시,양천구,70-74세,16603,7988,8615
202008,11470,서울특별시,양천구,70-74세,16719,8055,8664
202009,11470,서울특별시,양천구,70-74세,16854,8143,8711
202010,11470,서울특별시,양천구,70-74세,16948,8193,8755
202011,11470,서울특별시,양천구,70-74세,17097,8280,8817
202012,11470,서울특별시,양천구,70-74세,17183,8320,8863
202101,11470,서울특별시,양천구,70-74세,17311,8387,8924
202102,11470,서울특별시,양천구,70-74세,17398,8436,8962
202103,11470,서울특별시,양천구,70-74세,17299,8393,8906
202104,11470,서울특별시,양천구,70-74세,17379,8441,8938
202105,11470,서울특별시,양천구,70-74세,17431,8451,8980
202106,11470,서울특별시,양천구,70-74세,17416,8427,8989
202007,11470,서울특별시,양천구,75-79세,11522,5215,6307
202008,11470,서울특별시,양천구,75-79세,11544,5227,6317
202009,11470,서울특별시,양천구,75-79세,11524,5218,6306
202010,11470,서울특별시,양천구,75-79세,11488,5199,6289
202011,11470,서울특별시,양천구,75-79세,11431,5177,6254
202012,11470,서울특별시,양천구,75-79세,11410,5154,6256
202101,11470,서울특별시,양천구,75-79세,11416,5161,6255
202102,11470,서울특별시,양천구,75-79세,11405,5153,6252
202103,11470,서울특별시,양천구,75-79세,11327,5129,6198
202104,11470,서울특별시,양천구,75-79세,11347,5150,6197
202105,11470,서울특별시,양천구,75-79세,11384,5167,6217
202106,11470,서울특별시,양천구,75-79세,11398,5178,6220
202007,11470,서울특별시,양천구,80-84세,7022,2641,4381
202008,11470,서울특별시,양천구,80-84세,7052,2662,4390
202009,11470,서울특별시,양천구,80-84세,7079,2678,4401
202010,11470,서울특별시,양천구,80-84세,7097,2701,4396
202011,11470,서울특별시,양천구,80-84세,7120,2719,4401
202012,11470,서울특별시,양천구,80-84세,7127,2731,4396
202101,11470,서울특별시,양천구,80-84세,7161,2753,4408
202102,11470,서울특별시,양천구,80-84세,7217,2781,4436
202103,11470,서울특별시,양천구,80-84세,7196,2766,4430
202104,11470,서울특별시,양천구,80-84세,7201,2771,4430
202105,11470,서울특별시,양천구,80-84세,7228,2808,4420
202106,11470,서울특별시,양천구,80-84세,7309,2871,4438
202007,11470,서울특별시,양천구,85-89세,3487,1007,2480
202008,11470,서울특별시,양천구,85-89세,3496,1008,2488
202009,11470,서울특별시,양천구,85-89세,3521,1025,2496
202010,11470,서울특별시,양천구,85-89세,3547,1039,2508
202011,11470,서울특별시,양천구,85-89세,3562,1037,2525
202012,11470,서울특별시,양천구,85-89세,3594,1046,2548
202101,11470,서울특별시,양천구,85-89세,3606,1057,2549
202102,11470,서울특별시,양천구,85-89세,3616,1075,2541
202103,11470,서울특별시,양천구,85-89세,3635,1081,2554
202104,11470,서울특별시,양천구,85-89세,3683,1102,2581
202105,11470,서울특별시,양천구,85-89세,3714,1111,2603
202106,11470,서울특별시,양천구,85-89세,3699,1099,2600
202007,11470,서울특별시,양천구,90-94세,1292,326,966
202008,11470,서울특별시,양천구,90-94세,1311,328,983
202009,11470,서울특별시,양천구,90-94세,1316,331,985
202010,11470,서울특별시,양천구,90-94세,1329,333,996
202011,11470,서울특별시,양천구,90-94세,1343,344,999
202012,11470,서울특별시,양천구,90-94세,1341,350,991
202101,11470,서울특별시,양천구,90-94세,1356,356,1000
202102,11470,서울특별시,양천구,90-94세,1364,351,1013
202103,11470,서울특별시,양천구,90-94세,1314,332,982
202104,11470,서울특별시,양천구,90-94세,1316,332,984
202105,11470,서울특별시,양천구,90-94세,1321,333,988
202106,11470,서울특별시,양천구,90-94세,1324,336,988
202007,11470,서울특별시,양천구,95-99세,370,80,290
202008,11470,서울특별시,양천구,95-99세,364,83,281
202009,11470,서울특별시,양천구,95-99세,361,80,281
202010,11470,서울특별시,양천구,95-99세,355,77,278
202011,11470,서울특별시,양천구,95-99세,354,77,277
202012,11470,서울특별시,양천구,95-99세,352,75,277
202101,11470,서울특별시,양천구,95-99세,359,73,286
202102,11470,서울특별시,양천구,95-99세,369,75,294
202103,11470,서울특별시,양천구,95-99세,335,64,271
202104,11470,서울특별시,양천구,95-99세,333,62,271
202105,11470,서울특별시,양천구,95-99세,335,61,274
202106,11470,서울특별시,양천구,95-99세,336,61,275
202007,11470,서울특별시,양천구,100+,176,45,131
202008,11470,서울특별시,양천구,100+,182,46,136
202009,11470,서울특별시,양천구,100+,188,48,140
202010,11470,서울특별시,양천구,100+,190,48,142
202011,11470,서울특별시,양천구,100+,188,48,140
202012,11470,서울특별시,양천구,100+,187,49,138
202101,11470,서울특별시,양천구,100+,192,51,141
202102,11470,서울특별시,양천구,100+,193,50,143
202103,11470,서울특별시,양천구,100+,65,14,51
202104,11470,서울특별시,양천구,100+,68,14,54
202105,11470,서울특별시,양천구,100+,69,14,55
202106,11470,서울특별시,양천구,100+,69,14,55
202007,11500,서울특별시,강서구,0-4세,18895,9693,9202
202008,11500,서울특별시,강서구,0-4세,18584,9549,9035
202009,11500,서울특별시,강서구,0-4세,18294,9391,8903
202010,11500,서울특별시,강서구,0-4세,17962,9216,8746
202011,11500,서울특별시,강서구,0-4세,17763,9107,8656
202012,11500,서울특별시,강서구,0-4세,17481,8979,8502
202101,11500,서울특별시,강서구,0-4세,17134,8812,8322
202102,11500,서울특별시,강서구,0-4세,16987,8720,8267
202103,11500,서울특별시,강서구,0-4세,16878,8638,8240
202104,11500,서울특별시,강서구,0-4세,16792,8576,8216
202105,11500,서울특별시,강서구,0-4세,16667,8517,8150
202106,11500,서울특별시,강서구,0-4세,16521,8454,8067
202007,11500,서울특별시,강서구,5-9세,22734,11547,11187
202008,11500,서울특별시,강서구,5-9세,22581,11497,11084
202009,11500,서울특별시,강서구,5-9세,22359,11418,10941
202010,11500,서울특별시,강서구,5-9세,22264,11376,10888
202011,11500,서울특별시,강서구,5-9세,22212,11330,10882
202012,11500,서울특별시,강서구,5-9세,22079,11243,10836
202101,11500,서울특별시,강서구,5-9세,21909,11141,10768
202102,11500,서울특별시,강서구,5-9세,21838,11109,10729
202103,11500,서울특별시,강서구,5-9세,21817,11100,10717
202104,11500,서울특별시,강서구,5-9세,21783,11099,10684
202105,11500,서울특별시,강서구,5-9세,21726,11076,10650
202106,11500,서울특별시,강서구,5-9세,21707,11050,10657
202007,11500,서울특별시,강서구,10-14세,21439,11040,10399
202008,11500,서울특별시,강서구,10-14세,21372,10974,10398
202009,11500,서울특별시,강서구,10-14세,21356,10950,10406
202010,11500,서울특별시,강서구,10-14세,21346,10950,10396
202011,11500,서울특별시,강서구,10-14세,21312,10969,10343
202012,11500,서울특별시,강서구,10-14세,21202,10913,10289
202101,11500,서울특별시,강서구,10-14세,21231,10947,10284
202102,11500,서울특별시,강서구,10-14세,21151,10880,10271
202103,11500,서울특별시,강서구,10-14세,21166,10866,10300
202104,11500,서울특별시,강서구,10-14세,21208,10882,10326
202105,11500,서울특별시,강서구,10-14세,21244,10898,10346
202106,11500,서울특별시,강서구,10-14세,21272,10920,10352
202007,11500,서울특별시,강서구,15-19세,24451,12380,12071
202008,11500,서울특별시,강서구,15-19세,24268,12307,11961
202009,11500,서울특별시,강서구,15-19세,24096,12229,11867
202010,11500,서울특별시,강서구,15-19세,23863,12112,11751
202011,11500,서울특별시,강서구,15-19세,23682,12031,11651
202012,11500,서울특별시,강서구,15-19세,23492,11934,11558
202101,11500,서울특별시,강서구,15-19세,23342,11832,11510
202102,11500,서울특별시,강서구,15-19세,23231,11791,11440
202103,11500,서울특별시,강서구,15-19세,23093,11744,11349
202104,11500,서울특별시,강서구,15-19세,22988,11664,11324
202105,11500,서울특별시,강서구,15-19세,22840,11579,11261
202106,11500,서울특별시,강서구,15-19세,22745,11542,11203
202007,11500,서울특별시,강서구,20-24세,35043,16594,18449
202008,11500,서울특별시,강서구,20-24세,34886,16548,18338
202009,11500,서울특별시,강서구,20-24세,34714,16442,18272
202010,11500,서울특별시,강서구,20-24세,34504,16329,18175
202011,11500,서울특별시,강서구,20-24세,34367,16261,18106
202012,11500,서울특별시,강서구,20-24세,34061,16100,17961
202101,11500,서울특별시,강서구,20-24세,33864,16010,17854
202102,11500,서울특별시,강서구,20-24세,33909,15972,17937
202103,11500,서울특별시,강서구,20-24세,33893,15959,17934
202104,11500,서울특별시,강서구,20-24세,33810,15942,17868
202105,11500,서울특별시,강서구,20-24세,33751,15919,17832
202106,11500,서울특별시,강서구,20-24세,33687,15845,17842
202007,11500,서울특별시,강서구,25-29세,52395,24177,28218
202008,11500,서울특별시,강서구,25-29세,52512,24155,28357
202009,11500,서울특별시,강서구,25-29세,52591,24156,28435
202010,11500,서울특별시,강서구,25-29세,52706,24173,28533
202011,11500,서울특별시,강서구,25-29세,52793,24203,28590
202012,11500,서울특별시,강서구,25-29세,52930,24210,28720
202101,11500,서울특별시,강서구,25-29세,52785,24127,28658
202102,11500,서울특별시,강서구,25-29세,52640,24017,28623
202103,11500,서울특별시,강서구,25-29세,52937,24129,28808
202104,11500,서울특별시,강서구,25-29세,53029,24123,28906
202105,11500,서울특별시,강서구,25-29세,53009,24145,28864
202106,11500,서울특별시,강서구,25-29세,53041,24144,28897
202007,11500,서울특별시,강서구,30-34세,49673,24832,24841
202008,11500,서울특별시,강서구,30-34세,49673,24841,24832
202009,11500,서울특별시,강서구,30-34세,49626,24842,24784
202010,11500,서울특별시,강서구,30-34세,49691,24885,24806
202011,11500,서울특별시,강서구,30-34세,49724,24876,24848
202012,11500,서울특별시,강서구,30-34세,49668,24823,24845
202101,11500,서울특별시,강서구,30-34세,49681,24770,24911
202102,11500,서울특별시,강서구,30-34세,49710,24767,24943
202103,11500,서울특별시,강서구,30-34세,49868,24819,25049
202104,11500,서울특별시,강서구,30-34세,50127,24967,25160
202105,11500,서울특별시,강서구,30-34세,50280,25007,25273
202106,11500,서울특별시,강서구,30-34세,50404,25080,25324
202007,11500,서울특별시,강서구,35-39세,50936,26245,24691
202008,11500,서울특별시,강서구,35-39세,50564,26064,24500
202009,11500,서울특별시,강서구,35-39세,50169,25895,24274
202010,11500,서울특별시,강서구,35-39세,49856,25707,24149
202011,11500,서울특별시,강서구,35-39세,49657,25610,24047
202012,11500,서울특별시,강서구,35-39세,49394,25451,23943
202101,11500,서울특별시,강서구,35-39세,49025,25284,23741
202102,11500,서울특별시,강서구,35-39세,48874,25202,23672
202103,11500,서울특별시,강서구,35-39세,48508,24979,23529
202104,11500,서울특별시,강서구,35-39세,48439,24881,23558
202105,11500,서울특별시,강서구,35-39세,48272,24781,23491
202106,11500,서울특별시,강서구,35-39세,48075,24669,23406
202007,11500,서울특별시,강서구,40-44세,45338,22782,22556
202008,11500,서울특별시,강서구,40-44세,45249,22713,22536
202009,11500,서울특별시,강서구,40-44세,45281,22723,22558
202010,11500,서울특별시,강서구,40-44세,45339,22783,22556
202011,11500,서울특별시,강서구,40-44세,45413,22786,22627
202012,11500,서울특별시,강서구,40-44세,45143,22670,22473
202101,11500,서울특별시,강서구,40-44세,45092,22670,22422
202102,11500,서울특별시,강서구,40-44세,45222,22768,22454
202103,11500,서울특별시,강서구,40-44세,45052,22715,22337
202104,11500,서울특별시,강서구,40-44세,45083,22720,22363
202105,11500,서울특별시,강서구,40-44세,45183,22780,22403
202106,11500,서울특별시,강서구,40-44세,45386,22912,22474
202007,11500,서울특별시,강서구,45-49세,46878,23454,23424
202008,11500,서울특별시,강서구,45-49세,46627,23332,23295
202009,11500,서울특별시,강서구,45-49세,46347,23169,23178
202010,11500,서울특별시,강서구,45-49세,46090,23066,23024
202011,11500,서울특별시,강서구,45-49세,45858,22949,22909
202012,11500,서울특별시,강서구,45-49세,45745,22872,22873
202101,11500,서울특별시,강서구,45-49세,45627,22797,22830
202102,11500,서울특별시,강서구,45-49세,45588,22785,22803
202103,11500,서울특별시,강서구,45-49세,45388,22697,22691
202104,11500,서울특별시,강서구,45-49세,45308,22698,22610
202105,11500,서울특별시,강서구,45-49세,45032,22535,22497
202106,11500,서울특별시,강서구,45-49세,44801,22419,22382
202007,11500,서울특별시,강서구,50-54세,43195,20899,22296
202008,11500,서울특별시,강서구,50-54세,43151,20917,22234
202009,11500,서울특별시,강서구,50-54세,43121,20930,22191
202010,11500,서울특별시,강서구,50-54세,43242,20991,22251
202011,11500,서울특별시,강서구,50-54세,43234,21048,22186
202012,11500,서울특별시,강서구,50-54세,43004,20964,22040
202101,11500,서울특별시,강서구,50-54세,43240,21095,22145
202102,11500,서울특별시,강서구,50-54세,43374,21137,22237
202103,11500,서울특별시,강서구,50-54세,43088,21025,22063
202104,11500,서울특별시,강서구,50-54세,43134,21056,22078
202105,11500,서울특별시,강서구,50-54세,43356,21169,22187
202106,11500,서울특별시,강서구,50-54세,43509,21221,22288
202007,11500,서울특별시,강서구,55-59세,44358,20940,23418
202008,11500,서울특별시,강서구,55-59세,44124,20799,23325
202009,11500,서울특별시,강서구,55-59세,43804,20632,23172
202010,11500,서울특별시,강서구,55-59세,43518,20505,23013
202011,11500,서울특별시,강서구,55-59세,43333,20394,22939
202012,11500,서울특별시,강서구,55-59세,43192,20300,22892
202101,11500,서울특별시,강서구,55-59세,42789,20103,22686
202102,11500,서울특별시,강서구,55-59세,42540,20012,22528
202103,11500,서울특별시,강서구,55-59세,42171,19851,22320
202104,11500,서울특별시,강서구,55-59세,41919,19744,22175
202105,11500,서울특별시,강서구,55-59세,41603,19628,21975
202106,11500,서울특별시,강서구,55-59세,41201,19449,21752
202007,11500,서울특별시,강서구,60-64세,43924,20414,23510
202008,11500,서울특별시,강서구,60-64세,43949,20449,23500
202009,11500,서울특별시,강서구,60-64세,43996,20503,23493
202010,11500,서울특별시,강서구,60-64세,44090,20544,23546
202011,11500,서울특별시,강서구,60-64세,44146,20551,23595
202012,11500,서울특별시,강서구,60-64세,44061,20524,23537
202101,11500,서울특별시,강서구,60-64세,44286,20608,23678
202102,11500,서울특별시,강서구,60-64세,44441,20684,23757
202103,11500,서울특별시,강서구,60-64세,44334,20636,23698
202104,11500,서울특별시,강서구,60-64세,44512,20711,23801
202105,11500,서울특별시,강서구,60-64세,44706,20806,23900
202106,11500,서울특별시,강서구,60-64세,45010,20942,24068
202007,11500,서울특별시,강서구,65-69세,31368,14510,16858
202008,11500,서울특별시,강서구,65-69세,31504,14564,16940
202009,11500,서울특별시,강서구,65-69세,31748,14681,17067
202010,11500,서울특별시,강서구,65-69세,31928,14750,17178
202011,11500,서울특별시,강서구,65-69세,32073,14816,17257
202012,11500,서울특별시,강서구,65-69세,32279,14885,17394
202101,11500,서울특별시,강서구,65-69세,32460,14984,17476
202102,11500,서울특별시,강서구,65-69세,32660,15076,17584
202103,11500,서울특별시,강서구,65-69세,32869,15160,17709
202104,11500,서울특별시,강서구,65-69세,33074,15242,17832
202105,11500,서울특별시,강서구,65-69세,33317,15356,17961
202106,11500,서울특별시,강서구,65-69세,33480,15430,18050
202007,11500,서울특별시,강서구,70-74세,22962,10957,12005
202008,11500,서울특별시,강서구,70-74세,23045,10992,12053
202009,11500,서울특별시,강서구,70-74세,23100,11000,12100
202010,11500,서울특별시,강서구,70-74세,23210,11041,12169
202011,11500,서울특별시,강서구,70-74세,23333,11091,12242
202012,11500,서울특별시,강서구,70-74세,23418,11140,12278
202101,11500,서울특별시,강서구,70-74세,23546,11184,12362
202102,11500,서울특별시,강서구,70-74세,23598,11189,12409
202103,11500,서울특별시,강서구,70-74세,23422,11139,12283
202104,11500,서울특별시,강서구,70-74세,23428,11125,12303
202105,11500,서울특별시,강서구,70-74세,23443,11123,12320
202106,11500,서울특별시,강서구,70-74세,23468,11121,12347
202007,11500,서울특별시,강서구,75-79세,15623,7131,8492
202008,11500,서울특별시,강서구,75-79세,15680,7179,8501
202009,11500,서울특별시,강서구,75-79세,15674,7156,8518
202010,11500,서울특별시,강서구,75-79세,15604,7097,8507
202011,11500,서울특별시,강서구,75-79세,15577,7076,8501
202012,11500,서울특별시,강서구,75-79세,15497,7047,8450
202101,11500,서울특별시,강서구,75-79세,15490,7068,8422
202102,11500,서울특별시,강서구,75-79세,15491,7070,8421
202103,11500,서울특별시,강서구,75-79세,15352,7025,8327
202104,11500,서울특별시,강서구,75-79세,15356,7038,8318
202105,11500,서울특별시,강서구,75-79세,15375,7037,8338
202106,11500,서울특별시,강서구,75-79세,15435,7075,8360
202007,11500,서울특별시,강서구,80-84세,9590,3641,5949
202008,11500,서울특별시,강서구,80-84세,9612,3644,5968
202009,11500,서울특별시,강서구,80-84세,9650,3678,5972
202010,11500,서울특별시,강서구,80-84세,9718,3728,5990
202011,11500,서울특별시,강서구,80-84세,9739,3753,5986
202012,11500,서울특별시,강서구,80-84세,9788,3770,6018
202101,11500,서울특별시,강서구,80-84세,9867,3792,6075
202102,11500,서울특별시,강서구,80-84세,9971,3857,6114
202103,11500,서울특별시,강서구,80-84세,9900,3818,6082
202104,11500,서울특별시,강서구,80-84세,9946,3837,6109
202105,11500,서울특별시,강서구,80-84세,9984,3881,6103
202106,11500,서울특별시,강서구,80-84세,10064,3914,6150
202007,11500,서울특별시,강서구,85-89세,4828,1478,3350
202008,11500,서울특별시,강서구,85-89세,4854,1488,3366
202009,11500,서울특별시,강서구,85-89세,4884,1505,3379
202010,11500,서울특별시,강서구,85-89세,4908,1520,3388
202011,11500,서울특별시,강서구,85-89세,4936,1537,3399
202012,11500,서울특별시,강서구,85-89세,4990,1562,3428
202101,11500,서울특별시,강서구,85-89세,5033,1579,3454
202102,11500,서울특별시,강서구,85-89세,5064,1583,3481
202103,11500,서울특별시,강서구,85-89세,5058,1570,3488
202104,11500,서울특별시,강서구,85-89세,5097,1585,3512
202105,11500,서울특별시,강서구,85-89세,5135,1589,3546
202106,11500,서울특별시,강서구,85-89세,5123,1593,3530
202007,11500,서울특별시,강서구,90-94세,1946,438,1508
202008,11500,서울특별시,강서구,90-94세,1979,446,1533
202009,11500,서울특별시,강서구,90-94세,2011,460,1551
202010,11500,서울특별시,강서구,90-94세,2019,460,1559
202011,11500,서울특별시,강서구,90-94세,2029,457,1572
202012,11500,서울특별시,강서구,90-94세,2029,461,1568
202101,11500,서울특별시,강서구,90-94세,2020,465,1555
202102,11500,서울특별시,강서구,90-94세,2024,462,1562
202103,11500,서울특별시,강서구,90-94세,1965,443,1522
202104,11500,서울특별시,강서구,90-94세,1976,443,1533
202105,11500,서울특별시,강서구,90-94세,1994,452,1542
202106,11500,서울특별시,강서구,90-94세,2018,450,1568
202007,11500,서울특별시,강서구,95-99세,476,120,356
202008,11500,서울특별시,강서구,95-99세,477,117,360
202009,11500,서울특별시,강서구,95-99세,490,118,372
202010,11500,서울특별시,강서구,95-99세,494,116,378
202011,11500,서울특별시,강서구,95-99세,492,114,378
202012,11500,서울특별시,강서구,95-99세,493,111,382
202101,11500,서울특별시,강서구,95-99세,512,113,399
202102,11500,서울특별시,강서구,95-99세,523,112,411
202103,11500,서울특별시,강서구,95-99세,472,103,369
202104,11500,서울특별시,강서구,95-99세,481,105,376
202105,11500,서울특별시,강서구,95-99세,475,101,374
202106,11500,서울특별시,강서구,95-99세,480,101,379
202007,11500,서울특별시,강서구,100+,227,71,156
202008,11500,서울특별시,강서구,100+,229,72,157
202009,11500,서울특별시,강서구,100+,233,73,160
202010,11500,서울특별시,강서구,100+,234,73,161
202011,11500,서울특별시,강서구,100+,236,74,162
202012,11500,서울특별시,강서구,100+,239,75,164
202101,11500,서울특별시,강서구,100+,243,77,166
202102,11500,서울특별시,강서구,100+,246,76,170
202103,11500,서울특별시,강서구,100+,89,28,61
202104,11500,서울특별시,강서구,100+,90,28,62
202105,11500,서울특별시,강서구,100+,92,29,63
202106,11500,서울특별시,강서구,100+,92,29,63
202007,11530,서울특별시,구로구,0-4세,13448,6933,6515
202008,11530,서울특별시,구로구,0-4세,13339,6873,6466
202009,11530,서울특별시,구로구,0-4세,13242,6829,6413
202010,11530,서울특별시,구로구,0-4세,13138,6783,6355
202011,11530,서울특별시,구로구,0-4세,13019,6735,6284
202012,11530,서울특별시,구로구,0-4세,12869,6650,6219
202101,11530,서울특별시,구로구,0-4세,12692,6548,6144
202102,11530,서울특별시,구로구,0-4세,12448,6414,6034
202103,11530,서울특별시,구로구,0-4세,12334,6356,5978
202104,11530,서울특별시,구로구,0-4세,12214,6296,5918
202105,11530,서울특별시,구로구,0-4세,12145,6258,5887
202106,11530,서울특별시,구로구,0-4세,12079,6223,5856
202007,11530,서울특별시,구로구,5-9세,15792,8008,7784
202008,11530,서울특별시,구로구,5-9세,15733,7978,7755
202009,11530,서울특별시,구로구,5-9세,15652,7937,7715
202010,11530,서울특별시,구로구,5-9세,15548,7885,7663
202011,11530,서울특별시,구로구,5-9세,15451,7819,7632
202012,11530,서울특별시,구로구,5-9세,15330,7756,7574
202101,11530,서울특별시,구로구,5-9세,15162,7676,7486
202102,11530,서울특별시,구로구,5-9세,15001,7585,7416
202103,11530,서울특별시,구로구,5-9세,14954,7551,7403
202104,11530,서울특별시,구로구,5-9세,14850,7501,7349
202105,11530,서울특별시,구로구,5-9세,14779,7456,7323
202106,11530,서울특별시,구로구,5-9세,14720,7443,7277
202007,11530,서울특별시,구로구,10-14세,14669,7506,7163
202008,11530,서울특별시,구로구,10-14세,14687,7526,7161
202009,11530,서울특별시,구로구,10-14세,14683,7500,7183
202010,11530,서울특별시,구로구,10-14세,14694,7498,7196
202011,11530,서울특별시,구로구,10-14세,14680,7504,7176
202012,11530,서울특별시,구로구,10-14세,14686,7496,7190
202101,11530,서울특별시,구로구,10-14세,14633,7465,7168
202102,11530,서울특별시,구로구,10-14세,14513,7376,7137
202103,11530,서울특별시,구로구,10-14세,14536,7417,7119
202104,11530,서울특별시,구로구,10-14세,14590,7437,7153
202105,11530,서울특별시,구로구,10-14세,14578,7435,7143
202106,11530,서울특별시,구로구,10-14세,14552,7409,7143
202007,11530,서울특별시,구로구,15-19세,15963,8297,7666
202008,11530,서울특별시,구로구,15-19세,15911,8277,7634
202009,11530,서울특별시,구로구,15-19세,15823,8249,7574
202010,11530,서울특별시,구로구,15-19세,15712,8201,7511
202011,11530,서울특별시,구로구,15-19세,15610,8153,7457
202012,11530,서울특별시,구로구,15-19세,15503,8098,7405
202101,11530,서울특별시,구로구,15-19세,15337,8014,7323
202102,11530,서울특별시,구로구,15-19세,15253,7952,7301
202103,11530,서울특별시,구로구,15-19세,15147,7881,7266
202104,11530,서울특별시,구로구,15-19세,15079,7834,7245
202105,11530,서울특별시,구로구,15-19세,15082,7830,7252
202106,11530,서울특별시,구로구,15-19세,15023,7804,7219
202007,11530,서울특별시,구로구,20-24세,23951,11713,12238
202008,11530,서울특별시,구로구,20-24세,23862,11652,12210
202009,11530,서울특별시,구로구,20-24세,23784,11623,12161
202010,11530,서울특별시,구로구,20-24세,23638,11564,12074
202011,11530,서울특별시,구로구,20-24세,23541,11531,12010
202012,11530,서울특별시,구로구,20-24세,23351,11430,11921
202101,11530,서울특별시,구로구,20-24세,23231,11381,11850
202102,11530,서울특별시,구로구,20-24세,23196,11339,11857
202103,11530,서울특별시,구로구,20-24세,23193,11307,11886
202104,11530,서울특별시,구로구,20-24세,23073,11232,11841
202105,11530,서울특별시,구로구,20-24세,22947,11180,11767
202106,11530,서울특별시,구로구,20-24세,22872,11143,11729
202007,11530,서울특별시,구로구,25-29세,31699,15588,16111
202008,11530,서울특별시,구로구,25-29세,31755,15597,16158
202009,11530,서울특별시,구로구,25-29세,31793,15607,16186
202010,11530,서울특별시,구로구,25-29세,31891,15676,16215
202011,11530,서울특별시,구로구,25-29세,31941,15679,16262
202012,11530,서울특별시,구로구,25-29세,32064,15791,16273
202101,11530,서울특별시,구로구,25-29세,32028,15769,16259
202102,11530,서울특별시,구로구,25-29세,32012,15771,16241
202103,11530,서울특별시,구로구,25-29세,32063,15819,16244
202104,11530,서울특별시,구로구,25-29세,32042,15822,16220
202105,11530,서울특별시,구로구,25-29세,32038,15838,16200
202106,11530,서울특별시,구로구,25-29세,31931,15763,16168
202007,11530,서울특별시,구로구,30-34세,30508,15391,15117
202008,11530,서울특별시,구로구,30-34세,30602,15413,15189
202009,11530,서울특별시,구로구,30-34세,30713,15445,15268
202010,11530,서울특별시,구로구,30-34세,30709,15410,15299
202011,11530,서울특별시,구로구,30-34세,30724,15418,15306
202012,11530,서울특별시,구로구,30-34세,30724,15433,15291
202101,11530,서울특별시,구로구,30-34세,30670,15398,15272
202102,11530,서울특별시,구로구,30-34세,30575,15376,15199
202103,11530,서울특별시,구로구,30-34세,30622,15447,15175
202104,11530,서울특별시,구로구,30-34세,30700,15491,15209
202105,11530,서울특별시,구로구,30-34세,30738,15516,15222
202106,11530,서울특별시,구로구,30-34세,30725,15506,15219
202007,11530,서울특별시,구로구,35-39세,33192,17092,16100
202008,11530,서울특별시,구로구,35-39세,33147,17110,16037
202009,11530,서울특별시,구로구,35-39세,33004,17059,15945
202010,11530,서울특별시,구로구,35-39세,32879,16981,15898
202011,11530,서울특별시,구로구,35-39세,32666,16896,15770
202012,11530,서울특별시,구로구,35-39세,32423,16782,15641
202101,11530,서울특별시,구로구,35-39세,32234,16703,15531
202102,11530,서울특별시,구로구,35-39세,31932,16556,15376
202103,11530,서울특별시,구로구,35-39세,31623,16391,15232
202104,11530,서울특별시,구로구,35-39세,31380,16282,15098
202105,11530,서울특별시,구로구,35-39세,31163,16127,15036
202106,11530,서울특별시,구로구,35-39세,30928,16017,14911
202007,11530,서울특별시,구로구,40-44세,30977,15881,15096
202008,11530,서울특별시,구로구,40-44세,31024,15900,15124
202009,11530,서울특별시,구로구,40-44세,31085,15902,15183
202010,11530,서울특별시,구로구,40-44세,31089,15934,15155
202011,11530,서울특별시,구로구,40-44세,31197,15995,15202
202012,11530,서울특별시,구로구,40-44세,30981,15882,15099
202101,11530,서울특별시,구로구,40-44세,30854,15847,15007
202102,11530,서울특별시,구로구,40-44세,30860,15845,15015
202103,11530,서울특별시,구로구,40-44세,30742,15773,14969
202104,11530,서울특별시,구로구,40-44세,30673,15724,14949
202105,11530,서울특별시,구로구,40-44세,30708,15762,14946
202106,11530,서울특별시,구로구,40-44세,30772,15777,14995
202007,11530,서울특별시,구로구,45-49세,32823,16882,15941
202008,11530,서울특별시,구로구,45-49세,32711,16817,15894
202009,11530,서울특별시,구로구,45-49세,32523,16744,15779
202010,11530,서울특별시,구로구,45-49세,32419,16661,15758
202011,11530,서울특별시,구로구,45-49세,32280,16569,15711
202012,11530,서울특별시,구로구,45-49세,32222,16528,15694
202101,11530,서울특별시,구로구,45-49세,32145,16465,15680
202102,11530,서울특별시,구로구,45-49세,31938,16315,15623
202103,11530,서울특별시,구로구,45-49세,31713,16216,15497
202104,11530,서울특별시,구로구,45-49세,31638,16165,15473
202105,11530,서울특별시,구로구,45-49세,31428,16052,15376
202106,11530,서울특별시,구로구,45-49세,31275,15970,15305
202007,11530,서울특별시,구로구,50-54세,31571,15625,15946
202008,11530,서울특별시,구로구,50-54세,31605,15637,15968
202009,11530,서울특별시,구로구,50-54세,31754,15695,16059
202010,11530,서울특별시,구로구,50-54세,31869,15774,16095
202011,11530,서울특별시,구로구,50-54세,31889,15775,16114
202012,11530,서울특별시,구로구,50-54세,31791,15749,16042
202101,11530,서울특별시,구로구,50-54세,31865,15776,16089
202102,11530,서울특별시,구로구,50-54세,31987,15846,16141
202103,11530,서울특별시,구로구,50-54세,31815,15810,16005
202104,11530,서울특별시,구로구,50-54세,31801,15800,16001
202105,11530,서울특별시,구로구,50-54세,31907,15858,16049
202106,11530,서울특별시,구로구,50-54세,31939,15896,16043
202007,11530,서울특별시,구로구,55-59세,31875,15716,16159
202008,11530,서울특별시,구로구,55-59세,31861,15699,16162
202009,11530,서울특별시,구로구,55-59세,31789,15669,16120
202010,11530,서울특별시,구로구,55-59세,31702,15652,16050
202011,11530,서울특별시,구로구,55-59세,31630,15645,15985
202012,11530,서울특별시,구로구,55-59세,31539,15578,15961
202101,11530,서울특별시,구로구,55-59세,31291,15461,15830
202102,11530,서울특별시,구로구,55-59세,31141,15395,15746
202103,11530,서울특별시,구로구,55-59세,30960,15296,15664
202104,11530,서울특별시,구로구,55-59세,30867,15254,15613
202105,11530,서울특별시,구로구,55-59세,30635,15132,15503
202106,11530,서울특별시,구로구,55-59세,30366,14993,15373
202007,11530,서울특별시,구로구,60-64세,31249,14794,16455
202008,11530,서울특별시,구로구,60-64세,31374,14890,16484
202009,11530,서울특별시,구로구,60-64세,31445,14945,16500
202010,11530,서울특별시,구로구,60-64세,31521,14947,16574
202011,11530,서울특별시,구로구,60-64세,31646,15021,16625
202012,11530,서울특별시,구로구,60-64세,31724,15081,16643
202101,11530,서울특별시,구로구,60-64세,31827,15172,16655
202102,11530,서울특별시,구로구,60-64세,31940,15232,16708
202103,11530,서울특별시,구로구,60-64세,31887,15203,16684
202104,11530,서울특별시,구로구,60-64세,31809,15178,16631
202105,11530,서울특별시,구로구,60-64세,31962,15249,16713
202106,11530,서울특별시,구로구,60-64세,32104,15317,16787
202007,11530,서울특별시,구로구,65-69세,23495,11042,12453
202008,11530,서울특별시,구로구,65-69세,23674,11118,12556
202009,11530,서울특별시,구로구,65-69세,23880,11195,12685
202010,11530,서울특별시,구로구,65-69세,24061,11266,12795
202011,11530,서울특별시,구로구,65-69세,24123,11279,12844
202012,11530,서울특별시,구로구,65-69세,24259,11313,12946
202101,11530,서울특별시,구로구,65-69세,24425,11380,13045
202102,11530,서울특별시,구로구,65-69세,24555,11442,13113
202103,11530,서울특별시,구로구,65-69세,24621,11484,13137
202104,11530,서울특별시,구로구,65-69세,24721,11532,13189
202105,11530,서울특별시,구로구,65-69세,24773,11550,13223
202106,11530,서울특별시,구로구,65-69세,24833,11581,13252
202007,11530,서울특별시,구로구,70-74세,18234,8769,9465
202008,11530,서울특별시,구로구,70-74세,18258,8777,9481
202009,11530,서울특별시,구로구,70-74세,18367,8841,9526
202010,11530,서울특별시,구로구,70-74세,18504,8897,9607
202011,11530,서울특별시,구로구,70-74세,18623,8959,9664
202012,11530,서울특별시,구로구,70-74세,18721,9000,9721
202101,11530,서울특별시,구로구,70-74세,18801,9056,9745
202102,11530,서울특별시,구로구,70-74세,18860,9069,9791
202103,11530,서울특별시,구로구,70-74세,18694,8985,9709
202104,11530,서울특별시,구로구,70-74세,18729,8995,9734
202105,11530,서울특별시,구로구,70-74세,18760,9010,9750
202106,11530,서울특별시,구로구,70-74세,18754,8980,9774
202007,11530,서울특별시,구로구,75-79세,13125,6128,6997
202008,11530,서울특별시,구로구,75-79세,13172,6152,7020
202009,11530,서울특별시,구로구,75-79세,13152,6135,7017
202010,11530,서울특별시,구로구,75-79세,13136,6127,7009
202011,11530,서울특별시,구로구,75-79세,13100,6116,6984
202012,11530,서울특별시,구로구,75-79세,13083,6102,6981
202101,11530,서울특별시,구로구,75-79세,13063,6068,6995
202102,11530,서울특별시,구로구,75-79세,13067,6072,6995
202103,11530,서울특별시,구로구,75-79세,13039,6059,6980
202104,11530,서울특별시,구로구,75-79세,12987,6039,6948
202105,11530,서울특별시,구로구,75-79세,12986,6028,6958
202106,11530,서울특별시,구로구,75-79세,12988,6045,6943
202007,11530,서울특별시,구로구,80-84세,7712,3266,4446
202008,11530,서울특별시,구로구,80-84세,7747,3282,4465
202009,11530,서울특별시,구로구,80-84세,7787,3311,4476
202010,11530,서울특별시,구로구,80-84세,7826,3331,4495
202011,11530,서울특별시,구로구,80-84세,7878,3338,4540
202012,11530,서울특별시,구로구,80-84세,7907,3351,4556
202101,11530,서울특별시,구로구,80-84세,7969,3381,4588
202102,11530,서울특별시,구로구,80-84세,7992,3390,4602
202103,11530,서울특별시,구로구,80-84세,7970,3375,4595
202104,11530,서울특별시,구로구,80-84세,8051,3394,4657
202105,11530,서울특별시,구로구,80-84세,8090,3433,4657
202106,11530,서울특별시,구로구,80-84세,8139,3468,4671
202007,11530,서울특별시,구로구,85-89세,3352,1133,2219
202008,11530,서울특별시,구로구,85-89세,3388,1152,2236
202009,11530,서울특별시,구로구,85-89세,3438,1171,2267
202010,11530,서울특별시,구로구,85-89세,3471,1191,2280
202011,11530,서울특별시,구로구,85-89세,3512,1211,2301
202012,11530,서울특별시,구로구,85-89세,3536,1234,2302
202101,11530,서울특별시,구로구,85-89세,3576,1260,2316
202102,11530,서울특별시,구로구,85-89세,3641,1280,2361
202103,11530,서울특별시,구로구,85-89세,3617,1279,2338
202104,11530,서울특별시,구로구,85-89세,3662,1297,2365
202105,11530,서울특별시,구로구,85-89세,3687,1302,2385
202106,11530,서울특별시,구로구,85-89세,3722,1314,2408
202007,11530,서울특별시,구로구,90-94세,1145,286,859
202008,11530,서울특별시,구로구,90-94세,1157,285,872
202009,11530,서울특별시,구로구,90-94세,1179,294,885
202010,11530,서울특별시,구로구,90-94세,1189,300,889
202011,11530,서울특별시,구로구,90-94세,1195,303,892
202012,11530,서울특별시,구로구,90-94세,1203,300,903
202101,11530,서울특별시,구로구,90-94세,1221,302,919
202102,11530,서울특별시,구로구,90-94세,1240,311,929
202103,11530,서울특별시,구로구,90-94세,1215,296,919
202104,11530,서울특별시,구로구,90-94세,1203,293,910
202105,11530,서울특별시,구로구,90-94세,1199,292,907
202106,11530,서울특별시,구로구,90-94세,1201,294,907
202007,11530,서울특별시,구로구,95-99세,307,74,233
202008,11530,서울특별시,구로구,95-99세,315,77,238
202009,11530,서울특별시,구로구,95-99세,312,78,234
202010,11530,서울특별시,구로구,95-99세,311,78,233
202011,11530,서울특별시,구로구,95-99세,314,78,236
202012,11530,서울특별시,구로구,95-99세,313,79,234
202101,11530,서울특별시,구로구,95-99세,313,79,234
202102,11530,서울특별시,구로구,95-99세,309,80,229
202103,11530,서울특별시,구로구,95-99세,270,75,195
202104,11530,서울특별시,구로구,95-99세,276,74,202
202105,11530,서울특별시,구로구,95-99세,291,76,215
202106,11530,서울특별시,구로구,95-99세,291,77,214
202007,11530,서울특별시,구로구,100+,173,39,134
202008,11530,서울특별시,구로구,100+,173,39,134
202009,11530,서울특별시,구로구,100+,174,39,135
202010,11530,서울특별시,구로구,100+,174,39,135
202011,11530,서울특별시,구로구,100+,175,39,136
202012,11530,서울특별시,구로구,100+,179,40,139
202101,11530,서울특별시,구로구,100+,181,42,139
202102,11530,서울특별시,구로구,100+,182,41,141
202103,11530,서울특별시,구로구,100+,59,14,45
202104,11530,서울특별시,구로구,100+,54,13,41
202105,11530,서울특별시,구로구,100+,54,14,40
202106,11530,서울특별시,구로구,100+,52,14,38
202007,11545,서울특별시,금천구,0-4세,6124,3176,2948
202008,11545,서울특별시,금천구,0-4세,6037,3117,2920
202009,11545,서울특별시,금천구,0-4세,5983,3078,2905
202010,11545,서울특별시,금천구,0-4세,5931,3059,2872
202011,11545,서울특별시,금천구,0-4세,5868,3033,2835
202012,11545,서울특별시,금천구,0-4세,5775,2976,2799
202101,11545,서울특별시,금천구,0-4세,5700,2939,2761
202102,11545,서울특별시,금천구,0-4세,5610,2912,2698
202103,11545,서울특별시,금천구,0-4세,5538,2873,2665
202104,11545,서울특별시,금천구,0-4세,5470,2841,2629
202105,11545,서울특별시,금천구,0-4세,5434,2823,2611
202106,11545,서울특별시,금천구,0-4세,5445,2832,2613
202007,11545,서울특별시,금천구,5-9세,6983,3528,3455
202008,11545,서울특별시,금천구,5-9세,6935,3523,3412
202009,11545,서울특별시,금천구,5-9세,6906,3515,3391
202010,11545,서울특별시,금천구,5-9세,6860,3489,3371
202011,11545,서울특별시,금천구,5-9세,6824,3484,3340
202012,11545,서울특별시,금천구,5-9세,6773,3446,3327
202101,11545,서울특별시,금천구,5-9세,6713,3417,3296
202102,11545,서울특별시,금천구,5-9세,6655,3393,3262
202103,11545,서울특별시,금천구,5-9세,6625,3384,3241
202104,11545,서울특별시,금천구,5-9세,6573,3348,3225
202105,11545,서울특별시,금천구,5-9세,6558,3364,3194
202106,11545,서울특별시,금천구,5-9세,6583,3388,3195
202007,11545,서울특별시,금천구,10-14세,6763,3433,3330
202008,11545,서울특별시,금천구,10-14세,6735,3407,3328
202009,11545,서울특별시,금천구,10-14세,6715,3406,3309
202010,11545,서울특별시,금천구,10-14세,6695,3379,3316
202011,11545,서울특별시,금천구,10-14세,6681,3379,3302
202012,11545,서울특별시,금천구,10-14세,6685,3382,3303
202101,11545,서울특별시,금천구,10-14세,6703,3402,3301
202102,11545,서울특별시,금천구,10-14세,6676,3389,3287
202103,11545,서울특별시,금천구,10-14세,6660,3382,3278
202104,11545,서울특별시,금천구,10-14세,6675,3393,3282
202105,11545,서울특별시,금천구,10-14세,6672,3370,3302
202106,11545,서울특별시,금천구,10-14세,6639,3353,3286
202007,11545,서울특별시,금천구,15-19세,8286,4188,4098
202008,11545,서울특별시,금천구,15-19세,8231,4155,4076
202009,11545,서울특별시,금천구,15-19세,8179,4123,4056
202010,11545,서울특별시,금천구,15-19세,8137,4107,4030
202011,11545,서울특별시,금천구,15-19세,8080,4051,4029
202012,11545,서울특별시,금천구,15-19세,7984,3997,3987
202101,11545,서울특별시,금천구,15-19세,7874,3941,3933
202102,11545,서울특별시,금천구,15-19세,7831,3912,3919
202103,11545,서울특별시,금천구,15-19세,7827,3910,3917
202104,11545,서울특별시,금천구,15-19세,7756,3883,3873
202105,11545,서울특별시,금천구,15-19세,7682,3858,3824
202106,11545,서울특별시,금천구,15-19세,7656,3848,3808
202007,11545,서울특별시,금천구,20-24세,14657,7188,7469
202008,11545,서울특별시,금천구,20-24세,14625,7119,7506
202009,11545,서울특별시,금천구,20-24세,14603,7069,7534
202010,11545,서울특별시,금천구,20-24세,14512,7011,7501
202011,11545,서울특별시,금천구,20-24세,14384,6953,7431
202012,11545,서울특별시,금천구,20-24세,14365,6953,7412
202101,11545,서울특별시,금천구,20-24세,14306,6894,7412
202102,11545,서울특별시,금천구,20-24세,14264,6849,7415
202103,11545,서울특별시,금천구,20-24세,14214,6787,7427
202104,11545,서울특별시,금천구,20-24세,14144,6727,7417
202105,11545,서울특별시,금천구,20-24세,14092,6688,7404
202106,11545,서울특별시,금천구,20-24세,14028,6653,7375
202007,11545,서울특별시,금천구,25-29세,21958,11467,10491
202008,11545,서울특별시,금천구,25-29세,22253,11602,10651
202009,11545,서울특별시,금천구,25-29세,22474,11660,10814
202010,11545,서울특별시,금천구,25-29세,22569,11683,10886
202011,11545,서울특별시,금천구,25-29세,22663,11731,10932
202012,11545,서울특별시,금천구,25-29세,22762,11762,11000
202101,11545,서울특별시,금천구,25-29세,22796,11782,11014
202102,11545,서울특별시,금천구,25-29세,22768,11784,10984
202103,11545,서울특별시,금천구,25-29세,22888,11851,11037
202104,11545,서울특별시,금천구,25-29세,22946,11889,11057
202105,11545,서울특별시,금천구,25-29세,23042,11890,11152
202106,11545,서울특별시,금천구,25-29세,23156,11933,11223
202007,11545,서울특별시,금천구,30-34세,18272,10163,8109
202008,11545,서울특별시,금천구,30-34세,18305,10171,8134
202009,11545,서울특별시,금천구,30-34세,18450,10258,8192
202010,11545,서울특별시,금천구,30-34세,18483,10258,8225
202011,11545,서울특별시,금천구,30-34세,18547,10318,8229
202012,11545,서울특별시,금천구,30-34세,18576,10363,8213
202101,11545,서울특별시,금천구,30-34세,18679,10395,8284
202102,11545,서울특별시,금천구,30-34세,18748,10394,8354
202103,11545,서울특별시,금천구,30-34세,18760,10358,8402
202104,11545,서울특별시,금천구,30-34세,18794,10401,8393
202105,11545,서울특별시,금천구,30-34세,19020,10530,8490
202106,11545,서울특별시,금천구,30-34세,19191,10630,8561
202007,11545,서울특별시,금천구,35-39세,17218,9511,7707
202008,11545,서울특별시,금천구,35-39세,17136,9455,7681
202009,11545,서울특별시,금천구,35-39세,17042,9398,7644
202010,11545,서울특별시,금천구,35-39세,17014,9356,7658
202011,11545,서울특별시,금천구,35-39세,17011,9359,7652
202012,11545,서울특별시,금천구,35-39세,16905,9301,7604
202101,11545,서울특별시,금천구,35-39세,16795,9242,7553
202102,11545,서울특별시,금천구,35-39세,16699,9193,7506
202103,11545,서울특별시,금천구,35-39세,16595,9152,7443
202104,11545,서울특별시,금천구,35-39세,16541,9101,7440
202105,11545,서울특별시,금천구,35-39세,16456,9079,7377
202106,11545,서울특별시,금천구,35-39세,16460,9077,7383
202007,11545,서울특별시,금천구,40-44세,15319,8148,7171
202008,11545,서울특별시,금천구,40-44세,15318,8139,7179
202009,11545,서울특별시,금천구,40-44세,15387,8178,7209
202010,11545,서울특별시,금천구,40-44세,15388,8204,7184
202011,11545,서울특별시,금천구,40-44세,15346,8192,7154
202012,11545,서울특별시,금천구,40-44세,15298,8174,7124
202101,11545,서울특별시,금천구,40-44세,15290,8196,7094
202102,11545,서울특별시,금천구,40-44세,15278,8214,7064
202103,11545,서울특별시,금천구,40-44세,15178,8208,6970
202104,11545,서울특별시,금천구,40-44세,15173,8217,6956
202105,11545,서울특별시,금천구,40-44세,15251,8267,6984
202106,11545,서울특별시,금천구,40-44세,15290,8297,6993
202007,11545,서울특별시,금천구,45-49세,18116,9314,8802
202008,11545,서울특별시,금천구,45-49세,18027,9298,8729
202009,11545,서울특별시,금천구,45-49세,17877,9246,8631
202010,11545,서울특별시,금천구,45-49세,17791,9200,8591
202011,11545,서울특별시,금천구,45-49세,17710,9148,8562
202012,11545,서울특별시,금천구,45-49세,17605,9095,8510
202101,11545,서울특별시,금천구,45-49세,17554,9062,8492
202102,11545,서울특별시,금천구,45-49세,17389,8983,8406
202103,11545,서울특별시,금천구,45-49세,17132,8872,8260
202104,11545,서울특별시,금천구,45-49세,17049,8805,8244
202105,11545,서울특별시,금천구,45-49세,16889,8702,8187
202106,11545,서울특별시,금천구,45-49세,16809,8653,8156
202007,11545,서울특별시,금천구,50-54세,19780,9897,9883
202008,11545,서울특별시,금천구,50-54세,19761,9888,9873
202009,11545,서울특별시,금천구,50-54세,19732,9876,9856
202010,11545,서울특별시,금천구,50-54세,19753,9892,9861
202011,11545,서울특별시,금천구,50-54세,19767,9894,9873
202012,11545,서울특별시,금천구,50-54세,19667,9847,9820
202101,11545,서울특별시,금천구,50-54세,19667,9838,9829
202102,11545,서울특별시,금천구,50-54세,19634,9802,9832
202103,11545,서울특별시,금천구,50-54세,19382,9649,9733
202104,11545,서울특별시,금천구,50-54세,19351,9634,9717
202105,11545,서울특별시,금천구,50-54세,19444,9704,9740
202106,11545,서울특별시,금천구,50-54세,19441,9717,9724
202007,11545,서울특별시,금천구,55-59세,20921,10584,10337
202008,11545,서울특별시,금천구,55-59세,20855,10537,10318
202009,11545,서울특별시,금천구,55-59세,20795,10480,10315
202010,11545,서울특별시,금천구,55-59세,20780,10460,10320
202011,11545,서울특별시,금천구,55-59세,20664,10392,10272
202012,11545,서울특별시,금천구,55-59세,20625,10366,10259
202101,11545,서울특별시,금천구,55-59세,20558,10354,10204
202102,11545,서울특별시,금천구,55-59세,20487,10350,10137
202103,11545,서울특별시,금천구,55-59세,20400,10345,10055
202104,11545,서울특별시,금천구,55-59세,20306,10332,9974
202105,11545,서울특별시,금천구,55-59세,20171,10255,9916
202106,11545,서울특별시,금천구,55-59세,20064,10178,9886
202007,11545,서울특별시,금천구,60-64세,19035,9484,9551
202008,11545,서울특별시,금천구,60-64세,19089,9507,9582
202009,11545,서울특별시,금천구,60-64세,19193,9571,9622
202010,11545,서울특별시,금천구,60-64세,19252,9633,9619
202011,11545,서울특별시,금천구,60-64세,19293,9654,9639
202012,11545,서울특별시,금천구,60-64세,19399,9695,9704
202101,11545,서울특별시,금천구,60-64세,19484,9705,9779
202102,11545,서울특별시,금천구,60-64세,19576,9733,9843
202103,11545,서울특별시,금천구,60-64세,19497,9726,9771
202104,11545,서울특별시,금천구,60-64세,19580,9750,9830
202105,11545,서울특별시,금천구,60-64세,19657,9775,9882
202106,11545,서울특별시,금천구,60-64세,19839,9890,9949
202007,11545,서울특별시,금천구,65-69세,13327,6390,6937
202008,11545,서울특별시,금천구,65-69세,13422,6439,6983
202009,11545,서울특별시,금천구,65-69세,13471,6465,7006
202010,11545,서울특별시,금천구,65-69세,13555,6491,7064
202011,11545,서울특별시,금천구,65-69세,13653,6545,7108
202012,11545,서울특별시,금천구,65-69세,13720,6573,7147
202101,11545,서울특별시,금천구,65-69세,13833,6634,7199
202102,11545,서울특별시,금천구,65-69세,13939,6678,7261
202103,11545,서울특별시,금천구,65-69세,13949,6672,7277
202104,11545,서울특별시,금천구,65-69세,14020,6697,7323
202105,11545,서울특별시,금천구,65-69세,14087,6743,7344
202106,11545,서울특별시,금천구,65-69세,14147,6773,7374
202007,11545,서울특별시,금천구,70-74세,10208,4814,5394
202008,11545,서울특별시,금천구,70-74세,10252,4826,5426
202009,11545,서울특별시,금천구,70-74세,10289,4852,5437
202010,11545,서울특별시,금천구,70-74세,10331,4865,5466
202011,11545,서울특별시,금천구,70-74세,10372,4889,5483
202012,11545,서울특별시,금천구,70-74세,10435,4940,5495
202101,11545,서울특별시,금천구,70-74세,10492,4970,5522
202102,11545,서울특별시,금천구,70-74세,10521,4989,5532
202103,11545,서울특별시,금천구,70-74세,10357,4943,5414
202104,11545,서울특별시,금천구,70-74세,10367,4963,5404
202105,11545,서울특별시,금천구,70-74세,10397,4981,5416
202106,11545,서울특별시,금천구,70-74세,10388,4978,5410
202007,11545,서울특별시,금천구,75-79세,7698,3541,4157
202008,11545,서울특별시,금천구,75-79세,7716,3556,4160
202009,11545,서울특별시,금천구,75-79세,7694,3532,4162
202010,11545,서울특별시,금천구,75-79세,7674,3524,4150
202011,11545,서울특별시,금천구,75-79세,7659,3507,4152
202012,11545,서울특별시,금천구,75-79세,7624,3495,4129
202101,11545,서울특별시,금천구,75-79세,7605,3485,4120
202102,11545,서울특별시,금천구,75-79세,7565,3471,4094
202103,11545,서울특별시,금천구,75-79세,7463,3421,4042
202104,11545,서울특별시,금천구,75-79세,7448,3413,4035
202105,11545,서울특별시,금천구,75-79세,7470,3422,4048
202106,11545,서울특별시,금천구,75-79세,7489,3432,4057
202007,11545,서울특별시,금천구,80-84세,4329,1821,2508
202008,11545,서울특별시,금천구,80-84세,4349,1835,2514
202009,11545,서울특별시,금천구,80-84세,4364,1845,2519
202010,11545,서울특별시,금천구,80-84세,4401,1859,2542
202011,11545,서울특별시,금천구,80-84세,4405,1863,2542
202012,11545,서울특별시,금천구,80-84세,4431,1872,2559
202101,11545,서울특별시,금천구,80-84세,4457,1879,2578
202102,11545,서울특별시,금천구,80-84세,4497,1901,2596
202103,11545,서울특별시,금천구,80-84세,4456,1871,2585
202104,11545,서울특별시,금천구,80-84세,4490,1885,2605
202105,11545,서울특별시,금천구,80-84세,4525,1899,2626
202106,11545,서울특별시,금천구,80-84세,4570,1922,2648
202007,11545,서울특별시,금천구,85-89세,1961,656,1305
202008,11545,서울특별시,금천구,85-89세,1975,659,1316
202009,11545,서울특별시,금천구,85-89세,1991,670,1321
202010,11545,서울특별시,금천구,85-89세,2021,687,1334
202011,11545,서울특별시,금천구,85-89세,2030,688,1342
202012,11545,서울특별시,금천구,85-89세,2048,701,1347
202101,11545,서울특별시,금천구,85-89세,2063,713,1350
202102,11545,서울특별시,금천구,85-89세,2076,710,1366
202103,11545,서울특별시,금천구,85-89세,2043,701,1342
202104,11545,서울특별시,금천구,85-89세,2069,716,1353
202105,11545,서울특별시,금천구,85-89세,2074,719,1355
202106,11545,서울특별시,금천구,85-89세,2065,716,1349
202007,11545,서울특별시,금천구,90-94세,628,150,478
202008,11545,서울특별시,금천구,90-94세,633,151,482
202009,11545,서울특별시,금천구,90-94세,649,154,495
202010,11545,서울특별시,금천구,90-94세,658,156,502
202011,11545,서울특별시,금천구,90-94세,682,170,512
202012,11545,서울특별시,금천구,90-94세,691,174,517
202101,11545,서울특별시,금천구,90-94세,701,180,521
202102,11545,서울특별시,금천구,90-94세,715,182,533
202103,11545,서울특별시,금천구,90-94세,693,169,524
202104,11545,서울특별시,금천구,90-94세,696,168,528
202105,11545,서울특별시,금천구,90-94세,710,174,536
202106,11545,서울특별시,금천구,90-94세,717,172,545
202007,11545,서울특별시,금천구,95-99세,180,57,123
202008,11545,서울특별시,금천구,95-99세,184,56,128
202009,11545,서울특별시,금천구,95-99세,186,55,131
202010,11545,서울특별시,금천구,95-99세,192,57,135
202011,11545,서울특별시,금천구,95-99세,188,56,132
202012,11545,서울특별시,금천구,95-99세,188,56,132
202101,11545,서울특별시,금천구,95-99세,184,53,131
202102,11545,서울특별시,금천구,95-99세,183,53,130
202103,11545,서울특별시,금천구,95-99세,143,36,107
202104,11545,서울특별시,금천구,95-99세,144,35,109
202105,11545,서울특별시,금천구,95-99세,145,36,109
202106,11545,서울특별시,금천구,95-99세,145,36,109
202007,11545,서울특별시,금천구,100+,176,57,119
202008,11545,서울특별시,금천구,100+,175,57,118
202009,11545,서울특별시,금천구,100+,177,58,119
202010,11545,서울특별시,금천구,100+,176,59,117
202011,11545,서울특별시,금천구,100+,176,58,118
202012,11545,서울특별시,금천구,100+,177,58,119
202101,11545,서울특별시,금천구,100+,180,60,120
202102,11545,서울특별시,금천구,100+,179,58,121
202103,11545,서울특별시,금천구,100+,44,12,32
202104,11545,서울특별시,금천구,100+,47,13,34
202105,11545,서울특별시,금천구,100+,47,13,34
202106,11545,서울특별시,금천구,100+,46,13,33
202007,11560,서울특별시,영등포구,0-4세,12702,6426,6276
202008,11560,서울특별시,영등포구,0-4세,12729,6461,6268
202009,11560,서울특별시,영등포구,0-4세,12686,6462,6224
202010,11560,서울특별시,영등포구,0-4세,12733,6488,6245
202011,11560,서울특별시,영등포구,0-4세,12740,6479,6261
202012,11560,서울특별시,영등포구,0-4세,12788,6515,6273
202101,11560,서울특별시,영등포구,0-4세,12714,6489,6225
202102,11560,서울특별시,영등포구,0-4세,12607,6452,6155
202103,11560,서울특별시,영등포구,0-4세,12478,6394,6084
202104,11560,서울특별시,영등포구,0-4세,12437,6364,6073
202105,11560,서울특별시,영등포구,0-4세,12396,6345,6051
202106,11560,서울특별시,영등포구,0-4세,12345,6329,6016
202007,11560,서울특별시,영등포구,5-9세,12800,6540,6260
202008,11560,서울특별시,영등포구,5-9세,12884,6578,6306
202009,11560,서울특별시,영등포구,5-9세,12884,6562,6322
202010,11560,서울특별시,영등포구,5-9세,12920,6582,6338
202011,11560,서울특별시,영등포구,5-9세,13017,6647,6370
202012,11560,서울특별시,영등포구,5-9세,13048,6650,6398
202101,11560,서울특별시,영등포구,5-9세,13084,6678,6406
202102,11560,서울특별시,영등포구,5-9세,13050,6657,6393
202103,11560,서울특별시,영등포구,5-9세,13042,6645,6397
202104,11560,서울특별시,영등포구,5-9세,13059,6650,6409
202105,11560,서울특별시,영등포구,5-9세,13081,6669,6412
202106,11560,서울특별시,영등포구,5-9세,13077,6681,6396
202007,11560,서울특별시,영등포구,10-14세,11278,5841,5437
202008,11560,서울특별시,영등포구,10-14세,11284,5846,5438
202009,11560,서울특별시,영등포구,10-14세,11341,5880,5461
202010,11560,서울특별시,영등포구,10-14세,11401,5920,5481
202011,11560,서울특별시,영등포구,10-14세,11411,5921,5490
202012,11560,서울특별시,영등포구,10-14세,11444,5932,5512
202101,11560,서울특별시,영등포구,10-14세,11542,5963,5579
202102,11560,서울특별시,영등포구,10-14세,11534,5945,5589
202103,11560,서울특별시,영등포구,10-14세,11509,5918,5591
202104,11560,서울특별시,영등포구,10-14세,11534,5916,5618
202105,11560,서울특별시,영등포구,10-14세,11560,5934,5626
202106,11560,서울특별시,영등포구,10-14세,11580,5936,5644
202007,11560,서울특별시,영등포구,15-19세,13177,6904,6273
202008,11560,서울특별시,영등포구,15-19세,13089,6871,6218
202009,11560,서울특별시,영등포구,15-19세,13036,6850,6186
202010,11560,서울특별시,영등포구,15-19세,12977,6808,6169
202011,11560,서울특별시,영등포구,15-19세,12901,6781,6120
202012,11560,서울특별시,영등포구,15-19세,12834,6726,6108
202101,11560,서울특별시,영등포구,15-19세,12703,6672,6031
202102,11560,서울특별시,영등포구,15-19세,12691,6678,6013
202103,11560,서울특별시,영등포구,15-19세,12610,6622,5988
202104,11560,서울특별시,영등포구,15-19세,12502,6598,5904
202105,11560,서울특별시,영등포구,15-19세,12335,6512,5823
202106,11560,서울특별시,영등포구,15-19세,12293,6514,5779
202007,11560,서울특별시,영등포구,20-24세,22020,10247,11773
202008,11560,서울특별시,영등포구,20-24세,21996,10223,11773
202009,11560,서울특별시,영등포구,20-24세,21900,10202,11698
202010,11560,서울특별시,영등포구,20-24세,21852,10224,11628
202011,11560,서울특별시,영등포구,20-24세,21854,10233,11621
202012,11560,서울특별시,영등포구,20-24세,21920,10271,11649
202101,11560,서울특별시,영등포구,20-24세,21867,10215,11652
202102,11560,서울특별시,영등포구,20-24세,21921,10204,11717
202103,11560,서울특별시,영등포구,20-24세,21985,10189,11796
202104,11560,서울특별시,영등포구,20-24세,21966,10150,11816
202105,11560,서울특별시,영등포구,20-24세,21986,10143,11843
202106,11560,서울특별시,영등포구,20-24세,21918,10110,11808
202007,11560,서울특별시,영등포구,25-29세,36178,17153,19025
202008,11560,서울특별시,영등포구,25-29세,36391,17227,19164
202009,11560,서울특별시,영등포구,25-29세,36559,17243,19316
202010,11560,서울특별시,영등포구,25-29세,36764,17322,19442
202011,11560,서울특별시,영등포구,25-29세,36882,17355,19527
202012,11560,서울특별시,영등포구,25-29세,37156,17489,19667
202101,11560,서울특별시,영등포구,25-29세,37229,17476,19753
202102,11560,서울특별시,영등포구,25-29세,37231,17471,19760
202103,11560,서울특별시,영등포구,25-29세,37283,17498,19785
202104,11560,서울특별시,영등포구,25-29세,37286,17444,19842
202105,11560,서울특별시,영등포구,25-29세,37293,17405,19888
202106,11560,서울특별시,영등포구,25-29세,37193,17329,19864
202007,11560,서울특별시,영등포구,30-34세,34976,17711,17265
202008,11560,서울특별시,영등포구,30-34세,35263,17823,17440
202009,11560,서울특별시,영등포구,30-34세,35351,17892,17459
202010,11560,서울특별시,영등포구,30-34세,35520,17983,17537
202011,11560,서울특별시,영등포구,30-34세,35687,18078,17609
202012,11560,서울특별시,영등포구,30-34세,35791,18135,17656
202101,11560,서울특별시,영등포구,30-34세,35874,18147,17727
202102,11560,서울특별시,영등포구,30-34세,35901,18125,17776
202103,11560,서울특별시,영등포구,30-34세,35900,18069,17831
202104,11560,서울특별시,영등포구,30-34세,36095,18198,17897
202105,11560,서울특별시,영등포구,30-34세,36124,18243,17881
202106,11560,서울특별시,영등포구,30-34세,36209,18308,17901
202007,11560,서울특별시,영등포구,35-39세,32791,17163,15628
202008,11560,서울특별시,영등포구,35-39세,32890,17212,15678
202009,11560,서울특별시,영등포구,35-39세,32863,17199,15664
202010,11560,서울특별시,영등포구,35-39세,33059,17279,15780
202011,11560,서울특별시,영등포구,35-39세,33283,17364,15919
202012,11560,서울특별시,영등포구,35-39세,33454,17438,16016
202101,11560,서울특별시,영등포구,35-39세,33544,17502,16042
202102,11560,서울특별시,영등포구,35-39세,33523,17468,16055
202103,11560,서울특별시,영등포구,35-39세,33325,17374,15951
202104,11560,서울특별시,영등포구,35-39세,33285,17348,15937
202105,11560,서울특별시,영등포구,35-39세,33132,17260,15872
202106,11560,서울특별시,영등포구,35-39세,33058,17182,15876
202007,11560,서울특별시,영등포구,40-44세,27155,13938,13217
202008,11560,서울특별시,영등포구,40-44세,27293,14012,13281
202009,11560,서울특별시,영등포구,40-44세,27415,14103,13312
202010,11560,서울특별시,영등포구,40-44세,27638,14225,13413
202011,11560,서울특별시,영등포구,40-44세,27850,14341,13509
202012,11560,서울특별시,영등포구,40-44세,27931,14405,13526
202101,11560,서울특별시,영등포구,40-44세,27997,14461,13536
202102,11560,서울특별시,영등포구,40-44세,28116,14542,13574
202103,11560,서울특별시,영등포구,40-44세,27919,14463,13456
202104,11560,서울특별시,영등포구,40-44세,27949,14468,13481
202105,11560,서울특별시,영등포구,40-44세,28051,14503,13548
202106,11560,서울특별시,영등포구,40-44세,28181,14576,13605
202007,11560,서울특별시,영등포구,45-49세,28801,14781,14020
202008,11560,서울특별시,영등포구,45-49세,28697,14739,13958
202009,11560,서울특별시,영등포구,45-49세,28614,14665,13949
202010,11560,서울특별시,영등포구,45-49세,28530,14614,13916
202011,11560,서울특별시,영등포구,45-49세,28516,14623,13893
202012,11560,서울특별시,영등포구,45-49세,28507,14625,13882
202101,11560,서울특별시,영등포구,45-49세,28452,14594,13858
202102,11560,서울특별시,영등포구,45-49세,28312,14521,13791
202103,11560,서울특별시,영등포구,45-49세,28109,14429,13680
202104,11560,서울특별시,영등포구,45-49세,28018,14363,13655
202105,11560,서울특별시,영등포구,45-49세,27793,14258,13535
202106,11560,서울특별시,영등포구,45-49세,27684,14186,13498
202007,11560,서울특별시,영등포구,50-54세,28268,14394,13874
202008,11560,서울특별시,영등포구,50-54세,28338,14384,13954
202009,11560,서울특별시,영등포구,50-54세,28463,14423,14040
202010,11560,서울특별시,영등포구,50-54세,28647,14520,14127
202011,11560,서울특별시,영등포구,50-54세,28724,14515,14209
202012,11560,서울특별시,영등포구,50-54세,28741,14489,14252
202101,11560,서울특별시,영등포구,50-54세,28990,14622,14368
202102,11560,서울특별시,영등포구,50-54세,29145,14681,14464
202103,11560,서울특별시,영등포구,50-54세,28833,14555,14278
202104,11560,서울특별시,영등포구,50-54세,28832,14562,14270
202105,11560,서울특별시,영등포구,50-54세,28951,14605,14346
202106,11560,서울특별시,영등포구,50-54세,28984,14629,14355
202007,11560,서울특별시,영등포구,55-59세,28143,14321,13822
202008,11560,서울특별시,영등포구,55-59세,28173,14355,13818
202009,11560,서울특별시,영등포구,55-59세,28113,14334,13779
202010,11560,서울특별시,영등포구,55-59세,28069,14330,13739
202011,11560,서울특별시,영등포구,55-59세,28149,14387,13762
202012,11560,서울특별시,영등포구,55-59세,28190,14425,13765
202101,11560,서울특별시,영등포구,55-59세,28050,14368,13682
202102,11560,서울특별시,영등포구,55-59세,27933,14342,13591
202103,11560,서울특별시,영등포구,55-59세,27720,14205,13515
202104,11560,서울특별시,영등포구,55-59세,27549,14119,13430
202105,11560,서울특별시,영등포구,55-59세,27441,14096,13345
202106,11560,서울특별시,영등포구,55-59세,27198,13976,13222
202007,11560,서울특별시,영등포구,60-64세,26593,13104,13489
202008,11560,서울특별시,영등포구,60-64세,26606,13105,13501
202009,11560,서울특별시,영등포구,60-64세,26641,13111,13530
202010,11560,서울특별시,영등포구,60-64세,26752,13144,13608
202011,11560,서울특별시,영등포구,60-64세,26922,13207,13715
202012,11560,서울특별시,영등포구,60-64세,27013,13249,13764
202101,11560,서울특별시,영등포구,60-64세,27116,13293,13823
202102,11560,서울특별시,영등포구,60-64세,27242,13357,13885
202103,11560,서울특별시,영등포구,60-64세,26978,13234,13744
202104,11560,서울특별시,영등포구,60-64세,27168,13326,13842
202105,11560,서울특별시,영등포구,60-64세,27251,13364,13887
202106,11560,서울특별시,영등포구,60-64세,27389,13441,13948
202007,11560,서울특별시,영등포구,65-69세,19367,9242,10125
202008,11560,서울특별시,영등포구,65-69세,19517,9317,10200
202009,11560,서울특별시,영등포구,65-69세,19635,9384,10251
202010,11560,서울특별시,영등포구,65-69세,19752,9440,10312
202011,11560,서울특별시,영등포구,65-69세,19900,9534,10366
202012,11560,서울특별시,영등포구,65-69세,20059,9627,10432
202101,11560,서울특별시,영등포구,65-69세,20227,9710,10517
202102,11560,서울특별시,영등포구,65-69세,20319,9759,10560
202103,11560,서울특별시,영등포구,65-69세,20126,9709,10417
202104,11560,서울특별시,영등포구,65-69세,20160,9714,10446
202105,11560,서울특별시,영등포구,65-69세,20225,9738,10487
202106,11560,서울특별시,영등포구,65-69세,20328,9797,10531
202007,11560,서울특별시,영등포구,70-74세,15303,7171,8132
202008,11560,서울특별시,영등포구,70-74세,15346,7190,8156
202009,11560,서울특별시,영등포구,70-74세,15415,7214,8201
202010,11560,서울특별시,영등포구,70-74세,15525,7251,8274
202011,11560,서울특별시,영등포구,70-74세,15598,7271,8327
202012,11560,서울특별시,영등포구,70-74세,15723,7321,8402
202101,11560,서울특별시,영등포구,70-74세,15828,7380,8448
202102,11560,서울특별시,영등포구,70-74세,15851,7382,8469
202103,11560,서울특별시,영등포구,70-74세,15490,7251,8239
202104,11560,서울특별시,영등포구,70-74세,15504,7264,8240
202105,11560,서울특별시,영등포구,70-74세,15508,7263,8245
202106,11560,서울특별시,영등포구,70-74세,15462,7229,8233
202007,11560,서울특별시,영등포구,75-79세,11735,5287,6448
202008,11560,서울특별시,영등포구,75-79세,11786,5304,6482
202009,11560,서울특별시,영등포구,75-79세,11747,5290,6457
202010,11560,서울특별시,영등포구,75-79세,11690,5258,6432
202011,11560,서울특별시,영등포구,75-79세,11674,5252,6422
202012,11560,서울특별시,영등포구,75-79세,11657,5245,6412
202101,11560,서울특별시,영등포구,75-79세,11621,5216,6405
202102,11560,서울특별시,영등포구,75-79세,11619,5217,6402
202103,11560,서울특별시,영등포구,75-79세,11397,5137,6260
202104,11560,서울특별시,영등포구,75-79세,11363,5112,6251
202105,11560,서울특별시,영등포구,75-79세,11376,5135,6241
202106,11560,서울특별시,영등포구,75-79세,11378,5134,6244
202007,11560,서울특별시,영등포구,80-84세,7470,3189,4281
202008,11560,서울특별시,영등포구,80-84세,7482,3196,4286
202009,11560,서울특별시,영등포구,80-84세,7527,3204,4323
202010,11560,서울특별시,영등포구,80-84세,7580,3219,4361
202011,11560,서울특별시,영등포구,80-84세,7597,3234,4363
202012,11560,서울특별시,영등포구,80-84세,7628,3241,4387
202101,11560,서울특별시,영등포구,80-84세,7695,3284,4411
202102,11560,서울특별시,영등포구,80-84세,7753,3318,4435
202103,11560,서울특별시,영등포구,80-84세,7614,3236,4378
202104,11560,서울특별시,영등포구,80-84세,7632,3248,4384
202105,11560,서울특별시,영등포구,80-84세,7658,3256,4402
202106,11560,서울특별시,영등포구,80-84세,7724,3280,4444
202007,11560,서울특별시,영등포구,85-89세,3529,1248,2281
202008,11560,서울특별시,영등포구,85-89세,3555,1264,2291
202009,11560,서울특별시,영등포구,85-89세,3594,1272,2322
202010,11560,서울특별시,영등포구,85-89세,3650,1295,2355
202011,11560,서울특별시,영등포구,85-89세,3690,1318,2372
202012,11560,서울특별시,영등포구,85-89세,3711,1341,2370
202101,11560,서울특별시,영등포구,85-89세,3753,1368,2385
202102,11560,서울특별시,영등포구,85-89세,3803,1378,2425
202103,11560,서울특별시,영등포구,85-89세,3738,1356,2382
202104,11560,서울특별시,영등포구,85-89세,3814,1390,2424
202105,11560,서울특별시,영등포구,85-89세,3859,1410,2449
202106,11560,서울특별시,영등포구,85-89세,3858,1416,2442
202007,11560,서울특별시,영등포구,90-94세,1176,321,855
202008,11560,서울특별시,영등포구,90-94세,1176,324,852
202009,11560,서울특별시,영등포구,90-94세,1203,337,866
202010,11560,서울특별시,영등포구,90-94세,1220,341,879
202011,11560,서울특별시,영등포구,90-94세,1238,348,890
202012,11560,서울특별시,영등포구,90-94세,1236,348,888
202101,11560,서울특별시,영등포구,90-94세,1236,347,889
202102,11560,서울특별시,영등포구,90-94세,1237,355,882
202103,11560,서울특별시,영등포구,90-94세,1171,324,847
202104,11560,서울특별시,영등포구,90-94세,1181,334,847
202105,11560,서울특별시,영등포구,90-94세,1195,339,856
202106,11560,서울특별시,영등포구,90-94세,1202,341,861
202007,11560,서울특별시,영등포구,95-99세,361,106,255
202008,11560,서울특별시,영등포구,95-99세,360,100,260
202009,11560,서울특별시,영등포구,95-99세,364,100,264
202010,11560,서울특별시,영등포구,95-99세,365,101,264
202011,11560,서울특별시,영등포구,95-99세,363,101,262
202012,11560,서울특별시,영등포구,95-99세,362,100,262
202101,11560,서울특별시,영등포구,95-99세,356,97,259
202102,11560,서울특별시,영등포구,95-99세,361,98,263
202103,11560,서울특별시,영등포구,95-99세,297,70,227
202104,11560,서울특별시,영등포구,95-99세,296,69,227
202105,11560,서울특별시,영등포구,95-99세,295,70,225
202106,11560,서울특별시,영등포구,95-99세,296,71,225
202007,11560,서울특별시,영등포구,100+,274,69,205
202008,11560,서울특별시,영등포구,100+,278,72,206
202009,11560,서울특별시,영등포구,100+,279,73,206
202010,11560,서울특별시,영등포구,100+,280,73,207
202011,11560,서울특별시,영등포구,100+,280,72,208
202012,11560,서울특별시,영등포구,100+,287,75,212
202101,11560,서울특별시,영등포구,100+,291,78,213
202102,11560,서울특별시,영등포구,100+,294,79,215
202103,11560,서울특별시,영등포구,100+,66,14,52
202104,11560,서울특별시,영등포구,100+,66,15,51
202105,11560,서울특별시,영등포구,100+,67,16,51
202106,11560,서울특별시,영등포구,100+,64,17,47
202007,11590,서울특별시,동작구,0-4세,11670,5942,5728
202008,11590,서울특별시,동작구,0-4세,11493,5869,5624
202009,11590,서울특별시,동작구,0-4세,11336,5789,5547
202010,11590,서울특별시,동작구,0-4세,11173,5709,5464
202011,11590,서울특별시,동작구,0-4세,11056,5654,5402
202012,11590,서울특별시,동작구,0-4세,10942,5593,5349
202101,11590,서울특별시,동작구,0-4세,10814,5525,5289
202102,11590,서울특별시,동작구,0-4세,10664,5462,5202
202103,11590,서울특별시,동작구,0-4세,10609,5440,5169
202104,11590,서울특별시,동작구,0-4세,10565,5394,5171
202105,11590,서울특별시,동작구,0-4세,10493,5374,5119
202106,11590,서울특별시,동작구,0-4세,10443,5354,5089
202007,11590,서울특별시,동작구,5-9세,13953,7126,6827
202008,11590,서울특별시,동작구,5-9세,13878,7069,6809
202009,11590,서울특별시,동작구,5-9세,13844,7042,6802
202010,11590,서울특별시,동작구,5-9세,13801,7021,6780
202011,11590,서울특별시,동작구,5-9세,13687,6961,6726
202012,11590,서울특별시,동작구,5-9세,13622,6935,6687
202101,11590,서울특별시,동작구,5-9세,13534,6895,6639
202102,11590,서울특별시,동작구,5-9세,13433,6849,6584
202103,11590,서울특별시,동작구,5-9세,13483,6869,6614
202104,11590,서울특별시,동작구,5-9세,13488,6870,6618
202105,11590,서울특별시,동작구,5-9세,13464,6868,6596
202106,11590,서울특별시,동작구,5-9세,13430,6855,6575
202007,11590,서울특별시,동작구,10-14세,13103,6775,6328
202008,11590,서울특별시,동작구,10-14세,13082,6767,6315
202009,11590,서울특별시,동작구,10-14세,13099,6787,6312
202010,11590,서울특별시,동작구,10-14세,13084,6776,6308
202011,11590,서울특별시,동작구,10-14세,13133,6796,6337
202012,11590,서울특별시,동작구,10-14세,13111,6777,6334
202101,11590,서울특별시,동작구,10-14세,13123,6769,6354
202102,11590,서울특별시,동작구,10-14세,13084,6764,6320
202103,11590,서울특별시,동작구,10-14세,13044,6729,6315
202104,11590,서울특별시,동작구,10-14세,13065,6768,6297
202105,11590,서울특별시,동작구,10-14세,13076,6765,6311
202106,11590,서울특별시,동작구,10-14세,13040,6762,6278
202007,11590,서울특별시,동작구,15-19세,15543,7918,7625
202008,11590,서울특별시,동작구,15-19세,15369,7848,7521
202009,11590,서울특별시,동작구,15-19세,15196,7769,7427
202010,11590,서울특별시,동작구,15-19세,15041,7704,7337
202011,11590,서울특별시,동작구,15-19세,14873,7616,7257
202012,11590,서울특별시,동작구,15-19세,14710,7531,7179
202101,11590,서울특별시,동작구,15-19세,14552,7454,7098
202102,11590,서울특별시,동작구,15-19세,14500,7412,7088
202103,11590,서울특별시,동작구,15-19세,14469,7375,7094
202104,11590,서울특별시,동작구,15-19세,14371,7318,7053
202105,11590,서울특별시,동작구,15-19세,14231,7266,6965
202106,11590,서울특별시,동작구,15-19세,14251,7244,7007
202007,11590,서울특별시,동작구,20-24세,28283,13210,15073
202008,11590,서울특별시,동작구,20-24세,28184,13188,14996
202009,11590,서울특별시,동작구,20-24세,28108,13132,14976
202010,11590,서울특별시,동작구,20-24세,27890,13026,14864
202011,11590,서울특별시,동작구,20-24세,27747,12979,14768
202012,11590,서울특별시,동작구,20-24세,27603,12923,14680
202101,11590,서울특별시,동작구,20-24세,27305,12762,14543
202102,11590,서울특별시,동작구,20-24세,27209,12723,14486
202103,11590,서울특별시,동작구,20-24세,27227,12767,14460
202104,11590,서울특별시,동작구,20-24세,27102,12680,14422
202105,11590,서울특별시,동작구,20-24세,27052,12627,14425
202106,11590,서울특별시,동작구,20-24세,26947,12573,14374
202007,11590,서울특별시,동작구,25-29세,38654,19143,19511
202008,11590,서울특별시,동작구,25-29세,38789,19263,19526
202009,11590,서울특별시,동작구,25-29세,38819,19271,19548
202010,11590,서울특별시,동작구,25-29세,38835,19246,19589
202011,11590,서울특별시,동작구,25-29세,38910,19237,19673
202012,11590,서울특별시,동작구,25-29세,38942,19201,19741
202101,11590,서울특별시,동작구,25-29세,38824,19144,19680
202102,11590,서울특별시,동작구,25-29세,38564,19010,19554
202103,11590,서울특별시,동작구,25-29세,38583,19008,19575
202104,11590,서울특별시,동작구,25-29세,38525,19004,19521
202105,11590,서울특별시,동작구,25-29세,38505,19010,19495
202106,11590,서울특별시,동작구,25-29세,38488,18983,19505
202007,11590,서울특별시,동작구,30-34세,32087,16224,15863
202008,11590,서울특별시,동작구,30-34세,31960,16173,15787
202009,11590,서울특별시,동작구,30-34세,31951,16163,15788
202010,11590,서울특별시,동작구,30-34세,31881,16156,15725
202011,11590,서울특별시,동작구,30-34세,31852,16127,15725
202012,11590,서울특별시,동작구,30-34세,31789,16078,15711
202101,11590,서울특별시,동작구,30-34세,31808,16053,15755
202102,11590,서울특별시,동작구,30-34세,31754,16026,15728
202103,11590,서울특별시,동작구,30-34세,31894,16087,15807
202104,11590,서울특별시,동작구,30-34세,31964,16146,15818
202105,11590,서울특별시,동작구,30-34세,32007,16182,15825
202106,11590,서울특별시,동작구,30-34세,32065,16189,15876
202007,11590,서울특별시,동작구,35-39세,31108,15770,15338
202008,11590,서울특별시,동작구,35-39세,30905,15673,15232
202009,11590,서울특별시,동작구,35-39세,30690,15562,15128
202010,11590,서울특별시,동작구,35-39세,30548,15487,15061
202011,11590,서울특별시,동작구,35-39세,30437,15387,15050
202012,11590,서울특별시,동작구,35-39세,30307,15344,14963
202101,11590,서울특별시,동작구,35-39세,30189,15281,14908
202102,11590,서울특별시,동작구,35-39세,30036,15220,14816
202103,11590,서울특별시,동작구,35-39세,29836,15114,14722
202104,11590,서울특별시,동작구,35-39세,29797,15081,14716
202105,11590,서울특별시,동작구,35-39세,29686,15024,14662
202106,11590,서울특별시,동작구,35-39세,29504,14925,14579
202007,11590,서울특별시,동작구,40-44세,28874,14487,14387
202008,11590,서울특별시,동작구,40-44세,28799,14430,14369
202009,11590,서울특별시,동작구,40-44세,28825,14443,14382
202010,11590,서울특별시,동작구,40-44세,28864,14455,14409
202011,11590,서울특별시,동작구,40-44세,28812,14458,14354
202012,11590,서울특별시,동작구,40-44세,28722,14431,14291
202101,11590,서울특별시,동작구,40-44세,28614,14404,14210
202102,11590,서울특별시,동작구,40-44세,28569,14375,14194
202103,11590,서울특별시,동작구,40-44세,28491,14359,14132
202104,11590,서울특별시,동작구,40-44세,28544,14376,14168
202105,11590,서울특별시,동작구,40-44세,28554,14392,14162
202106,11590,서울특별시,동작구,40-44세,28596,14398,14198
202007,11590,서울특별시,동작구,45-49세,31006,15491,15515
202008,11590,서울특별시,동작구,45-49세,30834,15404,15430
202009,11590,서울특별시,동작구,45-49세,30632,15299,15333
202010,11590,서울특별시,동작구,45-49세,30350,15161,15189
202011,11590,서울특별시,동작구,45-49세,30186,15085,15101
202012,11590,서울특별시,동작구,45-49세,30190,15080,15110
202101,11590,서울특별시,동작구,45-49세,30074,15028,15046
202102,11590,서울특별시,동작구,45-49세,29990,14982,15008
202103,11590,서울특별시,동작구,45-49세,29845,14928,14917
202104,11590,서울특별시,동작구,45-49세,29770,14915,14855
202105,11590,서울특별시,동작구,45-49세,29590,14838,14752
202106,11590,서울특별시,동작구,45-49세,29465,14795,14670
202007,11590,서울특별시,동작구,50-54세,29677,14318,15359
202008,11590,서울특별시,동작구,50-54세,29803,14400,15403
202009,11590,서울특별시,동작구,50-54세,29864,14404,15460
202010,11590,서울특별시,동작구,50-54세,29856,14410,15446
202011,11590,서울특별시,동작구,50-54세,29800,14375,15425
202012,11590,서울특별시,동작구,50-54세,29702,14344,15358
202101,11590,서울특별시,동작구,50-54세,29844,14408,15436
202102,11590,서울특별시,동작구,50-54세,29925,14468,15457
202103,11590,서울특별시,동작구,50-54세,29844,14436,15408
202104,11590,서울특별시,동작구,50-54세,29899,14465,15434
202105,11590,서울특별시,동작구,50-54세,30093,14525,15568
202106,11590,서울특별시,동작구,50-54세,30151,14546,15605
202007,11590,서울특별시,동작구,55-59세,29148,13929,15219
202008,11590,서울특별시,동작구,55-59세,28942,13843,15099
202009,11590,서울특별시,동작구,55-59세,28864,13794,15070
202010,11590,서울특별시,동작구,55-59세,28807,13728,15079
202011,11590,서울특별시,동작구,55-59세,28688,13676,15012
202012,11590,서울특별시,동작구,55-59세,28641,13636,15005
202101,11590,서울특별시,동작구,55-59세,28435,13564,14871
202102,11590,서울특별시,동작구,55-59세,28343,13510,14833
202103,11590,서울특별시,동작구,55-59세,28194,13479,14715
202104,11590,서울특별시,동작구,55-59세,28083,13439,14644
202105,11590,서울특별시,동작구,55-59세,27899,13392,14507
202106,11590,서울특별시,동작구,55-59세,27637,13266,14371
202007,11590,서울특별시,동작구,60-64세,27838,12914,14924
202008,11590,서울특별시,동작구,60-64세,27922,12930,14992
202009,11590,서울특별시,동작구,60-64세,27919,12948,14971
202010,11590,서울특별시,동작구,60-64세,27946,12987,14959
202011,11590,서울특별시,동작구,60-64세,27973,12974,14999
202012,11590,서울특별시,동작구,60-64세,28011,13005,15006
202101,11590,서울특별시,동작구,60-64세,28044,12992,15052
202102,11590,서울특별시,동작구,60-64세,28154,13056,15098
202103,11590,서울특별시,동작구,60-64세,28120,13005,15115
202104,11590,서울특별시,동작구,60-64세,28225,13034,15191
202105,11590,서울특별시,동작구,60-64세,28298,13083,15215
202106,11590,서울특별시,동작구,60-64세,28401,13167,15234
202007,11590,서울특별시,동작구,65-69세,20690,9406,11284
202008,11590,서울특별시,동작구,65-69세,20777,9446,11331
202009,11590,서울특별시,동작구,65-69세,20918,9509,11409
202010,11590,서울특별시,동작구,65-69세,21010,9541,11469
202011,11590,서울특별시,동작구,65-69세,21061,9578,11483
202012,11590,서울특별시,동작구,65-69세,21151,9619,11532
202101,11590,서울특별시,동작구,65-69세,21277,9721,11556
202102,11590,서울특별시,동작구,65-69세,21371,9769,11602
202103,11590,서울특별시,동작구,65-69세,21379,9814,11565
202104,11590,서울특별시,동작구,65-69세,21518,9909,11609
202105,11590,서울특별시,동작구,65-69세,21607,9932,11675
202106,11590,서울특별시,동작구,65-69세,21630,9922,11708
202007,11590,서울특별시,동작구,70-74세,16732,7358,9374
202008,11590,서울특별시,동작구,70-74세,16767,7370,9397
202009,11590,서울특별시,동작구,70-74세,16842,7400,9442
202010,11590,서울특별시,동작구,70-74세,16936,7459,9477
202011,11590,서울특별시,동작구,70-74세,17010,7465,9545
202012,11590,서울특별시,동작구,70-74세,17066,7499,9567
202101,11590,서울특별시,동작구,70-74세,17195,7551,9644
202102,11590,서울특별시,동작구,70-74세,17230,7554,9676
202103,11590,서울특별시,동작구,70-74세,17137,7534,9603
202104,11590,서울특별시,동작구,70-74세,17120,7525,9595
202105,11590,서울특별시,동작구,70-74세,17066,7508,9558
202106,11590,서울특별시,동작구,70-74세,17030,7497,9533
202007,11590,서울특별시,동작구,75-79세,12878,5930,6948
202008,11590,서울특별시,동작구,75-79세,12884,5934,6950
202009,11590,서울특별시,동작구,75-79세,12843,5909,6934
202010,11590,서울특별시,동작구,75-79세,12767,5869,6898
202011,11590,서울특별시,동작구,75-79세,12716,5855,6861
202012,11590,서울특별시,동작구,75-79세,12689,5833,6856
202101,11590,서울특별시,동작구,75-79세,12704,5817,6887
202102,11590,서울특별시,동작구,75-79세,12714,5827,6887
202103,11590,서울특별시,동작구,75-79세,12610,5763,6847
202104,11590,서울특별시,동작구,75-79세,12586,5726,6860
202105,11590,서울특별시,동작구,75-79세,12630,5733,6897
202106,11590,서울특별시,동작구,75-79세,12623,5722,6901
202007,11590,서울특별시,동작구,80-84세,7980,3321,4659
202008,11590,서울특별시,동작구,80-84세,7998,3340,4658
202009,11590,서울특별시,동작구,80-84세,8032,3366,4666
202010,11590,서울특별시,동작구,80-84세,8062,3400,4662
202011,11590,서울특별시,동작구,80-84세,8111,3423,4688
202012,11590,서울특별시,동작구,80-84세,8108,3409,4699
202101,11590,서울특별시,동작구,80-84세,8156,3435,4721
202102,11590,서울특별시,동작구,80-84세,8211,3458,4753
202103,11590,서울특별시,동작구,80-84세,8148,3445,4703
202104,11590,서울특별시,동작구,80-84세,8198,3486,4712
202105,11590,서울특별시,동작구,80-84세,8241,3503,4738
202106,11590,서울특별시,동작구,80-84세,8281,3522,4759
202007,11590,서울특별시,동작구,85-89세,3611,1247,2364
202008,11590,서울특별시,동작구,85-89세,3637,1250,2387
202009,11590,서울특별시,동작구,85-89세,3658,1269,2389
202010,11590,서울특별시,동작구,85-89세,3702,1288,2414
202011,11590,서울특별시,동작구,85-89세,3732,1315,2417
202012,11590,서울특별시,동작구,85-89세,3787,1347,2440
202101,11590,서울특별시,동작구,85-89세,3810,1368,2442
202102,11590,서울특별시,동작구,85-89세,3851,1393,2458
202103,11590,서울특별시,동작구,85-89세,3876,1395,2481
202104,11590,서울특별시,동작구,85-89세,3907,1390,2517
202105,11590,서울특별시,동작구,85-89세,3951,1411,2540
202106,11590,서울특별시,동작구,85-89세,3956,1410,2546
202007,11590,서울특별시,동작구,90-94세,1383,367,1016
202008,11590,서울특별시,동작구,90-94세,1403,369,1034
202009,11590,서울특별시,동작구,90-94세,1415,376,1039
202010,11590,서울특별시,동작구,90-94세,1423,378,1045
202011,11590,서울특별시,동작구,90-94세,1420,378,1042
202012,11590,서울특별시,동작구,90-94세,1432,384,1048
202101,11590,서울특별시,동작구,90-94세,1425,385,1040
202102,11590,서울특별시,동작구,90-94세,1439,384,1055
202103,11590,서울특별시,동작구,90-94세,1398,361,1037
202104,11590,서울특별시,동작구,90-94세,1402,369,1033
202105,11590,서울특별시,동작구,90-94세,1408,370,1038
202106,11590,서울특별시,동작구,90-94세,1405,362,1043
202007,11590,서울특별시,동작구,95-99세,381,97,284
202008,11590,서울특별시,동작구,95-99세,382,97,285
202009,11590,서울특별시,동작구,95-99세,385,98,287
202010,11590,서울특별시,동작구,95-99세,387,98,289
202011,11590,서울특별시,동작구,95-99세,380,96,284
202012,11590,서울특별시,동작구,95-99세,382,92,290
202101,11590,서울특별시,동작구,95-99세,391,95,296
202102,11590,서울특별시,동작구,95-99세,395,93,302
202103,11590,서울특별시,동작구,95-99세,365,86,279
202104,11590,서울특별시,동작구,95-99세,366,86,280
202105,11590,서울특별시,동작구,95-99세,365,86,279
202106,11590,서울특별시,동작구,95-99세,349,84,265
202007,11590,서울특별시,동작구,100+,306,90,216
202008,11590,서울특별시,동작구,100+,310,91,219
202009,11590,서울특별시,동작구,100+,314,92,222
202010,11590,서울특별시,동작구,100+,311,91,220
202011,11590,서울특별시,동작구,100+,312,92,220
202012,11590,서울특별시,동작구,100+,313,91,222
202101,11590,서울특별시,동작구,100+,315,92,223
202102,11590,서울특별시,동작구,100+,318,93,225
202103,11590,서울특별시,동작구,100+,178,51,127
202104,11590,서울특별시,동작구,100+,177,51,126
202105,11590,서울특별시,동작구,100+,180,53,127
202106,11590,서울특별시,동작구,100+,155,41,114
202007,11620,서울특별시,관악구,0-4세,10700,5522,5178
202008,11620,서울특별시,관악구,0-4세,10519,5428,5091
202009,11620,서울특별시,관악구,0-4세,10379,5327,5052
202010,11620,서울특별시,관악구,0-4세,10158,5202,4956
202011,11620,서울특별시,관악구,0-4세,10029,5150,4879
202012,11620,서울특별시,관악구,0-4세,9898,5069,4829
202101,11620,서울특별시,관악구,0-4세,9725,4972,4753
202102,11620,서울특별시,관악구,0-4세,9554,4881,4673
202103,11620,서울특별시,관악구,0-4세,9399,4798,4601
202104,11620,서울특별시,관악구,0-4세,9280,4754,4526
202105,11620,서울특별시,관악구,0-4세,9208,4718,4490
202106,11620,서울특별시,관악구,0-4세,9113,4665,4448
202007,11620,서울특별시,관악구,5-9세,12910,6616,6294
202008,11620,서울특별시,관악구,5-9세,12834,6575,6259
202009,11620,서울특별시,관악구,5-9세,12801,6574,6227
202010,11620,서울특별시,관악구,5-9세,12699,6538,6161
202011,11620,서울특별시,관악구,5-9세,12582,6479,6103
202012,11620,서울특별시,관악구,5-9세,12474,6430,6044
202101,11620,서울특별시,관악구,5-9세,12384,6378,6006
202102,11620,서울특별시,관악구,5-9세,12184,6260,5924
202103,11620,서울특별시,관악구,5-9세,12075,6203,5872
202104,11620,서울특별시,관악구,5-9세,11984,6171,5813
202105,11620,서울특별시,관악구,5-9세,11958,6143,5815
202106,11620,서울특별시,관악구,5-9세,11931,6129,5802
202007,11620,서울특별시,관악구,10-14세,12910,6659,6251
202008,11620,서울특별시,관악구,10-14세,12875,6637,6238
202009,11620,서울특별시,관악구,10-14세,12850,6623,6227
202010,11620,서울특별시,관악구,10-14세,12792,6597,6195
202011,11620,서울특별시,관악구,10-14세,12768,6586,6182
202012,11620,서울특별시,관악구,10-14세,12731,6566,6165
202101,11620,서울특별시,관악구,10-14세,12692,6531,6161
202102,11620,서울특별시,관악구,10-14세,12624,6506,6118
202103,11620,서울특별시,관악구,10-14세,12639,6503,6136
202104,11620,서울특별시,관악구,10-14세,12645,6483,6162
202105,11620,서울특별시,관악구,10-14세,12602,6461,6141
202106,11620,서울특별시,관악구,10-14세,12553,6432,6121
202007,11620,서울특별시,관악구,15-19세,16739,8528,8211
202008,11620,서울특별시,관악구,15-19세,16591,8456,8135
202009,11620,서울특별시,관악구,15-19세,16434,8340,8094
202010,11620,서울특별시,관악구,15-19세,16195,8211,7984
202011,11620,서울특별시,관악구,15-19세,15998,8121,7877
202012,11620,서울특별시,관악구,15-19세,15869,8075,7794
202101,11620,서울특별시,관악구,15-19세,15707,7979,7728
202102,11620,서울특별시,관악구,15-19세,15635,7947,7688
202103,11620,서울특별시,관악구,15-19세,15604,7940,7664
202104,11620,서울특별시,관악구,15-19세,15490,7877,7613
202105,11620,서울특별시,관악구,15-19세,15403,7830,7573
202106,11620,서울특별시,관악구,15-19세,15320,7783,7537
202007,11620,서울특별시,관악구,20-24세,40422,17892,22530
202008,11620,서울특별시,관악구,20-24세,40449,17877,22572
202009,11620,서울특별시,관악구,20-24세,40149,17759,22390
202010,11620,서울특별시,관악구,20-24세,39674,17576,22098
202011,11620,서울특별시,관악구,20-24세,39366,17449,21917
202012,11620,서울특별시,관악구,20-24세,39220,17377,21843
202101,11620,서울특별시,관악구,20-24세,38956,17209,21747
202102,11620,서울특별시,관악구,20-24세,38931,17197,21734
202103,11620,서울특별시,관악구,20-24세,39038,17212,21826
202104,11620,서울특별시,관악구,20-24세,38821,17137,21684
202105,11620,서울특별시,관악구,20-24세,38628,17033,21595
202106,11620,서울특별시,관악구,20-24세,38590,17064,21526
202007,11620,서울특별시,관악구,25-29세,69463,35778,33685
202008,11620,서울특별시,관악구,25-29세,69611,35814,33797
202009,11620,서울특별시,관악구,25-29세,69666,35772,33894
202010,11620,서울특별시,관악구,25-29세,69728,35784,33944
202011,11620,서울특별시,관악구,25-29세,69866,35783,34083
202012,11620,서울특별시,관악구,25-29세,69915,35791,34124
202101,11620,서울특별시,관악구,25-29세,69669,35669,34000
202102,11620,서울특별시,관악구,25-29세,69522,35613,33909
202103,11620,서울특별시,관악구,25-29세,69813,35755,34058
202104,11620,서울특별시,관악구,25-29세,69886,35755,34131
202105,11620,서울특별시,관악구,25-29세,70149,35884,34265
202106,11620,서울특별시,관악구,25-29세,70151,35832,34319
202007,11620,서울특별시,관악구,30-34세,49001,27160,21841
202008,11620,서울특별시,관악구,30-34세,49079,27231,21848
202009,11620,서울특별시,관악구,30-34세,49151,27264,21887
202010,11620,서울특별시,관악구,30-34세,49072,27244,21828
202011,11620,서울특별시,관악구,30-34세,49034,27230,21804
202012,11620,서울특별시,관악구,30-34세,48899,27175,21724
202101,11620,서울특별시,관악구,30-34세,49043,27254,21789
202102,11620,서울특별시,관악구,30-34세,49051,27275,21776
202103,11620,서울특별시,관악구,30-34세,48983,27240,21743
202104,11620,서울특별시,관악구,30-34세,49025,27250,21775
202105,11620,서울특별시,관악구,30-34세,49154,27343,21811
202106,11620,서울특별시,관악구,30-34세,49308,27452,21856
202007,11620,서울특별시,관악구,35-39세,39112,21396,17716
202008,11620,서울특별시,관악구,35-39세,38825,21211,17614
202009,11620,서울특별시,관악구,35-39세,38554,21089,17465
202010,11620,서울특별시,관악구,35-39세,38346,21019,17327
202011,11620,서울특별시,관악구,35-39세,38097,20888,17209
202012,11620,서울특별시,관악구,35-39세,37882,20762,17120
202101,11620,서울특별시,관악구,35-39세,37679,20633,17046
202102,11620,서울특별시,관악구,35-39세,37376,20479,16897
202103,11620,서울특별시,관악구,35-39세,36967,20250,16717
202104,11620,서울특별시,관악구,35-39세,36721,20126,16595
202105,11620,서울특별시,관악구,35-39세,36583,20065,16518
202106,11620,서울특별시,관악구,35-39세,36426,19999,16427
202007,11620,서울특별시,관악구,40-44세,33411,17932,15479
202008,11620,서울특별시,관악구,40-44세,33399,17942,15457
202009,11620,서울특별시,관악구,40-44세,33411,17946,15465
202010,11620,서울특별시,관악구,40-44세,33381,17917,15464
202011,11620,서울특별시,관악구,40-44세,33323,17841,15482
202012,11620,서울특별시,관악구,40-44세,33151,17779,15372
202101,11620,서울특별시,관악구,40-44세,33063,17738,15325
202102,11620,서울특별시,관악구,40-44세,33137,17781,15356
202103,11620,서울특별시,관악구,40-44세,32856,17625,15231
202104,11620,서울특별시,관악구,40-44세,32836,17608,15228
202105,11620,서울특별시,관악구,40-44세,32821,17626,15195
202106,11620,서울특별시,관악구,40-44세,32937,17692,15245
202007,11620,서울특별시,관악구,45-49세,36304,19272,17032
202008,11620,서울특별시,관악구,45-49세,36108,19149,16959
202009,11620,서울특별시,관악구,45-49세,35921,19064,16857
202010,11620,서울특별시,관악구,45-49세,35644,18931,16713
202011,11620,서울특별시,관악구,45-49세,35434,18852,16582
202012,11620,서울특별시,관악구,45-49세,35333,18779,16554
202101,11620,서울특별시,관악구,45-49세,35157,18697,16460
202102,11620,서울특별시,관악구,45-49세,34882,18517,16365
202103,11620,서울특별시,관악구,45-49세,34506,18349,16157
202104,11620,서울특별시,관악구,45-49세,34377,18286,16091
202105,11620,서울특별시,관악구,45-49세,34060,18126,15934
202106,11620,서울특별시,관악구,45-49세,33859,18030,15829
202007,11620,서울특별시,관악구,50-54세,34579,17460,17119
202008,11620,서울특별시,관악구,50-54세,34574,17465,17109
202009,11620,서울특별시,관악구,50-54세,34633,17491,17142
202010,11620,서울특별시,관악구,50-54세,34619,17499,17120
202011,11620,서울특별시,관악구,50-54세,34581,17476,17105
202012,11620,서울특별시,관악구,50-54세,34474,17439,17035
202101,11620,서울특별시,관악구,50-54세,34654,17528,17126
202102,11620,서울특별시,관악구,50-54세,34776,17609,17167
202103,11620,서울특별시,관악구,50-54세,34525,17515,17010
202104,11620,서울특별시,관악구,50-54세,34558,17527,17031
202105,11620,서울특별시,관악구,50-54세,34703,17590,17113
202106,11620,서울특별시,관악구,50-54세,34767,17622,17145
202007,11620,서울특별시,관악구,55-59세,34167,16779,17388
202008,11620,서울특별시,관악구,55-59세,34065,16764,17301
202009,11620,서울특별시,관악구,55-59세,33882,16695,17187
202010,11620,서울특별시,관악구,55-59세,33753,16652,17101
202011,11620,서울특별시,관악구,55-59세,33678,16650,17028
202012,11620,서울특별시,관악구,55-59세,33578,16629,16949
202101,11620,서울특별시,관악구,55-59세,33370,16571,16799
202102,11620,서울특별시,관악구,55-59세,33297,16586,16711
202103,11620,서울특별시,관악구,55-59세,32991,16454,16537
202104,11620,서울특별시,관악구,55-59세,32805,16415,16390
202105,11620,서울특별시,관악구,55-59세,32631,16372,16259
202106,11620,서울특별시,관악구,55-59세,32364,16229,16135
202007,11620,서울특별시,관악구,60-64세,32905,15463,17442
202008,11620,서울특별시,관악구,60-64세,32953,15474,17479
202009,11620,서울특별시,관악구,60-64세,33009,15512,17497
202010,11620,서울특별시,관악구,60-64세,33135,15572,17563
202011,11620,서울특별시,관악구,60-64세,33168,15579,17589
202012,11620,서울특별시,관악구,60-64세,33206,15588,17618
202101,11620,서울특별시,관악구,60-64세,33309,15644,17665
202102,11620,서울특별시,관악구,60-64세,33386,15648,17738
202103,11620,서울특별시,관악구,60-64세,33082,15496,17586
202104,11620,서울특별시,관악구,60-64세,33147,15530,17617
202105,11620,서울특별시,관악구,60-64세,33234,15562,17672
202106,11620,서울특별시,관악구,60-64세,33353,15631,17722
202007,11620,서울특별시,관악구,65-69세,25487,11694,13793
202008,11620,서울특별시,관악구,65-69세,25612,11758,13854
202009,11620,서울특별시,관악구,65-69세,25805,11848,13957
202010,11620,서울특별시,관악구,65-69세,25860,11868,13992
202011,11620,서울특별시,관악구,65-69세,25937,11916,14021
202012,11620,서울특별시,관악구,65-69세,26037,11955,14082
202101,11620,서울특별시,관악구,65-69세,26158,12023,14135
202102,11620,서울특별시,관악구,65-69세,26227,12064,14163
202103,11620,서울특별시,관악구,65-69세,26199,12085,14114
202104,11620,서울특별시,관악구,65-69세,26178,12074,14104
202105,11620,서울특별시,관악구,65-69세,26207,12083,14124
202106,11620,서울특별시,관악구,65-69세,26267,12082,14185
202007,11620,서울특별시,관악구,70-74세,20804,9510,11294
202008,11620,서울특별시,관악구,70-74세,20838,9524,11314
202009,11620,서울특별시,관악구,70-74세,20885,9547,11338
202010,11620,서울특별시,관악구,70-74세,20966,9584,11382
202011,11620,서울특별시,관악구,70-74세,21058,9599,11459
202012,11620,서울특별시,관악구,70-74세,21172,9640,11532
202101,11620,서울특별시,관악구,70-74세,21262,9695,11567
202102,11620,서울특별시,관악구,70-74세,21328,9720,11608
202103,11620,서울특별시,관악구,70-74세,21023,9603,11420
202104,11620,서울특별시,관악구,70-74세,21022,9599,11423
202105,11620,서울특별시,관악구,70-74세,21042,9593,11449
202106,11620,서울특별시,관악구,70-74세,20983,9597,11386
202007,11620,서울특별시,관악구,75-79세,16172,7477,8695
202008,11620,서울특별시,관악구,75-79세,16227,7486,8741
202009,11620,서울특별시,관악구,75-79세,16170,7461,8709
202010,11620,서울특별시,관악구,75-79세,16088,7414,8674
202011,11620,서울특별시,관악구,75-79세,16055,7386,8669
202012,11620,서울특별시,관악구,75-79세,16004,7343,8661
202101,11620,서울특별시,관악구,75-79세,15989,7306,8683
202102,11620,서울특별시,관악구,75-79세,15926,7266,8660
202103,11620,서울특별시,관악구,75-79세,15665,7171,8494
202104,11620,서울특별시,관악구,75-79세,15607,7134,8473
202105,11620,서울특별시,관악구,75-79세,15573,7122,8451
202106,11620,서울특별시,관악구,75-79세,15590,7117,8473
202007,11620,서울특별시,관악구,80-84세,8974,3915,5059
202008,11620,서울특별시,관악구,80-84세,9038,3936,5102
202009,11620,서울특별시,관악구,80-84세,9084,3959,5125
202010,11620,서울특별시,관악구,80-84세,9143,3973,5170
202011,11620,서울특별시,관악구,80-84세,9233,4029,5204
202012,11620,서울특별시,관악구,80-84세,9292,4070,5222
202101,11620,서울특별시,관악구,80-84세,9371,4130,5241
202102,11620,서울특별시,관악구,80-84세,9449,4181,5268
202103,11620,서울특별시,관악구,80-84세,9363,4099,5264
202104,11620,서울특별시,관악구,80-84세,9446,4129,5317
202105,11620,서울특별시,관악구,80-84세,9524,4165,5359
202106,11620,서울특별시,관악구,80-84세,9615,4216,5399
202007,11620,서울특별시,관악구,85-89세,3671,1299,2372
202008,11620,서울특별시,관악구,85-89세,3707,1313,2394
202009,11620,서울특별시,관악구,85-89세,3759,1332,2427
202010,11620,서울특별시,관악구,85-89세,3787,1350,2437
202011,11620,서울특별시,관악구,85-89세,3806,1363,2443
202012,11620,서울특별시,관악구,85-89세,3849,1389,2460
202101,11620,서울특별시,관악구,85-89세,3883,1409,2474
202102,11620,서울특별시,관악구,85-89세,3971,1449,2522
202103,11620,서울특별시,관악구,85-89세,3895,1416,2479
202104,11620,서울특별시,관악구,85-89세,3911,1426,2485
202105,11620,서울특별시,관악구,85-89세,3952,1444,2508
202106,11620,서울특별시,관악구,85-89세,3946,1438,2508
202007,11620,서울특별시,관악구,90-94세,1332,323,1009
202008,11620,서울특별시,관악구,90-94세,1342,329,1013
202009,11620,서울특별시,관악구,90-94세,1354,330,1024
202010,11620,서울특별시,관악구,90-94세,1370,334,1036
202011,11620,서울특별시,관악구,90-94세,1372,331,1041
202012,11620,서울특별시,관악구,90-94세,1402,336,1066
202101,11620,서울특별시,관악구,90-94세,1423,339,1084
202102,11620,서울특별시,관악구,90-94세,1423,343,1080
202103,11620,서울특별시,관악구,90-94세,1328,311,1017
202104,11620,서울특별시,관악구,90-94세,1330,313,1017
202105,11620,서울특별시,관악구,90-94세,1333,320,1013
202106,11620,서울특별시,관악구,90-94세,1329,322,1007
202007,11620,서울특별시,관악구,95-99세,349,80,269
202008,11620,서울특별시,관악구,95-99세,355,82,273
202009,11620,서울특별시,관악구,95-99세,362,83,279
202010,11620,서울특별시,관악구,95-99세,358,80,278
202011,11620,서울특별시,관악구,95-99세,355,82,273
202012,11620,서울특별시,관악구,95-99세,351,79,272
202101,11620,서울특별시,관악구,95-99세,357,79,278
202102,11620,서울특별시,관악구,95-99세,371,80,291
202103,11620,서울특별시,관악구,95-99세,297,52,245
202104,11620,서울특별시,관악구,95-99세,292,52,240
202105,11620,서울특별시,관악구,95-99세,291,51,240
202106,11620,서울특별시,관악구,95-99세,292,51,241
202007,11620,서울특별시,관악구,100+,317,70,247
202008,11620,서울특별시,관악구,100+,315,69,246
202009,11620,서울특별시,관악구,100+,315,68,247
202010,11620,서울특별시,관악구,100+,314,67,247
202011,11620,서울특별시,관악구,100+,319,67,252
202012,11620,서울특별시,관악구,100+,323,68,255
202101,11620,서울특별시,관악구,100+,324,69,255
202102,11620,서울특별시,관악구,100+,324,70,254
202103,11620,서울특별시,관악구,100+,104,20,84
202104,11620,서울특별시,관악구,100+,103,20,83
202105,11620,서울특별시,관악구,100+,104,21,83
202106,11620,서울특별시,관악구,100+,106,21,85
202007,11650,서울특별시,서초구,0-4세,13725,7114,6611
202008,11650,서울특별시,서초구,0-4세,13551,7024,6527
202009,11650,서울특별시,서초구,0-4세,13439,6953,6486
202010,11650,서울특별시,서초구,0-4세,13353,6935,6418
202011,11650,서울특별시,서초구,0-4세,13226,6868,6358
202012,11650,서울특별시,서초구,0-4세,13125,6813,6312
202101,11650,서울특별시,서초구,0-4세,12985,6739,6246
202102,11650,서울특별시,서초구,0-4세,12907,6697,6210
202103,11650,서울특별시,서초구,0-4세,12774,6609,6165
202104,11650,서울특별시,서초구,0-4세,12623,6527,6096
202105,11650,서울특별시,서초구,0-4세,12456,6446,6010
202106,11650,서울특별시,서초구,0-4세,12351,6375,5976
202007,11650,서울특별시,서초구,5-9세,21088,10918,10170
202008,11650,서울특별시,서초구,5-9세,21052,10899,10153
202009,11650,서울특별시,서초구,5-9세,20943,10853,10090
202010,11650,서울특별시,서초구,5-9세,20893,10797,10096
202011,11650,서울특별시,서초구,5-9세,20790,10738,10052
202012,11650,서울특별시,서초구,5-9세,20726,10677,10049
202101,11650,서울특별시,서초구,5-9세,20559,10575,9984
202102,11650,서울특별시,서초구,5-9세,20501,10540,9961
202103,11650,서울특별시,서초구,5-9세,20385,10516,9869
202104,11650,서울특별시,서초구,5-9세,20276,10420,9856
202105,11650,서울특별시,서초구,5-9세,20202,10367,9835
202106,11650,서울특별시,서초구,5-9세,20196,10368,9828
202007,11650,서울특별시,서초구,10-14세,22634,11470,11164
202008,11650,서울특별시,서초구,10-14세,22669,11502,11167
202009,11650,서울특별시,서초구,10-14세,22736,11521,11215
202010,11650,서울특별시,서초구,10-14세,22873,11613,11260
202011,11650,서울특별시,서초구,10-14세,23028,11682,11346
202012,11650,서울특별시,서초구,10-14세,23103,11749,11354
202101,11650,서울특별시,서초구,10-14세,23210,11792,11418
202102,11650,서울특별시,서초구,10-14세,23224,11818,11406
202103,11650,서울특별시,서초구,10-14세,23181,11783,11398
202104,11650,서울특별시,서초구,10-14세,23137,11798,11339
202105,11650,서울특별시,서초구,10-14세,23086,11761,11325
202106,11650,서울특별시,서초구,10-14세,23084,11733,11351
202007,11650,서울특별시,서초구,15-19세,22661,11588,11073
202008,11650,서울특별시,서초구,15-19세,22564,11529,11035
202009,11650,서울특별시,서초구,15-19세,22477,11478,10999
202010,11650,서울특별시,서초구,15-19세,22380,11439,10941
202011,11650,서울특별시,서초구,15-19세,22290,11395,10895
202012,11650,서울특별시,서초구,15-19세,22226,11371,10855
202101,11650,서울특별시,서초구,15-19세,22093,11310,10783
202102,11650,서울특별시,서초구,15-19세,22007,11265,10742
202103,11650,서울특별시,서초구,15-19세,21893,11183,10710
202104,11650,서울특별시,서초구,15-19세,21788,11105,10683
202105,11650,서울특별시,서초구,15-19세,21802,11121,10681
202106,11650,서울특별시,서초구,15-19세,21761,11112,10649
202007,11650,서울특별시,서초구,20-24세,25541,12471,13070
202008,11650,서울특별시,서초구,20-24세,25518,12468,13050
202009,11650,서울특별시,서초구,20-24세,25357,12399,12958
202010,11650,서울특별시,서초구,20-24세,25276,12337,12939
202011,11650,서울특별시,서초구,20-24세,25228,12330,12898
202012,11650,서울특별시,서초구,20-24세,25144,12305,12839
202101,11650,서울특별시,서초구,20-24세,25101,12273,12828
202102,11650,서울특별시,서초구,20-24세,24994,12218,12776
202103,11650,서울특별시,서초구,20-24세,24833,12140,12693
202104,11650,서울특별시,서초구,20-24세,24722,12075,12647
202105,11650,서울특별시,서초구,20-24세,24536,11977,12559
202106,11650,서울특별시,서초구,20-24세,24462,11962,12500
202007,11650,서울특별시,서초구,25-29세,30458,14435,16023
202008,11650,서울특별시,서초구,25-29세,30309,14344,15965
202009,11650,서울특별시,서초구,25-29세,30168,14265,15903
202010,11650,서울특별시,서초구,25-29세,30060,14227,15833
202011,11650,서울특별시,서초구,25-29세,30002,14189,15813
202012,11650,서울특별시,서초구,25-29세,29947,14134,15813
202101,11650,서울특별시,서초구,25-29세,29755,14034,15721
202102,11650,서울특별시,서초구,25-29세,29435,13911,15524
202103,11650,서울특별시,서초구,25-29세,29404,13923,15481
202104,11650,서울특별시,서초구,25-29세,29391,13929,15462
202105,11650,서울특별시,서초구,25-29세,29287,13883,15404
202106,11650,서울특별시,서초구,25-29세,29175,13860,15315
202007,11650,서울특별시,서초구,30-34세,30319,13992,16327
202008,11650,서울특별시,서초구,30-34세,30137,13925,16212
202009,11650,서울특별시,서초구,30-34세,29993,13837,16156
202010,11650,서울특별시,서초구,30-34세,29843,13800,16043
202011,11650,서울특별시,서초구,30-34세,29731,13762,15969
202012,11650,서울특별시,서초구,30-34세,29652,13756,15896
202101,11650,서울특별시,서초구,30-34세,29680,13777,15903
202102,11650,서울특별시,서초구,30-34세,29534,13663,15871
202103,11650,서울특별시,서초구,30-34세,29452,13592,15860
202104,11650,서울특별시,서초구,30-34세,29412,13564,15848
202105,11650,서울특별시,서초구,30-34세,29385,13542,15843
202106,11650,서울특별시,서초구,30-34세,29240,13473,15767
202007,11650,서울특별시,서초구,35-39세,34630,15881,18749
202008,11650,서울특별시,서초구,35-39세,34371,15743,18628
202009,11650,서울특별시,서초구,35-39세,34093,15645,18448
202010,11650,서울특별시,서초구,35-39세,33833,15498,18335
202011,11650,서울특별시,서초구,35-39세,33720,15455,18265
202012,11650,서울특별시,서초구,35-39세,33572,15384,18188
202101,11650,서울특별시,서초구,35-39세,33405,15310,18095
202102,11650,서울특별시,서초구,35-39세,33112,15196,17916
202103,11650,서울특별시,서초구,35-39세,32740,15033,17707
202104,11650,서울특별시,서초구,35-39세,32541,14933,17608
202105,11650,서울특별시,서초구,35-39세,32176,14771,17405
202106,11650,서울특별시,서초구,35-39세,31926,14668,17258
202007,11650,서울특별시,서초구,40-44세,36964,16954,20010
202008,11650,서울특별시,서초구,40-44세,36980,16953,20027
202009,11650,서울특별시,서초구,40-44세,36985,16907,20078
202010,11650,서울특별시,서초구,40-44세,37150,16928,20222
202011,11650,서울특별시,서초구,40-44세,37152,16940,20212
202012,11650,서울특별시,서초구,40-44세,37128,16931,20197
202101,11650,서울특별시,서초구,40-44세,37073,16913,20160
202102,11650,서울특별시,서초구,40-44세,37184,16994,20190
202103,11650,서울특별시,서초구,40-44세,36846,16855,19991
202104,11650,서울특별시,서초구,40-44세,36785,16825,19960
202105,11650,서울특별시,서초구,40-44세,36759,16812,19947
202106,11650,서울특별시,서초구,40-44세,36839,16852,19987
202007,11650,서울특별시,서초구,45-49세,40989,19715,21274
202008,11650,서울특별시,서초구,45-49세,40751,19607,21144
202009,11650,서울특별시,서초구,45-49세,40522,19553,20969
202010,11650,서울특별시,서초구,45-49세,40401,19539,20862
202011,11650,서울특별시,서초구,45-49세,40300,19477,20823
202012,11650,서울특별시,서초구,45-49세,40227,19433,20794
202101,11650,서울특별시,서초구,45-49세,40125,19366,20759
202102,11650,서울특별시,서초구,45-49세,40033,19300,20733
202103,11650,서울특별시,서초구,45-49세,39750,19108,20642
202104,11650,서울특별시,서초구,45-49세,39551,19009,20542
202105,11650,서울특별시,서초구,45-49세,39315,18876,20439
202106,11650,서울특별시,서초구,45-49세,39166,18786,20380
202007,11650,서울특별시,서초구,50-54세,34330,17123,17207
202008,11650,서울특별시,서초구,50-54세,34421,17167,17254
202009,11650,서울특별시,서초구,50-54세,34439,17176,17263
202010,11650,서울특별시,서초구,50-54세,34537,17224,17313
202011,11650,서울특별시,서초구,50-54세,34760,17347,17413
202012,11650,서울특별시,서초구,50-54세,34723,17358,17365
202101,11650,서울특별시,서초구,50-54세,34979,17439,17540
202102,11650,서울특별시,서초구,50-54세,35124,17503,17621
202103,11650,서울특별시,서초구,50-54세,35035,17464,17571
202104,11650,서울특별시,서초구,50-54세,35097,17483,17614
202105,11650,서울특별시,서초구,50-54세,35272,17578,17694
202106,11650,서울특별시,서초구,50-54세,35379,17668,17711
202007,11650,서울특별시,서초구,55-59세,28799,13845,14954
202008,11650,서울특별시,서초구,55-59세,28648,13805,14843
202009,11650,서울특별시,서초구,55-59세,28546,13756,14790
202010,11650,서울특별시,서초구,55-59세,28466,13738,14728
202011,11650,서울특별시,서초구,55-59세,28406,13734,14672
202012,11650,서울특별시,서초구,55-59세,28474,13742,14732
202101,11650,서울특별시,서초구,55-59세,28386,13721,14665
202102,11650,서울특별시,서초구,55-59세,28266,13672,14594
202103,11650,서울특별시,서초구,55-59세,28169,13675,14494
202104,11650,서울특별시,서초구,55-59세,27993,13617,14376
202105,11650,서울특별시,서초구,55-59세,27811,13529,14282
202106,11650,서울특별시,서초구,55-59세,27590,13404,14186
202007,11650,서울특별시,서초구,60-64세,26953,12569,14384
202008,11650,서울특별시,서초구,60-64세,26933,12535,14398
202009,11650,서울특별시,서초구,60-64세,26917,12520,14397
202010,11650,서울특별시,서초구,60-64세,26874,12504,14370
202011,11650,서울특별시,서초구,60-64세,26923,12505,14418
202012,11650,서울특별시,서초구,60-64세,27007,12551,14456
202101,11650,서울특별시,서초구,60-64세,27009,12587,14422
202102,11650,서울특별시,서초구,60-64세,26951,12550,14401
202103,11650,서울특별시,서초구,60-64세,26754,12465,14289
202104,11650,서울특별시,서초구,60-64세,26797,12480,14317
202105,11650,서울특별시,서초구,60-64세,26847,12536,14311
202106,11650,서울특별시,서초구,60-64세,26946,12574,14372
202007,11650,서울특별시,서초구,65-69세,20313,9231,11082
202008,11650,서울특별시,서초구,65-69세,20406,9279,11127
202009,11650,서울특별시,서초구,65-69세,20445,9319,11126
202010,11650,서울특별시,서초구,65-69세,20609,9411,11198
202011,11650,서울특별시,서초구,65-69세,20748,9474,11274
202012,11650,서울특별시,서초구,65-69세,20790,9490,11300
202101,11650,서울특별시,서초구,65-69세,20839,9501,11338
202102,11650,서울특별시,서초구,65-69세,20966,9554,11412
202103,11650,서울특별시,서초구,65-69세,20999,9607,11392
202104,11650,서울특별시,서초구,65-69세,21077,9640,11437
202105,11650,서울특별시,서초구,65-69세,21163,9671,11492
202106,11650,서울특별시,서초구,65-69세,21227,9704,11523
202007,11650,서울특별시,서초구,70-74세,16222,7438,8784
202008,11650,서울특별시,서초구,70-74세,16239,7435,8804
202009,11650,서울특별시,서초구,70-74세,16235,7422,8813
202010,11650,서울특별시,서초구,70-74세,16240,7399,8841
202011,11650,서울특별시,서초구,70-74세,16294,7450,8844
202012,11650,서울특별시,서초구,70-74세,16331,7458,8873
202101,11650,서울특별시,서초구,70-74세,16440,7522,8918
202102,11650,서울특별시,서초구,70-74세,16465,7539,8926
202103,11650,서울특별시,서초구,70-74세,16300,7506,8794
202104,11650,서울특별시,서초구,70-74세,16244,7466,8778
202105,11650,서울특별시,서초구,70-74세,16153,7420,8733
202106,11650,서울특별시,서초구,70-74세,16058,7381,8677
202007,11650,서울특별시,서초구,75-79세,11061,5384,5677
202008,11650,서울특별시,서초구,75-79세,11070,5397,5673
202009,11650,서울특별시,서초구,75-79세,11040,5377,5663
202010,11650,서울특별시,서초구,75-79세,11052,5372,5680
202011,11650,서울특별시,서초구,75-79세,11064,5368,5696
202012,11650,서울특별시,서초구,75-79세,11103,5392,5711
202101,11650,서울특별시,서초구,75-79세,11146,5386,5760
202102,11650,서울특별시,서초구,75-79세,11140,5374,5766
202103,11650,서울특별시,서초구,75-79세,11050,5332,5718
202104,11650,서울특별시,서초구,75-79세,11064,5332,5732
202105,11650,서울특별시,서초구,75-79세,11073,5316,5757
202106,11650,서울특별시,서초구,75-79세,11143,5330,5813
202007,11650,서울특별시,서초구,80-84세,6360,2935,3425
202008,11650,서울특별시,서초구,80-84세,6409,2951,3458
202009,11650,서울특별시,서초구,80-84세,6433,2978,3455
202010,11650,서울특별시,서초구,80-84세,6445,2995,3450
202011,11650,서울특별시,서초구,80-84세,6450,3000,3450
202012,11650,서울특별시,서초구,80-84세,6461,3007,3454
202101,11650,서울특별시,서초구,80-84세,6498,3036,3462
202102,11650,서울특별시,서초구,80-84세,6551,3075,3476
202103,11650,서울특별시,서초구,80-84세,6536,3062,3474
202104,11650,서울특별시,서초구,80-84세,6569,3088,3481
202105,11650,서울특별시,서초구,80-84세,6589,3104,3485
202106,11650,서울특별시,서초구,80-84세,6650,3130,3520
202007,11650,서울특별시,서초구,85-89세,3191,1168,2023
202008,11650,서울특별시,서초구,85-89세,3193,1175,2018
202009,11650,서울특별시,서초구,85-89세,3216,1182,2034
202010,11650,서울특별시,서초구,85-89세,3240,1194,2046
202011,11650,서울특별시,서초구,85-89세,3276,1216,2060
202012,11650,서울특별시,서초구,85-89세,3326,1234,2092
202101,11650,서울특별시,서초구,85-89세,3355,1243,2112
202102,11650,서울특별시,서초구,85-89세,3365,1249,2116
202103,11650,서울특별시,서초구,85-89세,3324,1250,2074
202104,11650,서울특별시,서초구,85-89세,3344,1266,2078
202105,11650,서울특별시,서초구,85-89세,3333,1270,2063
202106,11650,서울특별시,서초구,85-89세,3341,1278,2063
202007,11650,서울특별시,서초구,90-94세,1372,371,1001
202008,11650,서울특별시,서초구,90-94세,1372,375,997
202009,11650,서울특별시,서초구,90-94세,1383,379,1004
202010,11650,서울특별시,서초구,90-94세,1385,387,998
202011,11650,서울특별시,서초구,90-94세,1395,393,1002
202012,11650,서울특별시,서초구,90-94세,1409,405,1004
202101,11650,서울특별시,서초구,90-94세,1409,400,1009
202102,11650,서울특별시,서초구,90-94세,1406,401,1005
202103,11650,서울특별시,서초구,90-94세,1386,384,1002
202104,11650,서울특별시,서초구,90-94세,1396,385,1011
202105,11650,서울특별시,서초구,90-94세,1395,382,1013
202106,11650,서울특별시,서초구,90-94세,1396,380,1016
202007,11650,서울특별시,서초구,95-99세,421,106,315
202008,11650,서울특별시,서초구,95-99세,422,108,314
202009,11650,서울특별시,서초구,95-99세,419,107,312
202010,11650,서울특별시,서초구,95-99세,420,109,311
202011,11650,서울특별시,서초구,95-99세,418,108,310
202012,11650,서울특별시,서초구,95-99세,420,107,313
202101,11650,서울특별시,서초구,95-99세,424,111,313
202102,11650,서울특별시,서초구,95-99세,425,111,314
202103,11650,서울특별시,서초구,95-99세,365,94,271
202104,11650,서울특별시,서초구,95-99세,368,94,274
202105,11650,서울특별시,서초구,95-99세,363,93,270
202106,11650,서울특별시,서초구,95-99세,365,95,270
202007,11650,서울특별시,서초구,100+,221,58,163
202008,11650,서울특별시,서초구,100+,222,59,163
202009,11650,서울특별시,서초구,100+,223,59,164
202010,11650,서울특별시,서초구,100+,228,61,167
202011,11650,서울특별시,서초구,100+,230,62,168
202012,11650,서울특별시,서초구,100+,232,62,170
202101,11650,서울특별시,서초구,100+,236,62,174
202102,11650,서울특별시,서초구,100+,239,62,177
202103,11650,서울특별시,서초구,100+,139,38,101
202104,11650,서울특별시,서초구,100+,143,39,104
202105,11650,서울특별시,서초구,100+,118,30,88
202106,11650,서울특별시,서초구,100+,112,30,82
202007,11680,서울특별시,강남구,0-4세,14205,7318,6887
202008,11680,서울특별시,강남구,0-4세,14048,7245,6803
202009,11680,서울특별시,강남구,0-4세,13841,7131,6710
202010,11680,서울특별시,강남구,0-4세,13786,7117,6669
202011,11680,서울특별시,강남구,0-4세,13698,7094,6604
202012,11680,서울특별시,강남구,0-4세,13621,7056,6565
202101,11680,서울특별시,강남구,0-4세,13476,6967,6509
202102,11680,서울특별시,강남구,0-4세,13397,6905,6492
202103,11680,서울특별시,강남구,0-4세,13254,6840,6414
202104,11680,서울특별시,강남구,0-4세,13145,6770,6375
202105,11680,서울특별시,강남구,0-4세,12983,6672,6311
202106,11680,서울특별시,강남구,0-4세,12865,6633,6232
202007,11680,서울특별시,강남구,5-9세,23375,12216,11159
202008,11680,서울특별시,강남구,5-9세,23336,12196,11140
202009,11680,서울특별시,강남구,5-9세,23268,12148,11120
202010,11680,서울특별시,강남구,5-9세,23256,12094,11162
202011,11680,서울특별시,강남구,5-9세,23187,12010,11177
202012,11680,서울특별시,강남구,5-9세,23145,11995,11150
202101,11680,서울특별시,강남구,5-9세,22974,11886,11088
202102,11680,서울특별시,강남구,5-9세,23021,11907,11114
202103,11680,서울특별시,강남구,5-9세,22927,11836,11091
202104,11680,서울특별시,강남구,5-9세,22776,11773,11003
202105,11680,서울특별시,강남구,5-9세,22630,11683,10947
202106,11680,서울특별시,강남구,5-9세,22519,11610,10909
202007,11680,서울특별시,강남구,10-14세,28579,14844,13735
202008,11680,서울특별시,강남구,10-14세,28695,14922,13773
202009,11680,서울특별시,강남구,10-14세,28755,14977,13778
202010,11680,서울특별시,강남구,10-14세,28945,15073,13872
202011,11680,서울특별시,강남구,10-14세,29030,15121,13909
202012,11680,서울특별시,강남구,10-14세,29138,15172,13966
202101,11680,서울특별시,강남구,10-14세,29350,15279,14071
202102,11680,서울특별시,강남구,10-14세,29441,15306,14135
202103,11680,서울특별시,강남구,10-14세,29355,15256,14099
202104,11680,서울특별시,강남구,10-14세,29339,15234,14105
202105,11680,서울특별시,강남구,10-14세,29285,15230,14055
202106,11680,서울특별시,강남구,10-14세,29320,15241,14079
202007,11680,서울특별시,강남구,15-19세,30716,16039,14677
202008,11680,서울특별시,강남구,15-19세,30673,15999,14674
202009,11680,서울특별시,강남구,15-19세,30601,15938,14663
202010,11680,서울특별시,강남구,15-19세,30482,15931,14551
202011,11680,서울특별시,강남구,15-19세,30326,15878,14448
202012,11680,서울특별시,강남구,15-19세,29996,15687,14309
202101,11680,서울특별시,강남구,15-19세,29720,15548,14172
202102,11680,서울특별시,강남구,15-19세,29406,15392,14014
202103,11680,서울특별시,강남구,15-19세,29133,15238,13895
202104,11680,서울특별시,강남구,15-19세,28908,15106,13802
202105,11680,서울특별시,강남구,15-19세,28868,15041,13827
202106,11680,서울특별시,강남구,15-19세,28863,15042,13821
202007,11680,서울특별시,강남구,20-24세,33592,16361,17231
202008,11680,서울특별시,강남구,20-24세,33634,16420,17214
202009,11680,서울특별시,강남구,20-24세,33588,16404,17184
202010,11680,서울특별시,강남구,20-24세,33548,16387,17161
202011,11680,서울특별시,강남구,20-24세,33459,16332,17127
202012,11680,서울특별시,강남구,20-24세,33282,16261,17021
202101,11680,서울특별시,강남구,20-24세,33052,16116,16936
202102,11680,서울특별시,강남구,20-24세,32810,15982,16828
202103,11680,서울특별시,강남구,20-24세,32568,15818,16750
202104,11680,서울특별시,강남구,20-24세,32477,15737,16740
202105,11680,서울특별시,강남구,20-24세,32332,15667,16665
202106,11680,서울특별시,강남구,20-24세,32230,15639,16591
202007,11680,서울특별시,강남구,25-29세,41296,19462,21834
202008,11680,서울특별시,강남구,25-29세,41049,19327,21722
202009,11680,서울특별시,강남구,25-29세,40823,19222,21601
202010,11680,서울특별시,강남구,25-29세,40786,19184,21602
202011,11680,서울특별시,강남구,25-29세,40680,19148,21532
202012,11680,서울특별시,강남구,25-29세,40658,19108,21550
202101,11680,서울특별시,강남구,25-29세,40482,19061,21421
202102,11680,서울특별시,강남구,25-29세,40135,18902,21233
202103,11680,서울특별시,강남구,25-29세,39908,18836,21072
202104,11680,서울특별시,강남구,25-29세,39744,18746,20998
202105,11680,서울특별시,강남구,25-29세,39600,18641,20959
202106,11680,서울특별시,강남구,25-29세,39436,18561,20875
202007,11680,서울특별시,강남구,30-34세,39887,18457,21430
202008,11680,서울특별시,강남구,30-34세,39724,18402,21322
202009,11680,서울특별시,강남구,30-34세,39629,18372,21257
202010,11680,서울특별시,강남구,30-34세,39577,18389,21188
202011,11680,서울특별시,강남구,30-34세,39465,18350,21115
202012,11680,서울특별시,강남구,30-34세,39296,18316,20980
202101,11680,서울특별시,강남구,30-34세,39121,18237,20884
202102,11680,서울특별시,강남구,30-34세,38909,18094,20815
202103,11680,서울특별시,강남구,30-34세,38765,18030,20735
202104,11680,서울특별시,강남구,30-34세,38653,18065,20588
202105,11680,서울특별시,강남구,30-34세,38491,18005,20486
202106,11680,서울특별시,강남구,30-34세,38385,17968,20417
202007,11680,서울특별시,강남구,35-39세,43592,19782,23810
202008,11680,서울특별시,강남구,35-39세,43346,19635,23711
202009,11680,서울특별시,강남구,35-39세,42977,19487,23490
202010,11680,서울특별시,강남구,35-39세,42887,19452,23435
202011,11680,서울특별시,강남구,35-39세,42672,19329,23343
202012,11680,서울특별시,강남구,35-39세,42542,19185,23357
202101,11680,서울특별시,강남구,35-39세,42264,19062,23202
202102,11680,서울특별시,강남구,35-39세,42132,19010,23122
202103,11680,서울특별시,강남구,35-39세,41738,18835,22903
202104,11680,서울특별시,강남구,35-39세,41367,18633,22734
202105,11680,서울특별시,강남구,35-39세,41033,18509,22524
202106,11680,서울특별시,강남구,35-39세,40678,18311,22367
202007,11680,서울특별시,강남구,40-44세,46738,21132,25606
202008,11680,서울특별시,강남구,40-44세,46805,21158,25647
202009,11680,서울특별시,강남구,40-44세,46832,21140,25692
202010,11680,서울특별시,강남구,40-44세,47053,21253,25800
202011,11680,서울특별시,강남구,40-44세,47057,21267,25790
202012,11680,서울특별시,강남구,40-44세,47098,21289,25809
202101,11680,서울특별시,강남구,40-44세,47173,21308,25865
202102,11680,서울특별시,강남구,40-44세,47400,21419,25981
202103,11680,서울특별시,강남구,40-44세,47154,21314,25840
202104,11680,서울특별시,강남구,40-44세,47063,21257,25806
202105,11680,서울특별시,강남구,40-44세,47052,21252,25800
202106,11680,서울특별시,강남구,40-44세,47162,21300,25862
202007,11680,서울특별시,강남구,45-49세,52731,25126,27605
202008,11680,서울특별시,강남구,45-49세,52646,25086,27560
202009,11680,서울특별시,강남구,45-49세,52454,25025,27429
202010,11680,서울특별시,강남구,45-49세,52317,24957,27360
202011,11680,서울특별시,강남구,45-49세,52258,24898,27360
202012,11680,서울특별시,강남구,45-49세,52168,24856,27312
202101,11680,서울특별시,강남구,45-49세,52007,24763,27244
202102,11680,서울특별시,강남구,45-49세,51765,24635,27130
202103,11680,서울특별시,강남구,45-49세,51319,24389,26930
202104,11680,서울특별시,강남구,45-49세,51114,24282,26832
202105,11680,서울특별시,강남구,45-49세,50752,24056,26696
202106,11680,서울특별시,강남구,45-49세,50552,23949,26603
202007,11680,서울특별시,강남구,50-54세,44250,22268,21982
202008,11680,서울특별시,강남구,50-54세,44324,22329,21995
202009,11680,서울특별시,강남구,50-54세,44370,22346,22024
202010,11680,서울특별시,강남구,50-54세,44674,22520,22154
202011,11680,서울특별시,강남구,50-54세,44793,22607,22186
202012,11680,서울특별시,강남구,50-54세,44682,22612,22070
202101,11680,서울특별시,강남구,50-54세,45037,22753,22284
202102,11680,서울특별시,강남구,50-54세,45187,22825,22362
202103,11680,서울특별시,강남구,50-54세,45119,22784,22335
202104,11680,서울특별시,강남구,50-54세,45296,22868,22428
202105,11680,서울특별시,강남구,50-54세,45497,22966,22531
202106,11680,서울특별시,강남구,50-54세,45610,23004,22606
202007,11680,서울특별시,강남구,55-59세,35731,17656,18075
202008,11680,서울특별시,강남구,55-59세,35551,17565,17986
202009,11680,서울특별시,강남구,55-59세,35534,17556,17978
202010,11680,서울특별시,강남구,55-59세,35660,17599,18061
202011,11680,서울특별시,강남구,55-59세,35565,17568,17997
202012,11680,서울특별시,강남구,55-59세,35668,17577,18091
202101,11680,서울특별시,강남구,55-59세,35475,17567,17908
202102,11680,서울특별시,강남구,55-59세,35424,17545,17879
202103,11680,서울특별시,강남구,55-59세,35163,17475,17688
202104,11680,서울특별시,강남구,55-59세,35019,17393,17626
202105,11680,서울특별시,강남구,55-59세,34862,17344,17518
202106,11680,서울특별시,강남구,55-59세,34677,17280,17397
202007,11680,서울특별시,강남구,60-64세,32689,15124,17565
202008,11680,서울특별시,강남구,60-64세,32792,15183,17609
202009,11680,서울특별시,강남구,60-64세,32760,15180,17580
202010,11680,서울특별시,강남구,60-64세,32871,15230,17641
202011,11680,서울특별시,강남구,60-64세,32974,15280,17694
202012,11680,서울특별시,강남구,60-64세,32978,15296,17682
202101,11680,서울특별시,강남구,60-64세,32989,15300,17689
202102,11680,서울특별시,강남구,60-64세,33032,15297,17735
202103,11680,서울특별시,강남구,60-64세,32953,15278,17675
202104,11680,서울특별시,강남구,60-64세,32997,15315,17682
202105,11680,서울특별시,강남구,60-64세,32958,15301,17657
202106,11680,서울특별시,강남구,60-64세,33050,15352,17698
202007,11680,서울특별시,강남구,65-69세,25675,11589,14086
202008,11680,서울특별시,강남구,65-69세,25787,11625,14162
202009,11680,서울특별시,강남구,65-69세,25959,11653,14306
202010,11680,서울특별시,강남구,65-69세,26140,11751,14389
202011,11680,서울특별시,강남구,65-69세,26324,11839,14485
202012,11680,서울특별시,강남구,65-69세,26445,11896,14549
202101,11680,서울특별시,강남구,65-69세,26632,11983,14649
202102,11680,서울특별시,강남구,65-69세,26783,12060,14723
202103,11680,서울특별시,강남구,65-69세,26857,12110,14747
202104,11680,서울특별시,강남구,65-69세,27081,12196,14885
202105,11680,서울특별시,강남구,65-69세,27252,12279,14973
202106,11680,서울특별시,강남구,65-69세,27335,12313,15022
202007,11680,서울특별시,강남구,70-74세,20178,9335,10843
202008,11680,서울특별시,강남구,70-74세,20228,9348,10880
202009,11680,서울특별시,강남구,70-74세,20223,9354,10869
202010,11680,서울특별시,강남구,70-74세,20402,9420,10982
202011,11680,서울특별시,강남구,70-74세,20498,9458,11040
202012,11680,서울특별시,강남구,70-74세,20595,9498,11097
202101,11680,서울특별시,강남구,70-74세,20718,9528,11190
202102,11680,서울특별시,강남구,70-74세,20842,9582,11260
202103,11680,서울특별시,강남구,70-74세,20713,9560,11153
202104,11680,서울특별시,강남구,70-74세,20628,9531,11097
202105,11680,서울특별시,강남구,70-74세,20599,9493,11106
202106,11680,서울특별시,강남구,70-74세,20534,9477,11057
202007,11680,서울특별시,강남구,75-79세,13487,6574,6913
202008,11680,서울특별시,강남구,75-79세,13510,6583,6927
202009,11680,서울특별시,강남구,75-79세,13558,6603,6955
202010,11680,서울특별시,강남구,75-79세,13581,6628,6953
202011,11680,서울특별시,강남구,75-79세,13599,6642,6957
202012,11680,서울특별시,강남구,75-79세,13572,6625,6947
202101,11680,서울특별시,강남구,75-79세,13591,6650,6941
202102,11680,서울특별시,강남구,75-79세,13623,6660,6963
202103,11680,서울특별시,강남구,75-79세,13559,6635,6924
202104,11680,서울특별시,강남구,75-79세,13602,6671,6931
202105,11680,서울특별시,강남구,75-79세,13676,6730,6946
202106,11680,서울특별시,강남구,75-79세,13720,6755,6965
202007,11680,서울특별시,강남구,80-84세,7593,3473,4120
202008,11680,서울특별시,강남구,80-84세,7667,3509,4158
202009,11680,서울특별시,강남구,80-84세,7695,3525,4170
202010,11680,서울특별시,강남구,80-84세,7733,3546,4187
202011,11680,서울특별시,강남구,80-84세,7784,3553,4231
202012,11680,서울특별시,강남구,80-84세,7836,3582,4254
202101,11680,서울특별시,강남구,80-84세,7927,3638,4289
202102,11680,서울특별시,강남구,80-84세,7978,3674,4304
202103,11680,서울특별시,강남구,80-84세,7934,3660,4274
202104,11680,서울특별시,강남구,80-84세,7960,3666,4294
202105,11680,서울특별시,강남구,80-84세,7988,3663,4325
202106,11680,서울특별시,강남구,80-84세,8041,3688,4353
202007,11680,서울특별시,강남구,85-89세,3829,1291,2538
202008,11680,서울특별시,강남구,85-89세,3834,1300,2534
202009,11680,서울특별시,강남구,85-89세,3858,1322,2536
202010,11680,서울특별시,강남구,85-89세,3910,1356,2554
202011,11680,서울특별시,강남구,85-89세,3940,1386,2554
202012,11680,서울특별시,강남구,85-89세,3977,1412,2565
202101,11680,서울특별시,강남구,85-89세,3983,1414,2569
202102,11680,서울특별시,강남구,85-89세,4013,1444,2569
202103,11680,서울특별시,강남구,85-89세,4025,1446,2579
202104,11680,서울특별시,강남구,85-89세,4035,1454,2581
202105,11680,서울특별시,강남구,85-89세,4075,1480,2595
202106,11680,서울특별시,강남구,85-89세,4065,1478,2587
202007,11680,서울특별시,강남구,90-94세,1707,406,1301
202008,11680,서울특별시,강남구,90-94세,1700,405,1295
202009,11680,서울특별시,강남구,90-94세,1705,404,1301
202010,11680,서울특별시,강남구,90-94세,1714,404,1310
202011,11680,서울특별시,강남구,90-94세,1726,406,1320
202012,11680,서울특별시,강남구,90-94세,1731,410,1321
202101,11680,서울특별시,강남구,90-94세,1755,422,1333
202102,11680,서울특별시,강남구,90-94세,1767,425,1342
202103,11680,서울특별시,강남구,90-94세,1718,416,1302
202104,11680,서울특별시,강남구,90-94세,1737,421,1316
202105,11680,서울특별시,강남구,90-94세,1741,423,1318
202106,11680,서울특별시,강남구,90-94세,1724,414,1310
202007,11680,서울특별시,강남구,95-99세,499,115,384
202008,11680,서울특별시,강남구,95-99세,509,114,395
202009,11680,서울특별시,강남구,95-99세,516,118,398
202010,11680,서울특별시,강남구,95-99세,517,114,403
202011,11680,서울특별시,강남구,95-99세,513,112,401
202012,11680,서울특별시,강남구,95-99세,507,109,398
202101,11680,서울특별시,강남구,95-99세,509,106,403
202102,11680,서울특별시,강남구,95-99세,507,105,402
202103,11680,서울특별시,강남구,95-99세,478,96,382
202104,11680,서울특별시,강남구,95-99세,484,96,388
202105,11680,서울특별시,강남구,95-99세,477,94,383
202106,11680,서울특별시,강남구,95-99세,477,95,382
202007,11680,서울특별시,강남구,100+,287,56,231
202008,11680,서울특별시,강남구,100+,290,56,234
202009,11680,서울특별시,강남구,100+,289,56,233
202010,11680,서울특별시,강남구,100+,288,56,232
202011,11680,서울특별시,강남구,100+,290,55,235
202012,11680,서울특별시,강남구,100+,296,57,239
202101,11680,서울특별시,강남구,100+,301,59,242
202102,11680,서울특별시,강남구,100+,307,62,245
202103,11680,서울특별시,강남구,100+,156,28,128
202104,11680,서울특별시,강남구,100+,154,29,125
202105,11680,서울특별시,강남구,100+,145,29,116
202106,11680,서울특별시,강남구,100+,132,29,103
202007,11710,서울특별시,송파구,0-4세,23001,11971,11030
202008,11710,서울특별시,송파구,0-4세,22810,11861,10949
202009,11710,서울특별시,송파구,0-4세,22634,11793,10841
202010,11710,서울특별시,송파구,0-4세,22391,11659,10732
202011,11710,서울특별시,송파구,0-4세,22159,11550,10609
202012,11710,서울특별시,송파구,0-4세,21984,11427,10557
202101,11710,서울특별시,송파구,0-4세,21688,11254,10434
202102,11710,서울특별시,송파구,0-4세,21400,11094,10306
202103,11710,서울특별시,송파구,0-4세,21075,10926,10149
202104,11710,서울특별시,송파구,0-4세,20799,10749,10050
202105,11710,서울특별시,송파구,0-4세,20546,10629,9917
202106,11710,서울특별시,송파구,0-4세,20315,10532,9783
202007,11710,서울특별시,송파구,5-9세,28957,14901,14056
202008,11710,서울특별시,송파구,5-9세,28956,14891,14065
202009,11710,서울특별시,송파구,5-9세,28851,14835,14016
202010,11710,서울특별시,송파구,5-9세,28733,14796,13937
202011,11710,서울특별시,송파구,5-9세,28771,14770,14001
202012,11710,서울특별시,송파구,5-9세,28760,14775,13985
202101,11710,서울특별시,송파구,5-9세,28685,14730,13955
202102,11710,서울특별시,송파구,5-9세,28552,14650,13902
202103,11710,서울특별시,송파구,5-9세,28428,14591,13837
202104,11710,서울특별시,송파구,5-9세,28309,14550,13759
202105,11710,서울특별시,송파구,5-9세,28286,14523,13763
202106,11710,서울특별시,송파구,5-9세,28218,14459,13759
202007,11710,서울특별시,송파구,10-14세,28765,14647,14118
202008,11710,서울특별시,송파구,10-14세,28775,14649,14126
202009,11710,서울특별시,송파구,10-14세,28823,14687,14136
202010,11710,서울특별시,송파구,10-14세,28884,14698,14186
202011,11710,서울특별시,송파구,10-14세,29012,14793,14219
202012,11710,서울특별시,송파구,10-14세,29061,14809,14252
202101,11710,서울특별시,송파구,10-14세,29114,14866,14248
202102,11710,서울특별시,송파구,10-14세,29067,14816,14251
202103,11710,서울특별시,송파구,10-14세,29017,14775,14242
202104,11710,서울특별시,송파구,10-14세,29025,14774,14251
202105,11710,서울특별시,송파구,10-14세,29008,14789,14219
202106,11710,서울특별시,송파구,10-14세,29008,14787,14221
202007,11710,서울특별시,송파구,15-19세,31151,15981,15170
202008,11710,서울특별시,송파구,15-19세,30928,15870,15058
202009,11710,서울특별시,송파구,15-19세,30684,15771,14913
202010,11710,서울특별시,송파구,15-19세,30409,15634,14775
202011,11710,서울특별시,송파구,15-19세,30181,15517,14664
202012,11710,서울특별시,송파구,15-19세,30007,15436,14571
202101,11710,서울특별시,송파구,15-19세,29757,15310,14447
202102,11710,서울특별시,송파구,15-19세,29551,15225,14326
202103,11710,서울특별시,송파구,15-19세,29332,15090,14242
202104,11710,서울특별시,송파구,15-19세,29145,14982,14163
202105,11710,서울특별시,송파구,15-19세,29029,14909,14120
202106,11710,서울특별시,송파구,15-19세,28863,14800,14063
202007,11710,서울특별시,송파구,20-24세,41027,19966,21061
202008,11710,서울특별시,송파구,20-24세,40942,19918,21024
202009,11710,서울특별시,송파구,20-24세,40734,19793,20941
202010,11710,서울특별시,송파구,20-24세,40507,19712,20795
202011,11710,서울특별시,송파구,20-24세,40361,19628,20733
202012,11710,서울특별시,송파구,20-24세,40237,19503,20734
202101,11710,서울특별시,송파구,20-24세,40123,19429,20694
202102,11710,서울특별시,송파구,20-24세,39851,19258,20593
202103,11710,서울특별시,송파구,20-24세,39576,19137,20439
202104,11710,서울특별시,송파구,20-24세,39505,19085,20420
202105,11710,서울특별시,송파구,20-24세,39348,19028,20320
202106,11710,서울특별시,송파구,20-24세,39284,18997,20287
202007,11710,서울특별시,송파구,25-29세,53933,25266,28667
202008,11710,서울특별시,송파구,25-29세,53942,25288,28654
202009,11710,서울특별시,송파구,25-29세,53941,25314,28627
202010,11710,서울특별시,송파구,25-29세,53851,25292,28559
202011,11710,서울특별시,송파구,25-29세,53775,25259,28516
202012,11710,서울특별시,송파구,25-29세,53882,25281,28601
202101,11710,서울특별시,송파구,25-29세,53782,25251,28531
202102,11710,서울특별시,송파구,25-29세,53405,25099,28306
202103,11710,서울특별시,송파구,25-29세,53350,25033,28317
202104,11710,서울특별시,송파구,25-29세,53170,24973,28197
202105,11710,서울특별시,송파구,25-29세,53038,24917,28121
202106,11710,서울특별시,송파구,25-29세,52931,24891,28040
202007,11710,서울특별시,송파구,30-34세,54546,26163,28383
202008,11710,서울특별시,송파구,30-34세,54454,26055,28399
202009,11710,서울특별시,송파구,30-34세,54242,25943,28299
202010,11710,서울특별시,송파구,30-34세,53881,25756,28125
202011,11710,서울특별시,송파구,30-34세,53790,25690,28100
202012,11710,서울특별시,송파구,30-34세,53580,25626,27954
202101,11710,서울특별시,송파구,30-34세,53327,25511,27816
202102,11710,서울특별시,송파구,30-34세,53039,25400,27639
202103,11710,서울특별시,송파구,30-34세,52652,25197,27455
202104,11710,서울특별시,송파구,30-34세,52590,25188,27402
202105,11710,서울특별시,송파구,30-34세,52631,25167,27464
202106,11710,서울특별시,송파구,30-34세,52571,25091,27480
202007,11710,서울특별시,송파구,35-39세,58167,28016,30151
202008,11710,서울특별시,송파구,35-39세,57930,27950,29980
202009,11710,서울특별시,송파구,35-39세,57669,27795,29874
202010,11710,서울특별시,송파구,35-39세,57421,27631,29790
202011,11710,서울특별시,송파구,35-39세,57198,27554,29644
202012,11710,서울특별시,송파구,35-39세,57010,27432,29578
202101,11710,서울특별시,송파구,35-39세,56717,27305,29412
202102,11710,서울특별시,송파구,35-39세,56259,27017,29242
202103,11710,서울특별시,송파구,35-39세,55777,26766,29011
202104,11710,서울특별시,송파구,35-39세,55407,26530,28877
202105,11710,서울특별시,송파구,35-39세,55114,26374,28740
202106,11710,서울특별시,송파구,35-39세,54827,26218,28609
202007,11710,서울특별시,송파구,40-44세,53658,25788,27870
202008,11710,서울특별시,송파구,40-44세,53739,25837,27902
202009,11710,서울특별시,송파구,40-44세,53881,25887,27994
202010,11710,서울특별시,송파구,40-44세,53975,25945,28030
202011,11710,서울특별시,송파구,40-44세,54173,26024,28149
202012,11710,서울특별시,송파구,40-44세,54173,26081,28092
202101,11710,서울특별시,송파구,40-44세,54319,26110,28209
202102,11710,서울특별시,송파구,40-44세,54394,26152,28242
202103,11710,서울특별시,송파구,40-44세,54033,26021,28012
202104,11710,서울특별시,송파구,40-44세,54025,25974,28051
202105,11710,서울특별시,송파구,40-44세,54111,25989,28122
202106,11710,서울특별시,송파구,40-44세,54287,26076,28211
202007,11710,서울특별시,송파구,45-49세,56287,27232,29055
202008,11710,서울특별시,송파구,45-49세,56153,27138,29015
202009,11710,서울특별시,송파구,45-49세,55813,26969,28844
202010,11710,서울특별시,송파구,45-49세,55463,26811,28652
202011,11710,서울특별시,송파구,45-49세,55288,26678,28610
202012,11710,서울특별시,송파구,45-49세,55126,26558,28568
202101,11710,서울특별시,송파구,45-49세,54905,26499,28406
202102,11710,서울특별시,송파구,45-49세,54678,26395,28283
202103,11710,서울특별시,송파구,45-49세,54149,26156,27993
202104,11710,서울특별시,송파구,45-49세,53958,26101,27857
202105,11710,서울특별시,송파구,45-49세,53560,25918,27642
202106,11710,서울특별시,송파구,45-49세,53247,25819,27428
202007,11710,서울특별시,송파구,50-54세,52867,25799,27068
202008,11710,서울특별시,송파구,50-54세,52899,25832,27067
202009,11710,서울특별시,송파구,50-54세,52915,25842,27073
202010,11710,서울특별시,송파구,50-54세,52969,25838,27131
202011,11710,서울특별시,송파구,50-54세,52995,25849,27146
202012,11710,서울특별시,송파구,50-54세,52816,25818,26998
202101,11710,서울특별시,송파구,50-54세,53033,25905,27128
202102,11710,서울특별시,송파구,50-54세,53095,25910,27185
202103,11710,서울특별시,송파구,50-54세,52760,25682,27078
202104,11710,서울특별시,송파구,50-54세,52726,25646,27080
202105,11710,서울특별시,송파구,50-54세,53002,25782,27220
202106,11710,서울특별시,송파구,50-54세,53126,25771,27355
202007,11710,서울특별시,송파구,55-59세,50538,24212,26326
202008,11710,서울특별시,송파구,55-59세,50391,24181,26210
202009,11710,서울특별시,송파구,55-59세,50250,24122,26128
202010,11710,서울특별시,송파구,55-59세,50014,24042,25972
202011,11710,서울특별시,송파구,55-59세,49821,24010,25811
202012,11710,서울특별시,송파구,55-59세,49750,23970,25780
202101,11710,서울특별시,송파구,55-59세,49472,23842,25630
202102,11710,서울특별시,송파구,55-59세,49294,23777,25517
202103,11710,서울특별시,송파구,55-59세,48970,23647,25323
202104,11710,서울특별시,송파구,55-59세,48726,23565,25161
202105,11710,서울특별시,송파구,55-59세,48446,23437,25009
202106,11710,서울특별시,송파구,55-59세,48053,23289,24764
202007,11710,서울특별시,송파구,60-64세,47705,22370,25335
202008,11710,서울특별시,송파구,60-64세,47864,22431,25433
202009,11710,서울특별시,송파구,60-64세,47927,22437,25490
202010,11710,서울특별시,송파구,60-64세,48033,22477,25556
202011,11710,서울특별시,송파구,60-64세,48159,22504,25655
202012,11710,서울특별시,송파구,60-64세,48265,22547,25718
202101,11710,서울특별시,송파구,60-64세,48389,22622,25767
202102,11710,서울특별시,송파구,60-64세,48404,22614,25790
202103,11710,서울특별시,송파구,60-64세,48335,22589,25746
202104,11710,서울특별시,송파구,60-64세,48531,22690,25841
202105,11710,서울특별시,송파구,60-64세,48752,22798,25954
202106,11710,서울특별시,송파구,60-64세,48962,22889,26073
202007,11710,서울특별시,송파구,65-69세,34732,16611,18121
202008,11710,서울특별시,송파구,65-69세,35065,16747,18318
202009,11710,서울특별시,송파구,65-69세,35314,16872,18442
202010,11710,서울특별시,송파구,65-69세,35505,16955,18550
202011,11710,서울특별시,송파구,65-69세,35683,17028,18655
202012,11710,서울특별시,송파구,65-69세,35919,17142,18777
202101,11710,서울특별시,송파구,65-69세,36144,17222,18922
202102,11710,서울특별시,송파구,65-69세,36408,17333,19075
202103,11710,서울특별시,송파구,65-69세,36589,17417,19172
202104,11710,서울특별시,송파구,65-69세,36779,17512,19267
202105,11710,서울특별시,송파구,65-69세,37009,17618,19391
202106,11710,서울특별시,송파구,65-69세,37216,17700,19516
202007,11710,서울특별시,송파구,70-74세,24064,11813,12251
202008,11710,서울특별시,송파구,70-74세,24118,11841,12277
202009,11710,서울특별시,송파구,70-74세,24254,11914,12340
202010,11710,서울특별시,송파구,70-74세,24411,11998,12413
202011,11710,서울특별시,송파구,70-74세,24567,12069,12498
202012,11710,서울특별시,송파구,70-74세,24716,12107,12609
202101,11710,서울특별시,송파구,70-74세,24958,12202,12756
202102,11710,서울특별시,송파구,70-74세,25111,12276,12835
202103,11710,서울특별시,송파구,70-74세,24909,12228,12681
202104,11710,서울특별시,송파구,70-74세,24923,12219,12704
202105,11710,서울특별시,송파구,70-74세,24903,12193,12710
202106,11710,서울특별시,송파구,70-74세,24941,12206,12735
202007,11710,서울특별시,송파구,75-79세,15678,7594,8084
202008,11710,서울특별시,송파구,75-79세,15741,7623,8118
202009,11710,서울특별시,송파구,75-79세,15709,7601,8108
202010,11710,서울특별시,송파구,75-79세,15693,7581,8112
202011,11710,서울특별시,송파구,75-79세,15714,7599,8115
202012,11710,서울특별시,송파구,75-79세,15724,7617,8107
202101,11710,서울특별시,송파구,75-79세,15749,7662,8087
202102,11710,서울특별시,송파구,75-79세,15782,7673,8109
202103,11710,서울특별시,송파구,75-79세,15660,7621,8039
202104,11710,서울특별시,송파구,75-79세,15657,7615,8042
202105,11710,서울특별시,송파구,75-79세,15694,7637,8057
202106,11710,서울특별시,송파구,75-79세,15765,7659,8106
202007,11710,서울특별시,송파구,80-84세,9017,3822,5195
202008,11710,서울특별시,송파구,80-84세,9060,3843,5217
202009,11710,서울특별시,송파구,80-84세,9092,3875,5217
202010,11710,서울특별시,송파구,80-84세,9127,3895,5232
202011,11710,서울특별시,송파구,80-84세,9138,3897,5241
202012,11710,서울특별시,송파구,80-84세,9165,3913,5252
202101,11710,서울특별시,송파구,80-84세,9229,3942,5287
202102,11710,서울특별시,송파구,80-84세,9307,3999,5308
202103,11710,서울특별시,송파구,80-84세,9212,3958,5254
202104,11710,서울특별시,송파구,80-84세,9286,4004,5282
202105,11710,서울특별시,송파구,80-84세,9336,4044,5292
202106,11710,서울특별시,송파구,80-84세,9444,4111,5333
202007,11710,서울특별시,송파구,85-89세,4772,1521,3251
202008,11710,서울특별시,송파구,85-89세,4794,1534,3260
202009,11710,서울특별시,송파구,85-89세,4832,1549,3283
202010,11710,서울특별시,송파구,85-89세,4866,1566,3300
202011,11710,서울특별시,송파구,85-89세,4909,1587,3322
202012,11710,서울특별시,송파구,85-89세,4967,1588,3379
202101,11710,서울특별시,송파구,85-89세,4984,1597,3387
202102,11710,서울특별시,송파구,85-89세,5025,1623,3402
202103,11710,서울특별시,송파구,85-89세,5011,1605,3406
202104,11710,서울특별시,송파구,85-89세,5008,1604,3404
202105,11710,서울특별시,송파구,85-89세,5043,1617,3426
202106,11710,서울특별시,송파구,85-89세,5022,1620,3402
202007,11710,서울특별시,송파구,90-94세,1917,453,1464
202008,11710,서울특별시,송파구,90-94세,1943,465,1478
202009,11710,서울특별시,송파구,90-94세,1952,470,1482
202010,11710,서울특별시,송파구,90-94세,1968,478,1490
202011,11710,서울특별시,송파구,90-94세,1981,478,1503
202012,11710,서울특별시,송파구,90-94세,1984,488,1496
202101,11710,서울특별시,송파구,90-94세,2009,507,1502
202102,11710,서울특별시,송파구,90-94세,2011,504,1507
202103,11710,서울특별시,송파구,90-94세,1974,490,1484
202104,11710,서울특별시,송파구,90-94세,1987,497,1490
202105,11710,서울특별시,송파구,90-94세,1989,496,1493
202106,11710,서울특별시,송파구,90-94세,1987,498,1489
202007,11710,서울특별시,송파구,95-99세,524,109,415
202008,11710,서울특별시,송파구,95-99세,521,107,414
202009,11710,서울특별시,송파구,95-99세,524,104,420
202010,11710,서울특별시,송파구,95-99세,528,106,422
202011,11710,서울특별시,송파구,95-99세,530,105,425
202012,11710,서울특별시,송파구,95-99세,535,103,432
202101,11710,서울특별시,송파구,95-99세,538,101,437
202102,11710,서울특별시,송파구,95-99세,545,104,441
202103,11710,서울특별시,송파구,95-99세,485,91,394
202104,11710,서울특별시,송파구,95-99세,490,90,400
202105,11710,서울특별시,송파구,95-99세,489,91,398
202106,11710,서울특별시,송파구,95-99세,491,93,398
202007,11710,서울특별시,송파구,100+,283,72,211
202008,11710,서울특별시,송파구,100+,287,73,214
202009,11710,서울특별시,송파구,100+,290,73,217
202010,11710,서울특별시,송파구,100+,291,72,219
202011,11710,서울특별시,송파구,100+,293,74,219
202012,11710,서울특별시,송파구,100+,299,78,221
202101,11710,서울특별시,송파구,100+,300,81,219
202102,11710,서울특별시,송파구,100+,285,72,213
202103,11710,서울특별시,송파구,100+,117,27,90
202104,11710,서울특별시,송파구,100+,114,26,88
202105,11710,서울특별시,송파구,100+,112,25,87
202106,11710,서울특별시,송파구,100+,112,25,87
202007,11740,서울특별시,강동구,0-4세,15384,7875,7509
202008,11740,서울특별시,강동구,0-4세,15276,7831,7445
202009,11740,서울특별시,강동구,0-4세,15372,7851,7521
202010,11740,서울특별시,강동구,0-4세,15343,7861,7482
202011,11740,서울특별시,강동구,0-4세,15270,7800,7470
202012,11740,서울특별시,강동구,0-4세,15301,7798,7503
202101,11740,서울특별시,강동구,0-4세,15254,7812,7442
202102,11740,서울특별시,강동구,0-4세,15433,7920,7513
202103,11740,서울특별시,강동구,0-4세,15609,8022,7587
202104,11740,서울특별시,강동구,0-4세,15582,8026,7556
202105,11740,서울특별시,강동구,0-4세,15565,8028,7537
202106,11740,서울특별시,강동구,0-4세,15429,7966,7463
202007,11740,서울특별시,강동구,5-9세,19411,10142,9269
202008,11740,서울특별시,강동구,5-9세,19391,10130,9261
202009,11740,서울특별시,강동구,5-9세,19426,10148,9278
202010,11740,서울특별시,강동구,5-9세,19414,10140,9274
202011,11740,서울특별시,강동구,5-9세,19357,10110,9247
202012,11740,서울특별시,강동구,5-9세,19449,10179,9270
202101,11740,서울특별시,강동구,5-9세,19533,10223,9310
202102,11740,서울특별시,강동구,5-9세,19803,10373,9430
202103,11740,서울특별시,강동구,5-9세,19908,10410,9498
202104,11740,서울특별시,강동구,5-9세,19986,10413,9573
202105,11740,서울특별시,강동구,5-9세,19939,10383,9556
202106,11740,서울특별시,강동구,5-9세,19959,10377,9582
202007,11740,서울특별시,강동구,10-14세,19026,10064,8962
202008,11740,서울특별시,강동구,10-14세,19107,10096,9011
202009,11740,서울특별시,강동구,10-14세,19130,10129,9001
202010,11740,서울특별시,강동구,10-14세,19213,10163,9050
202011,11740,서울특별시,강동구,10-14세,19297,10202,9095
202012,11740,서울특별시,강동구,10-14세,19321,10193,9128
202101,11740,서울특별시,강동구,10-14세,19466,10262,9204
202102,11740,서울특별시,강동구,10-14세,19678,10417,9261
202103,11740,서울특별시,강동구,10-14세,19758,10453,9305
202104,11740,서울특별시,강동구,10-14세,19728,10458,9270
202105,11740,서울특별시,강동구,10-14세,19757,10461,9296
202106,11740,서울특별시,강동구,10-14세,19803,10508,9295
202007,11740,서울특별시,강동구,15-19세,20322,10622,9700
202008,11740,서울특별시,강동구,15-19세,20147,10538,9609
202009,11740,서울특별시,강동구,15-19세,20048,10478,9570
202010,11740,서울특별시,강동구,15-19세,19890,10411,9479
202011,11740,서울특별시,강동구,15-19세,19720,10325,9395
202012,11740,서울특별시,강동구,15-19세,19640,10293,9347
202101,11740,서울특별시,강동구,15-19세,19534,10273,9261
202102,11740,서울특별시,강동구,15-19세,19552,10240,9312
202103,11740,서울특별시,강동구,15-19세,19495,10208,9287
202104,11740,서울특별시,강동구,15-19세,19394,10160,9234
202105,11740,서울특별시,강동구,15-19세,19351,10149,9202
202106,11740,서울특별시,강동구,15-19세,19295,10125,9170
202007,11740,서울특별시,강동구,20-24세,26927,13572,13355
202008,11740,서울특별시,강동구,20-24세,26866,13548,13318
202009,11740,서울특별시,강동구,20-24세,26728,13480,13248
202010,11740,서울특별시,강동구,20-24세,26658,13436,13222
202011,11740,서울특별시,강동구,20-24세,26651,13420,13231
202012,11740,서울특별시,강동구,20-24세,26636,13386,13250
202101,11740,서울특별시,강동구,20-24세,26596,13371,13225
202102,11740,서울특별시,강동구,20-24세,26615,13373,13242
202103,11740,서울특별시,강동구,20-24세,26633,13370,13263
202104,11740,서울특별시,강동구,20-24세,26619,13349,13270
202105,11740,서울특별시,강동구,20-24세,26548,13297,13251
202106,11740,서울특별시,강동구,20-24세,26469,13240,13229
202007,11740,서울특별시,강동구,25-29세,34452,16809,17643
202008,11740,서울특별시,강동구,25-29세,34495,16802,17693
202009,11740,서울특별시,강동구,25-29세,34597,16817,17780
202010,11740,서울특별시,강동구,25-29세,34636,16839,17797
202011,11740,서울특별시,강동구,25-29세,34671,16854,17817
202012,11740,서울특별시,강동구,25-29세,34821,16936,17885
202101,11740,서울특별시,강동구,25-29세,34784,16875,17909
202102,11740,서울특별시,강동구,25-29세,34921,16891,18030
202103,11740,서울특별시,강동구,25-29세,35136,16974,18162
202104,11740,서울특별시,강동구,25-29세,35157,16966,18191
202105,11740,서울특별시,강동구,25-29세,35037,16937,18100
202106,11740,서울특별시,강동구,25-29세,34918,16864,18054
202007,11740,서울특별시,강동구,30-34세,33413,16728,16685
202008,11740,서울특별시,강동구,30-34세,33404,16695,16709
202009,11740,서울특별시,강동구,30-34세,33643,16795,16848
202010,11740,서울특별시,강동구,30-34세,33727,16839,16888
202011,11740,서울특별시,강동구,30-34세,33744,16827,16917
202012,11740,서울특별시,강동구,30-34세,33875,16882,16993
202101,11740,서울특별시,강동구,30-34세,34063,16981,17082
202102,11740,서울특별시,강동구,30-34세,34159,16995,17164
202103,11740,서울특별시,강동구,30-34세,34423,17099,17324
202104,11740,서울특별시,강동구,30-34세,34561,17158,17403
202105,11740,서울특별시,강동구,30-34세,34610,17154,17456
202106,11740,서울특별시,강동구,30-34세,34609,17137,17472
202007,11740,서울특별시,강동구,35-39세,38277,19048,19229
202008,11740,서울특별시,강동구,35-39세,38155,19003,19152
202009,11740,서울특별시,강동구,35-39세,38168,18999,19169
202010,11740,서울특별시,강동구,35-39세,38110,18985,19125
202011,11740,서울특별시,강동구,35-39세,38035,18973,19062
202012,11740,서울특별시,강동구,35-39세,38211,19058,19153
202101,11740,서울특별시,강동구,35-39세,38227,19038,19189
202102,11740,서울특별시,강동구,35-39세,38451,19154,19297
202103,11740,서울특별시,강동구,35-39세,38478,19191,19287
202104,11740,서울특별시,강동구,35-39세,38394,19131,19263
202105,11740,서울특별시,강동구,35-39세,38183,19036,19147
202106,11740,서울특별시,강동구,35-39세,37987,18926,19061
202007,11740,서울특별시,강동구,40-44세,36161,18151,18010
202008,11740,서울특별시,강동구,40-44세,36279,18187,18092
202009,11740,서울특별시,강동구,40-44세,36496,18321,18175
202010,11740,서울특별시,강동구,40-44세,36756,18435,18321
202011,11740,서울특별시,강동구,40-44세,36877,18451,18426
202012,11740,서울특별시,강동구,40-44세,36959,18489,18470
202101,11740,서울특별시,강동구,40-44세,37246,18625,18621
202102,11740,서울특별시,강동구,40-44세,37793,18860,18933
202103,11740,서울특별시,강동구,40-44세,37899,18938,18961
202104,11740,서울특별시,강동구,40-44세,37960,18993,18967
202105,11740,서울특별시,강동구,40-44세,38147,19062,19085
202106,11740,서울특별시,강동구,40-44세,38362,19193,19169
202007,11740,서울특별시,강동구,45-49세,37406,18772,18634
202008,11740,서울특별시,강동구,45-49세,37308,18742,18566
202009,11740,서울특별시,강동구,45-49세,37228,18680,18548
202010,11740,서울특별시,강동구,45-49세,37109,18629,18480
202011,11740,서울특별시,강동구,45-49세,36987,18568,18419
202012,11740,서울특별시,강동구,45-49세,37085,18658,18427
202101,11740,서울특별시,강동구,45-49세,37077,18640,18437
202102,11740,서울특별시,강동구,45-49세,37187,18721,18466
202103,11740,서울특별시,강동구,45-49세,37050,18645,18405
202104,11740,서울특별시,강동구,45-49세,37051,18619,18432
202105,11740,서울특별시,강동구,45-49세,36888,18563,18325
202106,11740,서울특별시,강동구,45-49세,36741,18482,18259
202007,11740,서울특별시,강동구,50-54세,36106,17803,18303
202008,11740,서울특별시,강동구,50-54세,36113,17795,18318
202009,11740,서울특별시,강동구,50-54세,36166,17815,18351
202010,11740,서울특별시,강동구,50-54세,36221,17854,18367
202011,11740,서울특별시,강동구,50-54세,36257,17869,18388
202012,11740,서울특별시,강동구,50-54세,36237,17819,18418
202101,11740,서울특별시,강동구,50-54세,36486,17955,18531
202102,11740,서울특별시,강동구,50-54세,36716,18064,18652
202103,11740,서울특별시,강동구,50-54세,36665,18037,18628
202104,11740,서울특별시,강동구,50-54세,36636,18050,18586
202105,11740,서울특별시,강동구,50-54세,36824,18111,18713
202106,11740,서울특별시,강동구,50-54세,36921,18195,18726
202007,11740,서울특별시,강동구,55-59세,36626,17610,19016
202008,11740,서울특별시,강동구,55-59세,36480,17518,18962
202009,11740,서울특별시,강동구,55-59세,36320,17477,18843
202010,11740,서울특별시,강동구,55-59세,36177,17417,18760
202011,11740,서울특별시,강동구,55-59세,36042,17387,18655
202012,11740,서울특별시,강동구,55-59세,35990,17364,18626
202101,11740,서울특별시,강동구,55-59세,35747,17277,18470
202102,11740,서울특별시,강동구,55-59세,35772,17315,18457
202103,11740,서울특별시,강동구,55-59세,35652,17285,18367
202104,11740,서울특별시,강동구,55-59세,35529,17240,18289
202105,11740,서울특별시,강동구,55-59세,35306,17159,18147
202106,11740,서울특별시,강동구,55-59세,34968,16991,17977
202007,11740,서울특별시,강동구,60-64세,35842,16955,18887
202008,11740,서울특별시,강동구,60-64세,35961,17024,18937
202009,11740,서울특별시,강동구,60-64세,36061,17058,19003
202010,11740,서울특별시,강동구,60-64세,36190,17135,19055
202011,11740,서울특별시,강동구,60-64세,36313,17180,19133
202012,11740,서울특별시,강동구,60-64세,36542,17285,19257
202101,11740,서울특별시,강동구,60-64세,36803,17391,19412
202102,11740,서울특별시,강동구,60-64세,37032,17491,19541
202103,11740,서울특별시,강동구,60-64세,37130,17506,19624
202104,11740,서울특별시,강동구,60-64세,37240,17530,19710
202105,11740,서울특별시,강동구,60-64세,37381,17649,19732
202106,11740,서울특별시,강동구,60-64세,37609,17749,19860
202007,11740,서울특별시,강동구,65-69세,25675,12295,13380
202008,11740,서울특별시,강동구,65-69세,25859,12353,13506
202009,11740,서울특별시,강동구,65-69세,26049,12425,13624
202010,11740,서울특별시,강동구,65-69세,26264,12535,13729
202011,11740,서울특별시,강동구,65-69세,26434,12610,13824
202012,11740,서울특별시,강동구,65-69세,26702,12704,13998
202101,11740,서울특별시,강동구,65-69세,26974,12813,14161
202102,11740,서울특별시,강동구,65-69세,27259,12938,14321
202103,11740,서울특별시,강동구,65-69세,27555,13065,14490
202104,11740,서울특별시,강동구,65-69세,27820,13164,14656
202105,11740,서울특별시,강동구,65-69세,28006,13222,14784
202106,11740,서울특별시,강동구,65-69세,28120,13242,14878
202007,11740,서울특별시,강동구,70-74세,18130,8797,9333
202008,11740,서울특별시,강동구,70-74세,18190,8841,9349
202009,11740,서울특별시,강동구,70-74세,18240,8878,9362
202010,11740,서울특별시,강동구,70-74세,18357,8898,9459
202011,11740,서울특별시,강동구,70-74세,18464,8947,9517
202012,11740,서울특별시,강동구,70-74세,18615,9034,9581
202101,11740,서울특별시,강동구,70-74세,18782,9128,9654
202102,11740,서울특별시,강동구,70-74세,18903,9173,9730
202103,11740,서울특별시,강동구,70-74세,18861,9152,9709
202104,11740,서울특별시,강동구,70-74세,18895,9167,9728
202105,11740,서울특별시,강동구,70-74세,18989,9171,9818
202106,11740,서울특별시,강동구,70-74세,18980,9169,9811
202007,11740,서울특별시,강동구,75-79세,11934,5741,6193
202008,11740,서울특별시,강동구,75-79세,11972,5772,6200
202009,11740,서울특별시,강동구,75-79세,12014,5779,6235
202010,11740,서울특별시,강동구,75-79세,12034,5810,6224
202011,11740,서울특별시,강동구,75-79세,12026,5783,6243
202012,11740,서울특별시,강동구,75-79세,12017,5764,6253
202101,11740,서울특별시,강동구,75-79세,12064,5795,6269
202102,11740,서울특별시,강동구,75-79세,12101,5826,6275
202103,11740,서울특별시,강동구,75-79세,12051,5804,6247
202104,11740,서울특별시,강동구,75-79세,12116,5841,6275
202105,11740,서울특별시,강동구,75-79세,12172,5887,6285
202106,11740,서울특별시,강동구,75-79세,12209,5917,6292
202007,11740,서울특별시,강동구,80-84세,6787,2758,4029
202008,11740,서울특별시,강동구,80-84세,6837,2780,4057
202009,11740,서울특별시,강동구,80-84세,6848,2806,4042
202010,11740,서울특별시,강동구,80-84세,6831,2804,4027
202011,11740,서울특별시,강동구,80-84세,6860,2825,4035
202012,11740,서울특별시,강동구,80-84세,6920,2847,4073
202101,11740,서울특별시,강동구,80-84세,6994,2889,4105
202102,11740,서울특별시,강동구,80-84세,7091,2938,4153
202103,11740,서울특별시,강동구,80-84세,7074,2950,4124
202104,11740,서울특별시,강동구,80-84세,7088,2976,4112
202105,11740,서울특별시,강동구,80-84세,7120,3008,4112
202106,11740,서울특별시,강동구,80-84세,7186,3037,4149
202007,11740,서울특별시,강동구,85-89세,3377,986,2391
202008,11740,서울특별시,강동구,85-89세,3400,998,2402
202009,11740,서울특별시,강동구,85-89세,3419,1000,2419
202010,11740,서울특별시,강동구,85-89세,3444,1014,2430
202011,11740,서울특별시,강동구,85-89세,3475,1042,2433
202012,11740,서울특별시,강동구,85-89세,3530,1072,2458
202101,11740,서울특별시,강동구,85-89세,3577,1094,2483
202102,11740,서울특별시,강동구,85-89세,3585,1103,2482
202103,11740,서울특별시,강동구,85-89세,3576,1096,2480
202104,11740,서울특별시,강동구,85-89세,3621,1122,2499
202105,11740,서울특별시,강동구,85-89세,3683,1137,2546
202106,11740,서울특별시,강동구,85-89세,3681,1134,2547
202007,11740,서울특별시,강동구,90-94세,1466,301,1165
202008,11740,서울특별시,강동구,90-94세,1466,308,1158
202009,11740,서울특별시,강동구,90-94세,1482,321,1161
202010,11740,서울특별시,강동구,90-94세,1497,319,1178
202011,11740,서울특별시,강동구,90-94세,1492,315,1177
202012,11740,서울특별시,강동구,90-94세,1485,311,1174
202101,11740,서울특별시,강동구,90-94세,1487,305,1182
202102,11740,서울특별시,강동구,90-94세,1508,312,1196
202103,11740,서울특별시,강동구,90-94세,1471,299,1172
202104,11740,서울특별시,강동구,90-94세,1471,303,1168
202105,11740,서울특별시,강동구,90-94세,1467,296,1171
202106,11740,서울특별시,강동구,90-94세,1481,295,1186
202007,11740,서울특별시,강동구,95-99세,371,78,293
202008,11740,서울특별시,강동구,95-99세,374,78,296
202009,11740,서울특별시,강동구,95-99세,372,75,297
202010,11740,서울특별시,강동구,95-99세,377,78,299
202011,11740,서울특별시,강동구,95-99세,384,81,303
202012,11740,서울특별시,강동구,95-99세,379,80,299
202101,11740,서울특별시,강동구,95-99세,383,81,302
202102,11740,서울특별시,강동구,95-99세,393,87,306
202103,11740,서울특별시,강동구,95-99세,360,76,284
202104,11740,서울특별시,강동구,95-99세,367,73,294
202105,11740,서울특별시,강동구,95-99세,369,73,296
202106,11740,서울특별시,강동구,95-99세,363,75,288
202007,11740,서울특별시,강동구,100+,246,63,183
202008,11740,서울특별시,강동구,100+,250,64,186
202009,11740,서울특별시,강동구,100+,251,64,187
202010,11740,서울특별시,강동구,100+,247,62,185
202011,11740,서울특별시,강동구,100+,248,62,186
202012,11740,서울특별시,강동구,100+,255,64,191
202101,11740,서울특별시,강동구,100+,257,65,192
202102,11740,서울특별시,강동구,100+,256,65,191
202103,11740,서울특별시,강동구,100+,116,29,87
202104,11740,서울특별시,강동구,100+,116,29,87
202105,11740,서울특별시,강동구,100+,117,29,88
202106,11740,서울특별시,강동구,100+,119,30,89
202007,26110,부산광역시,중구,0-4세,565,306,259
202008,26110,부산광역시,중구,0-4세,561,306,255
202009,26110,부산광역시,중구,0-4세,551,295,256
202010,26110,부산광역시,중구,0-4세,538,294,244
202011,26110,부산광역시,중구,0-4세,532,290,242
202012,26110,부산광역시,중구,0-4세,526,282,244
202101,26110,부산광역시,중구,0-4세,522,283,239
202102,26110,부산광역시,중구,0-4세,517,278,239
202103,26110,부산광역시,중구,0-4세,502,276,226
202104,26110,부산광역시,중구,0-4세,494,271,223
202105,26110,부산광역시,중구,0-4세,481,265,216
202106,26110,부산광역시,중구,0-4세,458,252,206
202007,26110,부산광역시,중구,5-9세,833,429,404
202008,26110,부산광역시,중구,5-9세,817,422,395
202009,26110,부산광역시,중구,5-9세,813,420,393
202010,26110,부산광역시,중구,5-9세,810,421,389
202011,26110,부산광역시,중구,5-9세,804,418,386
202012,26110,부산광역시,중구,5-9세,794,407,387
202101,26110,부산광역시,중구,5-9세,780,403,377
202102,26110,부산광역시,중구,5-9세,775,396,379
202103,26110,부산광역시,중구,5-9세,774,385,389
202104,26110,부산광역시,중구,5-9세,765,381,384
202105,26110,부산광역시,중구,5-9세,751,373,378
202106,26110,부산광역시,중구,5-9세,742,372,370
202007,26110,부산광역시,중구,10-14세,875,434,441
202008,26110,부산광역시,중구,10-14세,864,431,433
202009,26110,부산광역시,중구,10-14세,860,430,430
202010,26110,부산광역시,중구,10-14세,854,426,428
202011,26110,부산광역시,중구,10-14세,854,429,425
202012,26110,부산광역시,중구,10-14세,861,435,426
202101,26110,부산광역시,중구,10-14세,869,432,437
202102,26110,부산광역시,중구,10-14세,867,423,444
202103,26110,부산광역시,중구,10-14세,868,426,442
202104,26110,부산광역시,중구,10-14세,865,424,441
202105,26110,부산광역시,중구,10-14세,861,427,434
202106,26110,부산광역시,중구,10-14세,852,424,428
202007,26110,부산광역시,중구,15-19세,1239,634,605
202008,26110,부산광역시,중구,15-19세,1226,629,597
202009,26110,부산광역시,중구,15-19세,1216,621,595
202010,26110,부산광역시,중구,15-19세,1192,610,582
202011,26110,부산광역시,중구,15-19세,1181,600,581
202012,26110,부산광역시,중구,15-19세,1166,597,569
202101,26110,부산광역시,중구,15-19세,1160,589,571
202102,26110,부산광역시,중구,15-19세,1171,588,583
202103,26110,부산광역시,중구,15-19세,1149,575,574
202104,26110,부산광역시,중구,15-19세,1113,557,556
202105,26110,부산광역시,중구,15-19세,1108,553,555
202106,26110,부산광역시,중구,15-19세,1097,552,545
202007,26110,부산광역시,중구,20-24세,2490,1163,1327
202008,26110,부산광역시,중구,20-24세,2504,1156,1348
202009,26110,부산광역시,중구,20-24세,2509,1166,1343
202010,26110,부산광역시,중구,20-24세,2497,1167,1330
202011,26110,부산광역시,중구,20-24세,2474,1161,1313
202012,26110,부산광역시,중구,20-24세,2482,1158,1324
202101,26110,부산광역시,중구,20-24세,2488,1165,1323
202102,26110,부산광역시,중구,20-24세,2520,1182,1338
202103,26110,부산광역시,중구,20-24세,2522,1188,1334
202104,26110,부산광역시,중구,20-24세,2531,1197,1334
202105,26110,부산광역시,중구,20-24세,2501,1174,1327
202106,26110,부산광역시,중구,20-24세,2514,1177,1337
202007,26110,부산광역시,중구,25-29세,3106,1636,1470
202008,26110,부산광역시,중구,25-29세,3135,1647,1488
202009,26110,부산광역시,중구,25-29세,3125,1640,1485
202010,26110,부산광역시,중구,25-29세,3154,1638,1516
202011,26110,부산광역시,중구,25-29세,3155,1632,1523
202012,26110,부산광역시,중구,25-29세,3197,1648,1549
202101,26110,부산광역시,중구,25-29세,3197,1641,1556
202102,26110,부산광역시,중구,25-29세,3167,1620,1547
202103,26110,부산광역시,중구,25-29세,3181,1626,1555
202104,26110,부산광역시,중구,25-29세,3177,1612,1565
202105,26110,부산광역시,중구,25-29세,3193,1611,1582
202106,26110,부산광역시,중구,25-29세,3210,1618,1592
202007,26110,부산광역시,중구,30-34세,2211,1195,1016
202008,26110,부산광역시,중구,30-34세,2219,1206,1013
202009,26110,부산광역시,중구,30-34세,2205,1196,1009
202010,26110,부산광역시,중구,30-34세,2183,1190,993
202011,26110,부산광역시,중구,30-34세,2197,1198,999
202012,26110,부산광역시,중구,30-34세,2201,1201,1000
202101,26110,부산광역시,중구,30-34세,2214,1206,1008
202102,26110,부산광역시,중구,30-34세,2261,1241,1020
202103,26110,부산광역시,중구,30-34세,2240,1226,1014
202104,26110,부산광역시,중구,30-34세,2258,1235,1023
202105,26110,부산광역시,중구,30-34세,2268,1258,1010
202106,26110,부산광역시,중구,30-34세,2285,1260,1025
202007,26110,부산광역시,중구,35-39세,2305,1243,1062
202008,26110,부산광역시,중구,35-39세,2295,1240,1055
202009,26110,부산광역시,중구,35-39세,2275,1228,1047
202010,26110,부산광역시,중구,35-39세,2292,1241,1051
202011,26110,부산광역시,중구,35-39세,2278,1231,1047
202012,26110,부산광역시,중구,35-39세,2270,1223,1047
202101,26110,부산광역시,중구,35-39세,2270,1210,1060
202102,26110,부산광역시,중구,35-39세,2248,1202,1046
202103,26110,부산광역시,중구,35-39세,2243,1194,1049
202104,26110,부산광역시,중구,35-39세,2214,1174,1040
202105,26110,부산광역시,중구,35-39세,2190,1160,1030
202106,26110,부산광역시,중구,35-39세,2146,1153,993
202007,26110,부산광역시,중구,40-44세,2368,1290,1078
202008,26110,부산광역시,중구,40-44세,2347,1274,1073
202009,26110,부산광역시,중구,40-44세,2366,1284,1082
202010,26110,부산광역시,중구,40-44세,2355,1270,1085
202011,26110,부산광역시,중구,40-44세,2347,1270,1077
202012,26110,부산광역시,중구,40-44세,2327,1258,1069
202101,26110,부산광역시,중구,40-44세,2340,1276,1064
202102,26110,부산광역시,중구,40-44세,2324,1264,1060
202103,26110,부산광역시,중구,40-44세,2328,1263,1065
202104,26110,부산광역시,중구,40-44세,2322,1262,1060
202105,26110,부산광역시,중구,40-44세,2313,1258,1055
202106,26110,부산광역시,중구,40-44세,2295,1249,1046
202007,26110,부산광역시,중구,45-49세,3178,1718,1460
202008,26110,부산광역시,중구,45-49세,3145,1698,1447
202009,26110,부산광역시,중구,45-49세,3125,1688,1437
202010,26110,부산광역시,중구,45-49세,3117,1692,1425
202011,26110,부산광역시,중구,45-49세,3104,1693,1411
202012,26110,부산광역시,중구,45-49세,3067,1681,1386
202101,26110,부산광역시,중구,45-49세,3047,1675,1372
202102,26110,부산광역시,중구,45-49세,3052,1678,1374
202103,26110,부산광역시,중구,45-49세,3025,1670,1355
202104,26110,부산광역시,중구,45-49세,3025,1671,1354
202105,26110,부산광역시,중구,45-49세,2991,1655,1336
202106,26110,부산광역시,중구,45-49세,2928,1626,1302
202007,26110,부산광역시,중구,50-54세,3408,1754,1654
202008,26110,부산광역시,중구,50-54세,3443,1774,1669
202009,26110,부산광역시,중구,50-54세,3441,1792,1649
202010,26110,부산광역시,중구,50-54세,3436,1792,1644
202011,26110,부산광역시,중구,50-54세,3438,1784,1654
202012,26110,부산광역시,중구,50-54세,3441,1780,1661
202101,26110,부산광역시,중구,50-54세,3415,1759,1656
202102,26110,부산광역시,중구,50-54세,3397,1746,1651
202103,26110,부산광역시,중구,50-54세,3389,1749,1640
202104,26110,부산광역시,중구,50-54세,3404,1757,1647
202105,26110,부산광역시,중구,50-54세,3399,1750,1649
202106,26110,부산광역시,중구,50-54세,3378,1730,1648
202007,26110,부산광역시,중구,55-59세,3715,1816,1899
202008,26110,부산광역시,중구,55-59세,3680,1795,1885
202009,26110,부산광역시,중구,55-59세,3668,1798,1870
202010,26110,부산광역시,중구,55-59세,3648,1772,1876
202011,26110,부산광역시,중구,55-59세,3637,1778,1859
202012,26110,부산광역시,중구,55-59세,3633,1782,1851
202101,26110,부산광역시,중구,55-59세,3636,1776,1860
202102,26110,부산광역시,중구,55-59세,3609,1776,1833
202103,26110,부산광역시,중구,55-59세,3575,1754,1821
202104,26110,부산광역시,중구,55-59세,3543,1742,1801
202105,26110,부산광역시,중구,55-59세,3520,1732,1788
202106,26110,부산광역시,중구,55-59세,3447,1707,1740
202007,26110,부산광역시,중구,60-64세,4255,2018,2237
202008,26110,부산광역시,중구,60-64세,4262,2024,2238
202009,26110,부산광역시,중구,60-64세,4260,2019,2241
202010,26110,부산광역시,중구,60-64세,4259,2024,2235
202011,26110,부산광역시,중구,60-64세,4251,2019,2232
202012,26110,부산광역시,중구,60-64세,4243,2012,2231
202101,26110,부산광역시,중구,60-64세,4243,2014,2229
202102,26110,부산광역시,중구,60-64세,4250,2021,2229
202103,26110,부산광역시,중구,60-64세,4261,2024,2237
202104,26110,부산광역시,중구,60-64세,4257,2025,2232
202105,26110,부산광역시,중구,60-64세,4283,2032,2251
202106,26110,부산광역시,중구,60-64세,4230,2017,2213
202007,26110,부산광역시,중구,65-69세,3529,1654,1875
202008,26110,부산광역시,중구,65-69세,3545,1657,1888
202009,26110,부산광역시,중구,65-69세,3576,1673,1903
202010,26110,부산광역시,중구,65-69세,3590,1676,1914
202011,26110,부산광역시,중구,65-69세,3611,1682,1929
202012,26110,부산광역시,중구,65-69세,3648,1697,1951
202101,26110,부산광역시,중구,65-69세,3671,1703,1968
202102,26110,부산광역시,중구,65-69세,3685,1710,1975
202103,26110,부산광역시,중구,65-69세,3677,1709,1968
202104,26110,부산광역시,중구,65-69세,3689,1708,1981
202105,26110,부산광역시,중구,65-69세,3695,1718,1977
202106,26110,부산광역시,중구,65-69세,3617,1691,1926
202007,26110,부산광역시,중구,70-74세,2767,1216,1551
202008,26110,부산광역시,중구,70-74세,2772,1223,1549
202009,26110,부산광역시,중구,70-74세,2791,1224,1567
202010,26110,부산광역시,중구,70-74세,2809,1235,1574
202011,26110,부산광역시,중구,70-74세,2828,1238,1590
202012,26110,부산광역시,중구,70-74세,2846,1250,1596
202101,26110,부산광역시,중구,70-74세,2856,1250,1606
202102,26110,부산광역시,중구,70-74세,2868,1255,1613
202103,26110,부산광역시,중구,70-74세,2889,1257,1632
202104,26110,부산광역시,중구,70-74세,2898,1256,1642
202105,26110,부산광역시,중구,70-74세,2896,1248,1648
202106,26110,부산광역시,중구,70-74세,2805,1211,1594
202007,26110,부산광역시,중구,75-79세,2278,986,1292
202008,26110,부산광역시,중구,75-79세,2294,988,1306
202009,26110,부산광역시,중구,75-79세,2292,989,1303
202010,26110,부산광역시,중구,75-79세,2279,980,1299
202011,26110,부산광역시,중구,75-79세,2279,986,1293
202012,26110,부산광역시,중구,75-79세,2264,976,1288
202101,26110,부산광역시,중구,75-79세,2259,981,1278
202102,26110,부산광역시,중구,75-79세,2240,968,1272
202103,26110,부산광역시,중구,75-79세,2217,960,1257
202104,26110,부산광역시,중구,75-79세,2211,954,1257
202105,26110,부산광역시,중구,75-79세,2200,952,1248
202106,26110,부산광역시,중구,75-79세,2133,924,1209
202007,26110,부산광역시,중구,80-84세,1452,567,885
202008,26110,부산광역시,중구,80-84세,1449,564,885
202009,26110,부산광역시,중구,80-84세,1439,555,884
202010,26110,부산광역시,중구,80-84세,1443,558,885
202011,26110,부산광역시,중구,80-84세,1434,553,881
202012,26110,부산광역시,중구,80-84세,1449,555,894
202101,26110,부산광역시,중구,80-84세,1463,560,903
202102,26110,부산광역시,중구,80-84세,1472,565,907
202103,26110,부산광역시,중구,80-84세,1486,571,915
202104,26110,부산광역시,중구,80-84세,1497,582,915
202105,26110,부산광역시,중구,80-84세,1504,583,921
202106,26110,부산광역시,중구,80-84세,1447,554,893
202007,26110,부산광역시,중구,85-89세,616,203,413
202008,26110,부산광역시,중구,85-89세,617,202,415
202009,26110,부산광역시,중구,85-89세,628,207,421
202010,26110,부산광역시,중구,85-89세,636,212,424
202011,26110,부산광역시,중구,85-89세,635,206,429
202012,26110,부산광역시,중구,85-89세,648,213,435
202101,26110,부산광역시,중구,85-89세,654,219,435
202102,26110,부산광역시,중구,85-89세,662,220,442
202103,26110,부산광역시,중구,85-89세,660,215,445
202104,26110,부산광역시,중구,85-89세,667,214,453
202105,26110,부산광역시,중구,85-89세,666,213,453
202106,26110,부산광역시,중구,85-89세,637,202,435
202007,26110,부산광역시,중구,90-94세,283,71,212
202008,26110,부산광역시,중구,90-94세,293,74,219
202009,26110,부산광역시,중구,90-94세,290,72,218
202010,26110,부산광역시,중구,90-94세,291,74,217
202011,26110,부산광역시,중구,90-94세,297,78,219
202012,26110,부산광역시,중구,90-94세,292,79,213
202101,26110,부산광역시,중구,90-94세,294,78,216
202102,26110,부산광역시,중구,90-94세,294,80,214
202103,26110,부산광역시,중구,90-94세,288,74,214
202104,26110,부산광역시,중구,90-94세,280,73,207
202105,26110,부산광역시,중구,90-94세,285,76,209
202106,26110,부산광역시,중구,90-94세,260,64,196
202007,26110,부산광역시,중구,95-99세,79,29,50
202008,26110,부산광역시,중구,95-99세,78,29,49
202009,26110,부산광역시,중구,95-99세,79,29,50
202010,26110,부산광역시,중구,95-99세,79,28,51
202011,26110,부산광역시,중구,95-99세,80,28,52
202012,26110,부산광역시,중구,95-99세,83,28,55
202101,26110,부산광역시,중구,95-99세,84,29,55
202102,26110,부산광역시,중구,95-99세,84,29,55
202103,26110,부산광역시,중구,95-99세,76,23,53
202104,26110,부산광역시,중구,95-99세,81,23,58
202105,26110,부산광역시,중구,95-99세,83,23,60
202106,26110,부산광역시,중구,95-99세,62,12,50
202007,26110,부산광역시,중구,100+,81,18,63
202008,26110,부산광역시,중구,100+,84,19,65
202009,26110,부산광역시,중구,100+,84,19,65
202010,26110,부산광역시,중구,100+,85,20,65
202011,26110,부산광역시,중구,100+,85,20,65
202012,26110,부산광역시,중구,100+,85,20,65
202101,26110,부산광역시,중구,100+,87,20,67
202102,26110,부산광역시,중구,100+,88,20,68
202103,26110,부산광역시,중구,100+,20,4,16
202104,26110,부산광역시,중구,100+,20,4,16
202105,26110,부산광역시,중구,100+,21,4,17
202106,26110,부산광역시,중구,100+,18,4,14
202007,26140,부산광역시,서구,0-4세,2327,1200,1127
202008,26140,부산광역시,서구,0-4세,2301,1177,1124
202009,26140,부산광역시,서구,0-4세,2310,1188,1122
202010,26140,부산광역시,서구,0-4세,2330,1188,1142
202011,26140,부산광역시,서구,0-4세,2323,1181,1142
202012,26140,부산광역시,서구,0-4세,2315,1182,1133
202101,26140,부산광역시,서구,0-4세,2275,1157,1118
202102,26140,부산광역시,서구,0-4세,2252,1155,1097
202103,26140,부산광역시,서구,0-4세,2213,1132,1081
202104,26140,부산광역시,서구,0-4세,2210,1135,1075
202105,26140,부산광역시,서구,0-4세,2214,1135,1079
202106,26140,부산광역시,서구,0-4세,2198,1128,1070
202007,26140,부산광역시,서구,5-9세,3314,1728,1586
202008,26140,부산광역시,서구,5-9세,3316,1738,1578
202009,26140,부산광역시,서구,5-9세,3295,1731,1564
202010,26140,부산광역시,서구,5-9세,3311,1751,1560
202011,26140,부산광역시,서구,5-9세,3307,1741,1566
202012,26140,부산광역시,서구,5-9세,3307,1735,1572
202101,26140,부산광역시,서구,5-9세,3282,1740,1542
202102,26140,부산광역시,서구,5-9세,3312,1757,1555
202103,26140,부산광역시,서구,5-9세,3321,1766,1555
202104,26140,부산광역시,서구,5-9세,3337,1764,1573
202105,26140,부산광역시,서구,5-9세,3315,1763,1552
202106,26140,부산광역시,서구,5-9세,3304,1753,1551
202007,26140,부산광역시,서구,10-14세,3255,1640,1615
202008,26140,부산광역시,서구,10-14세,3261,1645,1616
202009,26140,부산광역시,서구,10-14세,3286,1659,1627
202010,26140,부산광역시,서구,10-14세,3326,1680,1646
202011,26140,부산광역시,서구,10-14세,3360,1709,1651
202012,26140,부산광역시,서구,10-14세,3386,1721,1665
202101,26140,부산광역시,서구,10-14세,3406,1723,1683
202102,26140,부산광역시,서구,10-14세,3388,1725,1663
202103,26140,부산광역시,서구,10-14세,3379,1719,1660
202104,26140,부산광역시,서구,10-14세,3392,1736,1656
202105,26140,부산광역시,서구,10-14세,3394,1728,1666
202106,26140,부산광역시,서구,10-14세,3402,1740,1662
202007,26140,부산광역시,서구,15-19세,4086,2052,2034
202008,26140,부산광역시,서구,15-19세,4043,2038,2005
202009,26140,부산광역시,서구,15-19세,3995,2013,1982
202010,26140,부산광역시,서구,15-19세,3978,2005,1973
202011,26140,부산광역시,서구,15-19세,3942,1981,1961
202012,26140,부산광역시,서구,15-19세,3901,1968,1933
202101,26140,부산광역시,서구,15-19세,3890,1982,1908
202102,26140,부산광역시,서구,15-19세,3861,1941,1920
202103,26140,부산광역시,서구,15-19세,3854,1925,1929
202104,26140,부산광역시,서구,15-19세,3842,1931,1911
202105,26140,부산광역시,서구,15-19세,3825,1922,1903
202106,26140,부산광역시,서구,15-19세,3800,1912,1888
202007,26140,부산광역시,서구,20-24세,6779,3291,3488
202008,26140,부산광역시,서구,20-24세,6734,3248,3486
202009,26140,부산광역시,서구,20-24세,6707,3230,3477
202010,26140,부산광역시,서구,20-24세,6678,3201,3477
202011,26140,부산광역시,서구,20-24세,6695,3219,3476
202012,26140,부산광역시,서구,20-24세,6648,3182,3466
202101,26140,부산광역시,서구,20-24세,6618,3176,3442
202102,26140,부산광역시,서구,20-24세,6630,3174,3456
202103,26140,부산광역시,서구,20-24세,6616,3169,3447
202104,26140,부산광역시,서구,20-24세,6603,3153,3450
202105,26140,부산광역시,서구,20-24세,6593,3150,3443
202106,26140,부산광역시,서구,20-24세,6549,3128,3421
202007,26140,부산광역시,서구,25-29세,6770,3419,3351
202008,26140,부산광역시,서구,25-29세,6778,3439,3339
202009,26140,부산광역시,서구,25-29세,6797,3443,3354
202010,26140,부산광역시,서구,25-29세,6837,3483,3354
202011,26140,부산광역시,서구,25-29세,6854,3483,3371
202012,26140,부산광역시,서구,25-29세,6893,3494,3399
202101,26140,부산광역시,서구,25-29세,6864,3472,3392
202102,26140,부산광역시,서구,25-29세,6806,3441,3365
202103,26140,부산광역시,서구,25-29세,6801,3418,3383
202104,26140,부산광역시,서구,25-29세,6814,3422,3392
202105,26140,부산광역시,서구,25-29세,6827,3410,3417
202106,26140,부산광역시,서구,25-29세,6814,3394,3420
202007,26140,부산광역시,서구,30-34세,5211,2745,2466
202008,26140,부산광역시,서구,30-34세,5148,2709,2439
202009,26140,부산광역시,서구,30-34세,5148,2712,2436
202010,26140,부산광역시,서구,30-34세,5189,2717,2472
202011,26140,부산광역시,서구,30-34세,5173,2702,2471
202012,26140,부산광역시,서구,30-34세,5193,2716,2477
202101,26140,부산광역시,서구,30-34세,5173,2700,2473
202102,26140,부산광역시,서구,30-34세,5148,2677,2471
202103,26140,부산광역시,서구,30-34세,5145,2683,2462
202104,26140,부산광역시,서구,30-34세,5197,2718,2479
202105,26140,부산광역시,서구,30-34세,5225,2714,2511
202106,26140,부산광역시,서구,30-34세,5225,2719,2506
202007,26140,부산광역시,서구,35-39세,6216,3164,3052
202008,26140,부산광역시,서구,35-39세,6173,3142,3031
202009,26140,부산광역시,서구,35-39세,6121,3116,3005
202010,26140,부산광역시,서구,35-39세,6106,3099,3007
202011,26140,부산광역시,서구,35-39세,6079,3075,3004
202012,26140,부산광역시,서구,35-39세,6013,3041,2972
202101,26140,부산광역시,서구,35-39세,5950,3030,2920
202102,26140,부산광역시,서구,35-39세,5901,3013,2888
202103,26140,부산광역시,서구,35-39세,5759,2947,2812
202104,26140,부산광역시,서구,35-39세,5730,2938,2792
202105,26140,부산광역시,서구,35-39세,5703,2921,2782
202106,26140,부산광역시,서구,35-39세,5680,2901,2779
202007,26140,부산광역시,서구,40-44세,6520,3379,3141
202008,26140,부산광역시,서구,40-44세,6554,3383,3171
202009,26140,부산광역시,서구,40-44세,6571,3395,3176
202010,26140,부산광역시,서구,40-44세,6684,3450,3234
202011,26140,부산광역시,서구,40-44세,6712,3468,3244
202012,26140,부산광역시,서구,40-44세,6720,3470,3250
202101,26140,부산광역시,서구,40-44세,6772,3482,3290
202102,26140,부산광역시,서구,40-44세,6789,3501,3288
202103,26140,부산광역시,서구,40-44세,6677,3456,3221
202104,26140,부산광역시,서구,40-44세,6704,3457,3247
202105,26140,부산광역시,서구,40-44세,6726,3476,3250
202106,26140,부산광역시,서구,40-44세,6771,3497,3274
202007,26140,부산광역시,서구,45-49세,8165,4226,3939
202008,26140,부산광역시,서구,45-49세,8124,4204,3920
202009,26140,부산광역시,서구,45-49세,8070,4179,3891
202010,26140,부산광역시,서구,45-49세,8033,4164,3869
202011,26140,부산광역시,서구,45-49세,8016,4172,3844
202012,26140,부산광역시,서구,45-49세,7987,4146,3841
202101,26140,부산광역시,서구,45-49세,7923,4115,3808
202102,26140,부산광역시,서구,45-49세,7878,4096,3782
202103,26140,부산광역시,서구,45-49세,7771,4035,3736
202104,26140,부산광역시,서구,45-49세,7742,4025,3717
202105,26140,부산광역시,서구,45-49세,7663,3974,3689
202106,26140,부산광역시,서구,45-49세,7623,3958,3665
202007,26140,부산광역시,서구,50-54세,8602,4516,4086
202008,26140,부산광역시,서구,50-54세,8604,4518,4086
202009,26140,부산광역시,서구,50-54세,8598,4498,4100
202010,26140,부산광역시,서구,50-54세,8623,4499,4124
202011,26140,부산광역시,서구,50-54세,8676,4520,4156
202012,26140,부산광역시,서구,50-54세,8673,4539,4134
202101,26140,부산광역시,서구,50-54세,8704,4544,4160
202102,26140,부산광역시,서구,50-54세,8692,4515,4177
202103,26140,부산광역시,서구,50-54세,8532,4448,4084
202104,26140,부산광역시,서구,50-54세,8530,4436,4094
202105,26140,부산광역시,서구,50-54세,8565,4454,4111
202106,26140,부산광역시,서구,50-54세,8561,4460,4101
202007,26140,부산광역시,서구,55-59세,9566,4766,4800
202008,26140,부산광역시,서구,55-59세,9469,4709,4760
202009,26140,부산광역시,서구,55-59세,9418,4692,4726
202010,26140,부산광역시,서구,55-59세,9395,4677,4718
202011,26140,부산광역시,서구,55-59세,9335,4664,4671
202012,26140,부산광역시,서구,55-59세,9329,4652,4677
202101,26140,부산광역시,서구,55-59세,9220,4616,4604
202102,26140,부산광역시,서구,55-59세,9146,4592,4554
202103,26140,부산광역시,서구,55-59세,8985,4511,4474
202104,26140,부산광역시,서구,55-59세,8958,4502,4456
202105,26140,부산광역시,서구,55-59세,8854,4458,4396
202106,26140,부산광역시,서구,55-59세,8768,4427,4341
202007,26140,부산광역시,서구,60-64세,10300,4862,5438
202008,26140,부산광역시,서구,60-64세,10342,4898,5444
202009,26140,부산광역시,서구,60-64세,10358,4912,5446
202010,26140,부산광역시,서구,60-64세,10397,4943,5454
202011,26140,부산광역시,서구,60-64세,10425,4942,5483
202012,26140,부산광역시,서구,60-64세,10424,4940,5484
202101,26140,부산광역시,서구,60-64세,10459,4960,5499
202102,26140,부산광역시,서구,60-64세,10485,4968,5517
202103,26140,부산광역시,서구,60-64세,10395,4911,5484
202104,26140,부산광역시,서구,60-64세,10429,4914,5515
202105,26140,부산광역시,서구,60-64세,10490,4942,5548
202106,26140,부산광역시,서구,60-64세,10530,4949,5581
202007,26140,부산광역시,서구,65-69세,8419,3870,4549
202008,26140,부산광역시,서구,65-69세,8487,3893,4594
202009,26140,부산광역시,서구,65-69세,8541,3913,4628
202010,26140,부산광역시,서구,65-69세,8585,3924,4661
202011,26140,부산광역시,서구,65-69세,8624,3945,4679
202012,26140,부산광역시,서구,65-69세,8690,3980,4710
202101,26140,부산광역시,서구,65-69세,8719,3986,4733
202102,26140,부산광역시,서구,65-69세,8761,4020,4741
202103,26140,부산광역시,서구,65-69세,8658,3994,4664
202104,26140,부산광역시,서구,65-69세,8669,4003,4666
202105,26140,부산광역시,서구,65-69세,8706,4035,4671
202106,26140,부산광역시,서구,65-69세,8716,4027,4689
202007,26140,부산광역시,서구,70-74세,6719,3027,3692
202008,26140,부산광역시,서구,70-74세,6723,3033,3690
202009,26140,부산광역시,서구,70-74세,6771,3057,3714
202010,26140,부산광역시,서구,70-74세,6824,3080,3744
202011,26140,부산광역시,서구,70-74세,6893,3114,3779
202012,26140,부산광역시,서구,70-74세,6945,3137,3808
202101,26140,부산광역시,서구,70-74세,7007,3166,3841
202102,26140,부산광역시,서구,70-74세,7030,3170,3860
202103,26140,부산광역시,서구,70-74세,6943,3161,3782
202104,26140,부산광역시,서구,70-74세,6954,3158,3796
202105,26140,부산광역시,서구,70-74세,6986,3158,3828
202106,26140,부산광역시,서구,70-74세,6980,3147,3833
202007,26140,부산광역시,서구,75-79세,5572,2323,3249
202008,26140,부산광역시,서구,75-79세,5572,2320,3252
202009,26140,부산광역시,서구,75-79세,5538,2305,3233
202010,26140,부산광역시,서구,75-79세,5505,2302,3203
202011,26140,부산광역시,서구,75-79세,5472,2278,3194
202012,26140,부산광역시,서구,75-79세,5424,2255,3169
202101,26140,부산광역시,서구,75-79세,5393,2241,3152
202102,26140,부산광역시,서구,75-79세,5384,2229,3155
202103,26140,부산광역시,서구,75-79세,5269,2169,3100
202104,26140,부산광역시,서구,75-79세,5247,2164,3083
202105,26140,부산광역시,서구,75-79세,5269,2182,3087
202106,26140,부산광역시,서구,75-79세,5255,2189,3066
202007,26140,부산광역시,서구,80-84세,3633,1383,2250
202008,26140,부산광역시,서구,80-84세,3647,1395,2252
202009,26140,부산광역시,서구,80-84세,3653,1408,2245
202010,26140,부산광역시,서구,80-84세,3678,1418,2260
202011,26140,부산광역시,서구,80-84세,3699,1433,2266
202012,26140,부산광역시,서구,80-84세,3722,1440,2282
202101,26140,부산광역시,서구,80-84세,3730,1443,2287
202102,26140,부산광역시,서구,80-84세,3755,1454,2301
202103,26140,부산광역시,서구,80-84세,3714,1447,2267
202104,26140,부산광역시,서구,80-84세,3751,1466,2285
202105,26140,부산광역시,서구,80-84세,3757,1463,2294
202106,26140,부산광역시,서구,80-84세,3782,1466,2316
202007,26140,부산광역시,서구,85-89세,1621,514,1107
202008,26140,부산광역시,서구,85-89세,1630,518,1112
202009,26140,부산광역시,서구,85-89세,1650,519,1131
202010,26140,부산광역시,서구,85-89세,1653,519,1134
202011,26140,부산광역시,서구,85-89세,1670,525,1145
202012,26140,부산광역시,서구,85-89세,1704,537,1167
202101,26140,부산광역시,서구,85-89세,1736,553,1183
202102,26140,부산광역시,서구,85-89세,1742,557,1185
202103,26140,부산광역시,서구,85-89세,1727,547,1180
202104,26140,부산광역시,서구,85-89세,1742,554,1188
202105,26140,부산광역시,서구,85-89세,1745,559,1186
202106,26140,부산광역시,서구,85-89세,1750,569,1181
202007,26140,부산광역시,서구,90-94세,580,125,455
202008,26140,부산광역시,서구,90-94세,577,124,453
202009,26140,부산광역시,서구,90-94세,576,125,451
202010,26140,부산광역시,서구,90-94세,577,122,455
202011,26140,부산광역시,서구,90-94세,576,122,454
202012,26140,부산광역시,서구,90-94세,578,122,456
202101,26140,부산광역시,서구,90-94세,575,123,452
202102,26140,부산광역시,서구,90-94세,582,126,456
202103,26140,부산광역시,서구,90-94세,539,110,429
202104,26140,부산광역시,서구,90-94세,541,110,431
202105,26140,부산광역시,서구,90-94세,545,111,434
202106,26140,부산광역시,서구,90-94세,558,109,449
202007,26140,부산광역시,서구,95-99세,158,49,109
202008,26140,부산광역시,서구,95-99세,163,51,112
202009,26140,부산광역시,서구,95-99세,164,51,113
202010,26140,부산광역시,서구,95-99세,164,50,114
202011,26140,부산광역시,서구,95-99세,165,49,116
202012,26140,부산광역시,서구,95-99세,160,49,111
202101,26140,부산광역시,서구,95-99세,159,51,108
202102,26140,부산광역시,서구,95-99세,158,47,111
202103,26140,부산광역시,서구,95-99세,124,29,95
202104,26140,부산광역시,서구,95-99세,125,29,96
202105,26140,부산광역시,서구,95-99세,127,30,97
202106,26140,부산광역시,서구,95-99세,128,31,97
202007,26140,부산광역시,서구,100+,121,34,87
202008,26140,부산광역시,서구,100+,122,34,88
202009,26140,부산광역시,서구,100+,122,33,89
202010,26140,부산광역시,서구,100+,123,34,89
202011,26140,부산광역시,서구,100+,123,35,88
202012,26140,부산광역시,서구,100+,123,35,88
202101,26140,부산광역시,서구,100+,123,35,88
202102,26140,부산광역시,서구,100+,124,36,88
202103,26140,부산광역시,서구,100+,29,6,23
202104,26140,부산광역시,서구,100+,28,6,22
202105,26140,부산광역시,서구,100+,27,6,21
202106,26140,부산광역시,서구,100+,28,6,22
202007,26170,부산광역시,동구,0-4세,1986,1072,914
202008,26170,부산광역시,동구,0-4세,1958,1060,898
202009,26170,부산광역시,동구,0-4세,1934,1041,893
202010,26170,부산광역시,동구,0-4세,1899,1020,879
202011,26170,부산광역시,동구,0-4세,1864,996,868
202012,26170,부산광역시,동구,0-4세,1854,989,865
202101,26170,부산광역시,동구,0-4세,1829,976,853
202102,26170,부산광역시,동구,0-4세,1814,967,847
202103,26170,부산광역시,동구,0-4세,1841,987,854
202104,26170,부산광역시,동구,0-4세,1844,998,846
202105,26170,부산광역시,동구,0-4세,1812,970,842
202106,26170,부산광역시,동구,0-4세,1813,969,844
202007,26170,부산광역시,동구,5-9세,2233,1170,1063
202008,26170,부산광역시,동구,5-9세,2245,1175,1070
202009,26170,부산광역시,동구,5-9세,2246,1172,1074
202010,26170,부산광역시,동구,5-9세,2245,1170,1075
202011,26170,부산광역시,동구,5-9세,2242,1170,1072
202012,26170,부산광역시,동구,5-9세,2231,1160,1071
202101,26170,부산광역시,동구,5-9세,2210,1148,1062
202102,26170,부산광역시,동구,5-9세,2209,1152,1057
202103,26170,부산광역시,동구,5-9세,2229,1167,1062
202104,26170,부산광역시,동구,5-9세,2231,1160,1071
202105,26170,부산광역시,동구,5-9세,2228,1158,1070
202106,26170,부산광역시,동구,5-9세,2209,1151,1058
202007,26170,부산광역시,동구,10-14세,2248,1136,1112
202008,26170,부산광역시,동구,10-14세,2237,1120,1117
202009,26170,부산광역시,동구,10-14세,2237,1126,1111
202010,26170,부산광역시,동구,10-14세,2242,1122,1120
202011,26170,부산광역시,동구,10-14세,2236,1126,1110
202012,26170,부산광역시,동구,10-14세,2245,1138,1107
202101,26170,부산광역시,동구,10-14세,2249,1147,1102
202102,26170,부산광역시,동구,10-14세,2239,1133,1106
202103,26170,부산광역시,동구,10-14세,2253,1142,1111
202104,26170,부산광역시,동구,10-14세,2260,1144,1116
202105,26170,부산광역시,동구,10-14세,2273,1149,1124
202106,26170,부산광역시,동구,10-14세,2284,1152,1132
202007,26170,부산광역시,동구,15-19세,3007,1582,1425
202008,26170,부산광역시,동구,15-19세,3003,1578,1425
202009,26170,부산광역시,동구,15-19세,2983,1572,1411
202010,26170,부산광역시,동구,15-19세,2948,1557,1391
202011,26170,부산광역시,동구,15-19세,2929,1545,1384
202012,26170,부산광역시,동구,15-19세,2900,1522,1378
202101,26170,부산광역시,동구,15-19세,2854,1499,1355
202102,26170,부산광역시,동구,15-19세,2796,1468,1328
202103,26170,부산광역시,동구,15-19세,2767,1451,1316
202104,26170,부산광역시,동구,15-19세,2725,1424,1301
202105,26170,부산광역시,동구,15-19세,2699,1406,1293
202106,26170,부산광역시,동구,15-19세,2666,1392,1274
202007,26170,부산광역시,동구,20-24세,4785,2416,2369
202008,26170,부산광역시,동구,20-24세,4760,2395,2365
202009,26170,부산광역시,동구,20-24세,4676,2355,2321
202010,26170,부산광역시,동구,20-24세,4654,2343,2311
202011,26170,부산광역시,동구,20-24세,4617,2338,2279
202012,26170,부산광역시,동구,20-24세,4591,2316,2275
202101,26170,부산광역시,동구,20-24세,4562,2302,2260
202102,26170,부산광역시,동구,20-24세,4547,2268,2279
202103,26170,부산광역시,동구,20-24세,4519,2257,2262
202104,26170,부산광역시,동구,20-24세,4525,2270,2255
202105,26170,부산광역시,동구,20-24세,4534,2272,2262
202106,26170,부산광역시,동구,20-24세,4514,2243,2271
202007,26170,부산광역시,동구,25-29세,5917,3002,2915
202008,26170,부산광역시,동구,25-29세,5917,3011,2906
202009,26170,부산광역시,동구,25-29세,5913,3009,2904
202010,26170,부산광역시,동구,25-29세,5927,3003,2924
202011,26170,부산광역시,동구,25-29세,5897,2992,2905
202012,26170,부산광역시,동구,25-29세,5881,2987,2894
202101,26170,부산광역시,동구,25-29세,5871,2987,2884
202102,26170,부산광역시,동구,25-29세,5876,3000,2876
202103,26170,부산광역시,동구,25-29세,5887,2997,2890
202104,26170,부산광역시,동구,25-29세,5899,3002,2897
202105,26170,부산광역시,동구,25-29세,5848,2982,2866
202106,26170,부산광역시,동구,25-29세,5834,2977,2857
202007,26170,부산광역시,동구,30-34세,5137,2748,2389
202008,26170,부산광역시,동구,30-34세,5111,2715,2396
202009,26170,부산광역시,동구,30-34세,5099,2706,2393
202010,26170,부산광역시,동구,30-34세,5063,2689,2374
202011,26170,부산광역시,동구,30-34세,5074,2693,2381
202012,26170,부산광역시,동구,30-34세,5060,2678,2382
202101,26170,부산광역시,동구,30-34세,5080,2695,2385
202102,26170,부산광역시,동구,30-34세,5092,2697,2395
202103,26170,부산광역시,동구,30-34세,5133,2694,2439
202104,26170,부산광역시,동구,30-34세,5125,2685,2440
202105,26170,부산광역시,동구,30-34세,5175,2716,2459
202106,26170,부산광역시,동구,30-34세,5206,2724,2482
202007,26170,부산광역시,동구,35-39세,5467,2957,2510
202008,26170,부산광역시,동구,35-39세,5458,2955,2503
202009,26170,부산광역시,동구,35-39세,5404,2931,2473
202010,26170,부산광역시,동구,35-39세,5393,2924,2469
202011,26170,부산광역시,동구,35-39세,5351,2878,2473
202012,26170,부산광역시,동구,35-39세,5335,2874,2461
202101,26170,부산광역시,동구,35-39세,5320,2869,2451
202102,26170,부산광역시,동구,35-39세,5283,2859,2424
202103,26170,부산광역시,동구,35-39세,5288,2874,2414
202104,26170,부산광역시,동구,35-39세,5264,2854,2410
202105,26170,부산광역시,동구,35-39세,5236,2829,2407
202106,26170,부산광역시,동구,35-39세,5203,2800,2403
202007,26170,부산광역시,동구,40-44세,5395,2921,2474
202008,26170,부산광역시,동구,40-44세,5393,2915,2478
202009,26170,부산광역시,동구,40-44세,5375,2905,2470
202010,26170,부산광역시,동구,40-44세,5358,2883,2475
202011,26170,부산광역시,동구,40-44세,5381,2908,2473
202012,26170,부산광역시,동구,40-44세,5374,2915,2459
202101,26170,부산광역시,동구,40-44세,5341,2888,2453
202102,26170,부산광역시,동구,40-44세,5351,2889,2462
202103,26170,부산광역시,동구,40-44세,5322,2882,2440
202104,26170,부산광역시,동구,40-44세,5353,2898,2455
202105,26170,부산광역시,동구,40-44세,5355,2900,2455
202106,26170,부산광역시,동구,40-44세,5379,2919,2460
202007,26170,부산광역시,동구,45-49세,6773,3577,3196
202008,26170,부산광역시,동구,45-49세,6746,3560,3186
202009,26170,부산광역시,동구,45-49세,6700,3541,3159
202010,26170,부산광역시,동구,45-49세,6645,3521,3124
202011,26170,부산광역시,동구,45-49세,6587,3496,3091
202012,26170,부산광역시,동구,45-49세,6579,3495,3084
202101,26170,부산광역시,동구,45-49세,6548,3473,3075
202102,26170,부산광역시,동구,45-49세,6488,3452,3036
202103,26170,부산광역시,동구,45-49세,6405,3409,2996
202104,26170,부산광역시,동구,45-49세,6386,3395,2991
202105,26170,부산광역시,동구,45-49세,6328,3367,2961
202106,26170,부산광역시,동구,45-49세,6255,3323,2932
202007,26170,부산광역시,동구,50-54세,7328,3804,3524
202008,26170,부산광역시,동구,50-54세,7326,3821,3505
202009,26170,부산광역시,동구,50-54세,7301,3813,3488
202010,26170,부산광역시,동구,50-54세,7284,3797,3487
202011,26170,부산광역시,동구,50-54세,7255,3765,3490
202012,26170,부산광역시,동구,50-54세,7224,3740,3484
202101,26170,부산광역시,동구,50-54세,7264,3767,3497
202102,26170,부산광역시,동구,50-54세,7270,3769,3501
202103,26170,부산광역시,동구,50-54세,7230,3766,3464
202104,26170,부산광역시,동구,50-54세,7196,3746,3450
202105,26170,부산광역시,동구,50-54세,7239,3778,3461
202106,26170,부산광역시,동구,50-54세,7262,3817,3445
202007,26170,부산광역시,동구,55-59세,7703,3824,3879
202008,26170,부산광역시,동구,55-59세,7672,3814,3858
202009,26170,부산광역시,동구,55-59세,7603,3770,3833
202010,26170,부산광역시,동구,55-59세,7558,3754,3804
202011,26170,부산광역시,동구,55-59세,7542,3769,3773
202012,26170,부산광역시,동구,55-59세,7484,3752,3732
202101,26170,부산광역시,동구,55-59세,7402,3711,3691
202102,26170,부산광역시,동구,55-59세,7373,3687,3686
202103,26170,부산광역시,동구,55-59세,7275,3651,3624
202104,26170,부산광역시,동구,55-59세,7226,3632,3594
202105,26170,부산광역시,동구,55-59세,7156,3604,3552
202106,26170,부산광역시,동구,55-59세,7080,3562,3518
202007,26170,부산광역시,동구,60-64세,8684,4198,4486
202008,26170,부산광역시,동구,60-64세,8705,4199,4506
202009,26170,부산광역시,동구,60-64세,8740,4228,4512
202010,26170,부산광역시,동구,60-64세,8738,4225,4513
202011,26170,부산광역시,동구,60-64세,8753,4228,4525
202012,26170,부산광역시,동구,60-64세,8762,4231,4531
202101,26170,부산광역시,동구,60-64세,8759,4241,4518
202102,26170,부산광역시,동구,60-64세,8786,4251,4535
202103,26170,부산광역시,동구,60-64세,8740,4225,4515
202104,26170,부산광역시,동구,60-64세,8753,4234,4519
202105,26170,부산광역시,동구,60-64세,8752,4230,4522
202106,26170,부산광역시,동구,60-64세,8750,4225,4525
202007,26170,부산광역시,동구,65-69세,7198,3352,3846
202008,26170,부산광역시,동구,65-69세,7235,3355,3880
202009,26170,부산광역시,동구,65-69세,7271,3366,3905
202010,26170,부산광역시,동구,65-69세,7300,3371,3929
202011,26170,부산광역시,동구,65-69세,7315,3374,3941
202012,26170,부산광역시,동구,65-69세,7332,3364,3968
202101,26170,부산광역시,동구,65-69세,7389,3395,3994
202102,26170,부산광역시,동구,65-69세,7389,3396,3993
202103,26170,부산광역시,동구,65-69세,7377,3384,3993
202104,26170,부산광역시,동구,65-69세,7389,3399,3990
202105,26170,부산광역시,동구,65-69세,7398,3375,4023
202106,26170,부산광역시,동구,65-69세,7379,3366,4013
202007,26170,부산광역시,동구,70-74세,5754,2517,3237
202008,26170,부산광역시,동구,70-74세,5776,2536,3240
202009,26170,부산광역시,동구,70-74세,5796,2556,3240
202010,26170,부산광역시,동구,70-74세,5832,2573,3259
202011,26170,부산광역시,동구,70-74세,5881,2599,3282
202012,26170,부산광역시,동구,70-74세,5941,2635,3306
202101,26170,부산광역시,동구,70-74세,5967,2652,3315
202102,26170,부산광역시,동구,70-74세,5984,2654,3330
202103,26170,부산광역시,동구,70-74세,5962,2650,3312
202104,26170,부산광역시,동구,70-74세,5985,2653,3332
202105,26170,부산광역시,동구,70-74세,6003,2664,3339
202106,26170,부산광역시,동구,70-74세,6022,2673,3349
202007,26170,부산광역시,동구,75-79세,4947,2010,2937
202008,26170,부산광역시,동구,75-79세,4941,2006,2935
202009,26170,부산광역시,동구,75-79세,4899,1992,2907
202010,26170,부산광역시,동구,75-79세,4869,1990,2879
202011,26170,부산광역시,동구,75-79세,4829,1983,2846
202012,26170,부산광역시,동구,75-79세,4789,1958,2831
202101,26170,부산광역시,동구,75-79세,4750,1947,2803
202102,26170,부산광역시,동구,75-79세,4724,1937,2787
202103,26170,부산광역시,동구,75-79세,4650,1917,2733
202104,26170,부산광역시,동구,75-79세,4631,1919,2712
202105,26170,부산광역시,동구,75-79세,4643,1927,2716
202106,26170,부산광역시,동구,75-79세,4632,1930,2702
202007,26170,부산광역시,동구,80-84세,3133,1163,1970
202008,26170,부산광역시,동구,80-84세,3137,1160,1977
202009,26170,부산광역시,동구,80-84세,3162,1166,1996
202010,26170,부산광역시,동구,80-84세,3168,1164,2004
202011,26170,부산광역시,동구,80-84세,3179,1160,2019
202012,26170,부산광역시,동구,80-84세,3193,1158,2035
202101,26170,부산광역시,동구,80-84세,3208,1157,2051
202102,26170,부산광역시,동구,80-84세,3234,1175,2059
202103,26170,부산광역시,동구,80-84세,3226,1173,2053
202104,26170,부산광역시,동구,80-84세,3232,1180,2052
202105,26170,부산광역시,동구,80-84세,3238,1174,2064
202106,26170,부산광역시,동구,80-84세,3256,1183,2073
202007,26170,부산광역시,동구,85-89세,1353,385,968
202008,26170,부산광역시,동구,85-89세,1366,385,981
202009,26170,부산광역시,동구,85-89세,1386,387,999
202010,26170,부산광역시,동구,85-89세,1392,396,996
202011,26170,부산광역시,동구,85-89세,1410,405,1005
202012,26170,부산광역시,동구,85-89세,1439,421,1018
202101,26170,부산광역시,동구,85-89세,1464,432,1032
202102,26170,부산광역시,동구,85-89세,1487,440,1047
202103,26170,부산광역시,동구,85-89세,1482,435,1047
202104,26170,부산광역시,동구,85-89세,1499,436,1063
202105,26170,부산광역시,동구,85-89세,1529,450,1079
202106,26170,부산광역시,동구,85-89세,1534,450,1084
202007,26170,부산광역시,동구,90-94세,476,124,352
202008,26170,부산광역시,동구,90-94세,478,124,354
202009,26170,부산광역시,동구,90-94세,481,126,355
202010,26170,부산광역시,동구,90-94세,489,123,366
202011,26170,부산광역시,동구,90-94세,487,118,369
202012,26170,부산광역시,동구,90-94세,489,117,372
202101,26170,부산광역시,동구,90-94세,496,116,380
202102,26170,부산광역시,동구,90-94세,489,116,373
202103,26170,부산광역시,동구,90-94세,468,110,358
202104,26170,부산광역시,동구,90-94세,469,113,356
202105,26170,부산광역시,동구,90-94세,469,114,355
202106,26170,부산광역시,동구,90-94세,471,112,359
202007,26170,부산광역시,동구,95-99세,98,29,69
202008,26170,부산광역시,동구,95-99세,102,29,73
202009,26170,부산광역시,동구,95-99세,103,28,75
202010,26170,부산광역시,동구,95-99세,100,28,72
202011,26170,부산광역시,동구,95-99세,101,29,72
202012,26170,부산광역시,동구,95-99세,97,28,69
202101,26170,부산광역시,동구,95-99세,99,29,70
202102,26170,부산광역시,동구,95-99세,108,30,78
202103,26170,부산광역시,동구,95-99세,101,24,77
202104,26170,부산광역시,동구,95-99세,103,25,78
202105,26170,부산광역시,동구,95-99세,100,25,75
202106,26170,부산광역시,동구,95-99세,102,25,77
202007,26170,부산광역시,동구,100+,99,29,70
202008,26170,부산광역시,동구,100+,99,29,70
202009,26170,부산광역시,동구,100+,101,31,70
202010,26170,부산광역시,동구,100+,101,31,70
202011,26170,부산광역시,동구,100+,101,31,70
202012,26170,부산광역시,동구,100+,101,31,70
202101,26170,부산광역시,동구,100+,101,31,70
202102,26170,부산광역시,동구,100+,100,30,70
202103,26170,부산광역시,동구,100+,63,18,45
202104,26170,부산광역시,동구,100+,64,18,46
202105,26170,부산광역시,동구,100+,65,19,46
202106,26170,부산광역시,동구,100+,65,19,46
202007,26200,부산광역시,영도구,0-4세,2207,1095,1112
202008,26200,부산광역시,영도구,0-4세,2182,1079,1103
202009,26200,부산광역시,영도구,0-4세,2159,1062,1097
202010,26200,부산광역시,영도구,0-4세,2105,1041,1064
202011,26200,부산광역시,영도구,0-4세,2061,1013,1048
202012,26200,부산광역시,영도구,0-4세,2039,1001,1038
202101,26200,부산광역시,영도구,0-4세,2011,992,1019
202102,26200,부산광역시,영도구,0-4세,1977,980,997
202103,26200,부산광역시,영도구,0-4세,1941,967,974
202104,26200,부산광역시,영도구,0-4세,1919,954,965
202105,26200,부산광역시,영도구,0-4세,1957,966,991
202106,26200,부산광역시,영도구,0-4세,1956,964,992
202007,26200,부산광역시,영도구,5-9세,3248,1659,1589
202008,26200,부산광역시,영도구,5-9세,3209,1645,1564
202009,26200,부산광역시,영도구,5-9세,3181,1635,1546
202010,26200,부산광역시,영도구,5-9세,3159,1618,1541
202011,26200,부산광역시,영도구,5-9세,3137,1614,1523
202012,26200,부산광역시,영도구,5-9세,3100,1592,1508
202101,26200,부산광역시,영도구,5-9세,3072,1571,1501
202102,26200,부산광역시,영도구,5-9세,3055,1567,1488
202103,26200,부산광역시,영도구,5-9세,3070,1574,1496
202104,26200,부산광역시,영도구,5-9세,3047,1559,1488
202105,26200,부산광역시,영도구,5-9세,3067,1575,1492
202106,26200,부산광역시,영도구,5-9세,3052,1574,1478
202007,26200,부산광역시,영도구,10-14세,3402,1748,1654
202008,26200,부산광역시,영도구,10-14세,3408,1756,1652
202009,26200,부산광역시,영도구,10-14세,3397,1751,1646
202010,26200,부산광역시,영도구,10-14세,3397,1746,1651
202011,26200,부산광역시,영도구,10-14세,3404,1740,1664
202012,26200,부산광역시,영도구,10-14세,3395,1740,1655
202101,26200,부산광역시,영도구,10-14세,3395,1742,1653
202102,26200,부산광역시,영도구,10-14세,3402,1740,1662
202103,26200,부산광역시,영도구,10-14세,3394,1743,1651
202104,26200,부산광역시,영도구,10-14세,3398,1747,1651
202105,26200,부산광역시,영도구,10-14세,3411,1751,1660
202106,26200,부산광역시,영도구,10-14세,3438,1757,1681
202007,26200,부산광역시,영도구,15-19세,4256,2219,2037
202008,26200,부산광역시,영도구,15-19세,4209,2182,2027
202009,26200,부산광역시,영도구,15-19세,4159,2162,1997
202010,26200,부산광역시,영도구,15-19세,4104,2135,1969
202011,26200,부산광역시,영도구,15-19세,4053,2112,1941
202012,26200,부산광역시,영도구,15-19세,4008,2093,1915
202101,26200,부산광역시,영도구,15-19세,3974,2072,1902
202102,26200,부산광역시,영도구,15-19세,3921,2033,1888
202103,26200,부산광역시,영도구,15-19세,3859,1990,1869
202104,26200,부산광역시,영도구,15-19세,3835,1977,1858
202105,26200,부산광역시,영도구,15-19세,3802,1960,1842
202106,26200,부산광역시,영도구,15-19세,3780,1952,1828
202007,26200,부산광역시,영도구,20-24세,6149,3293,2856
202008,26200,부산광역시,영도구,20-24세,6106,3277,2829
202009,26200,부산광역시,영도구,20-24세,6090,3277,2813
202010,26200,부산광역시,영도구,20-24세,6054,3266,2788
202011,26200,부산광역시,영도구,20-24세,6010,3244,2766
202012,26200,부산광역시,영도구,20-24세,6001,3238,2763
202101,26200,부산광역시,영도구,20-24세,5932,3206,2726
202102,26200,부산광역시,영도구,20-24세,5939,3216,2723
202103,26200,부산광역시,영도구,20-24세,5899,3200,2699
202104,26200,부산광역시,영도구,20-24세,5862,3182,2680
202105,26200,부산광역시,영도구,20-24세,5822,3153,2669
202106,26200,부산광역시,영도구,20-24세,5805,3137,2668
202007,26200,부산광역시,영도구,25-29세,6023,3335,2688
202008,26200,부산광역시,영도구,25-29세,6015,3338,2677
202009,26200,부산광역시,영도구,25-29세,6019,3337,2682
202010,26200,부산광역시,영도구,25-29세,6017,3339,2678
202011,26200,부산광역시,영도구,25-29세,6012,3351,2661
202012,26200,부산광역시,영도구,25-29세,5989,3335,2654
202101,26200,부산광역시,영도구,25-29세,5958,3330,2628
202102,26200,부산광역시,영도구,25-29세,5942,3317,2625
202103,26200,부산광역시,영도구,25-29세,5908,3313,2595
202104,26200,부산광역시,영도구,25-29세,5924,3332,2592
202105,26200,부산광역시,영도구,25-29세,5968,3335,2633
202106,26200,부산광역시,영도구,25-29세,5987,3332,2655
202007,26200,부산광역시,영도구,30-34세,4875,2705,2170
202008,26200,부산광역시,영도구,30-34세,4826,2687,2139
202009,26200,부산광역시,영도구,30-34세,4787,2665,2122
202010,26200,부산광역시,영도구,30-34세,4760,2655,2105
202011,26200,부산광역시,영도구,30-34세,4734,2626,2108
202012,26200,부산광역시,영도구,30-34세,4711,2616,2095
202101,26200,부산광역시,영도구,30-34세,4736,2620,2116
202102,26200,부산광역시,영도구,30-34세,4720,2609,2111
202103,26200,부산광역시,영도구,30-34세,4710,2599,2111
202104,26200,부산광역시,영도구,30-34세,4711,2578,2133
202105,26200,부산광역시,영도구,30-34세,4758,2595,2163
202106,26200,부산광역시,영도구,30-34세,4790,2631,2159
202007,26200,부산광역시,영도구,35-39세,6227,3265,2962
202008,26200,부산광역시,영도구,35-39세,6155,3242,2913
202009,26200,부산광역시,영도구,35-39세,6099,3212,2887
202010,26200,부산광역시,영도구,35-39세,6009,3166,2843
202011,26200,부산광역시,영도구,35-39세,5956,3143,2813
202012,26200,부산광역시,영도구,35-39세,5899,3104,2795
202101,26200,부산광역시,영도구,35-39세,5826,3065,2761
202102,26200,부산광역시,영도구,35-39세,5754,3038,2716
202103,26200,부산광역시,영도구,35-39세,5641,2992,2649
202104,26200,부산광역시,영도구,35-39세,5608,2989,2619
202105,26200,부산광역시,영도구,35-39세,5632,3015,2617
202106,26200,부산광역시,영도구,35-39세,5612,2995,2617
202007,26200,부산광역시,영도구,40-44세,6814,3556,3258
202008,26200,부산광역시,영도구,40-44세,6802,3555,3247
202009,26200,부산광역시,영도구,40-44세,6785,3549,3236
202010,26200,부산광역시,영도구,40-44세,6777,3539,3238
202011,26200,부산광역시,영도구,40-44세,6774,3542,3232
202012,26200,부산광역시,영도구,40-44세,6741,3537,3204
202101,26200,부산광역시,영도구,40-44세,6701,3514,3187
202102,26200,부산광역시,영도구,40-44세,6710,3499,3211
202103,26200,부산광역시,영도구,40-44세,6655,3477,3178
202104,26200,부산광역시,영도구,40-44세,6651,3481,3170
202105,26200,부산광역시,영도구,40-44세,6692,3502,3190
202106,26200,부산광역시,영도구,40-44세,6763,3532,3231
202007,26200,부산광역시,영도구,45-49세,8720,4600,4120
202008,26200,부산광역시,영도구,45-49세,8655,4546,4109
202009,26200,부산광역시,영도구,45-49세,8611,4531,4080
202010,26200,부산광역시,영도구,45-49세,8545,4498,4047
202011,26200,부산광역시,영도구,45-49세,8472,4457,4015
202012,26200,부산광역시,영도구,45-49세,8418,4416,4002
202101,26200,부산광역시,영도구,45-49세,8381,4383,3998
202102,26200,부산광역시,영도구,45-49세,8328,4363,3965
202103,26200,부산광역시,영도구,45-49세,8206,4312,3894
202104,26200,부산광역시,영도구,45-49세,8189,4291,3898
202105,26200,부산광역시,영도구,45-49세,8149,4259,3890
202106,26200,부산광역시,영도구,45-49세,8111,4239,3872
202007,26200,부산광역시,영도구,50-54세,9392,4918,4474
202008,26200,부산광역시,영도구,50-54세,9396,4935,4461
202009,26200,부산광역시,영도구,50-54세,9370,4914,4456
202010,26200,부산광역시,영도구,50-54세,9355,4909,4446
202011,26200,부산광역시,영도구,50-54세,9358,4915,4443
202012,26200,부산광역시,영도구,50-54세,9322,4887,4435
202101,26200,부산광역시,영도구,50-54세,9301,4860,4441
202102,26200,부산광역시,영도구,50-54세,9301,4851,4450
202103,26200,부산광역시,영도구,50-54세,9141,4763,4378
202104,26200,부산광역시,영도구,50-54세,9147,4777,4370
202105,26200,부산광역시,영도구,50-54세,9138,4779,4359
202106,26200,부산광역시,영도구,50-54세,9157,4788,4369
202007,26200,부산광역시,영도구,55-59세,10576,5220,5356
202008,26200,부산광역시,영도구,55-59세,10482,5171,5311
202009,26200,부산광역시,영도구,55-59세,10442,5158,5284
202010,26200,부산광역시,영도구,55-59세,10334,5112,5222
202011,26200,부산광역시,영도구,55-59세,10273,5087,5186
202012,26200,부산광역시,영도구,55-59세,10237,5092,5145
202101,26200,부산광역시,영도구,55-59세,10143,5074,5069
202102,26200,부산광역시,영도구,55-59세,10073,5045,5028
202103,26200,부산광역시,영도구,55-59세,9899,4983,4916
202104,26200,부산광역시,영도구,55-59세,9812,4949,4863
202105,26200,부산광역시,영도구,55-59세,9781,4934,4847
202106,26200,부산광역시,영도구,55-59세,9687,4910,4777
202007,26200,부산광역시,영도구,60-64세,11991,5808,6183
202008,26200,부산광역시,영도구,60-64세,11977,5812,6165
202009,26200,부산광역시,영도구,60-64세,11958,5801,6157
202010,26200,부산광역시,영도구,60-64세,11980,5814,6166
202011,26200,부산광역시,영도구,60-64세,11994,5816,6178
202012,26200,부산광역시,영도구,60-64세,11999,5826,6173
202101,26200,부산광역시,영도구,60-64세,12037,5855,6182
202102,26200,부산광역시,영도구,60-64세,12051,5878,6173
202103,26200,부산광역시,영도구,60-64세,11943,5812,6131
202104,26200,부산광역시,영도구,60-64세,11948,5829,6119
202105,26200,부산광역시,영도구,60-64세,11955,5837,6118
202106,26200,부산광역시,영도구,60-64세,12023,5846,6177
202007,26200,부산광역시,영도구,65-69세,9863,4645,5218
202008,26200,부산광역시,영도구,65-69세,9911,4657,5254
202009,26200,부산광역시,영도구,65-69세,9993,4693,5300
202010,26200,부산광역시,영도구,65-69세,10073,4725,5348
202011,26200,부산광역시,영도구,65-69세,10105,4743,5362
202012,26200,부산광역시,영도구,65-69세,10172,4764,5408
202101,26200,부산광역시,영도구,65-69세,10224,4804,5420
202102,26200,부산광역시,영도구,65-69세,10217,4799,5418
202103,26200,부산광역시,영도구,65-69세,10182,4785,5397
202104,26200,부산광역시,영도구,65-69세,10227,4804,5423
202105,26200,부산광역시,영도구,65-69세,10274,4824,5450
202106,26200,부산광역시,영도구,65-69세,10303,4845,5458
202007,26200,부산광역시,영도구,70-74세,8012,3597,4415
202008,26200,부산광역시,영도구,70-74세,8022,3601,4421
202009,26200,부산광역시,영도구,70-74세,8048,3615,4433
202010,26200,부산광역시,영도구,70-74세,8070,3623,4447
202011,26200,부산광역시,영도구,70-74세,8120,3640,4480
202012,26200,부산광역시,영도구,70-74세,8166,3657,4509
202101,26200,부산광역시,영도구,70-74세,8216,3670,4546
202102,26200,부산광역시,영도구,70-74세,8279,3698,4581
202103,26200,부산광역시,영도구,70-74세,8197,3674,4523
202104,26200,부산광역시,영도구,70-74세,8218,3682,4536
202105,26200,부산광역시,영도구,70-74세,8227,3678,4549
202106,26200,부산광역시,영도구,70-74세,8227,3675,4552
202007,26200,부산광역시,영도구,75-79세,6540,2723,3817
202008,26200,부산광역시,영도구,75-79세,6542,2737,3805
202009,26200,부산광역시,영도구,75-79세,6509,2723,3786
202010,26200,부산광역시,영도구,75-79세,6492,2721,3771
202011,26200,부산광역시,영도구,75-79세,6440,2696,3744
202012,26200,부산광역시,영도구,75-79세,6390,2677,3713
202101,26200,부산광역시,영도구,75-79세,6328,2648,3680
202102,26200,부산광역시,영도구,75-79세,6283,2632,3651
202103,26200,부산광역시,영도구,75-79세,6216,2613,3603
202104,26200,부산광역시,영도구,75-79세,6214,2608,3606
202105,26200,부산광역시,영도구,75-79세,6215,2617,3598
202106,26200,부산광역시,영도구,75-79세,6230,2623,3607
202007,26200,부산광역시,영도구,80-84세,4018,1497,2521
202008,26200,부산광역시,영도구,80-84세,4052,1499,2553
202009,26200,부산광역시,영도구,80-84세,4067,1500,2567
202010,26200,부산광역시,영도구,80-84세,4080,1504,2576
202011,26200,부산광역시,영도구,80-84세,4115,1530,2585
202012,26200,부산광역시,영도구,80-84세,4125,1534,2591
202101,26200,부산광역시,영도구,80-84세,4150,1541,2609
202102,26200,부산광역시,영도구,80-84세,4180,1550,2630
202103,26200,부산광역시,영도구,80-84세,4124,1507,2617
202104,26200,부산광역시,영도구,80-84세,4135,1523,2612
202105,26200,부산광역시,영도구,80-84세,4151,1529,2622
202106,26200,부산광역시,영도구,80-84세,4191,1553,2638
202007,26200,부산광역시,영도구,85-89세,1698,524,1174
202008,26200,부산광역시,영도구,85-89세,1696,525,1171
202009,26200,부산광역시,영도구,85-89세,1710,535,1175
202010,26200,부산광역시,영도구,85-89세,1730,537,1193
202011,26200,부산광역시,영도구,85-89세,1736,534,1202
202012,26200,부산광역시,영도구,85-89세,1761,554,1207
202101,26200,부산광역시,영도구,85-89세,1793,566,1227
202102,26200,부산광역시,영도구,85-89세,1790,566,1224
202103,26200,부산광역시,영도구,85-89세,1787,561,1226
202104,26200,부산광역시,영도구,85-89세,1800,559,1241
202105,26200,부산광역시,영도구,85-89세,1829,567,1262
202106,26200,부산광역시,영도구,85-89세,1831,568,1263
202007,26200,부산광역시,영도구,90-94세,584,105,479
202008,26200,부산광역시,영도구,90-94세,582,106,476
202009,26200,부산광역시,영도구,90-94세,584,109,475
202010,26200,부산광역시,영도구,90-94세,583,112,471
202011,26200,부산광역시,영도구,90-94세,582,114,468
202012,26200,부산광역시,영도구,90-94세,580,114,466
202101,26200,부산광역시,영도구,90-94세,583,116,467
202102,26200,부산광역시,영도구,90-94세,596,122,474
202103,26200,부산광역시,영도구,90-94세,564,110,454
202104,26200,부산광역시,영도구,90-94세,568,113,455
202105,26200,부산광역시,영도구,90-94세,574,116,458
202106,26200,부산광역시,영도구,90-94세,568,114,454
202007,26200,부산광역시,영도구,95-99세,147,38,109
202008,26200,부산광역시,영도구,95-99세,151,39,112
202009,26200,부산광역시,영도구,95-99세,151,36,115
202010,26200,부산광역시,영도구,95-99세,153,35,118
202011,26200,부산광역시,영도구,95-99세,153,35,118
202012,26200,부산광역시,영도구,95-99세,157,36,121
202101,26200,부산광역시,영도구,95-99세,151,34,117
202102,26200,부산광역시,영도구,95-99세,155,35,120
202103,26200,부산광역시,영도구,95-99세,119,18,101
202104,26200,부산광역시,영도구,95-99세,122,20,102
202105,26200,부산광역시,영도구,95-99세,119,19,100
202106,26200,부산광역시,영도구,95-99세,121,21,100
202007,26200,부산광역시,영도구,100+,131,33,98
202008,26200,부산광역시,영도구,100+,133,33,100
202009,26200,부산광역시,영도구,100+,133,33,100
202010,26200,부산광역시,영도구,100+,132,33,99
202011,26200,부산광역시,영도구,100+,132,33,99
202012,26200,부산광역시,영도구,100+,132,33,99
202101,26200,부산광역시,영도구,100+,136,34,102
202102,26200,부산광역시,영도구,100+,136,33,103
202103,26200,부산광역시,영도구,100+,52,4,48
202104,26200,부산광역시,영도구,100+,52,4,48
202105,26200,부산광역시,영도구,100+,53,5,48
202106,26200,부산광역시,영도구,100+,53,5,48
202007,26230,부산광역시,부산진구,0-4세,9642,4932,4710
202008,26230,부산광역시,부산진구,0-4세,9506,4857,4649
202009,26230,부산광역시,부산진구,0-4세,9361,4775,4586
202010,26230,부산광역시,부산진구,0-4세,9357,4770,4587
202011,26230,부산광역시,부산진구,0-4세,9388,4781,4607
202012,26230,부산광역시,부산진구,0-4세,9349,4778,4571
202101,26230,부산광역시,부산진구,0-4세,9251,4743,4508
202102,26230,부산광역시,부산진구,0-4세,9185,4713,4472
202103,26230,부산광역시,부산진구,0-4세,9104,4677,4427
202104,26230,부산광역시,부산진구,0-4세,9037,4636,4401
202105,26230,부산광역시,부산진구,0-4세,8946,4578,4368
202106,26230,부산광역시,부산진구,0-4세,8856,4528,4328
202007,26230,부산광역시,부산진구,5-9세,12026,6073,5953
202008,26230,부산광역시,부산진구,5-9세,11995,6055,5940
202009,26230,부산광역시,부산진구,5-9세,12005,6058,5947
202010,26230,부산광역시,부산진구,5-9세,12016,6055,5961
202011,26230,부산광역시,부산진구,5-9세,11977,6022,5955
202012,26230,부산광역시,부산진구,5-9세,11969,6002,5967
202101,26230,부산광역시,부산진구,5-9세,11964,5985,5979
202102,26230,부산광역시,부산진구,5-9세,11962,6004,5958
202103,26230,부산광역시,부산진구,5-9세,11928,5999,5929
202104,26230,부산광역시,부산진구,5-9세,11898,5991,5907
202105,26230,부산광역시,부산진구,5-9세,11885,5980,5905
202106,26230,부산광역시,부산진구,5-9세,11860,5975,5885
202007,26230,부산광역시,부산진구,10-14세,11496,5803,5693
202008,26230,부산광역시,부산진구,10-14세,11535,5827,5708
202009,26230,부산광역시,부산진구,10-14세,11551,5844,5707
202010,26230,부산광역시,부산진구,10-14세,11590,5873,5717
202011,26230,부산광역시,부산진구,10-14세,11645,5905,5740
202012,26230,부산광역시,부산진구,10-14세,11722,5942,5780
202101,26230,부산광역시,부산진구,10-14세,11757,5947,5810
202102,26230,부산광역시,부산진구,10-14세,11706,5915,5791
202103,26230,부산광역시,부산진구,10-14세,11733,5906,5827
202104,26230,부산광역시,부산진구,10-14세,11709,5898,5811
202105,26230,부산광역시,부산진구,10-14세,11654,5881,5773
202106,26230,부산광역시,부산진구,10-14세,11695,5913,5782
202007,26230,부산광역시,부산진구,15-19세,13874,7150,6724
202008,26230,부산광역시,부산진구,15-19세,13719,7076,6643
202009,26230,부산광역시,부산진구,15-19세,13567,6964,6603
202010,26230,부산광역시,부산진구,15-19세,13457,6900,6557
202011,26230,부산광역시,부산진구,15-19세,13399,6867,6532
202012,26230,부산광역시,부산진구,15-19세,13283,6799,6484
202101,26230,부산광역시,부산진구,15-19세,13208,6753,6455
202102,26230,부산광역시,부산진구,15-19세,13174,6722,6452
202103,26230,부산광역시,부산진구,15-19세,13003,6623,6380
202104,26230,부산광역시,부산진구,15-19세,12905,6569,6336
202105,26230,부산광역시,부산진구,15-19세,12798,6513,6285
202106,26230,부산광역시,부산진구,15-19세,12730,6461,6269
202007,26230,부산광역시,부산진구,20-24세,23534,11493,12041
202008,26230,부산광역시,부산진구,20-24세,23617,11531,12086
202009,26230,부산광역시,부산진구,20-24세,23524,11450,12074
202010,26230,부산광역시,부산진구,20-24세,23477,11439,12038
202011,26230,부산광역시,부산진구,20-24세,23460,11412,12048
202012,26230,부산광역시,부산진구,20-24세,23393,11380,12013
202101,26230,부산광역시,부산진구,20-24세,23353,11324,12029
202102,26230,부산광역시,부산진구,20-24세,23432,11298,12134
202103,26230,부산광역시,부산진구,20-24세,23409,11256,12153
202104,26230,부산광역시,부산진구,20-24세,23276,11202,12074
202105,26230,부산광역시,부산진구,20-24세,23208,11137,12071
202106,26230,부산광역시,부산진구,20-24세,23074,11073,12001
202007,26230,부산광역시,부산진구,25-29세,28465,14120,14345
202008,26230,부산광역시,부산진구,25-29세,28593,14180,14413
202009,26230,부산광역시,부산진구,25-29세,28720,14239,14481
202010,26230,부산광역시,부산진구,25-29세,28936,14339,14597
202011,26230,부산광역시,부산진구,25-29세,29184,14464,14720
202012,26230,부산광역시,부산진구,25-29세,29388,14535,14853
202101,26230,부산광역시,부산진구,25-29세,29374,14497,14877
202102,26230,부산광역시,부산진구,25-29세,29282,14452,14830
202103,26230,부산광역시,부산진구,25-29세,29363,14479,14884
202104,26230,부산광역시,부산진구,25-29세,29326,14448,14878
202105,26230,부산광역시,부산진구,25-29세,29316,14468,14848
202106,26230,부산광역시,부산진구,25-29세,29213,14427,14786
202007,26230,부산광역시,부산진구,30-34세,22936,11599,11337
202008,26230,부산광역시,부산진구,30-34세,23055,11676,11379
202009,26230,부산광역시,부산진구,30-34세,23082,11697,11385
202010,26230,부산광역시,부산진구,30-34세,23159,11742,11417
202011,26230,부산광역시,부산진구,30-34세,23323,11808,11515
202012,26230,부산광역시,부산진구,30-34세,23443,11888,11555
202101,26230,부산광역시,부산진구,30-34세,23625,11986,11639
202102,26230,부산광역시,부산진구,30-34세,23735,12021,11714
202103,26230,부산광역시,부산진구,30-34세,23749,12017,11732
202104,26230,부산광역시,부산진구,30-34세,23827,12080,11747
202105,26230,부산광역시,부산진구,30-34세,23883,12106,11777
202106,26230,부산광역시,부산진구,30-34세,23923,12126,11797
202007,26230,부산광역시,부산진구,35-39세,24706,12685,12021
202008,26230,부산광역시,부산진구,35-39세,24567,12626,11941
202009,26230,부산광역시,부산진구,35-39세,24465,12579,11886
202010,26230,부산광역시,부산진구,35-39세,24511,12620,11891
202011,26230,부산광역시,부산진구,35-39세,24552,12662,11890
202012,26230,부산광역시,부산진구,35-39세,24551,12624,11927
202101,26230,부산광역시,부산진구,35-39세,24498,12573,11925
202102,26230,부산광역시,부산진구,35-39세,24299,12467,11832
202103,26230,부산광역시,부산진구,35-39세,24051,12357,11694
202104,26230,부산광역시,부산진구,35-39세,23960,12299,11661
202105,26230,부산광역시,부산진구,35-39세,23755,12173,11582
202106,26230,부산광역시,부산진구,35-39세,23541,12071,11470
202007,26230,부산광역시,부산진구,40-44세,24038,12229,11809
202008,26230,부산광역시,부산진구,40-44세,24091,12259,11832
202009,26230,부산광역시,부산진구,40-44세,24162,12288,11874
202010,26230,부산광역시,부산진구,40-44세,24286,12340,11946
202011,26230,부산광역시,부산진구,40-44세,24455,12408,12047
202012,26230,부산광역시,부산진구,40-44세,24430,12445,11985
202101,26230,부산광역시,부산진구,40-44세,24362,12428,11934
202102,26230,부산광역시,부산진구,40-44세,24460,12485,11975
202103,26230,부산광역시,부산진구,40-44세,24395,12496,11899
202104,26230,부산광역시,부산진구,40-44세,24401,12500,11901
202105,26230,부산광역시,부산진구,40-44세,24387,12520,11867
202106,26230,부산광역시,부산진구,40-44세,24476,12560,11916
202007,26230,부산광역시,부산진구,45-49세,27531,13794,13737
202008,26230,부산광역시,부산진구,45-49세,27436,13755,13681
202009,26230,부산광역시,부산진구,45-49세,27296,13670,13626
202010,26230,부산광역시,부산진구,45-49세,27214,13638,13576
202011,26230,부산광역시,부산진구,45-49세,27215,13659,13556
202012,26230,부산광역시,부산진구,45-49세,27268,13646,13622
202101,26230,부산광역시,부산진구,45-49세,27190,13606,13584
202102,26230,부산광역시,부산진구,45-49세,27173,13600,13573
202103,26230,부산광역시,부산진구,45-49세,26917,13487,13430
202104,26230,부산광역시,부산진구,45-49세,26728,13387,13341
202105,26230,부산광역시,부산진구,45-49세,26537,13297,13240
202106,26230,부산광역시,부산진구,45-49세,26379,13219,13160
202007,26230,부산광역시,부산진구,50-54세,28407,13858,14549
202008,26230,부산광역시,부산진구,50-54세,28420,13860,14560
202009,26230,부산광역시,부산진구,50-54세,28431,13891,14540
202010,26230,부산광역시,부산진구,50-54세,28606,13987,14619
202011,26230,부산광역시,부산진구,50-54세,28727,14032,14695
202012,26230,부산광역시,부산진구,50-54세,28695,14032,14663
202101,26230,부산광역시,부산진구,50-54세,28802,14090,14712
202102,26230,부산광역시,부산진구,50-54세,28767,14060,14707
202103,26230,부산광역시,부산진구,50-54세,28485,13931,14554
202104,26230,부산광역시,부산진구,50-54세,28460,13931,14529
202105,26230,부산광역시,부산진구,50-54세,28562,13954,14608
202106,26230,부산광역시,부산진구,50-54세,28564,13960,14604
202007,26230,부산광역시,부산진구,55-59세,30450,14619,15831
202008,26230,부산광역시,부산진구,55-59세,30305,14579,15726
202009,26230,부산광역시,부산진구,55-59세,30116,14496,15620
202010,26230,부산광역시,부산진구,55-59세,30009,14450,15559
202011,26230,부산광역시,부산진구,55-59세,29949,14391,15558
202012,26230,부산광역시,부산진구,55-59세,29941,14398,15543
202101,26230,부산광역시,부산진구,55-59세,29655,14256,15399
202102,26230,부산광역시,부산진구,55-59세,29519,14207,15312
202103,26230,부산광역시,부산진구,55-59세,29275,14074,15201
202104,26230,부산광역시,부산진구,55-59세,29099,14031,15068
202105,26230,부산광역시,부산진구,55-59세,28880,13948,14932
202106,26230,부산광역시,부산진구,55-59세,28604,13808,14796
202007,26230,부산광역시,부산진구,60-64세,31075,14651,16424
202008,26230,부산광역시,부산진구,60-64세,31195,14688,16507
202009,26230,부산광역시,부산진구,60-64세,31323,14727,16596
202010,26230,부산광역시,부산진구,60-64세,31376,14773,16603
202011,26230,부산광역시,부산진구,60-64세,31536,14840,16696
202012,26230,부산광역시,부산진구,60-64세,31558,14848,16710
202101,26230,부산광역시,부산진구,60-64세,31711,14899,16812
202102,26230,부산광역시,부산진구,60-64세,31866,14960,16906
202103,26230,부산광역시,부산진구,60-64세,31814,14940,16874
202104,26230,부산광역시,부산진구,60-64세,31903,14942,16961
202105,26230,부산광역시,부산진구,60-64세,32032,15002,17030
202106,26230,부산광역시,부산진구,60-64세,32152,15046,17106
202007,26230,부산광역시,부산진구,65-69세,23542,11098,12444
202008,26230,부산광역시,부산진구,65-69세,23690,11150,12540
202009,26230,부산광역시,부산진구,65-69세,23856,11238,12618
202010,26230,부산광역시,부산진구,65-69세,24087,11318,12769
202011,26230,부산광역시,부산진구,65-69세,24270,11422,12848
202012,26230,부산광역시,부산진구,65-69세,24456,11508,12948
202101,26230,부산광역시,부산진구,65-69세,24587,11590,12997
202102,26230,부산광역시,부산진구,65-69세,24645,11600,13045
202103,26230,부산광역시,부산진구,65-69세,24461,11518,12943
202104,26230,부산광역시,부산진구,65-69세,24577,11569,13008
202105,26230,부산광역시,부산진구,65-69세,24629,11599,13030
202106,26230,부산광역시,부산진구,65-69세,24706,11635,13071
202007,26230,부산광역시,부산진구,70-74세,17652,7958,9694
202008,26230,부산광역시,부산진구,70-74세,17708,7990,9718
202009,26230,부산광역시,부산진구,70-74세,17742,8008,9734
202010,26230,부산광역시,부산진구,70-74세,17887,8100,9787
202011,26230,부산광역시,부산진구,70-74세,17969,8131,9838
202012,26230,부산광역시,부산진구,70-74세,18126,8203,9923
202101,26230,부산광역시,부산진구,70-74세,18266,8269,9997
202102,26230,부산광역시,부산진구,70-74세,18352,8316,10036
202103,26230,부산광역시,부산진구,70-74세,18168,8273,9895
202104,26230,부산광역시,부산진구,70-74세,18262,8326,9936
202105,26230,부산광역시,부산진구,70-74세,18335,8336,9999
202106,26230,부산광역시,부산진구,70-74세,18353,8344,10009
202007,26230,부산광역시,부산진구,75-79세,14019,5945,8074
202008,26230,부산광역시,부산진구,75-79세,13987,5949,8038
202009,26230,부산광역시,부산진구,75-79세,13905,5924,7981
202010,26230,부산광역시,부산진구,75-79세,13819,5909,7910
202011,26230,부산광역시,부산진구,75-79세,13746,5870,7876
202012,26230,부산광역시,부산진구,75-79세,13639,5828,7811
202101,26230,부산광역시,부산진구,75-79세,13561,5802,7759
202102,26230,부산광역시,부산진구,75-79세,13491,5764,7727
202103,26230,부산광역시,부산진구,75-79세,13262,5661,7601
202104,26230,부산광역시,부산진구,75-79세,13179,5630,7549
202105,26230,부산광역시,부산진구,75-79세,13154,5634,7520
202106,26230,부산광역시,부산진구,75-79세,13160,5638,7522
202007,26230,부산광역시,부산진구,80-84세,8758,3317,5441
202008,26230,부산광역시,부산진구,80-84세,8777,3325,5452
202009,26230,부산광역시,부산진구,80-84세,8832,3338,5494
202010,26230,부산광역시,부산진구,80-84세,8862,3341,5521
202011,26230,부산광역시,부산진구,80-84세,8885,3360,5525
202012,26230,부산광역시,부산진구,80-84세,8928,3368,5560
202101,26230,부산광역시,부산진구,80-84세,9004,3390,5614
202102,26230,부산광역시,부산진구,80-84세,9094,3430,5664
202103,26230,부산광역시,부산진구,80-84세,8981,3371,5610
202104,26230,부산광역시,부산진구,80-84세,9037,3405,5632
202105,26230,부산광역시,부산진구,80-84세,9106,3434,5672
202106,26230,부산광역시,부산진구,80-84세,9156,3463,5693
202007,26230,부산광역시,부산진구,85-89세,3819,1233,2586
202008,26230,부산광역시,부산진구,85-89세,3842,1229,2613
202009,26230,부산광역시,부산진구,85-89세,3885,1237,2648
202010,26230,부산광역시,부산진구,85-89세,3920,1253,2667
202011,26230,부산광역시,부산진구,85-89세,3943,1266,2677
202012,26230,부산광역시,부산진구,85-89세,3991,1295,2696
202101,26230,부산광역시,부산진구,85-89세,4014,1317,2697
202102,26230,부산광역시,부산진구,85-89세,4067,1339,2728
202103,26230,부산광역시,부산진구,85-89세,4039,1334,2705
202104,26230,부산광역시,부산진구,85-89세,4089,1345,2744
202105,26230,부산광역시,부산진구,85-89세,4111,1360,2751
202106,26230,부산광역시,부산진구,85-89세,4119,1366,2753
202007,26230,부산광역시,부산진구,90-94세,1212,281,931
202008,26230,부산광역시,부산진구,90-94세,1210,284,926
202009,26230,부산광역시,부산진구,90-94세,1220,289,931
202010,26230,부산광역시,부산진구,90-94세,1228,289,939
202011,26230,부산광역시,부산진구,90-94세,1233,291,942
202012,26230,부산광역시,부산진구,90-94세,1236,284,952
202101,26230,부산광역시,부산진구,90-94세,1269,287,982
202102,26230,부산광역시,부산진구,90-94세,1289,291,998
202103,26230,부산광역시,부산진구,90-94세,1225,254,971
202104,26230,부산광역시,부산진구,90-94세,1240,260,980
202105,26230,부산광역시,부산진구,90-94세,1246,262,984
202106,26230,부산광역시,부산진구,90-94세,1244,260,984
202007,26230,부산광역시,부산진구,95-99세,287,68,219
202008,26230,부산광역시,부산진구,95-99세,292,70,222
202009,26230,부산광역시,부산진구,95-99세,287,69,218
202010,26230,부산광역시,부산진구,95-99세,288,70,218
202011,26230,부산광역시,부산진구,95-99세,288,70,218
202012,26230,부산광역시,부산진구,95-99세,288,69,219
202101,26230,부산광역시,부산진구,95-99세,293,71,222
202102,26230,부산광역시,부산진구,95-99세,293,71,222
202103,26230,부산광역시,부산진구,95-99세,221,38,183
202104,26230,부산광역시,부산진구,95-99세,219,37,182
202105,26230,부산광역시,부산진구,95-99세,220,34,186
202106,26230,부산광역시,부산진구,95-99세,221,35,186
202007,26230,부산광역시,부산진구,100+,226,47,179
202008,26230,부산광역시,부산진구,100+,228,48,180
202009,26230,부산광역시,부산진구,100+,228,48,180
202010,26230,부산광역시,부산진구,100+,232,48,184
202011,26230,부산광역시,부산진구,100+,231,48,183
202012,26230,부산광역시,부산진구,100+,232,48,184
202101,26230,부산광역시,부산진구,100+,234,48,186
202102,26230,부산광역시,부산진구,100+,234,48,186
202103,26230,부산광역시,부산진구,100+,62,12,50
202104,26230,부산광역시,부산진구,100+,61,12,49
202105,26230,부산광역시,부산진구,100+,62,12,50
202106,26230,부산광역시,부산진구,100+,65,13,52
202007,26260,부산광역시,동래구,0-4세,8255,4226,4029
202008,26260,부산광역시,동래구,0-4세,8181,4191,3990
202009,26260,부산광역시,동래구,0-4세,8124,4169,3955
202010,26260,부산광역시,동래구,0-4세,8090,4148,3942
202011,26260,부산광역시,동래구,0-4세,8026,4123,3903
202012,26260,부산광역시,동래구,0-4세,7913,4053,3860
202101,26260,부산광역시,동래구,0-4세,7820,3992,3828
202102,26260,부산광역시,동래구,0-4세,7753,3956,3797
202103,26260,부산광역시,동래구,0-4세,7659,3908,3751
202104,26260,부산광역시,동래구,0-4세,7581,3864,3717
202105,26260,부산광역시,동래구,0-4세,7525,3846,3679
202106,26260,부산광역시,동래구,0-4세,7488,3829,3659
202007,26260,부산광역시,동래구,5-9세,11783,6137,5646
202008,26260,부산광역시,동래구,5-9세,11791,6129,5662
202009,26260,부산광역시,동래구,5-9세,11758,6121,5637
202010,26260,부산광역시,동래구,5-9세,11692,6093,5599
202011,26260,부산광역시,동래구,5-9세,11707,6104,5603
202012,26260,부산광역시,동래구,5-9세,11722,6124,5598
202101,26260,부산광역시,동래구,5-9세,11733,6126,5607
202102,26260,부산광역시,동래구,5-9세,11783,6145,5638
202103,26260,부산광역시,동래구,5-9세,11754,6125,5629
202104,26260,부산광역시,동래구,5-9세,11681,6086,5595
202105,26260,부산광역시,동래구,5-9세,11661,6058,5603
202106,26260,부산광역시,동래구,5-9세,11639,6050,5589
202007,26260,부산광역시,동래구,10-14세,12094,6320,5774
202008,26260,부산광역시,동래구,10-14세,12094,6326,5768
202009,26260,부산광역시,동래구,10-14세,12128,6333,5795
202010,26260,부산광역시,동래구,10-14세,12188,6353,5835
202011,26260,부산광역시,동래구,10-14세,12200,6354,5846
202012,26260,부산광역시,동래구,10-14세,12284,6398,5886
202101,26260,부산광역시,동래구,10-14세,12345,6439,5906
202102,26260,부산광역시,동래구,10-14세,12355,6449,5906
202103,26260,부산광역시,동래구,10-14세,12342,6454,5888
202104,26260,부산광역시,동래구,10-14세,12392,6472,5920
202105,26260,부산광역시,동래구,10-14세,12390,6475,5915
202106,26260,부산광역시,동래구,10-14세,12398,6472,5926
202007,26260,부산광역시,동래구,15-19세,13103,6868,6235
202008,26260,부산광역시,동래구,15-19세,13046,6833,6213
202009,26260,부산광역시,동래구,15-19세,12962,6782,6180
202010,26260,부산광역시,동래구,15-19세,12872,6754,6118
202011,26260,부산광역시,동래구,15-19세,12787,6691,6096
202012,26260,부산광역시,동래구,15-19세,12686,6603,6083
202101,26260,부산광역시,동래구,15-19세,12636,6575,6061
202102,26260,부산광역시,동래구,15-19세,12543,6542,6001
202103,26260,부산광역시,동래구,15-19세,12473,6479,5994
202104,26260,부산광역시,동래구,15-19세,12381,6438,5943
202105,26260,부산광역시,동래구,15-19세,12318,6401,5917
202106,26260,부산광역시,동래구,15-19세,12291,6375,5916
202007,26260,부산광역시,동래구,20-24세,16405,8584,7821
202008,26260,부산광역시,동래구,20-24세,16292,8535,7757
202009,26260,부산광역시,동래구,20-24세,16251,8510,7741
202010,26260,부산광역시,동래구,20-24세,16195,8479,7716
202011,26260,부산광역시,동래구,20-24세,16115,8433,7682
202012,26260,부산광역시,동래구,20-24세,15963,8385,7578
202101,26260,부산광역시,동래구,20-24세,15858,8329,7529
202102,26260,부산광역시,동래구,20-24세,15780,8255,7525
202103,26260,부산광역시,동래구,20-24세,15704,8216,7488
202104,26260,부산광역시,동래구,20-24세,15627,8163,7464
202105,26260,부산광역시,동래구,20-24세,15584,8144,7440
202106,26260,부산광역시,동래구,20-24세,15508,8123,7385
202007,26260,부산광역시,동래구,25-29세,16938,8917,8021
202008,26260,부산광역시,동래구,25-29세,16833,8834,7999
202009,26260,부산광역시,동래구,25-29세,16789,8825,7964
202010,26260,부산광역시,동래구,25-29세,16786,8829,7957
202011,26260,부산광역시,동래구,25-29세,16776,8787,7989
202012,26260,부산광역시,동래구,25-29세,16719,8716,8003
202101,26260,부산광역시,동래구,25-29세,16707,8716,7991
202102,26260,부산광역시,동래구,25-29세,16640,8683,7957
202103,26260,부산광역시,동래구,25-29세,16637,8689,7948
202104,26260,부산광역시,동래구,25-29세,16616,8673,7943
202105,26260,부산광역시,동래구,25-29세,16528,8634,7894
202106,26260,부산광역시,동래구,25-29세,16515,8609,7906
202007,26260,부산광역시,동래구,30-34세,15061,7682,7379
202008,26260,부산광역시,동래구,30-34세,15043,7661,7382
202009,26260,부산광역시,동래구,30-34세,15012,7635,7377
202010,26260,부산광역시,동래구,30-34세,14959,7581,7378
202011,26260,부산광역시,동래구,30-34세,14820,7550,7270
202012,26260,부산광역시,동래구,30-34세,14743,7510,7233
202101,26260,부산광역시,동래구,30-34세,14721,7493,7228
202102,26260,부산광역시,동래구,30-34세,14661,7486,7175
202103,26260,부산광역시,동래구,30-34세,14690,7516,7174
202104,26260,부산광역시,동래구,30-34세,14685,7491,7194
202105,26260,부산광역시,동래구,30-34세,14690,7507,7183
202106,26260,부산광역시,동래구,30-34세,14657,7492,7165
202007,26260,부산광역시,동래구,35-39세,18856,9350,9506
202008,26260,부산광역시,동래구,35-39세,18740,9287,9453
202009,26260,부산광역시,동래구,35-39세,18621,9233,9388
202010,26260,부산광역시,동래구,35-39세,18463,9151,9312
202011,26260,부산광역시,동래구,35-39세,18383,9096,9287
202012,26260,부산광역시,동래구,35-39세,18335,9069,9266
202101,26260,부산광역시,동래구,35-39세,18242,9023,9219
202102,26260,부산광역시,동래구,35-39세,18157,8993,9164
202103,26260,부산광역시,동래구,35-39세,17938,8883,9055
202104,26260,부산광역시,동래구,35-39세,17833,8840,8993
202105,26260,부산광역시,동래구,35-39세,17701,8759,8942
202106,26260,부산광역시,동래구,35-39세,17607,8711,8896
202007,26260,부산광역시,동래구,40-44세,20329,9831,10498
202008,26260,부산광역시,동래구,40-44세,20380,9859,10521
202009,26260,부산광역시,동래구,40-44세,20442,9902,10540
202010,26260,부산광역시,동래구,40-44세,20501,9940,10561
202011,26260,부산광역시,동래구,40-44세,20491,9943,10548
202012,26260,부산광역시,동래구,40-44세,20458,9946,10512
202101,26260,부산광역시,동래구,40-44세,20498,9966,10532
202102,26260,부산광역시,동래구,40-44세,20616,10055,10561
202103,26260,부산광역시,동래구,40-44세,20575,10074,10501
202104,26260,부산광역시,동래구,40-44세,20490,10019,10471
202105,26260,부산광역시,동래구,40-44세,20543,10068,10475
202106,26260,부산광역시,동래구,40-44세,20674,10132,10542
202007,26260,부산광역시,동래구,45-49세,23124,11323,11801
202008,26260,부산광역시,동래구,45-49세,23051,11278,11773
202009,26260,부산광역시,동래구,45-49세,22892,11214,11678
202010,26260,부산광역시,동래구,45-49세,22795,11144,11651
202011,26260,부산광역시,동래구,45-49세,22741,11129,11612
202012,26260,부산광역시,동래구,45-49세,22726,11118,11608
202101,26260,부산광역시,동래구,45-49세,22647,11092,11555
202102,26260,부산광역시,동래구,45-49세,22672,11098,11574
202103,26260,부산광역시,동래구,45-49세,22521,11008,11513
202104,26260,부산광역시,동래구,45-49세,22477,11013,11464
202105,26260,부산광역시,동래구,45-49세,22258,10889,11369
202106,26260,부산광역시,동래구,45-49세,22114,10832,11282
202007,26260,부산광역시,동래구,50-54세,22529,10899,11630
202008,26260,부산광역시,동래구,50-54세,22507,10883,11624
202009,26260,부산광역시,동래구,50-54세,22614,10936,11678
202010,26260,부산광역시,동래구,50-54세,22620,10970,11650
202011,26260,부산광역시,동래구,50-54세,22576,10932,11644
202012,26260,부산광역시,동래구,50-54세,22484,10912,11572
202101,26260,부산광역시,동래구,50-54세,22627,10983,11644
202102,26260,부산광역시,동래구,50-54세,22625,10963,11662
202103,26260,부산광역시,동래구,50-54세,22489,10897,11592
202104,26260,부산광역시,동래구,50-54세,22465,10877,11588
202105,26260,부산광역시,동래구,50-54세,22571,10929,11642
202106,26260,부산광역시,동래구,50-54세,22639,10954,11685
202007,26260,부산광역시,동래구,55-59세,22426,10434,11992
202008,26260,부산광역시,동래구,55-59세,22281,10352,11929
202009,26260,부산광역시,동래구,55-59세,22198,10326,11872
202010,26260,부산광역시,동래구,55-59세,22071,10267,11804
202011,26260,부산광역시,동래구,55-59세,21958,10246,11712
202012,26260,부산광역시,동래구,55-59세,21908,10197,11711
202101,26260,부산광역시,동래구,55-59세,21702,10099,11603
202102,26260,부산광역시,동래구,55-59세,21626,10070,11556
202103,26260,부산광역시,동래구,55-59세,21479,9995,11484
202104,26260,부산광역시,동래구,55-59세,21348,9942,11406
202105,26260,부산광역시,동래구,55-59세,21140,9841,11299
202106,26260,부산광역시,동래구,55-59세,20961,9772,11189
202007,26260,부산광역시,동래구,60-64세,22678,10593,12085
202008,26260,부산광역시,동래구,60-64세,22761,10653,12108
202009,26260,부산광역시,동래구,60-64세,22759,10638,12121
202010,26260,부산광역시,동래구,60-64세,22809,10643,12166
202011,26260,부산광역시,동래구,60-64세,22851,10650,12201
202012,26260,부산광역시,동래구,60-64세,22877,10682,12195
202101,26260,부산광역시,동래구,60-64세,22971,10759,12212
202102,26260,부산광역시,동래구,60-64세,23030,10799,12231
202103,26260,부산광역시,동래구,60-64세,22983,10778,12205
202104,26260,부산광역시,동래구,60-64세,23051,10787,12264
202105,26260,부산광역시,동래구,60-64세,23188,10855,12333
202106,26260,부산광역시,동래구,60-64세,23275,10899,12376
202007,26260,부산광역시,동래구,65-69세,17627,8178,9449
202008,26260,부산광역시,동래구,65-69세,17751,8224,9527
202009,26260,부산광역시,동래구,65-69세,17896,8280,9616
202010,26260,부산광역시,동래구,65-69세,17990,8321,9669
202011,26260,부산광역시,동래구,65-69세,18066,8343,9723
202012,26260,부산광역시,동래구,65-69세,18151,8365,9786
202101,26260,부산광역시,동래구,65-69세,18271,8399,9872
202102,26260,부산광역시,동래구,65-69세,18342,8419,9923
202103,26260,부산광역시,동래구,65-69세,18351,8443,9908
202104,26260,부산광역시,동래구,65-69세,18355,8422,9933
202105,26260,부산광역시,동래구,65-69세,18367,8416,9951
202106,26260,부산광역시,동래구,65-69세,18405,8429,9976
202007,26260,부산광역시,동래구,70-74세,12737,5953,6784
202008,26260,부산광역시,동래구,70-74세,12767,5951,6816
202009,26260,부산광역시,동래구,70-74세,12846,5981,6865
202010,26260,부산광역시,동래구,70-74세,12924,6025,6899
202011,26260,부산광역시,동래구,70-74세,12992,6046,6946
202012,26260,부산광역시,동래구,70-74세,13095,6078,7017
202101,26260,부산광역시,동래구,70-74세,13168,6084,7084
202102,26260,부산광역시,동래구,70-74세,13304,6159,7145
202103,26260,부산광역시,동래구,70-74세,13281,6150,7131
202104,26260,부산광역시,동래구,70-74세,13378,6195,7183
202105,26260,부산광역시,동래구,70-74세,13453,6231,7222
202106,26260,부산광역시,동래구,70-74세,13476,6210,7266
202007,26260,부산광역시,동래구,75-79세,9383,4240,5143
202008,26260,부산광역시,동래구,75-79세,9398,4252,5146
202009,26260,부산광역시,동래구,75-79세,9354,4237,5117
202010,26260,부산광역시,동래구,75-79세,9301,4215,5086
202011,26260,부산광역시,동래구,75-79세,9287,4224,5063
202012,26260,부산광역시,동래구,75-79세,9196,4184,5012
202101,26260,부산광역시,동래구,75-79세,9166,4187,4979
202102,26260,부산광역시,동래구,75-79세,9111,4152,4959
202103,26260,부산광역시,동래구,75-79세,9048,4130,4918
202104,26260,부산광역시,동래구,75-79세,8974,4098,4876
202105,26260,부산광역시,동래구,75-79세,8978,4102,4876
202106,26260,부산광역시,동래구,75-79세,8975,4113,4862
202007,26260,부산광역시,동래구,80-84세,5479,2246,3233
202008,26260,부산광역시,동래구,80-84세,5504,2255,3249
202009,26260,부산광역시,동래구,80-84세,5535,2274,3261
202010,26260,부산광역시,동래구,80-84세,5568,2282,3286
202011,26260,부산광역시,동래구,80-84세,5585,2304,3281
202012,26260,부산광역시,동래구,80-84세,5634,2313,3321
202101,26260,부산광역시,동래구,80-84세,5681,2342,3339
202102,26260,부산광역시,동래구,80-84세,5733,2365,3368
202103,26260,부산광역시,동래구,80-84세,5753,2381,3372
202104,26260,부산광역시,동래구,80-84세,5803,2399,3404
202105,26260,부산광역시,동래구,80-84세,5807,2398,3409
202106,26260,부산광역시,동래구,80-84세,5860,2414,3446
202007,26260,부산광역시,동래구,85-89세,2532,777,1755
202008,26260,부산광역시,동래구,85-89세,2534,779,1755
202009,26260,부산광역시,동래구,85-89세,2567,787,1780
202010,26260,부산광역시,동래구,85-89세,2583,794,1789
202011,26260,부산광역시,동래구,85-89세,2606,796,1810
202012,26260,부산광역시,동래구,85-89세,2619,807,1812
202101,26260,부산광역시,동래구,85-89세,2655,814,1841
202102,26260,부산광역시,동래구,85-89세,2697,837,1860
202103,26260,부산광역시,동래구,85-89세,2685,826,1859
202104,26260,부산광역시,동래구,85-89세,2725,852,1873
202105,26260,부산광역시,동래구,85-89세,2770,873,1897
202106,26260,부산광역시,동래구,85-89세,2773,880,1893
202007,26260,부산광역시,동래구,90-94세,881,200,681
202008,26260,부산광역시,동래구,90-94세,892,203,689
202009,26260,부산광역시,동래구,90-94세,887,204,683
202010,26260,부산광역시,동래구,90-94세,888,206,682
202011,26260,부산광역시,동래구,90-94세,882,203,679
202012,26260,부산광역시,동래구,90-94세,891,206,685
202101,26260,부산광역시,동래구,90-94세,900,209,691
202102,26260,부산광역시,동래구,90-94세,906,216,690
202103,26260,부산광역시,동래구,90-94세,886,212,674
202104,26260,부산광역시,동래구,90-94세,877,206,671
202105,26260,부산광역시,동래구,90-94세,883,201,682
202106,26260,부산광역시,동래구,90-94세,876,201,675
202007,26260,부산광역시,동래구,95-99세,198,43,155
202008,26260,부산광역시,동래구,95-99세,199,44,155
202009,26260,부산광역시,동래구,95-99세,209,47,162
202010,26260,부산광역시,동래구,95-99세,202,45,157
202011,26260,부산광역시,동래구,95-99세,201,46,155
202012,26260,부산광역시,동래구,95-99세,202,47,155
202101,26260,부산광역시,동래구,95-99세,208,49,159
202102,26260,부산광역시,동래구,95-99세,203,48,155
202103,26260,부산광역시,동래구,95-99세,179,33,146
202104,26260,부산광역시,동래구,95-99세,184,30,154
202105,26260,부산광역시,동래구,95-99세,188,32,156
202106,26260,부산광역시,동래구,95-99세,188,32,156
202007,26260,부산광역시,동래구,100+,136,22,114
202008,26260,부산광역시,동래구,100+,137,22,115
202009,26260,부산광역시,동래구,100+,136,22,114
202010,26260,부산광역시,동래구,100+,136,22,114
202011,26260,부산광역시,동래구,100+,137,22,115
202012,26260,부산광역시,동래구,100+,139,22,117
202101,26260,부산광역시,동래구,100+,139,22,117
202102,26260,부산광역시,동래구,100+,141,22,119
202103,26260,부산광역시,동래구,100+,70,10,60
202104,26260,부산광역시,동래구,100+,73,13,60
202105,26260,부산광역시,동래구,100+,73,13,60
202106,26260,부산광역시,동래구,100+,72,13,59
202007,26290,부산광역시,남구,0-4세,7498,3818,3680
202008,26290,부산광역시,남구,0-4세,7446,3799,3647
202009,26290,부산광역시,남구,0-4세,7327,3736,3591
202010,26290,부산광역시,남구,0-4세,7220,3690,3530
202011,26290,부산광역시,남구,0-4세,7125,3631,3494
202012,26290,부산광역시,남구,0-4세,7042,3599,3443
202101,26290,부산광역시,남구,0-4세,6937,3545,3392
202102,26290,부산광역시,남구,0-4세,6815,3490,3325
202103,26290,부산광역시,남구,0-4세,6792,3475,3317
202104,26290,부산광역시,남구,0-4세,6709,3432,3277
202105,26290,부산광역시,남구,0-4세,6586,3366,3220
202106,26290,부산광역시,남구,0-4세,6520,3333,3187
202007,26290,부산광역시,남구,5-9세,11122,5664,5458
202008,26290,부산광역시,남구,5-9세,11056,5603,5453
202009,26290,부산광역시,남구,5-9세,11052,5604,5448
202010,26290,부산광역시,남구,5-9세,11029,5583,5446
202011,26290,부산광역시,남구,5-9세,11005,5597,5408
202012,26290,부산광역시,남구,5-9세,11010,5611,5399
202101,26290,부산광역시,남구,5-9세,10952,5595,5357
202102,26290,부산광역시,남구,5-9세,10945,5579,5366
202103,26290,부산광역시,남구,5-9세,10887,5537,5350
202104,26290,부산광역시,남구,5-9세,10831,5505,5326
202105,26290,부산광역시,남구,5-9세,10797,5503,5294
202106,26290,부산광역시,남구,5-9세,10742,5468,5274
202007,26290,부산광역시,남구,10-14세,11110,5721,5389
202008,26290,부산광역시,남구,10-14세,11114,5739,5375
202009,26290,부산광역시,남구,10-14세,11140,5757,5383
202010,26290,부산광역시,남구,10-14세,11147,5766,5381
202011,26290,부산광역시,남구,10-14세,11145,5748,5397
202012,26290,부산광역시,남구,10-14세,11107,5716,5391
202101,26290,부산광역시,남구,10-14세,11153,5750,5403
202102,26290,부산광역시,남구,10-14세,11142,5759,5383
202103,26290,부산광역시,남구,10-14세,11155,5766,5389
202104,26290,부산광역시,남구,10-14세,11154,5769,5385
202105,26290,부산광역시,남구,10-14세,11176,5756,5420
202106,26290,부산광역시,남구,10-14세,11163,5760,5403
202007,26290,부산광역시,남구,15-19세,12440,6432,6008
202008,26290,부산광역시,남구,15-19세,12319,6394,5925
202009,26290,부산광역시,남구,15-19세,12205,6335,5870
202010,26290,부산광역시,남구,15-19세,12075,6283,5792
202011,26290,부산광역시,남구,15-19세,12015,6267,5748
202012,26290,부산광역시,남구,15-19세,11928,6221,5707
202101,26290,부산광역시,남구,15-19세,11806,6155,5651
202102,26290,부산광역시,남구,15-19세,11754,6086,5668
202103,26290,부산광역시,남구,15-19세,11709,6040,5669
202104,26290,부산광역시,남구,15-19세,11636,5988,5648
202105,26290,부산광역시,남구,15-19세,11583,5979,5604
202106,26290,부산광역시,남구,15-19세,11544,5955,5589
202007,26290,부산광역시,남구,20-24세,18327,9550,8777
202008,26290,부산광역시,남구,20-24세,18282,9517,8765
202009,26290,부산광역시,남구,20-24세,18267,9494,8773
202010,26290,부산광역시,남구,20-24세,18220,9431,8789
202011,26290,부산광역시,남구,20-24세,18190,9401,8789
202012,26290,부산광역시,남구,20-24세,18159,9337,8822
202101,26290,부산광역시,남구,20-24세,18114,9299,8815
202102,26290,부산광역시,남구,20-24세,18124,9354,8770
202103,26290,부산광역시,남구,20-24세,18101,9359,8742
202104,26290,부산광역시,남구,20-24세,18043,9307,8736
202105,26290,부산광역시,남구,20-24세,17968,9259,8709
202106,26290,부산광역시,남구,20-24세,17872,9212,8660
202007,26290,부산광역시,남구,25-29세,17042,9220,7822
202008,26290,부산광역시,남구,25-29세,17054,9211,7843
202009,26290,부산광역시,남구,25-29세,17115,9265,7850
202010,26290,부산광역시,남구,25-29세,17143,9314,7829
202011,26290,부산광역시,남구,25-29세,17098,9282,7816
202012,26290,부산광역시,남구,25-29세,17080,9280,7800
202101,26290,부산광역시,남구,25-29세,16958,9215,7743
202102,26290,부산광역시,남구,25-29세,16871,9165,7706
202103,26290,부산광역시,남구,25-29세,16848,9147,7701
202104,26290,부산광역시,남구,25-29세,16829,9159,7670
202105,26290,부산광역시,남구,25-29세,16844,9161,7683
202106,26290,부산광역시,남구,25-29세,16742,9115,7627
202007,26290,부산광역시,남구,30-34세,13515,7048,6467
202008,26290,부산광역시,남구,30-34세,13478,7027,6451
202009,26290,부산광역시,남구,30-34세,13480,7032,6448
202010,26290,부산광역시,남구,30-34세,13406,7010,6396
202011,26290,부산광역시,남구,30-34세,13373,6988,6385
202012,26290,부산광역시,남구,30-34세,13333,6973,6360
202101,26290,부산광역시,남구,30-34세,13327,6960,6367
202102,26290,부산광역시,남구,30-34세,13342,7001,6341
202103,26290,부산광역시,남구,30-34세,13289,6976,6313
202104,26290,부산광역시,남구,30-34세,13273,6967,6306
202105,26290,부산광역시,남구,30-34세,13235,6937,6298
202106,26290,부산광역시,남구,30-34세,13231,6898,6333
202007,26290,부산광역시,남구,35-39세,17602,8884,8718
202008,26290,부산광역시,남구,35-39세,17414,8787,8627
202009,26290,부산광역시,남구,35-39세,17267,8711,8556
202010,26290,부산광역시,남구,35-39세,17092,8618,8474
202011,26290,부산광역시,남구,35-39세,16939,8538,8401
202012,26290,부산광역시,남구,35-39세,16853,8503,8350
202101,26290,부산광역시,남구,35-39세,16717,8421,8296
202102,26290,부산광역시,남구,35-39세,16513,8308,8205
202103,26290,부산광역시,남구,35-39세,16353,8229,8124
202104,26290,부산광역시,남구,35-39세,16127,8130,7997
202105,26290,부산광역시,남구,35-39세,15909,8039,7870
202106,26290,부산광역시,남구,35-39세,15778,7982,7796
202007,26290,부산광역시,남구,40-44세,19616,9745,9871
202008,26290,부산광역시,남구,40-44세,19643,9750,9893
202009,26290,부산광역시,남구,40-44세,19675,9756,9919
202010,26290,부산광역시,남구,40-44세,19706,9761,9945
202011,26290,부산광역시,남구,40-44세,19698,9781,9917
202012,26290,부산광역시,남구,40-44세,19610,9753,9857
202101,26290,부산광역시,남구,40-44세,19652,9761,9891
202102,26290,부산광역시,남구,40-44세,19642,9751,9891
202103,26290,부산광역시,남구,40-44세,19565,9725,9840
202104,26290,부산광역시,남구,40-44세,19600,9740,9860
202105,26290,부산광역시,남구,40-44세,19598,9724,9874
202106,26290,부산광역시,남구,40-44세,19629,9717,9912
202007,26290,부산광역시,남구,45-49세,22905,11563,11342
202008,26290,부산광역시,남구,45-49세,22733,11481,11252
202009,26290,부산광역시,남구,45-49세,22567,11388,11179
202010,26290,부산광역시,남구,45-49세,22419,11353,11066
202011,26290,부산광역시,남구,45-49세,22349,11340,11009
202012,26290,부산광역시,남구,45-49세,22283,11302,10981
202101,26290,부산광역시,남구,45-49세,22148,11215,10933
202102,26290,부산광역시,남구,45-49세,22064,11176,10888
202103,26290,부산광역시,남구,45-49세,21890,11093,10797
202104,26290,부산광역시,남구,45-49세,21798,11044,10754
202105,26290,부산광역시,남구,45-49세,21677,11002,10675
202106,26290,부산광역시,남구,45-49세,21502,10921,10581
202007,26290,부산광역시,남구,50-54세,21930,10832,11098
202008,26290,부산광역시,남구,50-54세,21956,10858,11098
202009,26290,부산광역시,남구,50-54세,21942,10864,11078
202010,26290,부산광역시,남구,50-54세,22053,10905,11148
202011,26290,부산광역시,남구,50-54세,22069,10903,11166
202012,26290,부산광역시,남구,50-54세,22019,10901,11118
202101,26290,부산광역시,남구,50-54세,22108,10954,11154
202102,26290,부산광역시,남구,50-54세,22120,10951,11169
202103,26290,부산광역시,남구,50-54세,22000,10894,11106
202104,26290,부산광역시,남구,50-54세,22007,10902,11105
202105,26290,부산광역시,남구,50-54세,22068,10911,11157
202106,26290,부산광역시,남구,50-54세,22164,10966,11198
202007,26290,부산광역시,남구,55-59세,21363,10226,11137
202008,26290,부산광역시,남구,55-59세,21224,10170,11054
202009,26290,부산광역시,남구,55-59세,21117,10115,11002
202010,26290,부산광역시,남구,55-59세,20941,10062,10879
202011,26290,부산광역시,남구,55-59세,20812,10004,10808
202012,26290,부산광역시,남구,55-59세,20780,9968,10812
202101,26290,부산광역시,남구,55-59세,20676,9931,10745
202102,26290,부산광역시,남구,55-59세,20641,9925,10716
202103,26290,부산광역시,남구,55-59세,20483,9887,10596
202104,26290,부산광역시,남구,55-59세,20379,9839,10540
202105,26290,부산광역시,남구,55-59세,20249,9794,10455
202106,26290,부산광역시,남구,55-59세,20090,9705,10385
202007,26290,부산광역시,남구,60-64세,22586,10403,12183
202008,26290,부산광역시,남구,60-64세,22626,10393,12233
202009,26290,부산광역시,남구,60-64세,22654,10412,12242
202010,26290,부산광역시,남구,60-64세,22675,10428,12247
202011,26290,부산광역시,남구,60-64세,22667,10417,12250
202012,26290,부산광역시,남구,60-64세,22629,10383,12246
202101,26290,부산광역시,남구,60-64세,22670,10420,12250
202102,26290,부산광역시,남구,60-64세,22717,10448,12269
202103,26290,부산광역시,남구,60-64세,22688,10432,12256
202104,26290,부산광역시,남구,60-64세,22666,10440,12226
202105,26290,부산광역시,남구,60-64세,22687,10445,12242
202106,26290,부산광역시,남구,60-64세,22730,10500,12230
202007,26290,부산광역시,남구,65-69세,17819,8238,9581
202008,26290,부산광역시,남구,65-69세,17918,8289,9629
202009,26290,부산광역시,남구,65-69세,18005,8303,9702
202010,26290,부산광역시,남구,65-69세,18103,8328,9775
202011,26290,부산광역시,남구,65-69세,18217,8394,9823
202012,26290,부산광역시,남구,65-69세,18289,8439,9850
202101,26290,부산광역시,남구,65-69세,18364,8459,9905
202102,26290,부산광역시,남구,65-69세,18404,8460,9944
202103,26290,부산광역시,남구,65-69세,18335,8429,9906
202104,26290,부산광역시,남구,65-69세,18393,8457,9936
202105,26290,부산광역시,남구,65-69세,18428,8475,9953
202106,26290,부산광역시,남구,65-69세,18465,8484,9981
202007,26290,부산광역시,남구,70-74세,13858,6265,7593
202008,26290,부산광역시,남구,70-74세,13901,6295,7606
202009,26290,부산광역시,남구,70-74세,13964,6329,7635
202010,26290,부산광역시,남구,70-74세,14024,6361,7663
202011,26290,부산광역시,남구,70-74세,14075,6376,7699
202012,26290,부산광역시,남구,70-74세,14164,6408,7756
202101,26290,부산광역시,남구,70-74세,14245,6443,7802
202102,26290,부산광역시,남구,70-74세,14327,6486,7841
202103,26290,부산광역시,남구,70-74세,14226,6446,7780
202104,26290,부산광역시,남구,70-74세,14279,6444,7835
202105,26290,부산광역시,남구,70-74세,14334,6465,7869
202106,26290,부산광역시,남구,70-74세,14359,6467,7892
202007,26290,부산광역시,남구,75-79세,10954,4839,6115
202008,26290,부산광역시,남구,75-79세,10973,4845,6128
202009,26290,부산광역시,남구,75-79세,10929,4833,6096
202010,26290,부산광역시,남구,75-79세,10840,4786,6054
202011,26290,부산광역시,남구,75-79세,10791,4762,6029
202012,26290,부산광역시,남구,75-79세,10719,4733,5986
202101,26290,부산광역시,남구,75-79세,10706,4724,5982
202102,26290,부산광역시,남구,75-79세,10639,4704,5935
202103,26290,부산광역시,남구,75-79세,10606,4690,5916
202104,26290,부산광역시,남구,75-79세,10580,4696,5884
202105,26290,부산광역시,남구,75-79세,10575,4712,5863
202106,26290,부산광역시,남구,75-79세,10557,4696,5861
202007,26290,부산광역시,남구,80-84세,6454,2625,3829
202008,26290,부산광역시,남구,80-84세,6483,2639,3844
202009,26290,부산광역시,남구,80-84세,6512,2650,3862
202010,26290,부산광역시,남구,80-84세,6564,2683,3881
202011,26290,부산광역시,남구,80-84세,6598,2694,3904
202012,26290,부산광역시,남구,80-84세,6604,2705,3899
202101,26290,부산광역시,남구,80-84세,6646,2722,3924
202102,26290,부산광역시,남구,80-84세,6686,2735,3951
202103,26290,부산광역시,남구,80-84세,6669,2742,3927
202104,26290,부산광역시,남구,80-84세,6695,2744,3951
202105,26290,부산광역시,남구,80-84세,6743,2762,3981
202106,26290,부산광역시,남구,80-84세,6786,2787,3999
202007,26290,부산광역시,남구,85-89세,2712,866,1846
202008,26290,부산광역시,남구,85-89세,2735,882,1853
202009,26290,부산광역시,남구,85-89세,2764,889,1875
202010,26290,부산광역시,남구,85-89세,2784,895,1889
202011,26290,부산광역시,남구,85-89세,2824,915,1909
202012,26290,부산광역시,남구,85-89세,2863,934,1929
202101,26290,부산광역시,남구,85-89세,2894,950,1944
202102,26290,부산광역시,남구,85-89세,2941,963,1978
202103,26290,부산광역시,남구,85-89세,2969,962,2007
202104,26290,부산광역시,남구,85-89세,2996,972,2024
202105,26290,부산광역시,남구,85-89세,3017,982,2035
202106,26290,부산광역시,남구,85-89세,3021,981,2040
202007,26290,부산광역시,남구,90-94세,946,200,746
202008,26290,부산광역시,남구,90-94세,938,197,741
202009,26290,부산광역시,남구,90-94세,936,201,735
202010,26290,부산광역시,남구,90-94세,939,206,733
202011,26290,부산광역시,남구,90-94세,926,203,723
202012,26290,부산광역시,남구,90-94세,926,202,724
202101,26290,부산광역시,남구,90-94세,937,205,732
202102,26290,부산광역시,남구,90-94세,960,214,746
202103,26290,부산광역시,남구,90-94세,941,207,734
202104,26290,부산광역시,남구,90-94세,946,207,739
202105,26290,부산광역시,남구,90-94세,952,207,745
202106,26290,부산광역시,남구,90-94세,952,208,744
202007,26290,부산광역시,남구,95-99세,190,46,144
202008,26290,부산광역시,남구,95-99세,197,48,149
202009,26290,부산광역시,남구,95-99세,195,47,148
202010,26290,부산광역시,남구,95-99세,195,46,149
202011,26290,부산광역시,남구,95-99세,197,47,150
202012,26290,부산광역시,남구,95-99세,196,46,150
202101,26290,부산광역시,남구,95-99세,207,45,162
202102,26290,부산광역시,남구,95-99세,209,45,164
202103,26290,부산광역시,남구,95-99세,188,31,157
202104,26290,부산광역시,남구,95-99세,186,31,155
202105,26290,부산광역시,남구,95-99세,187,31,156
202106,26290,부산광역시,남구,95-99세,185,31,154
202007,26290,부산광역시,남구,100+,136,24,112
202008,26290,부산광역시,남구,100+,136,24,112
202009,26290,부산광역시,남구,100+,138,24,114
202010,26290,부산광역시,남구,100+,136,24,112
202011,26290,부산광역시,남구,100+,136,22,114
202012,26290,부산광역시,남구,100+,137,23,114
202101,26290,부산광역시,남구,100+,134,23,111
202102,26290,부산광역시,남구,100+,133,23,110
202103,26290,부산광역시,남구,100+,65,13,52
202104,26290,부산광역시,남구,100+,67,13,54
202105,26290,부산광역시,남구,100+,66,13,53
202106,26290,부산광역시,남구,100+,66,13,53
202007,26320,부산광역시,북구,0-4세,8667,4471,4196
202008,26320,부산광역시,북구,0-4세,8535,4400,4135
202009,26320,부산광역시,북구,0-4세,8447,4346,4101
202010,26320,부산광역시,북구,0-4세,8321,4293,4028
202011,26320,부산광역시,북구,0-4세,8236,4262,3974
202012,26320,부산광역시,북구,0-4세,8158,4200,3958
202101,26320,부산광역시,북구,0-4세,8008,4125,3883
202102,26320,부산광역시,북구,0-4세,7901,4061,3840
202103,26320,부산광역시,북구,0-4세,7819,4019,3800
202104,26320,부산광역시,북구,0-4세,7768,3998,3770
202105,26320,부산광역시,북구,0-4세,7848,4046,3802
202106,26320,부산광역시,북구,0-4세,7839,4047,3792
202007,26320,부산광역시,북구,5-9세,11068,5686,5382
202008,26320,부산광역시,북구,5-9세,11022,5685,5337
202009,26320,부산광역시,북구,5-9세,10979,5680,5299
202010,26320,부산광역시,북구,5-9세,10914,5641,5273
202011,26320,부산광역시,북구,5-9세,10871,5627,5244
202012,26320,부산광역시,북구,5-9세,10836,5622,5214
202101,26320,부산광역시,북구,5-9세,10813,5603,5210
202102,26320,부산광역시,북구,5-9세,10789,5598,5191
202103,26320,부산광역시,북구,5-9세,10770,5580,5190
202104,26320,부산광역시,북구,5-9세,10824,5608,5216
202105,26320,부산광역시,북구,5-9세,10847,5612,5235
202106,26320,부산광역시,북구,5-9세,10850,5607,5243
202007,26320,부산광역시,북구,10-14세,10875,5650,5225
202008,26320,부산광역시,북구,10-14세,10815,5613,5202
202009,26320,부산광역시,북구,10-14세,10827,5605,5222
202010,26320,부산광역시,북구,10-14세,10859,5616,5243
202011,26320,부산광역시,북구,10-14세,10843,5600,5243
202012,26320,부산광역시,북구,10-14세,10768,5571,5197
202101,26320,부산광역시,북구,10-14세,10753,5569,5184
202102,26320,부산광역시,북구,10-14세,10710,5531,5179
202103,26320,부산광역시,북구,10-14세,10721,5535,5186
202104,26320,부산광역시,북구,10-14세,10723,5543,5180
202105,26320,부산광역시,북구,10-14세,10744,5557,5187
202106,26320,부산광역시,북구,10-14세,10756,5554,5202
202007,26320,부산광역시,북구,15-19세,13208,6888,6320
202008,26320,부산광역시,북구,15-19세,13079,6806,6273
202009,26320,부산광역시,북구,15-19세,12933,6735,6198
202010,26320,부산광역시,북구,15-19세,12775,6671,6104
202011,26320,부산광역시,북구,15-19세,12649,6614,6035
202012,26320,부산광역시,북구,15-19세,12533,6555,5978
202101,26320,부산광역시,북구,15-19세,12428,6510,5918
202102,26320,부산광역시,북구,15-19세,12323,6462,5861
202103,26320,부산광역시,북구,15-19세,12173,6365,5808
202104,26320,부산광역시,북구,15-19세,12092,6336,5756
202105,26320,부산광역시,북구,15-19세,12038,6305,5733
202106,26320,부산광역시,북구,15-19세,12000,6292,5708
202007,26320,부산광역시,북구,20-24세,18846,10126,8720
202008,26320,부산광역시,북구,20-24세,18709,10061,8648
202009,26320,부산광역시,북구,20-24세,18588,10023,8565
202010,26320,부산광역시,북구,20-24세,18434,9930,8504
202011,26320,부산광역시,북구,20-24세,18259,9819,8440
202012,26320,부산광역시,북구,20-24세,18105,9743,8362
202101,26320,부산광역시,북구,20-24세,17943,9637,8306
202102,26320,부산광역시,북구,20-24세,17806,9541,8265
202103,26320,부산광역시,북구,20-24세,17657,9478,8179
202104,26320,부산광역시,북구,20-24세,17571,9451,8120
202105,26320,부산광역시,북구,20-24세,17561,9441,8120
202106,26320,부산광역시,북구,20-24세,17486,9415,8071
202007,26320,부산광역시,북구,25-29세,19689,10578,9111
202008,26320,부산광역시,북구,25-29세,19640,10573,9067
202009,26320,부산광역시,북구,25-29세,19631,10564,9067
202010,26320,부산광역시,북구,25-29세,19583,10580,9003
202011,26320,부산광역시,북구,25-29세,19557,10565,8992
202012,26320,부산광역시,북구,25-29세,19480,10523,8957
202101,26320,부산광역시,북구,25-29세,19440,10473,8967
202102,26320,부산광역시,북구,25-29세,19251,10369,8882
202103,26320,부산광역시,북구,25-29세,19187,10328,8859
202104,26320,부산광역시,북구,25-29세,19138,10280,8858
202105,26320,부산광역시,북구,25-29세,19175,10298,8877
202106,26320,부산광역시,북구,25-29세,19225,10294,8931
202007,26320,부산광역시,북구,30-34세,16255,8444,7811
202008,26320,부산광역시,북구,30-34세,16132,8368,7764
202009,26320,부산광역시,북구,30-34세,16097,8354,7743
202010,26320,부산광역시,북구,30-34세,16044,8302,7742
202011,26320,부산광역시,북구,30-34세,15983,8273,7710
202012,26320,부산광역시,북구,30-34세,15880,8214,7666
202101,26320,부산광역시,북구,30-34세,15862,8213,7649
202102,26320,부산광역시,북구,30-34세,15875,8226,7649
202103,26320,부산광역시,북구,30-34세,15855,8223,7632
202104,26320,부산광역시,북구,30-34세,15994,8303,7691
202105,26320,부산광역시,북구,30-34세,16209,8417,7792
202106,26320,부산광역시,북구,30-34세,16313,8481,7832
202007,26320,부산광역시,북구,35-39세,18487,9568,8919
202008,26320,부산광역시,북구,35-39세,18308,9460,8848
202009,26320,부산광역시,북구,35-39세,18181,9397,8784
202010,26320,부산광역시,북구,35-39세,17948,9292,8656
202011,26320,부산광역시,북구,35-39세,17780,9229,8551
202012,26320,부산광역시,북구,35-39세,17637,9154,8483
202101,26320,부산광역시,북구,35-39세,17553,9094,8459
202102,26320,부산광역시,북구,35-39세,17420,9022,8398
202103,26320,부산광역시,북구,35-39세,17239,8948,8291
202104,26320,부산광역시,북구,35-39세,17285,8986,8299
202105,26320,부산광역시,북구,35-39세,17370,9046,8324
202106,26320,부산광역시,북구,35-39세,17367,9055,8312
202007,26320,부산광역시,북구,40-44세,18847,9619,9228
202008,26320,부산광역시,북구,40-44세,18791,9589,9202
202009,26320,부산광역시,북구,40-44세,18808,9582,9226
202010,26320,부산광역시,북구,40-44세,18817,9585,9232
202011,26320,부산광역시,북구,40-44세,18803,9575,9228
202012,26320,부산광역시,북구,40-44세,18742,9571,9171
202101,26320,부산광역시,북구,40-44세,18706,9574,9132
202102,26320,부산광역시,북구,40-44세,18701,9552,9149
202103,26320,부산광역시,북구,40-44세,18694,9537,9157
202104,26320,부산광역시,북구,40-44세,18740,9559,9181
202105,26320,부산광역시,북구,40-44세,18943,9679,9264
202106,26320,부산광역시,북구,40-44세,19054,9731,9323
202007,26320,부산광역시,북구,45-49세,22454,10799,11655
202008,26320,부산광역시,북구,45-49세,22299,10739,11560
202009,26320,부산광역시,북구,45-49세,22127,10665,11462
202010,26320,부산광역시,북구,45-49세,21927,10590,11337
202011,26320,부산광역시,북구,45-49세,21819,10542,11277
202012,26320,부산광역시,북구,45-49세,21743,10498,11245
202101,26320,부산광역시,북구,45-49세,21601,10432,11169
202102,26320,부산광역시,북구,45-49세,21485,10408,11077
202103,26320,부산광역시,북구,45-49세,21358,10368,10990
202104,26320,부산광역시,북구,45-49세,21322,10343,10979
202105,26320,부산광역시,북구,45-49세,21192,10282,10910
202106,26320,부산광역시,북구,45-49세,21071,10226,10845
202007,26320,부산광역시,북구,50-54세,26470,12382,14088
202008,26320,부산광역시,북구,50-54세,26444,12376,14068
202009,26320,부산광역시,북구,50-54세,26370,12340,14030
202010,26320,부산광역시,북구,50-54세,26305,12285,14020
202011,26320,부산광역시,북구,50-54세,26222,12220,14002
202012,26320,부산광역시,북구,50-54세,25985,12118,13867
202101,26320,부산광역시,북구,50-54세,25974,12134,13840
202102,26320,부산광역시,북구,50-54세,25876,12065,13811
202103,26320,부산광역시,북구,50-54세,25677,11948,13729
202104,26320,부산광역시,북구,50-54세,25603,11917,13686
202105,26320,부산광역시,북구,50-54세,25670,11935,13735
202106,26320,부산광역시,북구,50-54세,25762,11976,13786
202007,26320,부산광역시,북구,55-59세,28609,13975,14634
202008,26320,부산광역시,북구,55-59세,28446,13854,14592
202009,26320,부산광역시,북구,55-59세,28382,13819,14563
202010,26320,부산광역시,북구,55-59세,28230,13741,14489
202011,26320,부산광역시,북구,55-59세,28126,13691,14435
202012,26320,부산광역시,북구,55-59세,27966,13585,14381
202101,26320,부산광역시,북구,55-59세,27764,13458,14306
202102,26320,부산광역시,북구,55-59세,27613,13358,14255
202103,26320,부산광역시,북구,55-59세,27386,13271,14115
202104,26320,부산광역시,북구,55-59세,27256,13208,14048
202105,26320,부산광역시,북구,55-59세,27176,13141,14035
202106,26320,부산광역시,북구,55-59세,27040,13060,13980
202007,26320,부산광역시,북구,60-64세,26284,13081,13203
202008,26320,부산광역시,북구,60-64세,26405,13137,13268
202009,26320,부산광역시,북구,60-64세,26421,13150,13271
202010,26320,부산광역시,북구,60-64세,26606,13222,13384
202011,26320,부산광역시,북구,60-64세,26722,13290,13432
202012,26320,부산광역시,북구,60-64세,26815,13354,13461
202101,26320,부산광역시,북구,60-64세,26965,13432,13533
202102,26320,부산광역시,북구,60-64세,27131,13512,13619
202103,26320,부산광역시,북구,60-64세,27328,13563,13765
202104,26320,부산광역시,북구,60-64세,27510,13646,13864
202105,26320,부산광역시,북구,60-64세,27748,13772,13976
202106,26320,부산광역시,북구,60-64세,27960,13867,14093
202007,26320,부산광역시,북구,65-69세,17879,8680,9199
202008,26320,부산광역시,북구,65-69세,17989,8759,9230
202009,26320,부산광역시,북구,65-69세,18206,8852,9354
202010,26320,부산광역시,북구,65-69세,18314,8914,9400
202011,26320,부산광역시,북구,65-69세,18458,8991,9467
202012,26320,부산광역시,북구,65-69세,18650,9081,9569
202101,26320,부산광역시,북구,65-69세,18847,9178,9669
202102,26320,부산광역시,북구,65-69세,18969,9237,9732
202103,26320,부산광역시,북구,65-69세,19067,9287,9780
202104,26320,부산광역시,북구,65-69세,19188,9332,9856
202105,26320,부산광역시,북구,65-69세,19352,9404,9948
202106,26320,부산광역시,북구,65-69세,19495,9484,10011
202007,26320,부산광역시,북구,70-74세,12129,5716,6413
202008,26320,부산광역시,북구,70-74세,12218,5755,6463
202009,26320,부산광역시,북구,70-74세,12251,5780,6471
202010,26320,부산광역시,북구,70-74세,12357,5827,6530
202011,26320,부산광역시,북구,70-74세,12478,5854,6624
202012,26320,부산광역시,북구,70-74세,12547,5886,6661
202101,26320,부산광역시,북구,70-74세,12648,5938,6710
202102,26320,부산광역시,북구,70-74세,12735,5975,6760
202103,26320,부산광역시,북구,70-74세,12752,6005,6747
202104,26320,부산광역시,북구,70-74세,12824,6048,6776
202105,26320,부산광역시,북구,70-74세,12916,6102,6814
202106,26320,부산광역시,북구,70-74세,12965,6124,6841
202007,26320,부산광역시,북구,75-79세,8935,3903,5032
202008,26320,부산광역시,북구,75-79세,8901,3887,5014
202009,26320,부산광역시,북구,75-79세,8883,3888,4995
202010,26320,부산광역시,북구,75-79세,8831,3858,4973
202011,26320,부산광역시,북구,75-79세,8787,3856,4931
202012,26320,부산광역시,북구,75-79세,8761,3860,4901
202101,26320,부산광역시,북구,75-79세,8720,3841,4879
202102,26320,부산광역시,북구,75-79세,8677,3835,4842
202103,26320,부산광역시,북구,75-79세,8681,3841,4840
202104,26320,부산광역시,북구,75-79세,8682,3847,4835
202105,26320,부산광역시,북구,75-79세,8732,3882,4850
202106,26320,부산광역시,북구,75-79세,8760,3902,4858
202007,26320,부산광역시,북구,80-84세,5384,1967,3417
202008,26320,부산광역시,북구,80-84세,5434,1993,3441
202009,26320,부산광역시,북구,80-84세,5445,2003,3442
202010,26320,부산광역시,북구,80-84세,5465,2018,3447
202011,26320,부산광역시,북구,80-84세,5485,2034,3451
202012,26320,부산광역시,북구,80-84세,5523,2048,3475
202101,26320,부산광역시,북구,80-84세,5558,2070,3488
202102,26320,부산광역시,북구,80-84세,5622,2091,3531
202103,26320,부산광역시,북구,80-84세,5635,2094,3541
202104,26320,부산광역시,북구,80-84세,5681,2110,3571
202105,26320,부산광역시,북구,80-84세,5719,2129,3590
202106,26320,부산광역시,북구,80-84세,5744,2136,3608
202007,26320,부산광역시,북구,85-89세,2545,678,1867
202008,26320,부산광역시,북구,85-89세,2584,686,1898
202009,26320,부산광역시,북구,85-89세,2617,689,1928
202010,26320,부산광역시,북구,85-89세,2641,701,1940
202011,26320,부산광역시,북구,85-89세,2668,710,1958
202012,26320,부산광역시,북구,85-89세,2683,719,1964
202101,26320,부산광역시,북구,85-89세,2706,730,1976
202102,26320,부산광역시,북구,85-89세,2746,747,1999
202103,26320,부산광역시,북구,85-89세,2776,757,2019
202104,26320,부산광역시,북구,85-89세,2788,765,2023
202105,26320,부산광역시,북구,85-89세,2799,774,2025
202106,26320,부산광역시,북구,85-89세,2818,776,2042
202007,26320,부산광역시,북구,90-94세,811,164,647
202008,26320,부산광역시,북구,90-94세,818,168,650
202009,26320,부산광역시,북구,90-94세,829,175,654
202010,26320,부산광역시,북구,90-94세,830,175,655
202011,26320,부산광역시,북구,90-94세,826,174,652
202012,26320,부산광역시,북구,90-94세,835,174,661
202101,26320,부산광역시,북구,90-94세,850,181,669
202102,26320,부산광역시,북구,90-94세,855,185,670
202103,26320,부산광역시,북구,90-94세,843,178,665
202104,26320,부산광역시,북구,90-94세,848,181,667
202105,26320,부산광역시,북구,90-94세,862,180,682
202106,26320,부산광역시,북구,90-94세,873,182,691
202007,26320,부산광역시,북구,95-99세,194,30,164
202008,26320,부산광역시,북구,95-99세,197,29,168
202009,26320,부산광역시,북구,95-99세,206,29,177
202010,26320,부산광역시,북구,95-99세,205,28,177
202011,26320,부산광역시,북구,95-99세,200,28,172
202012,26320,부산광역시,북구,95-99세,201,29,172
202101,26320,부산광역시,북구,95-99세,204,31,173
202102,26320,부산광역시,북구,95-99세,204,31,173
202103,26320,부산광역시,북구,95-99세,196,26,170
202104,26320,부산광역시,북구,95-99세,200,26,174
202105,26320,부산광역시,북구,95-99세,200,26,174
202106,26320,부산광역시,북구,95-99세,198,26,172
202007,26320,부산광역시,북구,100+,100,21,79
202008,26320,부산광역시,북구,100+,99,21,78
202009,26320,부산광역시,북구,100+,99,22,77
202010,26320,부산광역시,북구,100+,101,22,79
202011,26320,부산광역시,북구,100+,100,22,78
202012,26320,부산광역시,북구,100+,104,22,82
202101,26320,부산광역시,북구,100+,109,22,87
202102,26320,부산광역시,북구,100+,110,22,88
202103,26320,부산광역시,북구,100+,37,4,33
202104,26320,부산광역시,북구,100+,36,4,32
202105,26320,부산광역시,북구,100+,37,4,33
202106,26320,부산광역시,북구,100+,36,3,33
202007,26350,부산광역시,해운대구,0-4세,11732,6043,5689
202008,26350,부산광역시,해운대구,0-4세,11624,5974,5650
202009,26350,부산광역시,해운대구,0-4세,11537,5919,5618
202010,26350,부산광역시,해운대구,0-4세,11449,5871,5578
202011,26350,부산광역시,해운대구,0-4세,11335,5822,5513
202012,26350,부산광역시,해운대구,0-4세,11277,5787,5490
202101,26350,부산광역시,해운대구,0-4세,11164,5742,5422
202102,26350,부산광역시,해운대구,0-4세,11082,5690,5392
202103,26350,부산광역시,해운대구,0-4세,10997,5645,5352
202104,26350,부산광역시,해운대구,0-4세,10903,5579,5324
202105,26350,부산광역시,해운대구,0-4세,10816,5546,5270
202106,26350,부산광역시,해운대구,0-4세,10767,5507,5260
202007,26350,부산광역시,해운대구,5-9세,17291,9019,8272
202008,26350,부산광역시,해운대구,5-9세,17263,9000,8263
202009,26350,부산광역시,해운대구,5-9세,17229,8965,8264
202010,26350,부산광역시,해운대구,5-9세,17254,8976,8278
202011,26350,부산광역시,해운대구,5-9세,17205,8933,8272
202012,26350,부산광역시,해운대구,5-9세,17234,8966,8268
202101,26350,부산광역시,해운대구,5-9세,17182,8930,8252
202102,26350,부산광역시,해운대구,5-9세,17211,8938,8273
202103,26350,부산광역시,해운대구,5-9세,17180,8904,8276
202104,26350,부산광역시,해운대구,5-9세,17141,8888,8253
202105,26350,부산광역시,해운대구,5-9세,17105,8856,8249
202106,26350,부산광역시,해운대구,5-9세,17031,8847,8184
202007,26350,부산광역시,해운대구,10-14세,18092,9302,8790
202008,26350,부산광역시,해운대구,10-14세,18104,9306,8798
202009,26350,부산광역시,해운대구,10-14세,18120,9335,8785
202010,26350,부산광역시,해운대구,10-14세,18130,9325,8805
202011,26350,부산광역시,해운대구,10-14세,18189,9375,8814
202012,26350,부산광역시,해운대구,10-14세,18216,9388,8828
202101,26350,부산광역시,해운대구,10-14세,18290,9405,8885
202102,26350,부산광역시,해운대구,10-14세,18278,9385,8893
202103,26350,부산광역시,해운대구,10-14세,18295,9404,8891
202104,26350,부산광역시,해운대구,10-14세,18297,9395,8902
202105,26350,부산광역시,해운대구,10-14세,18324,9434,8890
202106,26350,부산광역시,해운대구,10-14세,18317,9419,8898
202007,26350,부산광역시,해운대구,15-19세,20634,10673,9961
202008,26350,부산광역시,해운대구,15-19세,20447,10595,9852
202009,26350,부산광역시,해운대구,15-19세,20317,10526,9791
202010,26350,부산광역시,해운대구,15-19세,20182,10457,9725
202011,26350,부산광역시,해운대구,15-19세,20054,10389,9665
202012,26350,부산광역시,해운대구,15-19세,19934,10339,9595
202101,26350,부산광역시,해운대구,15-19세,19824,10256,9568
202102,26350,부산광역시,해운대구,15-19세,19654,10169,9485
202103,26350,부산광역시,해운대구,15-19세,19413,10049,9364
202104,26350,부산광역시,해운대구,15-19세,19311,10005,9306
202105,26350,부산광역시,해운대구,15-19세,19140,9905,9235
202106,26350,부산광역시,해운대구,15-19세,19058,9865,9193
202007,26350,부산광역시,해운대구,20-24세,24948,13187,11761
202008,26350,부산광역시,해운대구,20-24세,24899,13152,11747
202009,26350,부산광역시,해운대구,20-24세,24756,13069,11687
202010,26350,부산광역시,해운대구,20-24세,24689,13018,11671
202011,26350,부산광역시,해운대구,20-24세,24594,12968,11626
202012,26350,부산광역시,해운대구,20-24세,24433,12929,11504
202101,26350,부산광역시,해운대구,20-24세,24277,12829,11448
202102,26350,부산광역시,해운대구,20-24세,24154,12726,11428
202103,26350,부산광역시,해운대구,20-24세,23893,12605,11288
202104,26350,부산광역시,해운대구,20-24세,23820,12557,11263
202105,26350,부산광역시,해운대구,20-24세,23758,12518,11240
202106,26350,부산광역시,해운대구,20-24세,23665,12470,11195
202007,26350,부산광역시,해운대구,25-29세,24610,12744,11866
202008,26350,부산광역시,해운대구,25-29세,24558,12727,11831
202009,26350,부산광역시,해운대구,25-29세,24579,12740,11839
202010,26350,부산광역시,해운대구,25-29세,24618,12781,11837
202011,26350,부산광역시,해운대구,25-29세,24623,12805,11818
202012,26350,부산광역시,해운대구,25-29세,24635,12804,11831
202101,26350,부산광역시,해운대구,25-29세,24614,12814,11800
202102,26350,부산광역시,해운대구,25-29세,24426,12708,11718
202103,26350,부산광역시,해운대구,25-29세,24461,12718,11743
202104,26350,부산광역시,해운대구,25-29세,24385,12669,11716
202105,26350,부산광역시,해운대구,25-29세,24290,12575,11715
202106,26350,부산광역시,해운대구,25-29세,24288,12545,11743
202007,26350,부산광역시,해운대구,30-34세,20866,10325,10541
202008,26350,부산광역시,해운대구,30-34세,20762,10261,10501
202009,26350,부산광역시,해운대구,30-34세,20721,10234,10487
202010,26350,부산광역시,해운대구,30-34세,20737,10241,10496
202011,26350,부산광역시,해운대구,30-34세,20675,10204,10471
202012,26350,부산광역시,해운대구,30-34세,20596,10165,10431
202101,26350,부산광역시,해운대구,30-34세,20610,10161,10449
202102,26350,부산광역시,해운대구,30-34세,20607,10178,10429
202103,26350,부산광역시,해운대구,30-34세,20629,10217,10412
202104,26350,부산광역시,해운대구,30-34세,20711,10228,10483
202105,26350,부산광역시,해운대구,30-34세,20815,10290,10525
202106,26350,부산광역시,해운대구,30-34세,20888,10344,10544
202007,26350,부산광역시,해운대구,35-39세,26742,12865,13877
202008,26350,부산광역시,해운대구,35-39세,26563,12768,13795
202009,26350,부산광역시,해운대구,35-39세,26460,12744,13716
202010,26350,부산광역시,해운대구,35-39세,26319,12668,13651
202011,26350,부산광역시,해운대구,35-39세,26183,12631,13552
202012,26350,부산광역시,해운대구,35-39세,26193,12631,13562
202101,26350,부산광역시,해운대구,35-39세,26083,12594,13489
202102,26350,부산광역시,해운대구,35-39세,25825,12455,13370
202103,26350,부산광역시,해운대구,35-39세,25579,12348,13231
202104,26350,부산광역시,해운대구,35-39세,25423,12292,13131
202105,26350,부산광역시,해운대구,35-39세,25259,12227,13032
202106,26350,부산광역시,해운대구,35-39세,25097,12144,12953
202007,26350,부산광역시,해운대구,40-44세,30298,14546,15752
202008,26350,부산광역시,해운대구,40-44세,30229,14515,15714
202009,26350,부산광역시,해운대구,40-44세,30323,14543,15780
202010,26350,부산광역시,해운대구,40-44세,30408,14594,15814
202011,26350,부산광역시,해운대구,40-44세,30439,14597,15842
202012,26350,부산광역시,해운대구,40-44세,30340,14554,15786
202101,26350,부산광역시,해운대구,40-44세,30287,14505,15782
202102,26350,부산광역시,해운대구,40-44세,30509,14626,15883
202103,26350,부산광역시,해운대구,40-44세,30411,14562,15849
202104,26350,부산광역시,해운대구,40-44세,30480,14596,15884
202105,26350,부산광역시,해운대구,40-44세,30514,14608,15906
202106,26350,부산광역시,해운대구,40-44세,30686,14697,15989
202007,26350,부산광역시,해운대구,45-49세,36254,17064,19190
202008,26350,부산광역시,해운대구,45-49세,36121,16974,19147
202009,26350,부산광역시,해운대구,45-49세,35856,16853,19003
202010,26350,부산광역시,해운대구,45-49세,35664,16744,18920
202011,26350,부산광역시,해운대구,45-49세,35539,16700,18839
202012,26350,부산광역시,해운대구,45-49세,35489,16669,18820
202101,26350,부산광역시,해운대구,45-49세,35288,16607,18681
202102,26350,부산광역시,해운대구,45-49세,35075,16531,18544
202103,26350,부산광역시,해운대구,45-49세,34880,16440,18440
202104,26350,부산광역시,해운대구,45-49세,34797,16416,18381
202105,26350,부산광역시,해운대구,45-49세,34475,16234,18241
202106,26350,부산광역시,해운대구,45-49세,34297,16173,18124
202007,26350,부산광역시,해운대구,50-54세,35955,17187,18768
202008,26350,부산광역시,해운대구,50-54세,35964,17197,18767
202009,26350,부산광역시,해운대구,50-54세,36032,17199,18833
202010,26350,부산광역시,해운대구,50-54세,36180,17288,18892
202011,26350,부산광역시,해운대구,50-54세,36210,17333,18877
202012,26350,부산광역시,해운대구,50-54세,36079,17277,18802
202101,26350,부산광역시,해운대구,50-54세,36219,17312,18907
202102,26350,부산광역시,해운대구,50-54세,36239,17285,18954
202103,26350,부산광역시,해운대구,50-54세,36107,17237,18870
202104,26350,부산광역시,해운대구,50-54세,36100,17213,18887
202105,26350,부산광역시,해운대구,50-54세,36230,17289,18941
202106,26350,부산광역시,해운대구,50-54세,36339,17314,19025
202007,26350,부산광역시,해운대구,55-59세,34863,16518,18345
202008,26350,부산광역시,해운대구,55-59세,34615,16395,18220
202009,26350,부산광역시,해운대구,55-59세,34492,16332,18160
202010,26350,부산광역시,해운대구,55-59세,34376,16285,18091
202011,26350,부산광역시,해운대구,55-59세,34273,16184,18089
202012,26350,부산광역시,해운대구,55-59세,34211,16118,18093
202101,26350,부산광역시,해운대구,55-59세,33988,16043,17945
202102,26350,부산광역시,해운대구,55-59세,33880,16060,17820
202103,26350,부산광역시,해운대구,55-59세,33723,16011,17712
202104,26350,부산광역시,해운대구,55-59세,33579,15973,17606
202105,26350,부산광역시,해운대구,55-59세,33326,15893,17433
202106,26350,부산광역시,해운대구,55-59세,33086,15777,17309
202007,26350,부산광역시,해운대구,60-64세,32786,15598,17188
202008,26350,부산광역시,해운대구,60-64세,32863,15651,17212
202009,26350,부산광역시,해운대구,60-64세,32895,15669,17226
202010,26350,부산광역시,해운대구,60-64세,33071,15756,17315
202011,26350,부산광역시,해운대구,60-64세,33133,15801,17332
202012,26350,부산광역시,해운대구,60-64세,33226,15832,17394
202101,26350,부산광역시,해운대구,60-64세,33271,15828,17443
202102,26350,부산광역시,해운대구,60-64세,33410,15855,17555
202103,26350,부산광역시,해운대구,60-64세,33454,15857,17597
202104,26350,부산광역시,해운대구,60-64세,33518,15867,17651
202105,26350,부산광역시,해운대구,60-64세,33668,15900,17768
202106,26350,부산광역시,해운대구,60-64세,33799,15977,17822
202007,26350,부산광역시,해운대구,65-69세,23800,11157,12643
202008,26350,부산광역시,해운대구,65-69세,23975,11209,12766
202009,26350,부산광역시,해운대구,65-69세,24203,11334,12869
202010,26350,부산광역시,해운대구,65-69세,24371,11419,12952
202011,26350,부산광역시,해운대구,65-69세,24571,11506,13065
202012,26350,부산광역시,해운대구,65-69세,24676,11564,13112
202101,26350,부산광역시,해운대구,65-69세,24854,11657,13197
202102,26350,부산광역시,해운대구,65-69세,24978,11717,13261
202103,26350,부산광역시,해운대구,65-69세,25123,11812,13311
202104,26350,부산광역시,해운대구,65-69세,25281,11898,13383
202105,26350,부산광역시,해운대구,65-69세,25429,12004,13425
202106,26350,부산광역시,해운대구,65-69세,25563,12050,13513
202007,26350,부산광역시,해운대구,70-74세,17288,7854,9434
202008,26350,부산광역시,해운대구,70-74세,17330,7872,9458
202009,26350,부산광역시,해운대구,70-74세,17385,7876,9509
202010,26350,부산광역시,해운대구,70-74세,17485,7910,9575
202011,26350,부산광역시,해운대구,70-74세,17554,7930,9624
202012,26350,부산광역시,해운대구,70-74세,17708,7998,9710
202101,26350,부산광역시,해운대구,70-74세,17808,8049,9759
202102,26350,부산광역시,해운대구,70-74세,17909,8110,9799
202103,26350,부산광역시,해운대구,70-74세,18011,8137,9874
202104,26350,부산광역시,해운대구,70-74세,18094,8160,9934
202105,26350,부산광역시,해운대구,70-74세,18107,8145,9962
202106,26350,부산광역시,해운대구,70-74세,18156,8175,9981
202007,26350,부산광역시,해운대구,75-79세,13314,5633,7681
202008,26350,부산광역시,해운대구,75-79세,13328,5660,7668
202009,26350,부산광역시,해운대구,75-79세,13284,5648,7636
202010,26350,부산광역시,해운대구,75-79세,13208,5616,7592
202011,26350,부산광역시,해운대구,75-79세,13179,5617,7562
202012,26350,부산광역시,해운대구,75-79세,13088,5584,7504
202101,26350,부산광역시,해운대구,75-79세,12991,5546,7445
202102,26350,부산광역시,해운대구,75-79세,12957,5514,7443
202103,26350,부산광역시,해운대구,75-79세,12886,5506,7380
202104,26350,부산광역시,해운대구,75-79세,12831,5492,7339
202105,26350,부산광역시,해운대구,75-79세,12796,5499,7297
202106,26350,부산광역시,해운대구,75-79세,12769,5498,7271
202007,26350,부산광역시,해운대구,80-84세,8569,3209,5360
202008,26350,부산광역시,해운대구,80-84세,8577,3217,5360
202009,26350,부산광역시,해운대구,80-84세,8603,3226,5377
202010,26350,부산광역시,해운대구,80-84세,8683,3260,5423
202011,26350,부산광역시,해운대구,80-84세,8744,3287,5457
202012,26350,부산광역시,해운대구,80-84세,8763,3297,5466
202101,26350,부산광역시,해운대구,80-84세,8824,3325,5499
202102,26350,부산광역시,해운대구,80-84세,8907,3376,5531
202103,26350,부산광역시,해운대구,80-84세,8922,3391,5531
202104,26350,부산광역시,해운대구,80-84세,8953,3410,5543
202105,26350,부산광역시,해운대구,80-84세,9008,3421,5587
202106,26350,부산광역시,해운대구,80-84세,9054,3436,5618
202007,26350,부산광역시,해운대구,85-89세,4007,1238,2769
202008,26350,부산광역시,해운대구,85-89세,4064,1254,2810
202009,26350,부산광역시,해운대구,85-89세,4111,1273,2838
202010,26350,부산광역시,해운대구,85-89세,4133,1277,2856
202011,26350,부산광역시,해운대구,85-89세,4160,1288,2872
202012,26350,부산광역시,해운대구,85-89세,4211,1300,2911
202101,26350,부산광역시,해운대구,85-89세,4237,1311,2926
202102,26350,부산광역시,해운대구,85-89세,4258,1317,2941
202103,26350,부산광역시,해운대구,85-89세,4305,1324,2981
202104,26350,부산광역시,해운대구,85-89세,4356,1338,3018
202105,26350,부산광역시,해운대구,85-89세,4357,1348,3009
202106,26350,부산광역시,해운대구,85-89세,4331,1337,2994
202007,26350,부산광역시,해운대구,90-94세,1362,305,1057
202008,26350,부산광역시,해운대구,90-94세,1358,302,1056
202009,26350,부산광역시,해운대구,90-94세,1363,299,1064
202010,26350,부산광역시,해운대구,90-94세,1375,303,1072
202011,26350,부산광역시,해운대구,90-94세,1370,297,1073
202012,26350,부산광역시,해운대구,90-94세,1368,303,1065
202101,26350,부산광역시,해운대구,90-94세,1401,314,1087
202102,26350,부산광역시,해운대구,90-94세,1427,322,1105
202103,26350,부산광역시,해운대구,90-94세,1425,325,1100
202104,26350,부산광역시,해운대구,90-94세,1445,331,1114
202105,26350,부산광역시,해운대구,90-94세,1436,332,1104
202106,26350,부산광역시,해운대구,90-94세,1456,334,1122
202007,26350,부산광역시,해운대구,95-99세,308,63,245
202008,26350,부산광역시,해운대구,95-99세,315,64,251
202009,26350,부산광역시,해운대구,95-99세,324,65,259
202010,26350,부산광역시,해운대구,95-99세,328,66,262
202011,26350,부산광역시,해운대구,95-99세,328,66,262
202012,26350,부산광역시,해운대구,95-99세,330,67,263
202101,26350,부산광역시,해운대구,95-99세,335,67,268
202102,26350,부산광역시,해운대구,95-99세,331,64,267
202103,26350,부산광역시,해운대구,95-99세,302,57,245
202104,26350,부산광역시,해운대구,95-99세,306,58,248
202105,26350,부산광역시,해운대구,95-99세,297,57,240
202106,26350,부산광역시,해운대구,95-99세,296,54,242
202007,26350,부산광역시,해운대구,100+,159,43,116
202008,26350,부산광역시,해운대구,100+,159,44,115
202009,26350,부산광역시,해운대구,100+,159,44,115
202010,26350,부산광역시,해운대구,100+,160,44,116
202011,26350,부산광역시,해운대구,100+,160,44,116
202012,26350,부산광역시,해운대구,100+,162,46,116
202101,26350,부산광역시,해운대구,100+,163,46,117
202102,26350,부산광역시,해운대구,100+,163,46,117
202103,26350,부산광역시,해운대구,100+,87,27,60
202104,26350,부산광역시,해운대구,100+,90,27,63
202105,26350,부산광역시,해운대구,100+,72,21,51
202106,26350,부산광역시,해운대구,100+,72,22,50
202007,26380,부산광역시,사하구,0-4세,8846,4578,4268
202008,26380,부산광역시,사하구,0-4세,8722,4495,4227
202009,26380,부산광역시,사하구,0-4세,8551,4402,4149
202010,26380,부산광역시,사하구,0-4세,8360,4292,4068
202011,26380,부산광역시,사하구,0-4세,8282,4245,4037
202012,26380,부산광역시,사하구,0-4세,8191,4213,3978
202101,26380,부산광역시,사하구,0-4세,8041,4133,3908
202102,26380,부산광역시,사하구,0-4세,7965,4098,3867
202103,26380,부산광역시,사하구,0-4세,7867,4035,3832
202104,26380,부산광역시,사하구,0-4세,7749,3978,3771
202105,26380,부산광역시,사하구,0-4세,7665,3938,3727
202106,26380,부산광역시,사하구,0-4세,7569,3895,3674
202007,26380,부산광역시,사하구,5-9세,12189,6192,5997
202008,26380,부산광역시,사하구,5-9세,12101,6159,5942
202009,26380,부산광역시,사하구,5-9세,12076,6152,5924
202010,26380,부산광역시,사하구,5-9세,11996,6126,5870
202011,26380,부산광역시,사하구,5-9세,11854,6069,5785
202012,26380,부산광역시,사하구,5-9세,11778,6027,5751
202101,26380,부산광역시,사하구,5-9세,11700,6003,5697
202102,26380,부산광역시,사하구,5-9세,11665,5984,5681
202103,26380,부산광역시,사하구,5-9세,11615,5951,5664
202104,26380,부산광역시,사하구,5-9세,11556,5922,5634
202105,26380,부산광역시,사하구,5-9세,11457,5880,5577
202106,26380,부산광역시,사하구,5-9세,11448,5876,5572
202007,26380,부산광역시,사하구,10-14세,11938,6150,5788
202008,26380,부산광역시,사하구,10-14세,11876,6115,5761
202009,26380,부산광역시,사하구,10-14세,11860,6120,5740
202010,26380,부산광역시,사하구,10-14세,11865,6119,5746
202011,26380,부산광역시,사하구,10-14세,11908,6142,5766
202012,26380,부산광역시,사하구,10-14세,11883,6123,5760
202101,26380,부산광역시,사하구,10-14세,11910,6141,5769
202102,26380,부산광역시,사하구,10-14세,11909,6154,5755
202103,26380,부산광역시,사하구,10-14세,11913,6157,5756
202104,26380,부산광역시,사하구,10-14세,11919,6156,5763
202105,26380,부산광역시,사하구,10-14세,11903,6163,5740
202106,26380,부산광역시,사하구,10-14세,11888,6141,5747
202007,26380,부산광역시,사하구,15-19세,14227,7489,6738
202008,26380,부산광역시,사하구,15-19세,14083,7415,6668
202009,26380,부산광역시,사하구,15-19세,13947,7325,6622
202010,26380,부산광역시,사하구,15-19세,13812,7253,6559
202011,26380,부산광역시,사하구,15-19세,13632,7136,6496
202012,26380,부산광역시,사하구,15-19세,13502,7079,6423
202101,26380,부산광역시,사하구,15-19세,13359,6993,6366
202102,26380,부산광역시,사하구,15-19세,13298,6934,6364
202103,26380,부산광역시,사하구,15-19세,13164,6850,6314
202104,26380,부산광역시,사하구,15-19세,13043,6774,6269
202105,26380,부산광역시,사하구,15-19세,12978,6733,6245
202106,26380,부산광역시,사하구,15-19세,12885,6681,6204
202007,26380,부산광역시,사하구,20-24세,20425,10884,9541
202008,26380,부산광역시,사하구,20-24세,20285,10816,9469
202009,26380,부산광역시,사하구,20-24세,20137,10701,9436
202010,26380,부산광역시,사하구,20-24세,19976,10600,9376
202011,26380,부산광역시,사하구,20-24세,19853,10506,9347
202012,26380,부산광역시,사하구,20-24세,19724,10417,9307
202101,26380,부산광역시,사하구,20-24세,19627,10403,9224
202102,26380,부산광역시,사하구,20-24세,19592,10416,9176
202103,26380,부산광역시,사하구,20-24세,19542,10400,9142
202104,26380,부산광역시,사하구,20-24세,19412,10309,9103
202105,26380,부산광역시,사하구,20-24세,19291,10247,9044
202106,26380,부산광역시,사하구,20-24세,19259,10211,9048
202007,26380,부산광역시,사하구,25-29세,20316,11027,9289
202008,26380,부산광역시,사하구,25-29세,20244,10984,9260
202009,26380,부산광역시,사하구,25-29세,20218,10972,9246
202010,26380,부산광역시,사하구,25-29세,20192,10970,9222
202011,26380,부산광역시,사하구,25-29세,20214,10977,9237
202012,26380,부산광역시,사하구,25-29세,20104,10928,9176
202101,26380,부산광역시,사하구,25-29세,20046,10860,9186
202102,26380,부산광역시,사하구,25-29세,19893,10769,9124
202103,26380,부산광역시,사하구,25-29세,19931,10787,9144
202104,26380,부산광역시,사하구,25-29세,19898,10776,9122
202105,26380,부산광역시,사하구,25-29세,19820,10701,9119
202106,26380,부산광역시,사하구,25-29세,19761,10683,9078
202007,26380,부산광역시,사하구,30-34세,17113,9174,7939
202008,26380,부산광역시,사하구,30-34세,17009,9115,7894
202009,26380,부산광역시,사하구,30-34세,16878,9061,7817
202010,26380,부산광역시,사하구,30-34세,16718,8968,7750
202011,26380,부산광역시,사하구,30-34세,16650,8958,7692
202012,26380,부산광역시,사하구,30-34세,16530,8891,7639
202101,26380,부산광역시,사하구,30-34세,16496,8897,7599
202102,26380,부산광역시,사하구,30-34세,16477,8896,7581
202103,26380,부산광역시,사하구,30-34세,16414,8857,7557
202104,26380,부산광역시,사하구,30-34세,16417,8881,7536
202105,26380,부산광역시,사하구,30-34세,16373,8857,7516
202106,26380,부산광역시,사하구,30-34세,16403,8870,7533
202007,26380,부산광역시,사하구,35-39세,21483,11206,10277
202008,26380,부산광역시,사하구,35-39세,21303,11114,10189
202009,26380,부산광역시,사하구,35-39세,21081,10992,10089
202010,26380,부산광역시,사하구,35-39세,20803,10839,9964
202011,26380,부산광역시,사하구,35-39세,20612,10752,9860
202012,26380,부산광역시,사하구,35-39세,20447,10671,9776
202101,26380,부산광역시,사하구,35-39세,20221,10552,9669
202102,26380,부산광역시,사하구,35-39세,20020,10456,9564
202103,26380,부산광역시,사하구,35-39세,19826,10365,9461
202104,26380,부산광역시,사하구,35-39세,19664,10280,9384
202105,26380,부산광역시,사하구,35-39세,19467,10210,9257
202106,26380,부산광역시,사하구,35-39세,19253,10096,9157
202007,26380,부산광역시,사하구,40-44세,21714,11332,10382
202008,26380,부산광역시,사하구,40-44세,21665,11317,10348
202009,26380,부산광역시,사하구,40-44세,21640,11276,10364
202010,26380,부산광역시,사하구,40-44세,21650,11295,10355
202011,26380,부산광역시,사하구,40-44세,21624,11288,10336
202012,26380,부산광역시,사하구,40-44세,21529,11228,10301
202101,26380,부산광역시,사하구,40-44세,21524,11227,10297
202102,26380,부산광역시,사하구,40-44세,21632,11294,10338
202103,26380,부산광역시,사하구,40-44세,21534,11248,10286
202104,26380,부산광역시,사하구,40-44세,21520,11264,10256
202105,26380,부산광역시,사하구,40-44세,21613,11335,10278
202106,26380,부산광역시,사하구,40-44세,21655,11359,10296
202007,26380,부산광역시,사하구,45-49세,25313,12735,12578
202008,26380,부산광역시,사하구,45-49세,25160,12652,12508
202009,26380,부산광역시,사하구,45-49세,24974,12590,12384
202010,26380,부산광역시,사하구,45-49세,24787,12481,12306
202011,26380,부산광역시,사하구,45-49세,24653,12398,12255
202012,26380,부산광역시,사하구,45-49세,24494,12329,12165
202101,26380,부산광역시,사하구,45-49세,24326,12258,12068
202102,26380,부산광역시,사하구,45-49세,24177,12170,12007
202103,26380,부산광역시,사하구,45-49세,23934,12038,11896
202104,26380,부산광역시,사하구,45-49세,23873,12008,11865
202105,26380,부산광역시,사하구,45-49세,23613,11866,11747
202106,26380,부산광역시,사하구,45-49세,23523,11812,11711
202007,26380,부산광역시,사하구,50-54세,27167,13353,13814
202008,26380,부산광역시,사하구,50-54세,27151,13357,13794
202009,26380,부산광역시,사하구,50-54세,27115,13328,13787
202010,26380,부산광역시,사하구,50-54세,27088,13321,13767
202011,26380,부산광역시,사하구,50-54세,27039,13288,13751
202012,26380,부산광역시,사하구,50-54세,26933,13265,13668
202101,26380,부산광역시,사하구,50-54세,26984,13295,13689
202102,26380,부산광역시,사하구,50-54세,27016,13293,13723
202103,26380,부산광역시,사하구,50-54세,26840,13214,13626
202104,26380,부산광역시,사하구,50-54세,26712,13151,13561
202105,26380,부산광역시,사하구,50-54세,26789,13159,13630
202106,26380,부산광역시,사하구,50-54세,26744,13164,13580
202007,26380,부산광역시,사하구,55-59세,28815,14001,14814
202008,26380,부산광역시,사하구,55-59세,28639,13900,14739
202009,26380,부산광역시,사하구,55-59세,28408,13785,14623
202010,26380,부산광역시,사하구,55-59세,28210,13684,14526
202011,26380,부산광역시,사하구,55-59세,28085,13653,14432
202012,26380,부산광역시,사하구,55-59세,27949,13591,14358
202101,26380,부산광역시,사하구,55-59세,27694,13490,14204
202102,26380,부산광역시,사하구,55-59세,27615,13496,14119
202103,26380,부산광역시,사하구,55-59세,27452,13423,14029
202104,26380,부산광역시,사하구,55-59세,27299,13350,13949
202105,26380,부산광역시,사하구,55-59세,27076,13284,13792
202106,26380,부산광역시,사하구,55-59세,26865,13175,13690
202007,26380,부산광역시,사하구,60-64세,28889,13925,14964
202008,26380,부산광역시,사하구,60-64세,28942,13975,14967
202009,26380,부산광역시,사하구,60-64세,29005,13993,15012
202010,26380,부산광역시,사하구,60-64세,29075,14035,15040
202011,26380,부산광역시,사하구,60-64세,29087,14002,15085
202012,26380,부산광역시,사하구,60-64세,29123,13996,15127
202101,26380,부산광역시,사하구,60-64세,29267,14059,15208
202102,26380,부산광역시,사하구,60-64세,29353,14096,15257
202103,26380,부산광역시,사하구,60-64세,29330,14078,15252
202104,26380,부산광역시,사하구,60-64세,29418,14086,15332
202105,26380,부산광역시,사하구,60-64세,29576,14149,15427
202106,26380,부산광역시,사하구,60-64세,29738,14211,15527
202007,26380,부산광역시,사하구,65-69세,21306,10365,10941
202008,26380,부산광역시,사하구,65-69세,21518,10443,11075
202009,26380,부산광역시,사하구,65-69세,21702,10512,11190
202010,26380,부산광역시,사하구,65-69세,21875,10607,11268
202011,26380,부산광역시,사하구,65-69세,21991,10666,11325
202012,26380,부산광역시,사하구,65-69세,22119,10710,11409
202101,26380,부산광역시,사하구,65-69세,22268,10757,11511
202102,26380,부산광역시,사하구,65-69세,22370,10802,11568
202103,26380,부산광역시,사하구,65-69세,22464,10865,11599
202104,26380,부산광역시,사하구,65-69세,22623,10946,11677
202105,26380,부산광역시,사하구,65-69세,22722,11006,11716
202106,26380,부산광역시,사하구,65-69세,22769,11025,11744
202007,26380,부산광역시,사하구,70-74세,15086,7076,8010
202008,26380,부산광역시,사하구,70-74세,15108,7089,8019
202009,26380,부산광역시,사하구,70-74세,15190,7133,8057
202010,26380,부산광역시,사하구,70-74세,15319,7156,8163
202011,26380,부산광역시,사하구,70-74세,15452,7225,8227
202012,26380,부산광역시,사하구,70-74세,15550,7286,8264
202101,26380,부산광역시,사하구,70-74세,15633,7330,8303
202102,26380,부산광역시,사하구,70-74세,15698,7351,8347
202103,26380,부산광역시,사하구,70-74세,15639,7304,8335
202104,26380,부산광역시,사하구,70-74세,15675,7323,8352
202105,26380,부산광역시,사하구,70-74세,15721,7325,8396
202106,26380,부산광역시,사하구,70-74세,15753,7328,8425
202007,26380,부산광역시,사하구,75-79세,10948,4855,6093
202008,26380,부산광역시,사하구,75-79세,10963,4871,6092
202009,26380,부산광역시,사하구,75-79세,10920,4853,6067
202010,26380,부산광역시,사하구,75-79세,10850,4837,6013
202011,26380,부산광역시,사하구,75-79세,10747,4799,5948
202012,26380,부산광역시,사하구,75-79세,10685,4787,5898
202101,26380,부산광역시,사하구,75-79세,10683,4782,5901
202102,26380,부산광역시,사하구,75-79세,10698,4793,5905
202103,26380,부산광역시,사하구,75-79세,10667,4794,5873
202104,26380,부산광역시,사하구,75-79세,10652,4782,5870
202105,26380,부산광역시,사하구,75-79세,10678,4808,5870
202106,26380,부산광역시,사하구,75-79세,10689,4823,5866
202007,26380,부산광역시,사하구,80-84세,6564,2441,4123
202008,26380,부산광역시,사하구,80-84세,6591,2452,4139
202009,26380,부산광역시,사하구,80-84세,6619,2466,4153
202010,26380,부산광역시,사하구,80-84세,6663,2486,4177
202011,26380,부산광역시,사하구,80-84세,6701,2503,4198
202012,26380,부산광역시,사하구,80-84세,6736,2528,4208
202101,26380,부산광역시,사하구,80-84세,6754,2546,4208
202102,26380,부산광역시,사하구,80-84세,6799,2576,4223
202103,26380,부산광역시,사하구,80-84세,6788,2572,4216
202104,26380,부산광역시,사하구,80-84세,6829,2602,4227
202105,26380,부산광역시,사하구,80-84세,6840,2607,4233
202106,26380,부산광역시,사하구,80-84세,6888,2627,4261
202007,26380,부산광역시,사하구,85-89세,2896,816,2080
202008,26380,부산광역시,사하구,85-89세,2917,827,2090
202009,26380,부산광역시,사하구,85-89세,2919,841,2078
202010,26380,부산광역시,사하구,85-89세,2939,848,2091
202011,26380,부산광역시,사하구,85-89세,2948,859,2089
202012,26380,부산광역시,사하구,85-89세,2965,866,2099
202101,26380,부산광역시,사하구,85-89세,2988,871,2117
202102,26380,부산광역시,사하구,85-89세,3027,881,2146
202103,26380,부산광역시,사하구,85-89세,3023,868,2155
202104,26380,부산광역시,사하구,85-89세,3055,870,2185
202105,26380,부산광역시,사하구,85-89세,3083,885,2198
202106,26380,부산광역시,사하구,85-89세,3095,885,2210
202007,26380,부산광역시,사하구,90-94세,1068,223,845
202008,26380,부산광역시,사하구,90-94세,1068,218,850
202009,26380,부산광역시,사하구,90-94세,1071,219,852
202010,26380,부산광역시,사하구,90-94세,1082,226,856
202011,26380,부산광역시,사하구,90-94세,1085,224,861
202012,26380,부산광역시,사하구,90-94세,1086,218,868
202101,26380,부산광역시,사하구,90-94세,1098,221,877
202102,26380,부산광역시,사하구,90-94세,1098,224,874
202103,26380,부산광역시,사하구,90-94세,1078,213,865
202104,26380,부산광역시,사하구,90-94세,1087,213,874
202105,26380,부산광역시,사하구,90-94세,1087,212,875
202106,26380,부산광역시,사하구,90-94세,1092,215,877
202007,26380,부산광역시,사하구,95-99세,237,38,199
202008,26380,부산광역시,사하구,95-99세,240,40,200
202009,26380,부산광역시,사하구,95-99세,255,41,214
202010,26380,부산광역시,사하구,95-99세,256,41,215
202011,26380,부산광역시,사하구,95-99세,261,43,218
202012,26380,부산광역시,사하구,95-99세,267,42,225
202101,26380,부산광역시,사하구,95-99세,271,42,229
202102,26380,부산광역시,사하구,95-99세,276,44,232
202103,26380,부산광역시,사하구,95-99세,239,35,204
202104,26380,부산광역시,사하구,95-99세,242,38,204
202105,26380,부산광역시,사하구,95-99세,243,38,205
202106,26380,부산광역시,사하구,95-99세,242,37,205
202007,26380,부산광역시,사하구,100+,165,36,129
202008,26380,부산광역시,사하구,100+,163,35,128
202009,26380,부산광역시,사하구,100+,162,34,128
202010,26380,부산광역시,사하구,100+,161,33,128
202011,26380,부산광역시,사하구,100+,162,33,129
202012,26380,부산광역시,사하구,100+,162,33,129
202101,26380,부산광역시,사하구,100+,162,33,129
202102,26380,부산광역시,사하구,100+,162,33,129
202103,26380,부산광역시,사하구,100+,42,9,33
202104,26380,부산광역시,사하구,100+,41,9,32
202105,26380,부산광역시,사하구,100+,41,10,31
202106,26380,부산광역시,사하구,100+,40,10,30
202007,26410,부산광역시,금정구,0-4세,5462,2813,2649
202008,26410,부산광역시,금정구,0-4세,5406,2780,2626
202009,26410,부산광역시,금정구,0-4세,5304,2730,2574
202010,26410,부산광역시,금정구,0-4세,5213,2682,2531
202011,26410,부산광역시,금정구,0-4세,5148,2634,2514
202012,26410,부산광역시,금정구,0-4세,5126,2631,2495
202101,26410,부산광역시,금정구,0-4세,5062,2595,2467
202102,26410,부산광역시,금정구,0-4세,5059,2594,2465
202103,26410,부산광역시,금정구,0-4세,5000,2561,2439
202104,26410,부산광역시,금정구,0-4세,4953,2536,2417
202105,26410,부산광역시,금정구,0-4세,4925,2528,2397
202106,26410,부산광역시,금정구,0-4세,4890,2513,2377
202007,26410,부산광역시,금정구,5-9세,8040,4146,3894
202008,26410,부산광역시,금정구,5-9세,8030,4135,3895
202009,26410,부산광역시,금정구,5-9세,7991,4094,3897
202010,26410,부산광역시,금정구,5-9세,7975,4073,3902
202011,26410,부산광역시,금정구,5-9세,7933,4060,3873
202012,26410,부산광역시,금정구,5-9세,7907,4032,3875
202101,26410,부산광역시,금정구,5-9세,7872,4030,3842
202102,26410,부산광역시,금정구,5-9세,7850,4027,3823
202103,26410,부산광역시,금정구,5-9세,7816,4016,3800
202104,26410,부산광역시,금정구,5-9세,7797,4013,3784
202105,26410,부산광역시,금정구,5-9세,7712,3959,3753
202106,26410,부산광역시,금정구,5-9세,7686,3937,3749
202007,26410,부산광역시,금정구,10-14세,8124,4266,3858
202008,26410,부산광역시,금정구,10-14세,8115,4262,3853
202009,26410,부산광역시,금정구,10-14세,8148,4275,3873
202010,26410,부산광역시,금정구,10-14세,8138,4258,3880
202011,26410,부산광역시,금정구,10-14세,8157,4274,3883
202012,26410,부산광역시,금정구,10-14세,8155,4274,3881
202101,26410,부산광역시,금정구,10-14세,8133,4248,3885
202102,26410,부산광역시,금정구,10-14세,8145,4234,3911
202103,26410,부산광역시,금정구,10-14세,8150,4229,3921
202104,26410,부산광역시,금정구,10-14세,8152,4228,3924
202105,26410,부산광역시,금정구,10-14세,8170,4233,3937
202106,26410,부산광역시,금정구,10-14세,8159,4223,3936
202007,26410,부산광역시,금정구,15-19세,10106,5071,5035
202008,26410,부산광역시,금정구,15-19세,9970,4997,4973
202009,26410,부산광역시,금정구,15-19세,9879,4961,4918
202010,26410,부산광역시,금정구,15-19세,9763,4926,4837
202011,26410,부산광역시,금정구,15-19세,9680,4899,4781
202012,26410,부산광역시,금정구,15-19세,9555,4863,4692
202101,26410,부산광역시,금정구,15-19세,9484,4836,4648
202102,26410,부산광역시,금정구,15-19세,9376,4796,4580
202103,26410,부산광역시,금정구,15-19세,9357,4808,4549
202104,26410,부산광역시,금정구,15-19세,9253,4744,4509
202105,26410,부산광역시,금정구,15-19세,9187,4724,4463
202106,26410,부산광역시,금정구,15-19세,9118,4687,4431
202007,26410,부산광역시,금정구,20-24세,17282,8982,8300
202008,26410,부산광역시,금정구,20-24세,17224,8936,8288
202009,26410,부산광역시,금정구,20-24세,17134,8860,8274
202010,26410,부산광역시,금정구,20-24세,17024,8769,8255
202011,26410,부산광역시,금정구,20-24세,16911,8652,8259
202012,26410,부산광역시,금정구,20-24세,16809,8589,8220
202101,26410,부산광역시,금정구,20-24세,16633,8500,8133
202102,26410,부산광역시,금정구,20-24세,16664,8576,8088
202103,26410,부산광역시,금정구,20-24세,16653,8568,8085
202104,26410,부산광역시,금정구,20-24세,16569,8527,8042
202105,26410,부산광역시,금정구,20-24세,16442,8445,7997
202106,26410,부산광역시,금정구,20-24세,16340,8398,7942
202007,26410,부산광역시,금정구,25-29세,16434,9252,7182
202008,26410,부산광역시,금정구,25-29세,16447,9282,7165
202009,26410,부산광역시,금정구,25-29세,16403,9251,7152
202010,26410,부산광역시,금정구,25-29세,16444,9277,7167
202011,26410,부산광역시,금정구,25-29세,16544,9352,7192
202012,26410,부산광역시,금정구,25-29세,16500,9325,7175
202101,26410,부산광역시,금정구,25-29세,16403,9288,7115
202102,26410,부산광역시,금정구,25-29세,16282,9238,7044
202103,26410,부산광역시,금정구,25-29세,16288,9222,7066
202104,26410,부산광역시,금정구,25-29세,16279,9220,7059
202105,26410,부산광역시,금정구,25-29세,16222,9238,6984
202106,26410,부산광역시,금정구,25-29세,16206,9204,7002
202007,26410,부산광역시,금정구,30-34세,12209,6541,5668
202008,26410,부산광역시,금정구,30-34세,12191,6530,5661
202009,26410,부산광역시,금정구,30-34세,12188,6536,5652
202010,26410,부산광역시,금정구,30-34세,12135,6497,5638
202011,26410,부산광역시,금정구,30-34세,12103,6489,5614
202012,26410,부산광역시,금정구,30-34세,11962,6411,5551
202101,26410,부산광역시,금정구,30-34세,11935,6376,5559
202102,26410,부산광역시,금정구,30-34세,11923,6362,5561
202103,26410,부산광역시,금정구,30-34세,11880,6343,5537
202104,26410,부산광역시,금정구,30-34세,11842,6302,5540
202105,26410,부산광역시,금정구,30-34세,11863,6302,5561
202106,26410,부산광역시,금정구,30-34세,11867,6311,5556
202007,26410,부산광역시,금정구,35-39세,13792,6919,6873
202008,26410,부산광역시,금정구,35-39세,13693,6881,6812
202009,26410,부산광역시,금정구,35-39세,13595,6857,6738
202010,26410,부산광역시,금정구,35-39세,13444,6780,6664
202011,26410,부산광역시,금정구,35-39세,13323,6727,6596
202012,26410,부산광역시,금정구,35-39세,13266,6718,6548
202101,26410,부산광역시,금정구,35-39세,13120,6637,6483
202102,26410,부산광역시,금정구,35-39세,13030,6606,6424
202103,26410,부산광역시,금정구,35-39세,12894,6548,6346
202104,26410,부산광역시,금정구,35-39세,12838,6544,6294
202105,26410,부산광역시,금정구,35-39세,12702,6490,6212
202106,26410,부산광역시,금정구,35-39세,12619,6461,6158
202007,26410,부산광역시,금정구,40-44세,14846,7548,7298
202008,26410,부산광역시,금정구,40-44세,14831,7535,7296
202009,26410,부산광역시,금정구,40-44세,14842,7520,7322
202010,26410,부산광역시,금정구,40-44세,14912,7539,7373
202011,26410,부산광역시,금정구,40-44세,14974,7555,7419
202012,26410,부산광역시,금정구,40-44세,14926,7520,7406
202101,26410,부산광역시,금정구,40-44세,14908,7531,7377
202102,26410,부산광역시,금정구,40-44세,14948,7546,7402
202103,26410,부산광역시,금정구,40-44세,14875,7506,7369
202104,26410,부산광역시,금정구,40-44세,14876,7513,7363
202105,26410,부산광역시,금정구,40-44세,14916,7522,7394
202106,26410,부산광역시,금정구,40-44세,14978,7552,7426
202007,26410,부산광역시,금정구,45-49세,17881,8744,9137
202008,26410,부산광역시,금정구,45-49세,17766,8686,9080
202009,26410,부산광역시,금정구,45-49세,17635,8626,9009
202010,26410,부산광역시,금정구,45-49세,17491,8579,8912
202011,26410,부산광역시,금정구,45-49세,17368,8530,8838
202012,26410,부산광역시,금정구,45-49세,17258,8498,8760
202101,26410,부산광역시,금정구,45-49세,17151,8448,8703
202102,26410,부산광역시,금정구,45-49세,17088,8422,8666
202103,26410,부산광역시,금정구,45-49세,16915,8359,8556
202104,26410,부산광역시,금정구,45-49세,16853,8300,8553
202105,26410,부산광역시,금정구,45-49세,16702,8227,8475
202106,26410,부산광역시,금정구,45-49세,16568,8155,8413
202007,26410,부산광역시,금정구,50-54세,19733,9382,10351
202008,26410,부산광역시,금정구,50-54세,19691,9365,10326
202009,26410,부산광역시,금정구,50-54세,19663,9352,10311
202010,26410,부산광역시,금정구,50-54세,19642,9332,10310
202011,26410,부산광역시,금정구,50-54세,19631,9351,10280
202012,26410,부산광역시,금정구,50-54세,19526,9309,10217
202101,26410,부산광역시,금정구,50-54세,19505,9276,10229
202102,26410,부산광역시,금정구,50-54세,19469,9267,10202
202103,26410,부산광역시,금정구,50-54세,19285,9183,10102
202104,26410,부산광역시,금정구,50-54세,19257,9161,10096
202105,26410,부산광역시,금정구,50-54세,19275,9187,10088
202106,26410,부산광역시,금정구,50-54세,19247,9179,10068
202007,26410,부산광역시,금정구,55-59세,21675,10257,11418
202008,26410,부산광역시,금정구,55-59세,21521,10160,11361
202009,26410,부산광역시,금정구,55-59세,21429,10123,11306
202010,26410,부산광역시,금정구,55-59세,21314,10075,11239
202011,26410,부산광역시,금정구,55-59세,21177,9995,11182
202012,26410,부산광역시,금정구,55-59세,21092,9956,11136
202101,26410,부산광역시,금정구,55-59세,20914,9893,11021
202102,26410,부산광역시,금정구,55-59세,20808,9851,10957
202103,26410,부산광역시,금정구,55-59세,20579,9753,10826
202104,26410,부산광역시,금정구,55-59세,20416,9690,10726
202105,26410,부산광역시,금정구,55-59세,20311,9645,10666
202106,26410,부산광역시,금정구,55-59세,20120,9571,10549
202007,26410,부산광역시,금정구,60-64세,21566,10147,11419
202008,26410,부산광역시,금정구,60-64세,21569,10155,11414
202009,26410,부산광역시,금정구,60-64세,21546,10161,11385
202010,26410,부산광역시,금정구,60-64세,21567,10155,11412
202011,26410,부산광역시,금정구,60-64세,21615,10194,11421
202012,26410,부산광역시,금정구,60-64세,21664,10224,11440
202101,26410,부산광역시,금정구,60-64세,21686,10233,11453
202102,26410,부산광역시,금정구,60-64세,21773,10258,11515
202103,26410,부산광역시,금정구,60-64세,21826,10275,11551
202104,26410,부산광역시,금정구,60-64세,21888,10306,11582
202105,26410,부산광역시,금정구,60-64세,21897,10309,11588
202106,26410,부산광역시,금정구,60-64세,21976,10339,11637
202007,26410,부산광역시,금정구,65-69세,16543,7660,8883
202008,26410,부산광역시,금정구,65-69세,16682,7727,8955
202009,26410,부산광역시,금정구,65-69세,16797,7740,9057
202010,26410,부산광역시,금정구,65-69세,16906,7798,9108
202011,26410,부산광역시,금정구,65-69세,17012,7822,9190
202012,26410,부산광역시,금정구,65-69세,17100,7860,9240
202101,26410,부산광역시,금정구,65-69세,17235,7917,9318
202102,26410,부산광역시,금정구,65-69세,17303,7961,9342
202103,26410,부산광역시,금정구,65-69세,17326,7971,9355
202104,26410,부산광역시,금정구,65-69세,17404,8012,9392
202105,26410,부산광역시,금정구,65-69세,17488,8060,9428
202106,26410,부산광역시,금정구,65-69세,17532,8082,9450
202007,26410,부산광역시,금정구,70-74세,12179,5599,6580
202008,26410,부산광역시,금정구,70-74세,12211,5619,6592
202009,26410,부산광역시,금정구,70-74세,12280,5669,6611
202010,26410,부산광역시,금정구,70-74세,12331,5696,6635
202011,26410,부산광역시,금정구,70-74세,12429,5748,6681
202012,26410,부산광역시,금정구,70-74세,12521,5779,6742
202101,26410,부산광역시,금정구,70-74세,12603,5812,6791
202102,26410,부산광역시,금정구,70-74세,12666,5846,6820
202103,26410,부산광역시,금정구,70-74세,12639,5842,6797
202104,26410,부산광역시,금정구,70-74세,12693,5858,6835
202105,26410,부산광역시,금정구,70-74세,12668,5827,6841
202106,26410,부산광역시,금정구,70-74세,12659,5824,6835
202007,26410,부산광역시,금정구,75-79세,9410,4230,5180
202008,26410,부산광역시,금정구,75-79세,9395,4218,5177
202009,26410,부산광역시,금정구,75-79세,9347,4197,5150
202010,26410,부산광역시,금정구,75-79세,9305,4167,5138
202011,26410,부산광역시,금정구,75-79세,9241,4136,5105
202012,26410,부산광역시,금정구,75-79세,9151,4104,5047
202101,26410,부산광역시,금정구,75-79세,9086,4076,5010
202102,26410,부산광역시,금정구,75-79세,9035,4045,4990
202103,26410,부산광역시,금정구,75-79세,8988,4028,4960
202104,26410,부산광역시,금정구,75-79세,8950,4012,4938
202105,26410,부산광역시,금정구,75-79세,8974,4035,4939
202106,26410,부산광역시,금정구,75-79세,8974,4038,4936
202007,26410,부산광역시,금정구,80-84세,5746,2223,3523
202008,26410,부산광역시,금정구,80-84세,5728,2229,3499
202009,26410,부산광역시,금정구,80-84세,5744,2235,3509
202010,26410,부산광역시,금정구,80-84세,5767,2262,3505
202011,26410,부산광역시,금정구,80-84세,5802,2267,3535
202012,26410,부산광역시,금정구,80-84세,5842,2294,3548
202101,26410,부산광역시,금정구,80-84세,5891,2322,3569
202102,26410,부산광역시,금정구,80-84세,5954,2360,3594
202103,26410,부산광역시,금정구,80-84세,5982,2369,3613
202104,26410,부산광역시,금정구,80-84세,6022,2390,3632
202105,26410,부산광역시,금정구,80-84세,6065,2414,3651
202106,26410,부산광역시,금정구,80-84세,6084,2411,3673
202007,26410,부산광역시,금정구,85-89세,2798,846,1952
202008,26410,부산광역시,금정구,85-89세,2826,850,1976
202009,26410,부산광역시,금정구,85-89세,2848,865,1983
202010,26410,부산광역시,금정구,85-89세,2871,871,2000
202011,26410,부산광역시,금정구,85-89세,2879,875,2004
202012,26410,부산광역시,금정구,85-89세,2915,878,2037
202101,26410,부산광역시,금정구,85-89세,2921,881,2040
202102,26410,부산광역시,금정구,85-89세,2954,893,2061
202103,26410,부산광역시,금정구,85-89세,2956,885,2071
202104,26410,부산광역시,금정구,85-89세,2958,885,2073
202105,26410,부산광역시,금정구,85-89세,2966,893,2073
202106,26410,부산광역시,금정구,85-89세,2973,898,2075
202007,26410,부산광역시,금정구,90-94세,904,227,677
202008,26410,부산광역시,금정구,90-94세,916,228,688
202009,26410,부산광역시,금정구,90-94세,936,226,710
202010,26410,부산광역시,금정구,90-94세,931,224,707
202011,26410,부산광역시,금정구,90-94세,947,231,716
202012,26410,부산광역시,금정구,90-94세,959,238,721
202101,26410,부산광역시,금정구,90-94세,981,245,736
202102,26410,부산광역시,금정구,90-94세,978,246,732
202103,26410,부산광역시,금정구,90-94세,937,229,708
202104,26410,부산광역시,금정구,90-94세,947,229,718
202105,26410,부산광역시,금정구,90-94세,961,224,737
202106,26410,부산광역시,금정구,90-94세,966,228,738
202007,26410,부산광역시,금정구,95-99세,229,48,181
202008,26410,부산광역시,금정구,95-99세,229,49,180
202009,26410,부산광역시,금정구,95-99세,226,48,178
202010,26410,부산광역시,금정구,95-99세,230,50,180
202011,26410,부산광역시,금정구,95-99세,229,50,179
202012,26410,부산광역시,금정구,95-99세,233,49,184
202101,26410,부산광역시,금정구,95-99세,235,51,184
202102,26410,부산광역시,금정구,95-99세,238,49,189
202103,26410,부산광역시,금정구,95-99세,194,37,157
202104,26410,부산광역시,금정구,95-99세,193,37,156
202105,26410,부산광역시,금정구,95-99세,193,37,156
202106,26410,부산광역시,금정구,95-99세,194,36,158
202007,26410,부산광역시,금정구,100+,196,40,156
202008,26410,부산광역시,금정구,100+,199,41,158
202009,26410,부산광역시,금정구,100+,200,42,158
202010,26410,부산광역시,금정구,100+,198,42,156
202011,26410,부산광역시,금정구,100+,200,42,158
202012,26410,부산광역시,금정구,100+,199,43,156
202101,26410,부산광역시,금정구,100+,201,43,158
202102,26410,부산광역시,금정구,100+,200,42,158
202103,26410,부산광역시,금정구,100+,65,9,56
202104,26410,부산광역시,금정구,100+,64,8,56
202105,26410,부산광역시,금정구,100+,65,9,56
202106,26410,부산광역시,금정구,100+,66,9,57
202007,26440,부산광역시,강서구,0-4세,9104,4662,4442
202008,26440,부산광역시,강서구,0-4세,9193,4714,4479
202009,26440,부산광역시,강서구,0-4세,9374,4833,4541
202010,26440,부산광역시,강서구,0-4세,9401,4851,4550
202011,26440,부산광역시,강서구,0-4세,9368,4837,4531
202012,26440,부산광역시,강서구,0-4세,9310,4803,4507
202101,26440,부산광역시,강서구,0-4세,9246,4781,4465
202102,26440,부산광역시,강서구,0-4세,9166,4743,4423
202103,26440,부산광역시,강서구,0-4세,9081,4716,4365
202104,26440,부산광역시,강서구,0-4세,8971,4670,4301
202105,26440,부산광역시,강서구,0-4세,8952,4662,4290
202106,26440,부산광역시,강서구,0-4세,8867,4624,4243
202007,26440,부산광역시,강서구,5-9세,10288,5299,4989
202008,26440,부산광역시,강서구,5-9세,10436,5365,5071
202009,26440,부산광역시,강서구,5-9세,10585,5433,5152
202010,26440,부산광역시,강서구,5-9세,10673,5452,5221
202011,26440,부산광역시,강서구,5-9세,10745,5507,5238
202012,26440,부산광역시,강서구,5-9세,10785,5523,5262
202101,26440,부산광역시,강서구,5-9세,10843,5542,5301
202102,26440,부산광역시,강서구,5-9세,10889,5576,5313
202103,26440,부산광역시,강서구,5-9세,10941,5603,5338
202104,26440,부산광역시,강서구,5-9세,10977,5615,5362
202105,26440,부산광역시,강서구,5-9세,11004,5638,5366
202106,26440,부산광역시,강서구,5-9세,11046,5665,5381
202007,26440,부산광역시,강서구,10-14세,6471,3259,3212
202008,26440,부산광역시,강서구,10-14세,6634,3353,3281
202009,26440,부산광역시,강서구,10-14세,6772,3422,3350
202010,26440,부산광역시,강서구,10-14세,6888,3490,3398
202011,26440,부산광역시,강서구,10-14세,7003,3531,3472
202012,26440,부산광역시,강서구,10-14세,7106,3576,3530
202101,26440,부산광역시,강서구,10-14세,7229,3656,3573
202102,26440,부산광역시,강서구,10-14세,7306,3696,3610
202103,26440,부산광역시,강서구,10-14세,7414,3747,3667
202104,26440,부산광역시,강서구,10-14세,7514,3795,3719
202105,26440,부산광역시,강서구,10-14세,7615,3834,3781
202106,26440,부산광역시,강서구,10-14세,7712,3877,3835
202007,26440,부산광역시,강서구,15-19세,4478,2318,2160
202008,26440,부산광역시,강서구,15-19세,4507,2324,2183
202009,26440,부산광역시,강서구,15-19세,4558,2347,2211
202010,26440,부산광역시,강서구,15-19세,4591,2361,2230
202011,26440,부산광역시,강서구,15-19세,4604,2369,2235
202012,26440,부산광역시,강서구,15-19세,4608,2373,2235
202101,26440,부산광역시,강서구,15-19세,4640,2394,2246
202102,26440,부산광역시,강서구,15-19세,4634,2390,2244
202103,26440,부산광역시,강서구,15-19세,4626,2390,2236
202104,26440,부산광역시,강서구,15-19세,4647,2402,2245
202105,26440,부산광역시,강서구,15-19세,4665,2411,2254
202106,26440,부산광역시,강서구,15-19세,4676,2413,2263
202007,26440,부산광역시,강서구,20-24세,4918,2662,2256
202008,26440,부산광역시,강서구,20-24세,4906,2655,2251
202009,26440,부산광역시,강서구,20-24세,4975,2693,2282
202010,26440,부산광역시,강서구,20-24세,5013,2715,2298
202011,26440,부산광역시,강서구,20-24세,5040,2737,2303
202012,26440,부산광역시,강서구,20-24세,5054,2746,2308
202101,26440,부산광역시,강서구,20-24세,5073,2764,2309
202102,26440,부산광역시,강서구,20-24세,5090,2771,2319
202103,26440,부산광역시,강서구,20-24세,5088,2779,2309
202104,26440,부산광역시,강서구,20-24세,5109,2812,2297
202105,26440,부산광역시,강서구,20-24세,5097,2802,2295
202106,26440,부산광역시,강서구,20-24세,5115,2826,2289
202007,26440,부산광역시,강서구,25-29세,6950,3698,3252
202008,26440,부산광역시,강서구,25-29세,7033,3751,3282
202009,26440,부산광역시,강서구,25-29세,7140,3797,3343
202010,26440,부산광역시,강서구,25-29세,7161,3818,3343
202011,26440,부산광역시,강서구,25-29세,7214,3846,3368
202012,26440,부산광역시,강서구,25-29세,7281,3885,3396
202101,26440,부산광역시,강서구,25-29세,7244,3882,3362
202102,26440,부산광역시,강서구,25-29세,7311,3913,3398
202103,26440,부산광역시,강서구,25-29세,7340,3943,3397
202104,26440,부산광역시,강서구,25-29세,7372,3948,3424
202105,26440,부산광역시,강서구,25-29세,7454,4004,3450
202106,26440,부산광역시,강서구,25-29세,7506,4027,3479
202007,26440,부산광역시,강서구,30-34세,10404,5183,5221
202008,26440,부산광역시,강서구,30-34세,10510,5236,5274
202009,26440,부산광역시,강서구,30-34세,10710,5345,5365
202010,26440,부산광역시,강서구,30-34세,10828,5405,5423
202011,26440,부산광역시,강서구,30-34세,10872,5432,5440
202012,26440,부산광역시,강서구,30-34세,10908,5468,5440
202101,26440,부산광역시,강서구,30-34세,10893,5457,5436
202102,26440,부산광역시,강서구,30-34세,10846,5437,5409
202103,26440,부산광역시,강서구,30-34세,10855,5426,5429
202104,26440,부산광역시,강서구,30-34세,10905,5469,5436
202105,26440,부산광역시,강서구,30-34세,10938,5481,5457
202106,26440,부산광역시,강서구,30-34세,10939,5489,5450
202007,26440,부산광역시,강서구,35-39세,15906,8255,7651
202008,26440,부산광역시,강서구,35-39세,16121,8343,7778
202009,26440,부산광역시,강서구,35-39세,16349,8464,7885
202010,26440,부산광역시,강서구,35-39세,16433,8491,7942
202011,26440,부산광역시,강서구,35-39세,16391,8456,7935
202012,26440,부산광역시,강서구,35-39세,16400,8452,7948
202101,26440,부산광역시,강서구,35-39세,16445,8466,7979
202102,26440,부산광역시,강서구,35-39세,16383,8455,7928
202103,26440,부산광역시,강서구,35-39세,16314,8422,7892
202104,26440,부산광역시,강서구,35-39세,16273,8402,7871
202105,26440,부산광역시,강서구,35-39세,16264,8404,7860
202106,26440,부산광역시,강서구,35-39세,16265,8400,7865
202007,26440,부산광역시,강서구,40-44세,12795,7118,5677
202008,26440,부산광역시,강서구,40-44세,13013,7250,5763
202009,26440,부산광역시,강서구,40-44세,13268,7384,5884
202010,26440,부산광역시,강서구,40-44세,13508,7516,5992
202011,26440,부산광역시,강서구,40-44세,13679,7604,6075
202012,26440,부산광역시,강서구,40-44세,13829,7690,6139
202101,26440,부산광역시,강서구,40-44세,13995,7785,6210
202102,26440,부산광역시,강서구,40-44세,14165,7850,6315
202103,26440,부산광역시,강서구,40-44세,14264,7897,6367
202104,26440,부산광역시,강서구,40-44세,14413,7955,6458
202105,26440,부산광역시,강서구,40-44세,14561,8020,6541
202106,26440,부산광역시,강서구,40-44세,14738,8110,6628
202007,26440,부산광역시,강서구,45-49세,9388,5304,4084
202008,26440,부산광역시,강서구,45-49세,9505,5373,4132
202009,26440,부산광역시,강서구,45-49세,9614,5436,4178
202010,26440,부산광역시,강서구,45-49세,9691,5471,4220
202011,26440,부산광역시,강서구,45-49세,9733,5482,4251
202012,26440,부산광역시,강서구,45-49세,9838,5532,4306
202101,26440,부산광역시,강서구,45-49세,9935,5584,4351
202102,26440,부산광역시,강서구,45-49세,9983,5634,4349
202103,26440,부산광역시,강서구,45-49세,10011,5671,4340
202104,26440,부산광역시,강서구,45-49세,10039,5691,4348
202105,26440,부산광역시,강서구,45-49세,10047,5694,4353
202106,26440,부산광역시,강서구,45-49세,10075,5722,4353
202007,26440,부산광역시,강서구,50-54세,7954,4204,3750
202008,26440,부산광역시,강서구,50-54세,7988,4219,3769
202009,26440,부산광역시,강서구,50-54세,8105,4260,3845
202010,26440,부산광역시,강서구,50-54세,8181,4315,3866
202011,26440,부산광역시,강서구,50-54세,8243,4349,3894
202012,26440,부산광역시,강서구,50-54세,8263,4363,3900
202101,26440,부산광역시,강서구,50-54세,8316,4376,3940
202102,26440,부산광역시,강서구,50-54세,8405,4406,3999
202103,26440,부산광역시,강서구,50-54세,8400,4402,3998
202104,26440,부산광역시,강서구,50-54세,8447,4442,4005
202105,26440,부산광역시,강서구,50-54세,8504,4477,4027
202106,26440,부산광역시,강서구,50-54세,8554,4498,4056
202007,26440,부산광역시,강서구,55-59세,8519,4271,4248
202008,26440,부산광역시,강서구,55-59세,8537,4280,4257
202009,26440,부산광역시,강서구,55-59세,8587,4293,4294
202010,26440,부산광역시,강서구,55-59세,8636,4299,4337
202011,26440,부산광역시,강서구,55-59세,8649,4307,4342
202012,26440,부산광역시,강서구,55-59세,8684,4325,4359
202101,26440,부산광역시,강서구,55-59세,8651,4325,4326
202102,26440,부산광역시,강서구,55-59세,8654,4336,4318
202103,26440,부산광역시,강서구,55-59세,8602,4321,4281
202104,26440,부산광역시,강서구,55-59세,8509,4278,4231
202105,26440,부산광역시,강서구,55-59세,8467,4280,4187
202106,26440,부산광역시,강서구,55-59세,8418,4250,4168
202007,26440,부산광역시,강서구,60-64세,8872,4437,4435
202008,26440,부산광역시,강서구,60-64세,8904,4452,4452
202009,26440,부산광역시,강서구,60-64세,9037,4538,4499
202010,26440,부산광역시,강서구,60-64세,9087,4571,4516
202011,26440,부산광역시,강서구,60-64세,9194,4649,4545
202012,26440,부산광역시,강서구,60-64세,9258,4663,4595
202101,26440,부산광역시,강서구,60-64세,9331,4686,4645
202102,26440,부산광역시,강서구,60-64세,9388,4711,4677
202103,26440,부산광역시,강서구,60-64세,9461,4738,4723
202104,26440,부산광역시,강서구,60-64세,9546,4777,4769
202105,26440,부산광역시,강서구,60-64세,9611,4806,4805
202106,26440,부산광역시,강서구,60-64세,9704,4861,4843
202007,26440,부산광역시,강서구,65-69세,6222,3257,2965
202008,26440,부산광역시,강서구,65-69세,6303,3292,3011
202009,26440,부산광역시,강서구,65-69세,6410,3353,3057
202010,26440,부산광역시,강서구,65-69세,6478,3376,3102
202011,26440,부산광역시,강서구,65-69세,6543,3384,3159
202012,26440,부산광역시,강서구,65-69세,6589,3397,3192
202101,26440,부산광역시,강서구,65-69세,6651,3435,3216
202102,26440,부산광역시,강서구,65-69세,6719,3469,3250
202103,26440,부산광역시,강서구,65-69세,6746,3478,3268
202104,26440,부산광역시,강서구,65-69세,6788,3494,3294
202105,26440,부산광역시,강서구,65-69세,6848,3520,3328
202106,26440,부산광역시,강서구,65-69세,6898,3551,3347
202007,26440,부산광역시,강서구,70-74세,3873,2014,1859
202008,26440,부산광역시,강서구,70-74세,3897,2023,1874
202009,26440,부산광역시,강서구,70-74세,3960,2052,1908
202010,26440,부산광역시,강서구,70-74세,4023,2086,1937
202011,26440,부산광역시,강서구,70-74세,4065,2117,1948
202012,26440,부산광역시,강서구,70-74세,4111,2148,1963
202101,26440,부산광역시,강서구,70-74세,4170,2168,2002
202102,26440,부산광역시,강서구,70-74세,4186,2170,2016
202103,26440,부산광역시,강서구,70-74세,4217,2186,2031
202104,26440,부산광역시,강서구,70-74세,4260,2214,2046
202105,26440,부산광역시,강서구,70-74세,4288,2220,2068
202106,26440,부산광역시,강서구,70-74세,4289,2208,2081
202007,26440,부산광역시,강서구,75-79세,2758,1303,1455
202008,26440,부산광역시,강서구,75-79세,2779,1310,1469
202009,26440,부산광역시,강서구,75-79세,2773,1309,1464
202010,26440,부산광역시,강서구,75-79세,2766,1306,1460
202011,26440,부산광역시,강서구,75-79세,2755,1300,1455
202012,26440,부산광역시,강서구,75-79세,2764,1314,1450
202101,26440,부산광역시,강서구,75-79세,2737,1306,1431
202102,26440,부산광역시,강서구,75-79세,2723,1299,1424
202103,26440,부산광역시,강서구,75-79세,2695,1290,1405
202104,26440,부산광역시,강서구,75-79세,2679,1275,1404
202105,26440,부산광역시,강서구,75-79세,2682,1274,1408
202106,26440,부산광역시,강서구,75-79세,2684,1276,1408
202007,26440,부산광역시,강서구,80-84세,1741,625,1116
202008,26440,부산광역시,강서구,80-84세,1741,627,1114
202009,26440,부산광역시,강서구,80-84세,1745,633,1112
202010,26440,부산광역시,강서구,80-84세,1761,639,1122
202011,26440,부산광역시,강서구,80-84세,1768,638,1130
202012,26440,부산광역시,강서구,80-84세,1782,636,1146
202101,26440,부산광역시,강서구,80-84세,1820,662,1158
202102,26440,부산광역시,강서구,80-84세,1836,674,1162
202103,26440,부산광역시,강서구,80-84세,1825,666,1159
202104,26440,부산광역시,강서구,80-84세,1833,673,1160
202105,26440,부산광역시,강서구,80-84세,1839,687,1152
202106,26440,부산광역시,강서구,80-84세,1856,705,1151
202007,26440,부산광역시,강서구,85-89세,859,251,608
202008,26440,부산광역시,강서구,85-89세,860,254,606
202009,26440,부산광역시,강서구,85-89세,873,259,614
202010,26440,부산광역시,강서구,85-89세,876,261,615
202011,26440,부산광역시,강서구,85-89세,876,259,617
202012,26440,부산광역시,강서구,85-89세,893,258,635
202101,26440,부산광역시,강서구,85-89세,885,257,628
202102,26440,부산광역시,강서구,85-89세,898,256,642
202103,26440,부산광역시,강서구,85-89세,892,240,652
202104,26440,부산광역시,강서구,85-89세,904,245,659
202105,26440,부산광역시,강서구,85-89세,909,247,662
202106,26440,부산광역시,강서구,85-89세,909,242,667
202007,26440,부산광역시,강서구,90-94세,352,63,289
202008,26440,부산광역시,강서구,90-94세,361,65,296
202009,26440,부산광역시,강서구,90-94세,367,64,303
202010,26440,부산광역시,강서구,90-94세,364,63,301
202011,26440,부산광역시,강서구,90-94세,362,65,297
202012,26440,부산광역시,강서구,90-94세,369,66,303
202101,26440,부산광역시,강서구,90-94세,377,66,311
202102,26440,부산광역시,강서구,90-94세,376,67,309
202103,26440,부산광역시,강서구,90-94세,363,64,299
202104,26440,부산광역시,강서구,90-94세,359,61,298
202105,26440,부산광역시,강서구,90-94세,365,61,304
202106,26440,부산광역시,강서구,90-94세,366,61,305
202007,26440,부산광역시,강서구,95-99세,83,13,70
202008,26440,부산광역시,강서구,95-99세,82,14,68
202009,26440,부산광역시,강서구,95-99세,83,13,70
202010,26440,부산광역시,강서구,95-99세,81,14,67
202011,26440,부산광역시,강서구,95-99세,79,14,65
202012,26440,부산광역시,강서구,95-99세,78,14,64
202101,26440,부산광역시,강서구,95-99세,82,15,67
202102,26440,부산광역시,강서구,95-99세,83,16,67
202103,26440,부산광역시,강서구,95-99세,81,15,66
202104,26440,부산광역시,강서구,95-99세,85,15,70
202105,26440,부산광역시,강서구,95-99세,83,13,70
202106,26440,부산광역시,강서구,95-99세,80,13,67
202007,26440,부산광역시,강서구,100+,44,12,32
202008,26440,부산광역시,강서구,100+,44,12,32
202009,26440,부산광역시,강서구,100+,45,13,32
202010,26440,부산광역시,강서구,100+,45,13,32
202011,26440,부산광역시,강서구,100+,46,13,33
202012,26440,부산광역시,강서구,100+,47,13,34
202101,26440,부산광역시,강서구,100+,47,13,34
202102,26440,부산광역시,강서구,100+,47,13,34
202103,26440,부산광역시,강서구,100+,23,6,17
202104,26440,부산광역시,강서구,100+,22,6,16
202105,26440,부산광역시,강서구,100+,22,6,16
202106,26440,부산광역시,강서구,100+,23,6,17
202007,26470,부산광역시,연제구,0-4세,6729,3486,3243
202008,26470,부산광역시,연제구,0-4세,6772,3502,3270
202009,26470,부산광역시,연제구,0-4세,6752,3482,3270
202010,26470,부산광역시,연제구,0-4세,6637,3427,3210
202011,26470,부산광역시,연제구,0-4세,6529,3354,3175
202012,26470,부산광역시,연제구,0-4세,6448,3315,3133
202101,26470,부산광역시,연제구,0-4세,6338,3242,3096
202102,26470,부산광역시,연제구,0-4세,6244,3181,3063
202103,26470,부산광역시,연제구,0-4세,6120,3120,3000
202104,26470,부산광역시,연제구,0-4세,6014,3062,2952
202105,26470,부산광역시,연제구,0-4세,5911,2990,2921
202106,26470,부산광역시,연제구,0-4세,5854,2959,2895
202007,26470,부산광역시,연제구,5-9세,8321,4188,4133
202008,26470,부산광역시,연제구,5-9세,8395,4220,4175
202009,26470,부산광역시,연제구,5-9세,8400,4229,4171
202010,26470,부산광역시,연제구,5-9세,8381,4231,4150
202011,26470,부산광역시,연제구,5-9세,8329,4213,4116
202012,26470,부산광역시,연제구,5-9세,8299,4196,4103
202101,26470,부산광역시,연제구,5-9세,8261,4167,4094
202102,26470,부산광역시,연제구,5-9세,8243,4152,4091
202103,26470,부산광역시,연제구,5-9세,8236,4156,4080
202104,26470,부산광역시,연제구,5-9세,8257,4166,4091
202105,26470,부산광역시,연제구,5-9세,8247,4160,4087
202106,26470,부산광역시,연제구,5-9세,8228,4151,4077
202007,26470,부산광역시,연제구,10-14세,7806,4035,3771
202008,26470,부산광역시,연제구,10-14세,7837,4054,3783
202009,26470,부산광역시,연제구,10-14세,7857,4067,3790
202010,26470,부산광역시,연제구,10-14세,7911,4091,3820
202011,26470,부산광역시,연제구,10-14세,7930,4093,3837
202012,26470,부산광역시,연제구,10-14세,7927,4089,3838
202101,26470,부산광역시,연제구,10-14세,7971,4105,3866
202102,26470,부산광역시,연제구,10-14세,8001,4135,3866
202103,26470,부산광역시,연제구,10-14세,8007,4158,3849
202104,26470,부산광역시,연제구,10-14세,7996,4142,3854
202105,26470,부산광역시,연제구,10-14세,8018,4165,3853
202106,26470,부산광역시,연제구,10-14세,8046,4180,3866
202007,26470,부산광역시,연제구,15-19세,8793,4526,4267
202008,26470,부산광역시,연제구,15-19세,8765,4497,4268
202009,26470,부산광역시,연제구,15-19세,8731,4468,4263
202010,26470,부산광역시,연제구,15-19세,8649,4425,4224
202011,26470,부산광역시,연제구,15-19세,8566,4386,4180
202012,26470,부산광역시,연제구,15-19세,8540,4346,4194
202101,26470,부산광역시,연제구,15-19세,8451,4330,4121
202102,26470,부산광역시,연제구,15-19세,8437,4323,4114
202103,26470,부산광역시,연제구,15-19세,8375,4286,4089
202104,26470,부산광역시,연제구,15-19세,8333,4255,4078
202105,26470,부산광역시,연제구,15-19세,8292,4234,4058
202106,26470,부산광역시,연제구,15-19세,8237,4197,4040
202007,26470,부산광역시,연제구,20-24세,12464,6440,6024
202008,26470,부산광역시,연제구,20-24세,12454,6434,6020
202009,26470,부산광역시,연제구,20-24세,12419,6414,6005
202010,26470,부산광역시,연제구,20-24세,12434,6430,6004
202011,26470,부산광역시,연제구,20-24세,12375,6392,5983
202012,26470,부산광역시,연제구,20-24세,12261,6339,5922
202101,26470,부산광역시,연제구,20-24세,12229,6297,5932
202102,26470,부산광역시,연제구,20-24세,12100,6229,5871
202103,26470,부산광역시,연제구,20-24세,11952,6191,5761
202104,26470,부산광역시,연제구,20-24세,11895,6158,5737
202105,26470,부산광역시,연제구,20-24세,11834,6121,5713
202106,26470,부산광역시,연제구,20-24세,11786,6091,5695
202007,26470,부산광역시,연제구,25-29세,13828,6907,6921
202008,26470,부산광역시,연제구,25-29세,13884,6937,6947
202009,26470,부산광역시,연제구,25-29세,13923,6967,6956
202010,26470,부산광역시,연제구,25-29세,13907,6941,6966
202011,26470,부산광역시,연제구,25-29세,13888,6912,6976
202012,26470,부산광역시,연제구,25-29세,13870,6887,6983
202101,26470,부산광역시,연제구,25-29세,13784,6862,6922
202102,26470,부산광역시,연제구,25-29세,13768,6852,6916
202103,26470,부산광역시,연제구,25-29세,13759,6856,6903
202104,26470,부산광역시,연제구,25-29세,13701,6821,6880
202105,26470,부산광역시,연제구,25-29세,13637,6827,6810
202106,26470,부산광역시,연제구,25-29세,13555,6764,6791
202007,26470,부산광역시,연제구,30-34세,12599,6319,6280
202008,26470,부산광역시,연제구,30-34세,12677,6331,6346
202009,26470,부산광역시,연제구,30-34세,12746,6379,6367
202010,26470,부산광역시,연제구,30-34세,12727,6376,6351
202011,26470,부산광역시,연제구,30-34세,12670,6345,6325
202012,26470,부산광역시,연제구,30-34세,12555,6317,6238
202101,26470,부산광역시,연제구,30-34세,12598,6328,6270
202102,26470,부산광역시,연제구,30-34세,12508,6257,6251
202103,26470,부산광역시,연제구,30-34세,12436,6219,6217
202104,26470,부산광역시,연제구,30-34세,12407,6223,6184
202105,26470,부산광역시,연제구,30-34세,12354,6182,6172
202106,26470,부산광역시,연제구,30-34세,12365,6198,6167
202007,26470,부산광역시,연제구,35-39세,15088,7578,7510
202008,26470,부산광역시,연제구,35-39세,15199,7659,7540
202009,26470,부산광역시,연제구,35-39세,15132,7622,7510
202010,26470,부산광역시,연제구,35-39세,14955,7531,7424
202011,26470,부산광역시,연제구,35-39세,14774,7445,7329
202012,26470,부산광역시,연제구,35-39세,14639,7347,7292
202101,26470,부산광역시,연제구,35-39세,14453,7260,7193
202102,26470,부산광역시,연제구,35-39세,14335,7187,7148
202103,26470,부산광역시,연제구,35-39세,14194,7129,7065
202104,26470,부산광역시,연제구,35-39세,14067,7052,7015
202105,26470,부산광역시,연제구,35-39세,13938,6995,6943
202106,26470,부산광역시,연제구,35-39세,13841,6966,6875
202007,26470,부산광역시,연제구,40-44세,15123,7434,7689
202008,26470,부산광역시,연제구,40-44세,15257,7504,7753
202009,26470,부산광역시,연제구,40-44세,15319,7515,7804
202010,26470,부산광역시,연제구,40-44세,15374,7530,7844
202011,26470,부산광역시,연제구,40-44세,15402,7542,7860
202012,26470,부산광역시,연제구,40-44세,15371,7534,7837
202101,26470,부산광역시,연제구,40-44세,15404,7548,7856
202102,26470,부산광역시,연제구,40-44세,15497,7616,7881
202103,26470,부산광역시,연제구,40-44세,15379,7550,7829
202104,26470,부산광역시,연제구,40-44세,15380,7546,7834
202105,26470,부산광역시,연제구,40-44세,15431,7566,7865
202106,26470,부산광역시,연제구,40-44세,15477,7560,7917
202007,26470,부산광역시,연제구,45-49세,16840,8214,8626
202008,26470,부산광역시,연제구,45-49세,16791,8176,8615
202009,26470,부산광역시,연제구,45-49세,16693,8120,8573
202010,26470,부산광역시,연제구,45-49세,16656,8119,8537
202011,26470,부산광역시,연제구,45-49세,16595,8089,8506
202012,26470,부산광역시,연제구,45-49세,16536,8050,8486
202101,26470,부산광역시,연제구,45-49세,16423,8000,8423
202102,26470,부산광역시,연제구,45-49세,16393,7982,8411
202103,26470,부산광역시,연제구,45-49세,16261,7934,8327
202104,26470,부산광역시,연제구,45-49세,16187,7911,8276
202105,26470,부산광역시,연제구,45-49세,16048,7852,8196
202106,26470,부산광역시,연제구,45-49세,15994,7835,8159
202007,26470,부산광역시,연제구,50-54세,17094,8140,8954
202008,26470,부산광역시,연제구,50-54세,17155,8180,8975
202009,26470,부산광역시,연제구,50-54세,17208,8185,9023
202010,26470,부산광역시,연제구,50-54세,17217,8180,9037
202011,26470,부산광역시,연제구,50-54세,17199,8155,9044
202012,26470,부산광역시,연제구,50-54세,17140,8161,8979
202101,26470,부산광역시,연제구,50-54세,17229,8223,9006
202102,26470,부산광역시,연제구,50-54세,17290,8235,9055
202103,26470,부산광역시,연제구,50-54세,17108,8144,8964
202104,26470,부산광역시,연제구,50-54세,17123,8151,8972
202105,26470,부산광역시,연제구,50-54세,17190,8176,9014
202106,26470,부산광역시,연제구,50-54세,17191,8179,9012
202007,26470,부산광역시,연제구,55-59세,17248,8085,9163
202008,26470,부산광역시,연제구,55-59세,17230,8066,9164
202009,26470,부산광역시,연제구,55-59세,17161,8046,9115
202010,26470,부산광역시,연제구,55-59세,17115,8036,9079
202011,26470,부산광역시,연제구,55-59세,17016,8042,8974
202012,26470,부산광역시,연제구,55-59세,17001,8014,8987
202101,26470,부산광역시,연제구,55-59세,16914,7953,8961
202102,26470,부산광역시,연제구,55-59세,16810,7914,8896
202103,26470,부산광역시,연제구,55-59세,16660,7850,8810
202104,26470,부산광역시,연제구,55-59세,16572,7808,8764
202105,26470,부산광역시,연제구,55-59세,16421,7750,8671
202106,26470,부산광역시,연제구,55-59세,16285,7707,8578
202007,26470,부산광역시,연제구,60-64세,17908,8212,9696
202008,26470,부산광역시,연제구,60-64세,17977,8244,9733
202009,26470,부산광역시,연제구,60-64세,18047,8269,9778
202010,26470,부산광역시,연제구,60-64세,18077,8277,9800
202011,26470,부산광역시,연제구,60-64세,18101,8271,9830
202012,26470,부산광역시,연제구,60-64세,18055,8241,9814
202101,26470,부산광역시,연제구,60-64세,18077,8265,9812
202102,26470,부산광역시,연제구,60-64세,18130,8293,9837
202103,26470,부산광역시,연제구,60-64세,18080,8278,9802
202104,26470,부산광역시,연제구,60-64세,18118,8283,9835
202105,26470,부산광역시,연제구,60-64세,18136,8277,9859
202106,26470,부산광역시,연제구,60-64세,18184,8285,9899
202007,26470,부산광역시,연제구,65-69세,13953,6486,7467
202008,26470,부산광역시,연제구,65-69세,14076,6542,7534
202009,26470,부산광역시,연제구,65-69세,14175,6573,7602
202010,26470,부산광역시,연제구,65-69세,14279,6606,7673
202011,26470,부산광역시,연제구,65-69세,14358,6637,7721
202012,26470,부산광역시,연제구,65-69세,14454,6678,7776
202101,26470,부산광역시,연제구,65-69세,14611,6737,7874
202102,26470,부산광역시,연제구,65-69세,14707,6776,7931
202103,26470,부산광역시,연제구,65-69세,14697,6783,7914
202104,26470,부산광역시,연제구,65-69세,14722,6818,7904
202105,26470,부산광역시,연제구,65-69세,14785,6848,7937
202106,26470,부산광역시,연제구,65-69세,14823,6861,7962
202007,26470,부산광역시,연제구,70-74세,10188,4710,5478
202008,26470,부산광역시,연제구,70-74세,10237,4728,5509
202009,26470,부산광역시,연제구,70-74세,10331,4773,5558
202010,26470,부산광역시,연제구,70-74세,10410,4826,5584
202011,26470,부산광역시,연제구,70-74세,10510,4870,5640
202012,26470,부산광역시,연제구,70-74세,10591,4904,5687
202101,26470,부산광역시,연제구,70-74세,10642,4936,5706
202102,26470,부산광역시,연제구,70-74세,10702,4966,5736
202103,26470,부산광역시,연제구,70-74세,10712,4963,5749
202104,26470,부산광역시,연제구,70-74세,10752,4962,5790
202105,26470,부산광역시,연제구,70-74세,10778,4961,5817
202106,26470,부산광역시,연제구,70-74세,10769,4956,5813
202007,26470,부산광역시,연제구,75-79세,7774,3472,4302
202008,26470,부산광역시,연제구,75-79세,7797,3480,4317
202009,26470,부산광역시,연제구,75-79세,7764,3475,4289
202010,26470,부산광역시,연제구,75-79세,7726,3451,4275
202011,26470,부산광역시,연제구,75-79세,7664,3422,4242
202012,26470,부산광역시,연제구,75-79세,7606,3389,4217
202101,26470,부산광역시,연제구,75-79세,7564,3366,4198
202102,26470,부산광역시,연제구,75-79세,7529,3363,4166
202103,26470,부산광역시,연제구,75-79세,7468,3362,4106
202104,26470,부산광역시,연제구,75-79세,7454,3360,4094
202105,26470,부산광역시,연제구,75-79세,7474,3367,4107
202106,26470,부산광역시,연제구,75-79세,7466,3368,4098
202007,26470,부산광역시,연제구,80-84세,4687,1938,2749
202008,26470,부산광역시,연제구,80-84세,4721,1956,2765
202009,26470,부산광역시,연제구,80-84세,4742,1972,2770
202010,26470,부산광역시,연제구,80-84세,4758,1982,2776
202011,26470,부산광역시,연제구,80-84세,4774,1980,2794
202012,26470,부산광역시,연제구,80-84세,4823,2006,2817
202101,26470,부산광역시,연제구,80-84세,4882,2039,2843
202102,26470,부산광역시,연제구,80-84세,4935,2063,2872
202103,26470,부산광역시,연제구,80-84세,4952,2065,2887
202104,26470,부산광역시,연제구,80-84세,4970,2075,2895
202105,26470,부산광역시,연제구,80-84세,5000,2082,2918
202106,26470,부산광역시,연제구,80-84세,5065,2106,2959
202007,26470,부산광역시,연제구,85-89세,1998,604,1394
202008,26470,부산광역시,연제구,85-89세,2022,619,1403
202009,26470,부산광역시,연제구,85-89세,2042,638,1404
202010,26470,부산광역시,연제구,85-89세,2052,644,1408
202011,26470,부산광역시,연제구,85-89세,2077,662,1415
202012,26470,부산광역시,연제구,85-89세,2108,674,1434
202101,26470,부산광역시,연제구,85-89세,2132,689,1443
202102,26470,부산광역시,연제구,85-89세,2164,704,1460
202103,26470,부산광역시,연제구,85-89세,2155,706,1449
202104,26470,부산광역시,연제구,85-89세,2172,702,1470
202105,26470,부산광역시,연제구,85-89세,2179,711,1468
202106,26470,부산광역시,연제구,85-89세,2193,714,1479
202007,26470,부산광역시,연제구,90-94세,657,155,502
202008,26470,부산광역시,연제구,90-94세,653,153,500
202009,26470,부산광역시,연제구,90-94세,666,156,510
202010,26470,부산광역시,연제구,90-94세,676,157,519
202011,26470,부산광역시,연제구,90-94세,687,158,529
202012,26470,부산광역시,연제구,90-94세,687,158,529
202101,26470,부산광역시,연제구,90-94세,693,163,530
202102,26470,부산광역시,연제구,90-94세,707,168,539
202103,26470,부산광역시,연제구,90-94세,698,163,535
202104,26470,부산광역시,연제구,90-94세,691,165,526
202105,26470,부산광역시,연제구,90-94세,708,166,542
202106,26470,부산광역시,연제구,90-94세,712,167,545
202007,26470,부산광역시,연제구,95-99세,166,36,130
202008,26470,부산광역시,연제구,95-99세,163,37,126
202009,26470,부산광역시,연제구,95-99세,169,38,131
202010,26470,부산광역시,연제구,95-99세,161,37,124
202011,26470,부산광역시,연제구,95-99세,154,35,119
202012,26470,부산광역시,연제구,95-99세,156,35,121
202101,26470,부산광역시,연제구,95-99세,153,33,120
202102,26470,부산광역시,연제구,95-99세,152,34,118
202103,26470,부산광역시,연제구,95-99세,128,24,104
202104,26470,부산광역시,연제구,95-99세,127,22,105
202105,26470,부산광역시,연제구,95-99세,127,23,104
202106,26470,부산광역시,연제구,95-99세,128,24,104
202007,26470,부산광역시,연제구,100+,81,19,62
202008,26470,부산광역시,연제구,100+,84,19,65
202009,26470,부산광역시,연제구,100+,85,19,66
202010,26470,부산광역시,연제구,100+,89,20,69
202011,26470,부산광역시,연제구,100+,90,20,70
202012,26470,부산광역시,연제구,100+,90,20,70
202101,26470,부산광역시,연제구,100+,91,20,71
202102,26470,부산광역시,연제구,100+,91,20,71
202103,26470,부산광역시,연제구,100+,42,11,31
202104,26470,부산광역시,연제구,100+,41,11,30
202105,26470,부산광역시,연제구,100+,39,11,28
202106,26470,부산광역시,연제구,100+,40,12,28
202007,26500,부산광역시,수영구,0-4세,4773,2446,2327
202008,26500,부산광역시,수영구,0-4세,4757,2435,2322
202009,26500,부산광역시,수영구,0-4세,4747,2425,2322
202010,26500,부산광역시,수영구,0-4세,4691,2372,2319
202011,26500,부산광역시,수영구,0-4세,4640,2337,2303
202012,26500,부산광역시,수영구,0-4세,4628,2330,2298
202101,26500,부산광역시,수영구,0-4세,4582,2302,2280
202102,26500,부산광역시,수영구,0-4세,4564,2288,2276
202103,26500,부산광역시,수영구,0-4세,4525,2270,2255
202104,26500,부산광역시,수영구,0-4세,4545,2285,2260
202105,26500,부산광역시,수영구,0-4세,4543,2290,2253
202106,26500,부산광역시,수영구,0-4세,4505,2255,2250
202007,26500,부산광역시,수영구,5-9세,5685,2929,2756
202008,26500,부산광역시,수영구,5-9세,5683,2930,2753
202009,26500,부산광역시,수영구,5-9세,5705,2951,2754
202010,26500,부산광역시,수영구,5-9세,5708,2962,2746
202011,26500,부산광역시,수영구,5-9세,5693,2970,2723
202012,26500,부산광역시,수영구,5-9세,5700,2979,2721
202101,26500,부산광역시,수영구,5-9세,5696,2989,2707
202102,26500,부산광역시,수영구,5-9세,5694,2988,2706
202103,26500,부산광역시,수영구,5-9세,5702,2992,2710
202104,26500,부산광역시,수영구,5-9세,5697,2989,2708
202105,26500,부산광역시,수영구,5-9세,5674,2967,2707
202106,26500,부산광역시,수영구,5-9세,5687,2978,2709
202007,26500,부산광역시,수영구,10-14세,5332,2750,2582
202008,26500,부산광역시,수영구,10-14세,5349,2753,2596
202009,26500,부산광역시,수영구,10-14세,5382,2765,2617
202010,26500,부산광역시,수영구,10-14세,5381,2768,2613
202011,26500,부산광역시,수영구,10-14세,5420,2786,2634
202012,26500,부산광역시,수영구,10-14세,5429,2795,2634
202101,26500,부산광역시,수영구,10-14세,5440,2793,2647
202102,26500,부산광역시,수영구,10-14세,5441,2809,2632
202103,26500,부산광역시,수영구,10-14세,5446,2808,2638
202104,26500,부산광역시,수영구,10-14세,5467,2806,2661
202105,26500,부산광역시,수영구,10-14세,5494,2819,2675
202106,26500,부산광역시,수영구,10-14세,5469,2807,2662
202007,26500,부산광역시,수영구,15-19세,6665,3442,3223
202008,26500,부산광역시,수영구,15-19세,6621,3400,3221
202009,26500,부산광역시,수영구,15-19세,6596,3391,3205
202010,26500,부산광역시,수영구,15-19세,6552,3367,3185
202011,26500,부산광역시,수영구,15-19세,6476,3337,3139
202012,26500,부산광역시,수영구,15-19세,6423,3321,3102
202101,26500,부산광역시,수영구,15-19세,6373,3297,3076
202102,26500,부산광역시,수영구,15-19세,6304,3256,3048
202103,26500,부산광역시,수영구,15-19세,6219,3216,3003
202104,26500,부산광역시,수영구,15-19세,6189,3191,2998
202105,26500,부산광역시,수영구,15-19세,6149,3171,2978
202106,26500,부산광역시,수영구,15-19세,6121,3151,2970
202007,26500,부산광역시,수영구,20-24세,10439,5090,5349
202008,26500,부산광역시,수영구,20-24세,10371,5070,5301
202009,26500,부산광역시,수영구,20-24세,10356,5071,5285
202010,26500,부산광역시,수영구,20-24세,10302,5048,5254
202011,26500,부산광역시,수영구,20-24세,10244,5007,5237
202012,26500,부산광역시,수영구,20-24세,10251,4978,5273
202101,26500,부산광역시,수영구,20-24세,10238,4946,5292
202102,26500,부산광역시,수영구,20-24세,10203,4933,5270
202103,26500,부산광역시,수영구,20-24세,10198,4941,5257
202104,26500,부산광역시,수영구,20-24세,10128,4898,5230
202105,26500,부산광역시,수영구,20-24세,10069,4870,5199
202106,26500,부산광역시,수영구,20-24세,10046,4833,5213
202007,26500,부산광역시,수영구,25-29세,13834,6747,7087
202008,26500,부산광역시,수영구,25-29세,13929,6803,7126
202009,26500,부산광역시,수영구,25-29세,14038,6839,7199
202010,26500,부산광역시,수영구,25-29세,14075,6833,7242
202011,26500,부산광역시,수영구,25-29세,14017,6794,7223
202012,26500,부산광역시,수영구,25-29세,14098,6861,7237
202101,26500,부산광역시,수영구,25-29세,14060,6855,7205
202102,26500,부산광역시,수영구,25-29세,14062,6852,7210
202103,26500,부산광역시,수영구,25-29세,13998,6812,7186
202104,26500,부산광역시,수영구,25-29세,14052,6840,7212
202105,26500,부산광역시,수영구,25-29세,14026,6827,7199
202106,26500,부산광역시,수영구,25-29세,14029,6838,7191
202007,26500,부산광역시,수영구,30-34세,11590,5767,5823
202008,26500,부산광역시,수영구,30-34세,11641,5794,5847
202009,26500,부산광역시,수영구,30-34세,11712,5845,5867
202010,26500,부산광역시,수영구,30-34세,11685,5837,5848
202011,26500,부산광역시,수영구,30-34세,11672,5840,5832
202012,26500,부산광역시,수영구,30-34세,11670,5812,5858
202101,26500,부산광역시,수영구,30-34세,11641,5796,5845
202102,26500,부산광역시,수영구,30-34세,11680,5832,5848
202103,26500,부산광역시,수영구,30-34세,11703,5836,5867
202104,26500,부산광역시,수영구,30-34세,11752,5856,5896
202105,26500,부산광역시,수영구,30-34세,11760,5855,5905
202106,26500,부산광역시,수영구,30-34세,11780,5866,5914
202007,26500,부산광역시,수영구,35-39세,12518,6229,6289
202008,26500,부산광역시,수영구,35-39세,12473,6216,6257
202009,26500,부산광역시,수영구,35-39세,12359,6147,6212
202010,26500,부산광역시,수영구,35-39세,12312,6127,6185
202011,26500,부산광역시,수영구,35-39세,12241,6092,6149
202012,26500,부산광역시,수영구,35-39세,12207,6079,6128
202101,26500,부산광역시,수영구,35-39세,12168,6075,6093
202102,26500,부산광역시,수영구,35-39세,12107,6050,6057
202103,26500,부산광역시,수영구,35-39세,12102,6044,6058
202104,26500,부산광역시,수영구,35-39세,12068,6037,6031
202105,26500,부산광역시,수영구,35-39세,11989,5986,6003
202106,26500,부산광역시,수영구,35-39세,11900,5947,5953
202007,26500,부산광역시,수영구,40-44세,12037,6070,5967
202008,26500,부산광역시,수영구,40-44세,12072,6075,5997
202009,26500,부산광역시,수영구,40-44세,12178,6117,6061
202010,26500,부산광역시,수영구,40-44세,12200,6148,6052
202011,26500,부산광역시,수영구,40-44세,12227,6149,6078
202012,26500,부산광역시,수영구,40-44세,12236,6153,6083
202101,26500,부산광역시,수영구,40-44세,12223,6149,6074
202102,26500,부산광역시,수영구,40-44세,12296,6191,6105
202103,26500,부산광역시,수영구,40-44세,12220,6139,6081
202104,26500,부산광역시,수영구,40-44세,12248,6160,6088
202105,26500,부산광역시,수영구,40-44세,12329,6213,6116
202106,26500,부산광역시,수영구,40-44세,12406,6236,6170
202007,26500,부산광역시,수영구,45-49세,13552,6511,7041
202008,26500,부산광역시,수영구,45-49세,13566,6517,7049
202009,26500,부산광역시,수영구,45-49세,13491,6472,7019
202010,26500,부산광역시,수영구,45-49세,13364,6412,6952
202011,26500,부산광역시,수영구,45-49세,13320,6411,6909
202012,26500,부산광역시,수영구,45-49세,13251,6381,6870
202101,26500,부산광역시,수영구,45-49세,13202,6371,6831
202102,26500,부산광역시,수영구,45-49세,13139,6332,6807
202103,26500,부산광역시,수영구,45-49세,13043,6306,6737
202104,26500,부산광역시,수영구,45-49세,13010,6279,6731
202105,26500,부산광역시,수영구,45-49세,12888,6224,6664
202106,26500,부산광역시,수영구,45-49세,12767,6171,6596
202007,26500,부산광역시,수영구,50-54세,13564,6407,7157
202008,26500,부산광역시,수영구,50-54세,13576,6427,7149
202009,26500,부산광역시,수영구,50-54세,13674,6471,7203
202010,26500,부산광역시,수영구,50-54세,13727,6487,7240
202011,26500,부산광역시,수영구,50-54세,13773,6501,7272
202012,26500,부산광역시,수영구,50-54세,13773,6511,7262
202101,26500,부산광역시,수영구,50-54세,13835,6540,7295
202102,26500,부산광역시,수영구,50-54세,13842,6548,7294
202103,26500,부산광역시,수영구,50-54세,13761,6538,7223
202104,26500,부산광역시,수영구,50-54세,13787,6549,7238
202105,26500,부산광역시,수영구,50-54세,13837,6571,7266
202106,26500,부산광역시,수영구,50-54세,13865,6595,7270
202007,26500,부산광역시,수영구,55-59세,14200,6286,7914
202008,26500,부산광역시,수영구,55-59세,14141,6252,7889
202009,26500,부산광역시,수영구,55-59세,14109,6267,7842
202010,26500,부산광역시,수영구,55-59세,14056,6250,7806
202011,26500,부산광역시,수영구,55-59세,13983,6231,7752
202012,26500,부산광역시,수영구,55-59세,13945,6210,7735
202101,26500,부산광역시,수영구,55-59세,13816,6170,7646
202102,26500,부산광역시,수영구,55-59세,13738,6145,7593
202103,26500,부산광역시,수영구,55-59세,13626,6089,7537
202104,26500,부산광역시,수영구,55-59세,13558,6087,7471
202105,26500,부산광역시,수영구,55-59세,13428,6058,7370
202106,26500,부산광역시,수영구,55-59세,13316,5988,7328
202007,26500,부산광역시,수영구,60-64세,15623,6941,8682
202008,26500,부산광역시,수영구,60-64세,15724,7009,8715
202009,26500,부산광역시,수영구,60-64세,15708,6989,8719
202010,26500,부산광역시,수영구,60-64세,15676,6951,8725
202011,26500,부산광역시,수영구,60-64세,15699,6957,8742
202012,26500,부산광역시,수영구,60-64세,15673,6944,8729
202101,26500,부산광역시,수영구,60-64세,15678,6939,8739
202102,26500,부산광역시,수영구,60-64세,15735,6950,8785
202103,26500,부산광역시,수영구,60-64세,15730,6942,8788
202104,26500,부산광역시,수영구,60-64세,15741,6923,8818
202105,26500,부산광역시,수영구,60-64세,15744,6922,8822
202106,26500,부산광역시,수영구,60-64세,15778,6949,8829
202007,26500,부산광역시,수영구,65-69세,12412,5571,6841
202008,26500,부산광역시,수영구,65-69세,12500,5613,6887
202009,26500,부산광역시,수영구,65-69세,12601,5664,6937
202010,26500,부산광역시,수영구,65-69세,12712,5717,6995
202011,26500,부산광역시,수영구,65-69세,12781,5741,7040
202012,26500,부산광역시,수영구,65-69세,12872,5784,7088
202101,26500,부산광역시,수영구,65-69세,12980,5820,7160
202102,26500,부산광역시,수영구,65-69세,13033,5844,7189
202103,26500,부산광역시,수영구,65-69세,13044,5848,7196
202104,26500,부산광역시,수영구,65-69세,13101,5883,7218
202105,26500,부산광역시,수영구,65-69세,13144,5882,7262
202106,26500,부산광역시,수영구,65-69세,13159,5875,7284
202007,26500,부산광역시,수영구,70-74세,9829,4443,5386
202008,26500,부산광역시,수영구,70-74세,9818,4437,5381
202009,26500,부산광역시,수영구,70-74세,9891,4472,5419
202010,26500,부산광역시,수영구,70-74세,9944,4481,5463
202011,26500,부산광역시,수영구,70-74세,9996,4489,5507
202012,26500,부산광역시,수영구,70-74세,10035,4503,5532
202101,26500,부산광역시,수영구,70-74세,10084,4526,5558
202102,26500,부산광역시,수영구,70-74세,10089,4521,5568
202103,26500,부산광역시,수영구,70-74세,10060,4512,5548
202104,26500,부산광역시,수영구,70-74세,10122,4529,5593
202105,26500,부산광역시,수영구,70-74세,10099,4497,5602
202106,26500,부산광역시,수영구,70-74세,10103,4497,5606
202007,26500,부산광역시,수영구,75-79세,7193,3236,3957
202008,26500,부산광역시,수영구,75-79세,7188,3231,3957
202009,26500,부산광역시,수영구,75-79세,7160,3201,3959
202010,26500,부산광역시,수영구,75-79세,7103,3182,3921
202011,26500,부산광역시,수영구,75-79세,7067,3166,3901
202012,26500,부산광역시,수영구,75-79세,7010,3132,3878
202101,26500,부산광역시,수영구,75-79세,6969,3119,3850
202102,26500,부산광역시,수영구,75-79세,6956,3116,3840
202103,26500,부산광역시,수영구,75-79세,6966,3128,3838
202104,26500,부산광역시,수영구,75-79세,6963,3126,3837
202105,26500,부산광역시,수영구,75-79세,6983,3145,3838
202106,26500,부산광역시,수영구,75-79세,7011,3149,3862
202007,26500,부산광역시,수영구,80-84세,4469,1838,2631
202008,26500,부산광역시,수영구,80-84세,4500,1849,2651
202009,26500,부산광역시,수영구,80-84세,4510,1858,2652
202010,26500,부산광역시,수영구,80-84세,4557,1873,2684
202011,26500,부산광역시,수영구,80-84세,4580,1886,2694
202012,26500,부산광역시,수영구,80-84세,4616,1898,2718
202101,26500,부산광역시,수영구,80-84세,4663,1921,2742
202102,26500,부산광역시,수영구,80-84세,4686,1946,2740
202103,26500,부산광역시,수영구,80-84세,4689,1936,2753
202104,26500,부산광역시,수영구,80-84세,4730,1962,2768
202105,26500,부산광역시,수영구,80-84세,4776,1986,2790
202106,26500,부산광역시,수영구,80-84세,4804,2003,2801
202007,26500,부산광역시,수영구,85-89세,2091,649,1442
202008,26500,부산광역시,수영구,85-89세,2089,651,1438
202009,26500,부산광역시,수영구,85-89세,2109,656,1453
202010,26500,부산광역시,수영구,85-89세,2101,652,1449
202011,26500,부산광역시,수영구,85-89세,2115,648,1467
202012,26500,부산광역시,수영구,85-89세,2141,670,1471
202101,26500,부산광역시,수영구,85-89세,2158,670,1488
202102,26500,부산광역시,수영구,85-89세,2182,671,1511
202103,26500,부산광역시,수영구,85-89세,2203,692,1511
202104,26500,부산광역시,수영구,85-89세,2201,691,1510
202105,26500,부산광역시,수영구,85-89세,2202,689,1513
202106,26500,부산광역시,수영구,85-89세,2194,690,1504
202007,26500,부산광역시,수영구,90-94세,737,186,551
202008,26500,부산광역시,수영구,90-94세,737,189,548
202009,26500,부산광역시,수영구,90-94세,738,193,545
202010,26500,부산광역시,수영구,90-94세,738,192,546
202011,26500,부산광역시,수영구,90-94세,738,196,542
202012,26500,부산광역시,수영구,90-94세,738,194,544
202101,26500,부산광역시,수영구,90-94세,741,200,541
202102,26500,부산광역시,수영구,90-94세,750,202,548
202103,26500,부산광역시,수영구,90-94세,750,202,548
202104,26500,부산광역시,수영구,90-94세,757,201,556
202105,26500,부산광역시,수영구,90-94세,765,211,554
202106,26500,부산광역시,수영구,90-94세,773,217,556
202007,26500,부산광역시,수영구,95-99세,136,22,114
202008,26500,부산광역시,수영구,95-99세,138,22,116
202009,26500,부산광역시,수영구,95-99세,138,23,115
202010,26500,부산광역시,수영구,95-99세,139,24,115
202011,26500,부산광역시,수영구,95-99세,141,24,117
202012,26500,부산광역시,수영구,95-99세,137,24,113
202101,26500,부산광역시,수영구,95-99세,135,22,113
202102,26500,부산광역시,수영구,95-99세,140,24,116
202103,26500,부산광역시,수영구,95-99세,126,21,105
202104,26500,부산광역시,수영구,95-99세,125,20,105
202105,26500,부산광역시,수영구,95-99세,128,19,109
202106,26500,부산광역시,수영구,95-99세,129,18,111
202007,26500,부산광역시,수영구,100+,63,13,50
202008,26500,부산광역시,수영구,100+,64,13,51
202009,26500,부산광역시,수영구,100+,64,13,51
202010,26500,부산광역시,수영구,100+,62,13,49
202011,26500,부산광역시,수영구,100+,62,14,48
202012,26500,부산광역시,수영구,100+,61,14,47
202101,26500,부산광역시,수영구,100+,60,14,46
202102,26500,부산광역시,수영구,100+,62,14,48
202103,26500,부산광역시,수영구,100+,34,8,26
202104,26500,부산광역시,수영구,100+,35,8,27
202105,26500,부산광역시,수영구,100+,35,8,27
202106,26500,부산광역시,수영구,100+,35,8,27
202007,26530,부산광역시,사상구,0-4세,5685,2918,2767
202008,26530,부산광역시,사상구,0-4세,5599,2871,2728
202009,26530,부산광역시,사상구,0-4세,5499,2830,2669
202010,26530,부산광역시,사상구,0-4세,5399,2777,2622
202011,26530,부산광역시,사상구,0-4세,5291,2729,2562
202012,26530,부산광역시,사상구,0-4세,5203,2691,2512
202101,26530,부산광역시,사상구,0-4세,5145,2661,2484
202102,26530,부산광역시,사상구,0-4세,5089,2633,2456
202103,26530,부산광역시,사상구,0-4세,5014,2601,2413
202104,26530,부산광역시,사상구,0-4세,4958,2568,2390
202105,26530,부산광역시,사상구,0-4세,4867,2508,2359
202106,26530,부산광역시,사상구,0-4세,4831,2502,2329
202007,26530,부산광역시,사상구,5-9세,7395,3729,3666
202008,26530,부산광역시,사상구,5-9세,7356,3700,3656
202009,26530,부산광역시,사상구,5-9세,7303,3668,3635
202010,26530,부산광역시,사상구,5-9세,7250,3644,3606
202011,26530,부산광역시,사상구,5-9세,7201,3617,3584
202012,26530,부산광역시,사상구,5-9세,7152,3601,3551
202101,26530,부산광역시,사상구,5-9세,7104,3574,3530
202102,26530,부산광역시,사상구,5-9세,7078,3567,3511
202103,26530,부산광역시,사상구,5-9세,7045,3553,3492
202104,26530,부산광역시,사상구,5-9세,6999,3517,3482
202105,26530,부산광역시,사상구,5-9세,6959,3523,3436
202106,26530,부산광역시,사상구,5-9세,6946,3509,3437
202007,26530,부산광역시,사상구,10-14세,6982,3624,3358
202008,26530,부산광역시,사상구,10-14세,6956,3607,3349
202009,26530,부산광역시,사상구,10-14세,6960,3609,3351
202010,26530,부산광역시,사상구,10-14세,6978,3617,3361
202011,26530,부산광역시,사상구,10-14세,6990,3605,3385
202012,26530,부산광역시,사상구,10-14세,6961,3581,3380
202101,26530,부산광역시,사상구,10-14세,6971,3593,3378
202102,26530,부산광역시,사상구,10-14세,6949,3583,3366
202103,26530,부산광역시,사상구,10-14세,6955,3572,3383
202104,26530,부산광역시,사상구,10-14세,6950,3565,3385
202105,26530,부산광역시,사상구,10-14세,6942,3545,3397
202106,26530,부산광역시,사상구,10-14세,6959,3550,3409
202007,26530,부산광역시,사상구,15-19세,8606,4544,4062
202008,26530,부산광역시,사상구,15-19세,8524,4508,4016
202009,26530,부산광역시,사상구,15-19세,8447,4468,3979
202010,26530,부산광역시,사상구,15-19세,8314,4413,3901
202011,26530,부산광역시,사상구,15-19세,8206,4358,3848
202012,26530,부산광역시,사상구,15-19세,8127,4301,3826
202101,26530,부산광역시,사상구,15-19세,8041,4251,3790
202102,26530,부산광역시,사상구,15-19세,7990,4224,3766
202103,26530,부산광역시,사상구,15-19세,7932,4196,3736
202104,26530,부산광역시,사상구,15-19세,7879,4168,3711
202105,26530,부산광역시,사상구,15-19세,7833,4141,3692
202106,26530,부산광역시,사상구,15-19세,7780,4121,3659
202007,26530,부산광역시,사상구,20-24세,13905,7289,6616
202008,26530,부산광역시,사상구,20-24세,13873,7265,6608
202009,26530,부산광역시,사상구,20-24세,13776,7211,6565
202010,26530,부산광역시,사상구,20-24세,13696,7140,6556
202011,26530,부산광역시,사상구,20-24세,13581,7097,6484
202012,26530,부산광역시,사상구,20-24세,13511,7074,6437
202101,26530,부산광역시,사상구,20-24세,13366,6987,6379
202102,26530,부산광역시,사상구,20-24세,13351,6952,6399
202103,26530,부산광역시,사상구,20-24세,13246,6904,6342
202104,26530,부산광역시,사상구,20-24세,13206,6885,6321
202105,26530,부산광역시,사상구,20-24세,13141,6841,6300
202106,26530,부산광역시,사상구,20-24세,13066,6799,6267
202007,26530,부산광역시,사상구,25-29세,15467,8463,7004
202008,26530,부산광역시,사상구,25-29세,15411,8447,6964
202009,26530,부산광역시,사상구,25-29세,15413,8448,6965
202010,26530,부산광역시,사상구,25-29세,15421,8458,6963
202011,26530,부산광역시,사상구,25-29세,15443,8472,6971
202012,26530,부산광역시,사상구,25-29세,15421,8445,6976
202101,26530,부산광역시,사상구,25-29세,15389,8421,6968
202102,26530,부산광역시,사상구,25-29세,15364,8413,6951
202103,26530,부산광역시,사상구,25-29세,15384,8399,6985
202104,26530,부산광역시,사상구,25-29세,15379,8402,6977
202105,26530,부산광역시,사상구,25-29세,15430,8428,7002
202106,26530,부산광역시,사상구,25-29세,15395,8396,6999
202007,26530,부산광역시,사상구,30-34세,12240,6698,5542
202008,26530,부산광역시,사상구,30-34세,12228,6683,5545
202009,26530,부산광역시,사상구,30-34세,12234,6690,5544
202010,26530,부산광역시,사상구,30-34세,12186,6663,5523
202011,26530,부산광역시,사상구,30-34세,12105,6623,5482
202012,26530,부산광역시,사상구,30-34세,12029,6571,5458
202101,26530,부산광역시,사상구,30-34세,11982,6552,5430
202102,26530,부산광역시,사상구,30-34세,12001,6564,5437
202103,26530,부산광역시,사상구,30-34세,12013,6587,5426
202104,26530,부산광역시,사상구,30-34세,12062,6607,5455
202105,26530,부산광역시,사상구,30-34세,12082,6601,5481
202106,26530,부산광역시,사상구,30-34세,12130,6638,5492
202007,26530,부산광역시,사상구,35-39세,13819,7298,6521
202008,26530,부산광역시,사상구,35-39세,13649,7197,6452
202009,26530,부산광역시,사상구,35-39세,13514,7122,6392
202010,26530,부산광역시,사상구,35-39세,13337,7048,6289
202011,26530,부산광역시,사상구,35-39세,13255,6980,6275
202012,26530,부산광역시,사상구,35-39세,13195,6957,6238
202101,26530,부산광역시,사상구,35-39세,13099,6905,6194
202102,26530,부산광역시,사상구,35-39세,12957,6858,6099
202103,26530,부산광역시,사상구,35-39세,12799,6781,6018
202104,26530,부산광역시,사상구,35-39세,12749,6760,5989
202105,26530,부산광역시,사상구,35-39세,12615,6703,5912
202106,26530,부산광역시,사상구,35-39세,12499,6643,5856
202007,26530,부산광역시,사상구,40-44세,13932,7441,6491
202008,26530,부산광역시,사상구,40-44세,13908,7433,6475
202009,26530,부산광역시,사상구,40-44세,13879,7430,6449
202010,26530,부산광역시,사상구,40-44세,13902,7437,6465
202011,26530,부산광역시,사상구,40-44세,13825,7402,6423
202012,26530,부산광역시,사상구,40-44세,13735,7370,6365
202101,26530,부산광역시,사상구,40-44세,13713,7350,6363
202102,26530,부산광역시,사상구,40-44세,13780,7366,6414
202103,26530,부산광역시,사상구,40-44세,13755,7362,6393
202104,26530,부산광역시,사상구,40-44세,13735,7355,6380
202105,26530,부산광역시,사상구,40-44세,13775,7375,6400
202106,26530,부산광역시,사상구,40-44세,13849,7407,6442
202007,26530,부산광역시,사상구,45-49세,16114,8285,7829
202008,26530,부산광역시,사상구,45-49세,16016,8241,7775
202009,26530,부산광역시,사상구,45-49세,15899,8173,7726
202010,26530,부산광역시,사상구,45-49세,15760,8103,7657
202011,26530,부산광역시,사상구,45-49세,15692,8065,7627
202012,26530,부산광역시,사상구,45-49세,15628,8052,7576
202101,26530,부산광역시,사상구,45-49세,15564,8016,7548
202102,26530,부산광역시,사상구,45-49세,15461,8004,7457
202103,26530,부산광역시,사상구,45-49세,15358,7975,7383
202104,26530,부산광역시,사상구,45-49세,15282,7949,7333
202105,26530,부산광역시,사상구,45-49세,15145,7871,7274
202106,26530,부산광역시,사상구,45-49세,15060,7832,7228
202007,26530,부산광역시,사상구,50-54세,19708,9736,9972
202008,26530,부산광역시,사상구,50-54세,19675,9714,9961
202009,26530,부산광역시,사상구,50-54세,19640,9711,9929
202010,26530,부산광역시,사상구,50-54세,19590,9680,9910
202011,26530,부산광역시,사상구,50-54세,19524,9652,9872
202012,26530,부산광역시,사상구,50-54세,19365,9572,9793
202101,26530,부산광역시,사상구,50-54세,19343,9572,9771
202102,26530,부산광역시,사상구,50-54세,19281,9510,9771
202103,26530,부산광역시,사상구,50-54세,19111,9428,9683
202104,26530,부산광역시,사상구,50-54세,19042,9386,9656
202105,26530,부산광역시,사상구,50-54세,19009,9363,9646
202106,26530,부산광역시,사상구,50-54세,18912,9304,9608
202007,26530,부산광역시,사상구,55-59세,22342,11231,11111
202008,26530,부산광역시,사상구,55-59세,22250,11198,11052
202009,26530,부산광역시,사상구,55-59세,22099,11104,10995
202010,26530,부산광역시,사상구,55-59세,21968,11059,10909
202011,26530,부산광역시,사상구,55-59세,21891,10991,10900
202012,26530,부산광역시,사상구,55-59세,21825,10930,10895
202101,26530,부산광역시,사상구,55-59세,21641,10861,10780
202102,26530,부산광역시,사상구,55-59세,21539,10836,10703
202103,26530,부산광역시,사상구,55-59세,21358,10739,10619
202104,26530,부산광역시,사상구,55-59세,21195,10646,10549
202105,26530,부산광역시,사상구,55-59세,20993,10567,10426
202106,26530,부산광역시,사상구,55-59세,20841,10495,10346
202007,26530,부산광역시,사상구,60-64세,21165,10609,10556
202008,26530,부산광역시,사상구,60-64세,21213,10627,10586
202009,26530,부산광역시,사상구,60-64세,21293,10674,10619
202010,26530,부산광역시,사상구,60-64세,21388,10709,10679
202011,26530,부산광역시,사상구,60-64세,21448,10775,10673
202012,26530,부산광역시,사상구,60-64세,21569,10865,10704
202101,26530,부산광역시,사상구,60-64세,21721,10939,10782
202102,26530,부산광역시,사상구,60-64세,21877,11012,10865
202103,26530,부산광역시,사상구,60-64세,21928,11010,10918
202104,26530,부산광역시,사상구,60-64세,21993,11030,10963
202105,26530,부산광역시,사상구,60-64세,22149,11098,11051
202106,26530,부산광역시,사상구,60-64세,22292,11163,11129
202007,26530,부산광역시,사상구,65-69세,14731,7254,7477
202008,26530,부산광역시,사상구,65-69세,14824,7286,7538
202009,26530,부산광역시,사상구,65-69세,14960,7344,7616
202010,26530,부산광역시,사상구,65-69세,15027,7370,7657
202011,26530,부산광역시,사상구,65-69세,15123,7394,7729
202012,26530,부산광역시,사상구,65-69세,15149,7393,7756
202101,26530,부산광역시,사상구,65-69세,15223,7430,7793
202102,26530,부산광역시,사상구,65-69세,15343,7470,7873
202103,26530,부산광역시,사상구,65-69세,15408,7501,7907
202104,26530,부산광역시,사상구,65-69세,15503,7552,7951
202105,26530,부산광역시,사상구,65-69세,15531,7573,7958
202106,26530,부산광역시,사상구,65-69세,15581,7602,7979
202007,26530,부산광역시,사상구,70-74세,9915,4705,5210
202008,26530,부산광역시,사상구,70-74세,9987,4750,5237
202009,26530,부산광역시,사상구,70-74세,10064,4786,5278
202010,26530,부산광역시,사상구,70-74세,10151,4826,5325
202011,26530,부산광역시,사상구,70-74세,10226,4849,5377
202012,26530,부산광역시,사상구,70-74세,10356,4905,5451
202101,26530,부산광역시,사상구,70-74세,10469,4957,5512
202102,26530,부산광역시,사상구,70-74세,10542,4992,5550
202103,26530,부산광역시,사상구,70-74세,10555,4993,5562
202104,26530,부산광역시,사상구,70-74세,10595,5022,5573
202105,26530,부산광역시,사상구,70-74세,10640,5053,5587
202106,26530,부산광역시,사상구,70-74세,10698,5063,5635
202007,26530,부산광역시,사상구,75-79세,6910,3100,3810
202008,26530,부산광역시,사상구,75-79세,6906,3091,3815
202009,26530,부산광역시,사상구,75-79세,6890,3088,3802
202010,26530,부산광역시,사상구,75-79세,6868,3073,3795
202011,26530,부산광역시,사상구,75-79세,6825,3061,3764
202012,26530,부산광역시,사상구,75-79세,6776,3030,3746
202101,26530,부산광역시,사상구,75-79세,6762,3021,3741
202102,26530,부산광역시,사상구,75-79세,6722,3005,3717
202103,26530,부산광역시,사상구,75-79세,6712,2992,3720
202104,26530,부산광역시,사상구,75-79세,6668,2979,3689
202105,26530,부산광역시,사상구,75-79세,6675,2977,3698
202106,26530,부산광역시,사상구,75-79세,6657,2983,3674
202007,26530,부산광역시,사상구,80-84세,3993,1424,2569
202008,26530,부산광역시,사상구,80-84세,4003,1439,2564
202009,26530,부산광역시,사상구,80-84세,4016,1448,2568
202010,26530,부산광역시,사상구,80-84세,4039,1458,2581
202011,26530,부산광역시,사상구,80-84세,4069,1477,2592
202012,26530,부산광역시,사상구,80-84세,4084,1491,2593
202101,26530,부산광역시,사상구,80-84세,4104,1511,2593
202102,26530,부산광역시,사상구,80-84세,4144,1536,2608
202103,26530,부산광역시,사상구,80-84세,4156,1531,2625
202104,26530,부산광역시,사상구,80-84세,4206,1548,2658
202105,26530,부산광역시,사상구,80-84세,4232,1559,2673
202106,26530,부산광역시,사상구,80-84세,4279,1573,2706
202007,26530,부산광역시,사상구,85-89세,1708,447,1261
202008,26530,부산광역시,사상구,85-89세,1725,445,1280
202009,26530,부산광역시,사상구,85-89세,1739,451,1288
202010,26530,부산광역시,사상구,85-89세,1747,450,1297
202011,26530,부산광역시,사상구,85-89세,1757,453,1304
202012,26530,부산광역시,사상구,85-89세,1765,453,1312
202101,26530,부산광역시,사상구,85-89세,1789,467,1322
202102,26530,부산광역시,사상구,85-89세,1826,479,1347
202103,26530,부산광역시,사상구,85-89세,1833,478,1355
202104,26530,부산광역시,사상구,85-89세,1846,482,1364
202105,26530,부산광역시,사상구,85-89세,1857,483,1374
202106,26530,부산광역시,사상구,85-89세,1859,491,1368
202007,26530,부산광역시,사상구,90-94세,526,85,441
202008,26530,부산광역시,사상구,90-94세,530,87,443
202009,26530,부산광역시,사상구,90-94세,530,88,442
202010,26530,부산광역시,사상구,90-94세,532,94,438
202011,26530,부산광역시,사상구,90-94세,531,96,435
202012,26530,부산광역시,사상구,90-94세,540,98,442
202101,26530,부산광역시,사상구,90-94세,546,97,449
202102,26530,부산광역시,사상구,90-94세,544,97,447
202103,26530,부산광역시,사상구,90-94세,526,95,431
202104,26530,부산광역시,사상구,90-94세,533,92,441
202105,26530,부산광역시,사상구,90-94세,542,98,444
202106,26530,부산광역시,사상구,90-94세,536,97,439
202007,26530,부산광역시,사상구,95-99세,121,17,104
202008,26530,부산광역시,사상구,95-99세,123,18,105
202009,26530,부산광역시,사상구,95-99세,119,15,104
202010,26530,부산광역시,사상구,95-99세,123,16,107
202011,26530,부산광역시,사상구,95-99세,124,16,108
202012,26530,부산광역시,사상구,95-99세,125,16,109
202101,26530,부산광역시,사상구,95-99세,131,17,114
202102,26530,부산광역시,사상구,95-99세,128,18,110
202103,26530,부산광역시,사상구,95-99세,121,16,105
202104,26530,부산광역시,사상구,95-99세,119,13,106
202105,26530,부산광역시,사상구,95-99세,118,13,105
202106,26530,부산광역시,사상구,95-99세,118,13,105
202007,26530,부산광역시,사상구,100+,68,9,59
202008,26530,부산광역시,사상구,100+,70,9,61
202009,26530,부산광역시,사상구,100+,71,9,62
202010,26530,부산광역시,사상구,100+,71,9,62
202011,26530,부산광역시,사상구,100+,71,9,62
202012,26530,부산광역시,사상구,100+,70,9,61
202101,26530,부산광역시,사상구,100+,70,9,61
202102,26530,부산광역시,사상구,100+,72,9,63
202103,26530,부산광역시,사상구,100+,43,4,39
202104,26530,부산광역시,사상구,100+,44,4,40
202105,26530,부산광역시,사상구,100+,44,4,40
202106,26530,부산광역시,사상구,100+,45,4,41
202007,26710,부산광역시,기장군,0-4세,8159,4074,4085
202008,26710,부산광역시,기장군,0-4세,8152,4076,4076
202009,26710,부산광역시,기장군,0-4세,8098,4056,4042
202010,26710,부산광역시,기장군,0-4세,8021,4024,3997
202011,26710,부산광역시,기장군,0-4세,7991,4006,3985
202012,26710,부산광역시,기장군,0-4세,7995,4018,3977
202101,26710,부산광역시,기장군,0-4세,7959,3996,3963
202102,26710,부산광역시,기장군,0-4세,7921,4004,3917
202103,26710,부산광역시,기장군,0-4세,7811,3960,3851
202104,26710,부산광역시,기장군,0-4세,7749,3935,3814
202105,26710,부산광역시,기장군,0-4세,7685,3909,3776
202106,26710,부산광역시,기장군,0-4세,7641,3883,3758
202007,26710,부산광역시,기장군,5-9세,11138,5716,5422
202008,26710,부산광역시,기장군,5-9세,11204,5746,5458
202009,26710,부산광역시,기장군,5-9세,11178,5734,5444
202010,26710,부산광역시,기장군,5-9세,11173,5740,5433
202011,26710,부산광역시,기장군,5-9세,11190,5748,5442
202012,26710,부산광역시,기장군,5-9세,11158,5724,5434
202101,26710,부산광역시,기장군,5-9세,11162,5736,5426
202102,26710,부산광역시,기장군,5-9세,11225,5757,5468
202103,26710,부산광역시,기장군,5-9세,11234,5740,5494
202104,26710,부산광역시,기장군,5-9세,11203,5723,5480
202105,26710,부산광역시,기장군,5-9세,11187,5720,5467
202106,26710,부산광역시,기장군,5-9세,11194,5734,5460
202007,26710,부산광역시,기장군,10-14세,9018,4697,4321
202008,26710,부산광역시,기장군,10-14세,9058,4694,4364
202009,26710,부산광역시,기장군,10-14세,9147,4731,4416
202010,26710,부산광역시,기장군,10-14세,9207,4758,4449
202011,26710,부산광역시,기장군,10-14세,9296,4803,4493
202012,26710,부산광역시,기장군,10-14세,9363,4823,4540
202101,26710,부산광역시,기장군,10-14세,9447,4867,4580
202102,26710,부산광역시,기장군,10-14세,9530,4903,4627
202103,26710,부산광역시,기장군,10-14세,9603,4958,4645
202104,26710,부산광역시,기장군,10-14세,9672,4993,4679
202105,26710,부산광역시,기장군,10-14세,9699,5001,4698
202106,26710,부산광역시,기장군,10-14세,9724,5018,4706
202007,26710,부산광역시,기장군,15-19세,8108,4258,3850
202008,26710,부산광역시,기장군,15-19세,8140,4294,3846
202009,26710,부산광역시,기장군,15-19세,8120,4295,3825
202010,26710,부산광역시,기장군,15-19세,8113,4302,3811
202011,26710,부산광역시,기장군,15-19세,8107,4289,3818
202012,26710,부산광역시,기장군,15-19세,8112,4268,3844
202101,26710,부산광역시,기장군,15-19세,8114,4256,3858
202102,26710,부산광역시,기장군,15-19세,8112,4257,3855
202103,26710,부산광역시,기장군,15-19세,8071,4240,3831
202104,26710,부산광역시,기장군,15-19세,8044,4221,3823
202105,26710,부산광역시,기장군,15-19세,8046,4214,3832
202106,26710,부산광역시,기장군,15-19세,8034,4198,3836
202007,26710,부산광역시,기장군,20-24세,8095,4241,3854
202008,26710,부산광역시,기장군,20-24세,8126,4273,3853
202009,26710,부산광역시,기장군,20-24세,8178,4304,3874
202010,26710,부산광역시,기장군,20-24세,8167,4286,3881
202011,26710,부산광역시,기장군,20-24세,8223,4344,3879
202012,26710,부산광역시,기장군,20-24세,8246,4368,3878
202101,26710,부산광역시,기장군,20-24세,8259,4372,3887
202102,26710,부산광역시,기장군,20-24세,8313,4393,3920
202103,26710,부산광역시,기장군,20-24세,8304,4364,3940
202104,26710,부산광역시,기장군,20-24세,8321,4379,3942
202105,26710,부산광역시,기장군,20-24세,8298,4374,3924
202106,26710,부산광역시,기장군,20-24세,8312,4390,3922
202007,26710,부산광역시,기장군,25-29세,8514,4543,3971
202008,26710,부산광역시,기장군,25-29세,8590,4569,4021
202009,26710,부산광역시,기장군,25-29세,8637,4595,4042
202010,26710,부산광역시,기장군,25-29세,8708,4638,4070
202011,26710,부산광역시,기장군,25-29세,8792,4663,4129
202012,26710,부산광역시,기장군,25-29세,8820,4685,4135
202101,26710,부산광역시,기장군,25-29세,8834,4688,4146
202102,26710,부산광역시,기장군,25-29세,8827,4707,4120
202103,26710,부산광역시,기장군,25-29세,8811,4690,4121
202104,26710,부산광역시,기장군,25-29세,8822,4694,4128
202105,26710,부산광역시,기장군,25-29세,8850,4709,4141
202106,26710,부산광역시,기장군,25-29세,8881,4734,4147
202007,26710,부산광역시,기장군,30-34세,9769,4835,4934
202008,26710,부산광역시,기장군,30-34세,9859,4881,4978
202009,26710,부산광역시,기장군,30-34세,9850,4893,4957
202010,26710,부산광역시,기장군,30-34세,9833,4879,4954
202011,26710,부산광역시,기장군,30-34세,9868,4917,4951
202012,26710,부산광역시,기장군,30-34세,9915,4937,4978
202101,26710,부산광역시,기장군,30-34세,9979,4955,5024
202102,26710,부산광역시,기장군,30-34세,10015,4974,5041
202103,26710,부산광역시,기장군,30-34세,10046,5012,5034
202104,26710,부산광역시,기장군,30-34세,10065,5033,5032
202105,26710,부산광역시,기장군,30-34세,10078,5042,5036
202106,26710,부산광역시,기장군,30-34세,10067,5030,5037
202007,26710,부산광역시,기장군,35-39세,15390,7607,7783
202008,26710,부산광역시,기장군,35-39세,15362,7621,7741
202009,26710,부산광역시,기장군,35-39세,15246,7566,7680
202010,26710,부산광역시,기장군,35-39세,15119,7512,7607
202011,26710,부산광역시,기장군,35-39세,15047,7477,7570
202012,26710,부산광역시,기장군,35-39세,15045,7482,7563
202101,26710,부산광역시,기장군,35-39세,14979,7449,7530
202102,26710,부산광역시,기장군,35-39세,14902,7387,7515
202103,26710,부산광역시,기장군,35-39세,14817,7342,7475
202104,26710,부산광역시,기장군,35-39세,14736,7301,7435
202105,26710,부산광역시,기장군,35-39세,14620,7255,7365
202106,26710,부산광역시,기장군,35-39세,14549,7208,7341
202007,26710,부산광역시,기장군,40-44세,16318,8293,8025
202008,26710,부산광역시,기장군,40-44세,16422,8325,8097
202009,26710,부산광역시,기장군,40-44세,16578,8401,8177
202010,26710,부산광역시,기장군,40-44세,16709,8453,8256
202011,26710,부산광역시,기장군,40-44세,16818,8514,8304
202012,26710,부산광역시,기장군,40-44세,16834,8528,8306
202101,26710,부산광역시,기장군,40-44세,16968,8591,8377
202102,26710,부산광역시,기장군,40-44세,17125,8693,8432
202103,26710,부산광역시,기장군,40-44세,17075,8663,8412
202104,26710,부산광역시,기장군,40-44세,17123,8680,8443
202105,26710,부산광역시,기장군,40-44세,17198,8713,8485
202106,26710,부산광역시,기장군,40-44세,17274,8758,8516
202007,26710,부산광역시,기장군,45-49세,15132,7926,7206
202008,26710,부산광역시,기장군,45-49세,15174,7950,7224
202009,26710,부산광역시,기장군,45-49세,15203,7974,7229
202010,26710,부산광역시,기장군,45-49세,15227,7974,7253
202011,26710,부산광역시,기장군,45-49세,15272,7987,7285
202012,26710,부산광역시,기장군,45-49세,15381,8003,7378
202101,26710,부산광역시,기장군,45-49세,15423,8020,7403
202102,26710,부산광역시,기장군,45-49세,15484,8022,7462
202103,26710,부산광역시,기장군,45-49세,15526,8043,7483
202104,26710,부산광역시,기장군,45-49세,15570,8050,7520
202105,26710,부산광역시,기장군,45-49세,15516,8010,7506
202106,26710,부산광역시,기장군,45-49세,15478,7999,7479
202007,26710,부산광역시,기장군,50-54세,12308,6347,5961
202008,26710,부산광역시,기장군,50-54세,12435,6414,6021
202009,26710,부산광역시,기장군,50-54세,12498,6426,6072
202010,26710,부산광역시,기장군,50-54세,12594,6497,6097
202011,26710,부산광역시,기장군,50-54세,12701,6549,6152
202012,26710,부산광역시,기장군,50-54세,12752,6590,6162
202101,26710,부산광역시,기장군,50-54세,12964,6699,6265
202102,26710,부산광역시,기장군,50-54세,13079,6767,6312
202103,26710,부산광역시,기장군,50-54세,13079,6749,6330
202104,26710,부산광역시,기장군,50-54세,13111,6789,6322
202105,26710,부산광역시,기장군,50-54세,13197,6841,6356
202106,26710,부산광역시,기장군,50-54세,13271,6880,6391
202007,26710,부산광역시,기장군,55-59세,11174,5491,5683
202008,26710,부산광역시,기장군,55-59세,11238,5520,5718
202009,26710,부산광역시,기장군,55-59세,11237,5526,5711
202010,26710,부산광역시,기장군,55-59세,11211,5511,5700
202011,26710,부산광역시,기장군,55-59세,11207,5515,5692
202012,26710,부산광역시,기장군,55-59세,11254,5541,5713
202101,26710,부산광역시,기장군,55-59세,11275,5554,5721
202102,26710,부산광역시,기장군,55-59세,11281,5568,5713
202103,26710,부산광역시,기장군,55-59세,11277,5588,5689
202104,26710,부산광역시,기장군,55-59세,11303,5610,5693
202105,26710,부산광역시,기장군,55-59세,11305,5610,5695
202106,26710,부산광역시,기장군,55-59세,11287,5605,5682
202007,26710,부산광역시,기장군,60-64세,11507,5362,6145
202008,26710,부산광역시,기장군,60-64세,11586,5412,6174
202009,26710,부산광역시,기장군,60-64세,11688,5469,6219
202010,26710,부산광역시,기장군,60-64세,11773,5493,6280
202011,26710,부산광역시,기장군,60-64세,11889,5551,6338
202012,26710,부산광역시,기장군,60-64세,11928,5572,6356
202101,26710,부산광역시,기장군,60-64세,12050,5644,6406
202102,26710,부산광역시,기장군,60-64세,12132,5669,6463
202103,26710,부산광역시,기장군,60-64세,12198,5705,6493
202104,26710,부산광역시,기장군,60-64세,12243,5729,6514
202105,26710,부산광역시,기장군,60-64세,12270,5737,6533
202106,26710,부산광역시,기장군,60-64세,12346,5769,6577
202007,26710,부산광역시,기장군,65-69세,8957,4153,4804
202008,26710,부산광역시,기장군,65-69세,9087,4220,4867
202009,26710,부산광역시,기장군,65-69세,9207,4264,4943
202010,26710,부산광역시,기장군,65-69세,9287,4305,4982
202011,26710,부산광역시,기장군,65-69세,9345,4330,5015
202012,26710,부산광역시,기장군,65-69세,9470,4387,5083
202101,26710,부산광역시,기장군,65-69세,9598,4435,5163
202102,26710,부산광역시,기장군,65-69세,9628,4455,5173
202103,26710,부산광역시,기장군,65-69세,9656,4490,5166
202104,26710,부산광역시,기장군,65-69세,9718,4502,5216
202105,26710,부산광역시,기장군,65-69세,9763,4527,5236
202106,26710,부산광역시,기장군,65-69세,9795,4542,5253
202007,26710,부산광역시,기장군,70-74세,6806,3188,3618
202008,26710,부산광역시,기장군,70-74세,6840,3195,3645
202009,26710,부산광역시,기장군,70-74세,6889,3226,3663
202010,26710,부산광역시,기장군,70-74세,6985,3266,3719
202011,26710,부산광역시,기장군,70-74세,7107,3328,3779
202012,26710,부산광역시,기장군,70-74세,7184,3365,3819
202101,26710,부산광역시,기장군,70-74세,7286,3409,3877
202102,26710,부산광역시,기장군,70-74세,7345,3431,3914
202103,26710,부산광역시,기장군,70-74세,7357,3424,3933
202104,26710,부산광역시,기장군,70-74세,7380,3454,3926
202105,26710,부산광역시,기장군,70-74세,7424,3474,3950
202106,26710,부산광역시,기장군,70-74세,7447,3495,3952
202007,26710,부산광역시,기장군,75-79세,5250,2284,2966
202008,26710,부산광역시,기장군,75-79세,5254,2288,2966
202009,26710,부산광역시,기장군,75-79세,5213,2274,2939
202010,26710,부산광역시,기장군,75-79세,5191,2272,2919
202011,26710,부산광역시,기장군,75-79세,5177,2271,2906
202012,26710,부산광역시,기장군,75-79세,5151,2253,2898
202101,26710,부산광역시,기장군,75-79세,5138,2256,2882
202102,26710,부산광역시,기장군,75-79세,5142,2261,2881
202103,26710,부산광역시,기장군,75-79세,5144,2259,2885
202104,26710,부산광역시,기장군,75-79세,5149,2252,2897
202105,26710,부산광역시,기장군,75-79세,5148,2250,2898
202106,26710,부산광역시,기장군,75-79세,5160,2246,2914
202007,26710,부산광역시,기장군,80-84세,3346,1215,2131
202008,26710,부산광역시,기장군,80-84세,3349,1224,2125
202009,26710,부산광역시,기장군,80-84세,3376,1230,2146
202010,26710,부산광역시,기장군,80-84세,3393,1227,2166
202011,26710,부산광역시,기장군,80-84세,3423,1244,2179
202012,26710,부산광역시,기장군,80-84세,3446,1263,2183
202101,26710,부산광역시,기장군,80-84세,3476,1278,2198
202102,26710,부산광역시,기장군,80-84세,3503,1294,2209
202103,26710,부산광역시,기장군,80-84세,3516,1294,2222
202104,26710,부산광역시,기장군,80-84세,3533,1300,2233
202105,26710,부산광역시,기장군,80-84세,3565,1309,2256
202106,26710,부산광역시,기장군,80-84세,3588,1323,2265
202007,26710,부산광역시,기장군,85-89세,1632,467,1165
202008,26710,부산광역시,기장군,85-89세,1649,471,1178
202009,26710,부산광역시,기장군,85-89세,1661,483,1178
202010,26710,부산광역시,기장군,85-89세,1680,489,1191
202011,26710,부산광역시,기장군,85-89세,1681,482,1199
202012,26710,부산광역시,기장군,85-89세,1704,491,1213
202101,26710,부산광역시,기장군,85-89세,1724,498,1226
202102,26710,부산광역시,기장군,85-89세,1757,511,1246
202103,26710,부산광역시,기장군,85-89세,1777,517,1260
202104,26710,부산광역시,기장군,85-89세,1784,519,1265
202105,26710,부산광역시,기장군,85-89세,1793,527,1266
202106,26710,부산광역시,기장군,85-89세,1803,527,1276
202007,26710,부산광역시,기장군,90-94세,551,105,446
202008,26710,부산광역시,기장군,90-94세,560,108,452
202009,26710,부산광역시,기장군,90-94세,563,105,458
202010,26710,부산광역시,기장군,90-94세,565,107,458
202011,26710,부산광역시,기장군,90-94세,574,110,464
202012,26710,부산광역시,기장군,90-94세,578,112,466
202101,26710,부산광역시,기장군,90-94세,584,116,468
202102,26710,부산광역시,기장군,90-94세,580,111,469
202103,26710,부산광역시,기장군,90-94세,568,113,455
202104,26710,부산광역시,기장군,90-94세,576,118,458
202105,26710,부산광역시,기장군,90-94세,586,123,463
202106,26710,부산광역시,기장군,90-94세,581,122,459
202007,26710,부산광역시,기장군,95-99세,154,20,134
202008,26710,부산광역시,기장군,95-99세,160,21,139
202009,26710,부산광역시,기장군,95-99세,163,22,141
202010,26710,부산광역시,기장군,95-99세,167,21,146
202011,26710,부산광역시,기장군,95-99세,165,20,145
202012,26710,부산광역시,기장군,95-99세,166,21,145
202101,26710,부산광역시,기장군,95-99세,165,21,144
202102,26710,부산광역시,기장군,95-99세,166,22,144
202103,26710,부산광역시,기장군,95-99세,158,19,139
202104,26710,부산광역시,기장군,95-99세,156,20,136
202105,26710,부산광역시,기장군,95-99세,151,20,131
202106,26710,부산광역시,기장군,95-99세,151,21,130
202007,26710,부산광역시,기장군,100+,43,7,36
202008,26710,부산광역시,기장군,100+,43,7,36
202009,26710,부산광역시,기장군,100+,44,7,37
202010,26710,부산광역시,기장군,100+,44,7,37
202011,26710,부산광역시,기장군,100+,45,8,37
202012,26710,부산광역시,기장군,100+,43,8,35
202101,26710,부산광역시,기장군,100+,44,8,36
202102,26710,부산광역시,기장군,100+,45,8,37
202103,26710,부산광역시,기장군,100+,28,2,26
202104,26710,부산광역시,기장군,100+,29,2,27
202105,26710,부산광역시,기장군,100+,32,2,30
202106,26710,부산광역시,기장군,100+,34,2,32
202007,27110,대구광역시,중구,0-4세,2533,1317,1216
202008,27110,대구광역시,중구,0-4세,2529,1317,1212
202009,27110,대구광역시,중구,0-4세,2497,1301,1196
202010,27110,대구광역시,중구,0-4세,2476,1283,1193
202011,27110,대구광역시,중구,0-4세,2419,1255,1164
202012,27110,대구광역시,중구,0-4세,2384,1226,1158
202101,27110,대구광역시,중구,0-4세,2348,1204,1144
202102,27110,대구광역시,중구,0-4세,2321,1183,1138
202103,27110,대구광역시,중구,0-4세,2275,1152,1123
202104,27110,대구광역시,중구,0-4세,2248,1141,1107
202105,27110,대구광역시,중구,0-4세,2210,1122,1088
202106,27110,대구광역시,중구,0-4세,2195,1111,1084
202007,27110,대구광역시,중구,5-9세,2798,1437,1361
202008,27110,대구광역시,중구,5-9세,2776,1421,1355
202009,27110,대구광역시,중구,5-9세,2765,1415,1350
202010,27110,대구광역시,중구,5-9세,2764,1417,1347
202011,27110,대구광역시,중구,5-9세,2767,1431,1336
202012,27110,대구광역시,중구,5-9세,2758,1429,1329
202101,27110,대구광역시,중구,5-9세,2737,1424,1313
202102,27110,대구광역시,중구,5-9세,2712,1409,1303
202103,27110,대구광역시,중구,5-9세,2700,1404,1296
202104,27110,대구광역시,중구,5-9세,2679,1399,1280
202105,27110,대구광역시,중구,5-9세,2676,1393,1283
202106,27110,대구광역시,중구,5-9세,2674,1387,1287
202007,27110,대구광역시,중구,10-14세,2293,1199,1094
202008,27110,대구광역시,중구,10-14세,2300,1203,1097
202009,27110,대구광역시,중구,10-14세,2303,1199,1104
202010,27110,대구광역시,중구,10-14세,2301,1203,1098
202011,27110,대구광역시,중구,10-14세,2317,1212,1105
202012,27110,대구광역시,중구,10-14세,2316,1214,1102
202101,27110,대구광역시,중구,10-14세,2332,1214,1118
202102,27110,대구광역시,중구,10-14세,2342,1220,1122
202103,27110,대구광역시,중구,10-14세,2331,1220,1111
202104,27110,대구광역시,중구,10-14세,2336,1216,1120
202105,27110,대구광역시,중구,10-14세,2353,1235,1118
202106,27110,대구광역시,중구,10-14세,2355,1238,1117
202007,27110,대구광역시,중구,15-19세,2816,1413,1403
202008,27110,대구광역시,중구,15-19세,2804,1415,1389
202009,27110,대구광역시,중구,15-19세,2808,1413,1395
202010,27110,대구광역시,중구,15-19세,2803,1421,1382
202011,27110,대구광역시,중구,15-19세,2784,1423,1361
202012,27110,대구광역시,중구,15-19세,2773,1417,1356
202101,27110,대구광역시,중구,15-19세,2722,1387,1335
202102,27110,대구광역시,중구,15-19세,2686,1366,1320
202103,27110,대구광역시,중구,15-19세,2670,1345,1325
202104,27110,대구광역시,중구,15-19세,2649,1336,1313
202105,27110,대구광역시,중구,15-19세,2621,1321,1300
202106,27110,대구광역시,중구,15-19세,2610,1320,1290
202007,27110,대구광역시,중구,20-24세,5257,2403,2854
202008,27110,대구광역시,중구,20-24세,5276,2402,2874
202009,27110,대구광역시,중구,20-24세,5251,2392,2859
202010,27110,대구광역시,중구,20-24세,5165,2355,2810
202011,27110,대구광역시,중구,20-24세,5145,2348,2797
202012,27110,대구광역시,중구,20-24세,5094,2320,2774
202101,27110,대구광역시,중구,20-24세,5085,2326,2759
202102,27110,대구광역시,중구,20-24세,5038,2305,2733
202103,27110,대구광역시,중구,20-24세,4981,2288,2693
202104,27110,대구광역시,중구,20-24세,4959,2277,2682
202105,27110,대구광역시,중구,20-24세,4928,2259,2669
202106,27110,대구광역시,중구,20-24세,4899,2239,2660
202007,27110,대구광역시,중구,25-29세,6676,3319,3357
202008,27110,대구광역시,중구,25-29세,6719,3339,3380
202009,27110,대구광역시,중구,25-29세,6725,3340,3385
202010,27110,대구광역시,중구,25-29세,6745,3350,3395
202011,27110,대구광역시,중구,25-29세,6747,3348,3399
202012,27110,대구광역시,중구,25-29세,6770,3340,3430
202101,27110,대구광역시,중구,25-29세,6775,3356,3419
202102,27110,대구광역시,중구,25-29세,6756,3336,3420
202103,27110,대구광역시,중구,25-29세,6738,3327,3411
202104,27110,대구광역시,중구,25-29세,6679,3295,3384
202105,27110,대구광역시,중구,25-29세,6669,3290,3379
202106,27110,대구광역시,중구,25-29세,6641,3277,3364
202007,27110,대구광역시,중구,30-34세,5267,2745,2522
202008,27110,대구광역시,중구,30-34세,5268,2742,2526
202009,27110,대구광역시,중구,30-34세,5281,2738,2543
202010,27110,대구광역시,중구,30-34세,5239,2719,2520
202011,27110,대구광역시,중구,30-34세,5218,2712,2506
202012,27110,대구광역시,중구,30-34세,5169,2699,2470
202101,27110,대구광역시,중구,30-34세,5195,2694,2501
202102,27110,대구광역시,중구,30-34세,5177,2667,2510
202103,27110,대구광역시,중구,30-34세,5168,2647,2521
202104,27110,대구광역시,중구,30-34세,5183,2667,2516
202105,27110,대구광역시,중구,30-34세,5197,2681,2516
202106,27110,대구광역시,중구,30-34세,5169,2652,2517
202007,27110,대구광역시,중구,35-39세,5751,2947,2804
202008,27110,대구광역시,중구,35-39세,5744,2960,2784
202009,27110,대구광역시,중구,35-39세,5693,2930,2763
202010,27110,대구광역시,중구,35-39세,5661,2912,2749
202011,27110,대구광역시,중구,35-39세,5602,2888,2714
202012,27110,대구광역시,중구,35-39세,5586,2868,2718
202101,27110,대구광역시,중구,35-39세,5549,2854,2695
202102,27110,대구광역시,중구,35-39세,5520,2877,2643
202103,27110,대구광역시,중구,35-39세,5483,2855,2628
202104,27110,대구광역시,중구,35-39세,5423,2824,2599
202105,27110,대구광역시,중구,35-39세,5353,2787,2566
202106,27110,대구광역시,중구,35-39세,5307,2780,2527
202007,27110,대구광역시,중구,40-44세,5053,2627,2426
202008,27110,대구광역시,중구,40-44세,5038,2620,2418
202009,27110,대구광역시,중구,40-44세,5036,2618,2418
202010,27110,대구광역시,중구,40-44세,5049,2619,2430
202011,27110,대구광역시,중구,40-44세,5043,2610,2433
202012,27110,대구광역시,중구,40-44세,5025,2614,2411
202101,27110,대구광역시,중구,40-44세,5039,2621,2418
202102,27110,대구광역시,중구,40-44세,5036,2608,2428
202103,27110,대구광역시,중구,40-44세,5021,2602,2419
202104,27110,대구광역시,중구,40-44세,5021,2595,2426
202105,27110,대구광역시,중구,40-44세,5031,2613,2418
202106,27110,대구광역시,중구,40-44세,5062,2620,2442
202007,27110,대구광역시,중구,45-49세,5754,2881,2873
202008,27110,대구광역시,중구,45-49세,5760,2881,2879
202009,27110,대구광역시,중구,45-49세,5736,2863,2873
202010,27110,대구광역시,중구,45-49세,5734,2863,2871
202011,27110,대구광역시,중구,45-49세,5756,2877,2879
202012,27110,대구광역시,중구,45-49세,5741,2856,2885
202101,27110,대구광역시,중구,45-49세,5689,2828,2861
202102,27110,대구광역시,중구,45-49세,5622,2786,2836
202103,27110,대구광역시,중구,45-49세,5564,2766,2798
202104,27110,대구광역시,중구,45-49세,5523,2742,2781
202105,27110,대구광역시,중구,45-49세,5474,2709,2765
202106,27110,대구광역시,중구,45-49세,5445,2697,2748
202007,27110,대구광역시,중구,50-54세,5750,2861,2889
202008,27110,대구광역시,중구,50-54세,5755,2864,2891
202009,27110,대구광역시,중구,50-54세,5768,2880,2888
202010,27110,대구광역시,중구,50-54세,5752,2859,2893
202011,27110,대구광역시,중구,50-54세,5763,2855,2908
202012,27110,대구광역시,중구,50-54세,5734,2850,2884
202101,27110,대구광역시,중구,50-54세,5719,2840,2879
202102,27110,대구광역시,중구,50-54세,5737,2854,2883
202103,27110,대구광역시,중구,50-54세,5703,2829,2874
202104,27110,대구광역시,중구,50-54세,5695,2834,2861
202105,27110,대구광역시,중구,50-54세,5720,2839,2881
202106,27110,대구광역시,중구,50-54세,5706,2834,2872
202007,27110,대구광역시,중구,55-59세,5686,2777,2909
202008,27110,대구광역시,중구,55-59세,5693,2783,2910
202009,27110,대구광역시,중구,55-59세,5689,2784,2905
202010,27110,대구광역시,중구,55-59세,5660,2776,2884
202011,27110,대구광역시,중구,55-59세,5626,2761,2865
202012,27110,대구광역시,중구,55-59세,5591,2747,2844
202101,27110,대구광역시,중구,55-59세,5553,2730,2823
202102,27110,대구광역시,중구,55-59세,5527,2707,2820
202103,27110,대구광역시,중구,55-59세,5500,2707,2793
202104,27110,대구광역시,중구,55-59세,5472,2698,2774
202105,27110,대구광역시,중구,55-59세,5422,2679,2743
202106,27110,대구광역시,중구,55-59세,5331,2643,2688
202007,27110,대구광역시,중구,60-64세,5674,2702,2972
202008,27110,대구광역시,중구,60-64세,5657,2697,2960
202009,27110,대구광역시,중구,60-64세,5643,2689,2954
202010,27110,대구광역시,중구,60-64세,5666,2692,2974
202011,27110,대구광역시,중구,60-64세,5658,2692,2966
202012,27110,대구광역시,중구,60-64세,5678,2700,2978
202101,27110,대구광역시,중구,60-64세,5685,2704,2981
202102,27110,대구광역시,중구,60-64세,5715,2724,2991
202103,27110,대구광역시,중구,60-64세,5672,2688,2984
202104,27110,대구광역시,중구,60-64세,5668,2682,2986
202105,27110,대구광역시,중구,60-64세,5646,2672,2974
202106,27110,대구광역시,중구,60-64세,5618,2669,2949
202007,27110,대구광역시,중구,65-69세,4461,1984,2477
202008,27110,대구광역시,중구,65-69세,4497,1992,2505
202009,27110,대구광역시,중구,65-69세,4523,2001,2522
202010,27110,대구광역시,중구,65-69세,4527,2008,2519
202011,27110,대구광역시,중구,65-69세,4542,2006,2536
202012,27110,대구광역시,중구,65-69세,4549,2019,2530
202101,27110,대구광역시,중구,65-69세,4559,2025,2534
202102,27110,대구광역시,중구,65-69세,4582,2039,2543
202103,27110,대구광역시,중구,65-69세,4582,2056,2526
202104,27110,대구광역시,중구,65-69세,4594,2058,2536
202105,27110,대구광역시,중구,65-69세,4603,2068,2535
202106,27110,대구광역시,중구,65-69세,4583,2053,2530
202007,27110,대구광역시,중구,70-74세,3969,1672,2297
202008,27110,대구광역시,중구,70-74세,3975,1679,2296
202009,27110,대구광역시,중구,70-74세,3985,1688,2297
202010,27110,대구광역시,중구,70-74세,4001,1694,2307
202011,27110,대구광역시,중구,70-74세,4024,1708,2316
202012,27110,대구광역시,중구,70-74세,4061,1709,2352
202101,27110,대구광역시,중구,70-74세,4078,1723,2355
202102,27110,대구광역시,중구,70-74세,4073,1717,2356
202103,27110,대구광역시,중구,70-74세,4045,1708,2337
202104,27110,대구광역시,중구,70-74세,4038,1701,2337
202105,27110,대구광역시,중구,70-74세,4038,1700,2338
202106,27110,대구광역시,중구,70-74세,3978,1683,2295
202007,27110,대구광역시,중구,75-79세,3410,1439,1971
202008,27110,대구광역시,중구,75-79세,3389,1431,1958
202009,27110,대구광역시,중구,75-79세,3369,1423,1946
202010,27110,대구광역시,중구,75-79세,3349,1411,1938
202011,27110,대구광역시,중구,75-79세,3340,1408,1932
202012,27110,대구광역시,중구,75-79세,3314,1397,1917
202101,27110,대구광역시,중구,75-79세,3281,1386,1895
202102,27110,대구광역시,중구,75-79세,3244,1365,1879
202103,27110,대구광역시,중구,75-79세,3229,1352,1877
202104,27110,대구광역시,중구,75-79세,3210,1342,1868
202105,27110,대구광역시,중구,75-79세,3200,1349,1851
202106,27110,대구광역시,중구,75-79세,3170,1337,1833
202007,27110,대구광역시,중구,80-84세,2272,877,1395
202008,27110,대구광역시,중구,80-84세,2292,886,1406
202009,27110,대구광역시,중구,80-84세,2289,878,1411
202010,27110,대구광역시,중구,80-84세,2294,882,1412
202011,27110,대구광역시,중구,80-84세,2308,886,1422
202012,27110,대구광역시,중구,80-84세,2311,882,1429
202101,27110,대구광역시,중구,80-84세,2319,889,1430
202102,27110,대구광역시,중구,80-84세,2340,897,1443
202103,27110,대구광역시,중구,80-84세,2308,875,1433
202104,27110,대구광역시,중구,80-84세,2310,879,1431
202105,27110,대구광역시,중구,80-84세,2309,868,1441
202106,27110,대구광역시,중구,80-84세,2303,858,1445
202007,27110,대구광역시,중구,85-89세,1065,347,718
202008,27110,대구광역시,중구,85-89세,1073,352,721
202009,27110,대구광역시,중구,85-89세,1090,368,722
202010,27110,대구광역시,중구,85-89세,1084,370,714
202011,27110,대구광역시,중구,85-89세,1089,375,714
202012,27110,대구광역시,중구,85-89세,1102,374,728
202101,27110,대구광역시,중구,85-89세,1120,379,741
202102,27110,대구광역시,중구,85-89세,1128,383,745
202103,27110,대구광역시,중구,85-89세,1122,386,736
202104,27110,대구광역시,중구,85-89세,1122,387,735
202105,27110,대구광역시,중구,85-89세,1123,392,731
202106,27110,대구광역시,중구,85-89세,1135,397,738
202007,27110,대구광역시,중구,90-94세,375,95,280
202008,27110,대구광역시,중구,90-94세,375,94,281
202009,27110,대구광역시,중구,90-94세,377,91,286
202010,27110,대구광역시,중구,90-94세,375,93,282
202011,27110,대구광역시,중구,90-94세,378,94,284
202012,27110,대구광역시,중구,90-94세,391,96,295
202101,27110,대구광역시,중구,90-94세,396,98,298
202102,27110,대구광역시,중구,90-94세,398,101,297
202103,27110,대구광역시,중구,90-94세,391,95,296
202104,27110,대구광역시,중구,90-94세,392,95,297
202105,27110,대구광역시,중구,90-94세,392,97,295
202106,27110,대구광역시,중구,90-94세,380,96,284
202007,27110,대구광역시,중구,95-99세,101,19,82
202008,27110,대구광역시,중구,95-99세,99,19,80
202009,27110,대구광역시,중구,95-99세,101,20,81
202010,27110,대구광역시,중구,95-99세,103,20,83
202011,27110,대구광역시,중구,95-99세,99,20,79
202012,27110,대구광역시,중구,95-99세,97,21,76
202101,27110,대구광역시,중구,95-99세,97,21,76
202102,27110,대구광역시,중구,95-99세,101,22,79
202103,27110,대구광역시,중구,95-99세,92,17,75
202104,27110,대구광역시,중구,95-99세,93,16,77
202105,27110,대구광역시,중구,95-99세,94,17,77
202106,27110,대구광역시,중구,95-99세,94,17,77
202007,27110,대구광역시,중구,100+,101,21,80
202008,27110,대구광역시,중구,100+,101,21,80
202009,27110,대구광역시,중구,100+,101,21,80
202010,27110,대구광역시,중구,100+,101,21,80
202011,27110,대구광역시,중구,100+,102,21,81
202012,27110,대구광역시,중구,100+,103,21,82
202101,27110,대구광역시,중구,100+,104,21,83
202102,27110,대구광역시,중구,100+,104,20,84
202103,27110,대구광역시,중구,100+,72,15,57
202104,27110,대구광역시,중구,100+,72,15,57
202105,27110,대구광역시,중구,100+,74,15,59
202106,27110,대구광역시,중구,100+,72,14,58
202007,27140,대구광역시,동구,0-4세,11460,5787,5673
202008,27140,대구광역시,동구,0-4세,11427,5803,5624
202009,27140,대구광역시,동구,0-4세,11305,5732,5573
202010,27140,대구광역시,동구,0-4세,11203,5680,5523
202011,27140,대구광역시,동구,0-4세,11169,5662,5507
202012,27140,대구광역시,동구,0-4세,11024,5606,5418
202101,27140,대구광역시,동구,0-4세,10860,5536,5324
202102,27140,대구광역시,동구,0-4세,10764,5512,5252
202103,27140,대구광역시,동구,0-4세,10717,5480,5237
202104,27140,대구광역시,동구,0-4세,10593,5426,5167
202105,27140,대구광역시,동구,0-4세,10461,5371,5090
202106,27140,대구광역시,동구,0-4세,10300,5309,4991
202007,27140,대구광역시,동구,5-9세,14345,7388,6957
202008,27140,대구광역시,동구,5-9세,14360,7372,6988
202009,27140,대구광역시,동구,5-9세,14378,7371,7007
202010,27140,대구광역시,동구,5-9세,14271,7321,6950
202011,27140,대구광역시,동구,5-9세,14203,7278,6925
202012,27140,대구광역시,동구,5-9세,14169,7261,6908
202101,27140,대구광역시,동구,5-9세,14084,7216,6868
202102,27140,대구광역시,동구,5-9세,14101,7220,6881
202103,27140,대구광역시,동구,5-9세,14126,7228,6898
202104,27140,대구광역시,동구,5-9세,14106,7189,6917
202105,27140,대구광역시,동구,5-9세,14083,7146,6937
202106,27140,대구광역시,동구,5-9세,14075,7128,6947
202007,27140,대구광역시,동구,10-14세,12831,6660,6171
202008,27140,대구광역시,동구,10-14세,12869,6679,6190
202009,27140,대구광역시,동구,10-14세,12867,6697,6170
202010,27140,대구광역시,동구,10-14세,12872,6678,6194
202011,27140,대구광역시,동구,10-14세,12918,6708,6210
202012,27140,대구광역시,동구,10-14세,12907,6699,6208
202101,27140,대구광역시,동구,10-14세,12928,6699,6229
202102,27140,대구광역시,동구,10-14세,12945,6702,6243
202103,27140,대구광역시,동구,10-14세,13000,6721,6279
202104,27140,대구광역시,동구,10-14세,13000,6728,6272
202105,27140,대구광역시,동구,10-14세,13034,6755,6279
202106,27140,대구광역시,동구,10-14세,13050,6750,6300
202007,27140,대구광역시,동구,15-19세,14139,7475,6664
202008,27140,대구광역시,동구,15-19세,14071,7459,6612
202009,27140,대구광역시,동구,15-19세,13979,7399,6580
202010,27140,대구광역시,동구,15-19세,13838,7324,6514
202011,27140,대구광역시,동구,15-19세,13734,7284,6450
202012,27140,대구광역시,동구,15-19세,13659,7231,6428
202101,27140,대구광역시,동구,15-19세,13547,7168,6379
202102,27140,대구광역시,동구,15-19세,13511,7145,6366
202103,27140,대구광역시,동구,15-19세,13477,7155,6322
202104,27140,대구광역시,동구,15-19세,13403,7105,6298
202105,27140,대구광역시,동구,15-19세,13326,7084,6242
202106,27140,대구광역시,동구,15-19세,13264,7063,6201
202007,27140,대구광역시,동구,20-24세,19776,10500,9276
202008,27140,대구광역시,동구,20-24세,19730,10453,9277
202009,27140,대구광역시,동구,20-24세,19701,10494,9207
202010,27140,대구광역시,동구,20-24세,19568,10427,9141
202011,27140,대구광역시,동구,20-24세,19507,10361,9146
202012,27140,대구광역시,동구,20-24세,19381,10315,9066
202101,27140,대구광역시,동구,20-24세,19311,10299,9012
202102,27140,대구광역시,동구,20-24세,19270,10250,9020
202103,27140,대구광역시,동구,20-24세,19235,10198,9037
202104,27140,대구광역시,동구,20-24세,19144,10130,9014
202105,27140,대구광역시,동구,20-24세,19041,10069,8972
202106,27140,대구광역시,동구,20-24세,18973,10015,8958
202007,27140,대구광역시,동구,25-29세,22011,11874,10137
202008,27140,대구광역시,동구,25-29세,22130,11929,10201
202009,27140,대구광역시,동구,25-29세,22146,11915,10231
202010,27140,대구광역시,동구,25-29세,22201,11965,10236
202011,27140,대구광역시,동구,25-29세,22263,12006,10257
202012,27140,대구광역시,동구,25-29세,22303,11992,10311
202101,27140,대구광역시,동구,25-29세,22265,11950,10315
202102,27140,대구광역시,동구,25-29세,22194,11932,10262
202103,27140,대구광역시,동구,25-29세,22360,12026,10334
202104,27140,대구광역시,동구,25-29세,22383,12061,10322
202105,27140,대구광역시,동구,25-29세,22232,11978,10254
202106,27140,대구광역시,동구,25-29세,22222,11937,10285
202007,27140,대구광역시,동구,30-34세,20270,10939,9331
202008,27140,대구광역시,동구,30-34세,20398,11011,9387
202009,27140,대구광역시,동구,30-34세,20464,11065,9399
202010,27140,대구광역시,동구,30-34세,20365,10995,9370
202011,27140,대구광역시,동구,30-34세,20338,10990,9348
202012,27140,대구광역시,동구,30-34세,20200,10934,9266
202101,27140,대구광역시,동구,30-34세,20181,10914,9267
202102,27140,대구광역시,동구,30-34세,20227,10891,9336
202103,27140,대구광역시,동구,30-34세,20414,10995,9419
202104,27140,대구광역시,동구,30-34세,20518,11051,9467
202105,27140,대구광역시,동구,30-34세,20560,11074,9486
202106,27140,대구광역시,동구,30-34세,20546,11063,9483
202007,27140,대구광역시,동구,35-39세,24282,12496,11786
202008,27140,대구광역시,동구,35-39세,24262,12496,11766
202009,27140,대구광역시,동구,35-39세,24050,12370,11680
202010,27140,대구광역시,동구,35-39세,23853,12284,11569
202011,27140,대구광역시,동구,35-39세,23723,12217,11506
202012,27140,대구광역시,동구,35-39세,23621,12179,11442
202101,27140,대구광역시,동구,35-39세,23466,12137,11329
202102,27140,대구광역시,동구,35-39세,23273,12079,11194
202103,27140,대구광역시,동구,35-39세,23253,12107,11146
202104,27140,대구광역시,동구,35-39세,23068,12018,11050
202105,27140,대구광역시,동구,35-39세,22912,11934,10978
202106,27140,대구광역시,동구,35-39세,22718,11840,10878
202007,27140,대구광역시,동구,40-44세,24601,12680,11921
202008,27140,대구광역시,동구,40-44세,24672,12717,11955
202009,27140,대구광역시,동구,40-44세,24734,12756,11978
202010,27140,대구광역시,동구,40-44세,24772,12769,12003
202011,27140,대구광역시,동구,40-44세,24794,12798,11996
202012,27140,대구광역시,동구,40-44세,24693,12751,11942
202101,27140,대구광역시,동구,40-44세,24692,12707,11985
202102,27140,대구광역시,동구,40-44세,24777,12746,12031
202103,27140,대구광역시,동구,40-44세,24872,12755,12117
202104,27140,대구광역시,동구,40-44세,24906,12749,12157
202105,27140,대구광역시,동구,40-44세,24903,12750,12153
202106,27140,대구광역시,동구,40-44세,24918,12791,12127
202007,27140,대구광역시,동구,45-49세,26980,13929,13051
202008,27140,대구광역시,동구,45-49세,26978,13936,13042
202009,27140,대구광역시,동구,45-49세,26948,13893,13055
202010,27140,대구광역시,동구,45-49세,26772,13802,12970
202011,27140,대구광역시,동구,45-49세,26751,13770,12981
202012,27140,대구광역시,동구,45-49세,26717,13736,12981
202101,27140,대구광역시,동구,45-49세,26562,13676,12886
202102,27140,대구광역시,동구,45-49세,26506,13635,12871
202103,27140,대구광역시,동구,45-49세,26407,13556,12851
202104,27140,대구광역시,동구,45-49세,26343,13530,12813
202105,27140,대구광역시,동구,45-49세,26151,13413,12738
202106,27140,대구광역시,동구,45-49세,25978,13318,12660
202007,27140,대구광역시,동구,50-54세,28009,13747,14262
202008,27140,대구광역시,동구,50-54세,28024,13788,14236
202009,27140,대구광역시,동구,50-54세,28075,13814,14261
202010,27140,대구광역시,동구,50-54세,28051,13783,14268
202011,27140,대구광역시,동구,50-54세,28073,13832,14241
202012,27140,대구광역시,동구,50-54세,27982,13826,14156
202101,27140,대구광역시,동구,50-54세,28043,13830,14213
202102,27140,대구광역시,동구,50-54세,28148,13897,14251
202103,27140,대구광역시,동구,50-54세,28223,13926,14297
202104,27140,대구광역시,동구,50-54세,28177,13888,14289
202105,27140,대구광역시,동구,50-54세,28210,13926,14284
202106,27140,대구광역시,동구,50-54세,28194,13913,14281
202007,27140,대구광역시,동구,55-59세,29359,14077,15282
202008,27140,대구광역시,동구,55-59세,29384,14030,15354
202009,27140,대구광역시,동구,55-59세,29243,13965,15278
202010,27140,대구광역시,동구,55-59세,29145,13935,15210
202011,27140,대구광역시,동구,55-59세,29047,13867,15180
202012,27140,대구광역시,동구,55-59세,29016,13850,15166
202101,27140,대구광역시,동구,55-59세,28830,13806,15024
202102,27140,대구광역시,동구,55-59세,28728,13775,14953
202103,27140,대구광역시,동구,55-59세,28769,13808,14961
202104,27140,대구광역시,동구,55-59세,28679,13804,14875
202105,27140,대구광역시,동구,55-59세,28452,13708,14744
202106,27140,대구광역시,동구,55-59세,28186,13596,14590
202007,27140,대구광역시,동구,60-64세,28316,13301,15015
202008,27140,대구광역시,동구,60-64세,28414,13387,15027
202009,27140,대구광역시,동구,60-64세,28498,13444,15054
202010,27140,대구광역시,동구,60-64세,28586,13470,15116
202011,27140,대구광역시,동구,60-64세,28693,13517,15176
202012,27140,대구광역시,동구,60-64세,28809,13555,15254
202101,27140,대구광역시,동구,60-64세,28964,13631,15333
202102,27140,대구광역시,동구,60-64세,29110,13691,15419
202103,27140,대구광역시,동구,60-64세,29282,13739,15543
202104,27140,대구광역시,동구,60-64세,29398,13780,15618
202105,27140,대구광역시,동구,60-64세,29460,13815,15645
202106,27140,대구광역시,동구,60-64세,29523,13820,15703
202007,27140,대구광역시,동구,65-69세,21946,10042,11904
202008,27140,대구광역시,동구,65-69세,22107,10113,11994
202009,27140,대구광역시,동구,65-69세,22281,10179,12102
202010,27140,대구광역시,동구,65-69세,22420,10259,12161
202011,27140,대구광역시,동구,65-69세,22543,10317,12226
202012,27140,대구광역시,동구,65-69세,22609,10329,12280
202101,27140,대구광역시,동구,65-69세,22766,10410,12356
202102,27140,대구광역시,동구,65-69세,22905,10482,12423
202103,27140,대구광역시,동구,65-69세,23155,10617,12538
202104,27140,대구광역시,동구,65-69세,23295,10667,12628
202105,27140,대구광역시,동구,65-69세,23356,10688,12668
202106,27140,대구광역시,동구,65-69세,23344,10697,12647
202007,27140,대구광역시,동구,70-74세,16606,7512,9094
202008,27140,대구광역시,동구,70-74세,16686,7529,9157
202009,27140,대구광역시,동구,70-74세,16744,7552,9192
202010,27140,대구광역시,동구,70-74세,16823,7574,9249
202011,27140,대구광역시,동구,70-74세,16924,7606,9318
202012,27140,대구광역시,동구,70-74세,17040,7654,9386
202101,27140,대구광역시,동구,70-74세,17177,7701,9476
202102,27140,대구광역시,동구,70-74세,17276,7733,9543
202103,27140,대구광역시,동구,70-74세,17393,7818,9575
202104,27140,대구광역시,동구,70-74세,17396,7830,9566
202105,27140,대구광역시,동구,70-74세,17491,7864,9627
202106,27140,대구광역시,동구,70-74세,17514,7872,9642
202007,27140,대구광역시,동구,75-79세,13511,5646,7865
202008,27140,대구광역시,동구,75-79세,13498,5638,7860
202009,27140,대구광역시,동구,75-79세,13430,5612,7818
202010,27140,대구광역시,동구,75-79세,13354,5578,7776
202011,27140,대구광역시,동구,75-79세,13262,5528,7734
202012,27140,대구광역시,동구,75-79세,13171,5509,7662
202101,27140,대구광역시,동구,75-79세,13071,5465,7606
202102,27140,대구광역시,동구,75-79세,13003,5447,7556
202103,27140,대구광역시,동구,75-79세,12957,5414,7543
202104,27140,대구광역시,동구,75-79세,12928,5416,7512
202105,27140,대구광역시,동구,75-79세,12845,5381,7464
202106,27140,대구광역시,동구,75-79세,12760,5349,7411
202007,27140,대구광역시,동구,80-84세,8692,3257,5435
202008,27140,대구광역시,동구,80-84세,8726,3268,5458
202009,27140,대구광역시,동구,80-84세,8754,3273,5481
202010,27140,대구광역시,동구,80-84세,8798,3298,5500
202011,27140,대구광역시,동구,80-84세,8791,3302,5489
202012,27140,대구광역시,동구,80-84세,8827,3316,5511
202101,27140,대구광역시,동구,80-84세,8877,3354,5523
202102,27140,대구광역시,동구,80-84세,8953,3387,5566
202103,27140,대구광역시,동구,80-84세,8984,3402,5582
202104,27140,대구광역시,동구,80-84세,9038,3417,5621
202105,27140,대구광역시,동구,80-84세,9107,3444,5663
202106,27140,대구광역시,동구,80-84세,9085,3432,5653
202007,27140,대구광역시,동구,85-89세,3958,1247,2711
202008,27140,대구광역시,동구,85-89세,4011,1269,2742
202009,27140,대구광역시,동구,85-89세,4057,1289,2768
202010,27140,대구광역시,동구,85-89세,4081,1302,2779
202011,27140,대구광역시,동구,85-89세,4109,1310,2799
202012,27140,대구광역시,동구,85-89세,4186,1336,2850
202101,27140,대구광역시,동구,85-89세,4242,1345,2897
202102,27140,대구광역시,동구,85-89세,4319,1374,2945
202103,27140,대구광역시,동구,85-89세,4399,1412,2987
202104,27140,대구광역시,동구,85-89세,4463,1432,3031
202105,27140,대구광역시,동구,85-89세,4475,1448,3027
202106,27140,대구광역시,동구,85-89세,4473,1442,3031
202007,27140,대구광역시,동구,90-94세,1174,254,920
202008,27140,대구광역시,동구,90-94세,1169,257,912
202009,27140,대구광역시,동구,90-94세,1169,260,909
202010,27140,대구광역시,동구,90-94세,1171,261,910
202011,27140,대구광역시,동구,90-94세,1181,271,910
202012,27140,대구광역시,동구,90-94세,1196,276,920
202101,27140,대구광역시,동구,90-94세,1224,286,938
202102,27140,대구광역시,동구,90-94세,1235,287,948
202103,27140,대구광역시,동구,90-94세,1259,287,972
202104,27140,대구광역시,동구,90-94세,1255,284,971
202105,27140,대구광역시,동구,90-94세,1260,283,977
202106,27140,대구광역시,동구,90-94세,1248,277,971
202007,27140,대구광역시,동구,95-99세,268,52,216
202008,27140,대구광역시,동구,95-99세,277,54,223
202009,27140,대구광역시,동구,95-99세,287,55,232
202010,27140,대구광역시,동구,95-99세,285,53,232
202011,27140,대구광역시,동구,95-99세,285,51,234
202012,27140,대구광역시,동구,95-99세,285,51,234
202101,27140,대구광역시,동구,95-99세,281,49,232
202102,27140,대구광역시,동구,95-99세,287,52,235
202103,27140,대구광역시,동구,95-99세,293,51,242
202104,27140,대구광역시,동구,95-99세,293,52,241
202105,27140,대구광역시,동구,95-99세,290,51,239
202106,27140,대구광역시,동구,95-99세,271,44,227
202007,27140,대구광역시,동구,100+,123,36,87
202008,27140,대구광역시,동구,100+,124,36,88
202009,27140,대구광역시,동구,100+,123,35,88
202010,27140,대구광역시,동구,100+,123,35,88
202011,27140,대구광역시,동구,100+,124,37,87
202012,27140,대구광역시,동구,100+,125,37,88
202101,27140,대구광역시,동구,100+,127,39,88
202102,27140,대구광역시,동구,100+,129,39,90
202103,27140,대구광역시,동구,100+,81,27,54
202104,27140,대구광역시,동구,100+,82,27,55
202105,27140,대구광역시,동구,100+,81,27,54
202106,27140,대구광역시,동구,100+,51,12,39
202007,27170,대구광역시,서구,0-4세,3297,1752,1545
202008,27170,대구광역시,서구,0-4세,3244,1718,1526
202009,27170,대구광역시,서구,0-4세,3179,1691,1488
202010,27170,대구광역시,서구,0-4세,3126,1656,1470
202011,27170,대구광역시,서구,0-4세,3085,1642,1443
202012,27170,대구광역시,서구,0-4세,3048,1624,1424
202101,27170,대구광역시,서구,0-4세,2999,1597,1402
202102,27170,대구광역시,서구,0-4세,2959,1562,1397
202103,27170,대구광역시,서구,0-4세,2909,1531,1378
202104,27170,대구광역시,서구,0-4세,2872,1510,1362
202105,27170,대구광역시,서구,0-4세,2834,1485,1349
202106,27170,대구광역시,서구,0-4세,2798,1470,1328
202007,27170,대구광역시,서구,5-9세,4588,2303,2285
202008,27170,대구광역시,서구,5-9세,4580,2300,2280
202009,27170,대구광역시,서구,5-9세,4566,2308,2258
202010,27170,대구광역시,서구,5-9세,4549,2303,2246
202011,27170,대구광역시,서구,5-9세,4533,2289,2244
202012,27170,대구광역시,서구,5-9세,4516,2288,2228
202101,27170,대구광역시,서구,5-9세,4498,2274,2224
202102,27170,대구광역시,서구,5-9세,4442,2256,2186
202103,27170,대구광역시,서구,5-9세,4406,2255,2151
202104,27170,대구광역시,서구,5-9세,4374,2233,2141
202105,27170,대구광역시,서구,5-9세,4378,2226,2152
202106,27170,대구광역시,서구,5-9세,4378,2232,2146
202007,27170,대구광역시,서구,10-14세,4716,2396,2320
202008,27170,대구광역시,서구,10-14세,4728,2404,2324
202009,27170,대구광역시,서구,10-14세,4707,2370,2337
202010,27170,대구광역시,서구,10-14세,4706,2359,2347
202011,27170,대구광역시,서구,10-14세,4650,2324,2326
202012,27170,대구광역시,서구,10-14세,4657,2325,2332
202101,27170,대구광역시,서구,10-14세,4673,2342,2331
202102,27170,대구광역시,서구,10-14세,4677,2328,2349
202103,27170,대구광역시,서구,10-14세,4694,2328,2366
202104,27170,대구광역시,서구,10-14세,4697,2334,2363
202105,27170,대구광역시,서구,10-14세,4667,2309,2358
202106,27170,대구광역시,서구,10-14세,4643,2298,2345
202007,27170,대구광역시,서구,15-19세,6557,3513,3044
202008,27170,대구광역시,서구,15-19세,6485,3466,3019
202009,27170,대구광역시,서구,15-19세,6429,3446,2983
202010,27170,대구광역시,서구,15-19세,6347,3405,2942
202011,27170,대구광역시,서구,15-19세,6290,3377,2913
202012,27170,대구광역시,서구,15-19세,6205,3331,2874
202101,27170,대구광역시,서구,15-19세,6112,3268,2844
202102,27170,대구광역시,서구,15-19세,6067,3249,2818
202103,27170,대구광역시,서구,15-19세,5958,3187,2771
202104,27170,대구광역시,서구,15-19세,5911,3154,2757
202105,27170,대구광역시,서구,15-19세,5858,3136,2722
202106,27170,대구광역시,서구,15-19세,5815,3113,2702
202007,27170,대구광역시,서구,20-24세,10305,5537,4768
202008,27170,대구광역시,서구,20-24세,10214,5492,4722
202009,27170,대구광역시,서구,20-24세,10148,5448,4700
202010,27170,대구광역시,서구,20-24세,10103,5440,4663
202011,27170,대구광역시,서구,20-24세,10025,5386,4639
202012,27170,대구광역시,서구,20-24세,9892,5316,4576
202101,27170,대구광역시,서구,20-24세,9804,5270,4534
202102,27170,대구광역시,서구,20-24세,9704,5203,4501
202103,27170,대구광역시,서구,20-24세,9568,5124,4444
202104,27170,대구광역시,서구,20-24세,9497,5097,4400
202105,27170,대구광역시,서구,20-24세,9449,5085,4364
202106,27170,대구광역시,서구,20-24세,9391,5056,4335
202007,27170,대구광역시,서구,25-29세,11737,6579,5158
202008,27170,대구광역시,서구,25-29세,11741,6597,5144
202009,27170,대구광역시,서구,25-29세,11697,6582,5115
202010,27170,대구광역시,서구,25-29세,11713,6586,5127
202011,27170,대구광역시,서구,25-29세,11724,6611,5113
202012,27170,대구광역시,서구,25-29세,11781,6613,5168
202101,27170,대구광역시,서구,25-29세,11802,6640,5162
202102,27170,대구광역시,서구,25-29세,11711,6575,5136
202103,27170,대구광역시,서구,25-29세,11706,6565,5141
202104,27170,대구광역시,서구,25-29세,11681,6541,5140
202105,27170,대구광역시,서구,25-29세,11621,6504,5117
202106,27170,대구광역시,서구,25-29세,11538,6457,5081
202007,27170,대구광역시,서구,30-34세,8535,4981,3554
202008,27170,대구광역시,서구,30-34세,8549,5001,3548
202009,27170,대구광역시,서구,30-34세,8550,5009,3541
202010,27170,대구광역시,서구,30-34세,8510,4993,3517
202011,27170,대구광역시,서구,30-34세,8457,4962,3495
202012,27170,대구광역시,서구,30-34세,8407,4942,3465
202101,27170,대구광역시,서구,30-34세,8420,4923,3497
202102,27170,대구광역시,서구,30-34세,8435,4948,3487
202103,27170,대구광역시,서구,30-34세,8467,4985,3482
202104,27170,대구광역시,서구,30-34세,8506,5015,3491
202105,27170,대구광역시,서구,30-34세,8528,4995,3533
202106,27170,대구광역시,서구,30-34세,8474,4975,3499
202007,27170,대구광역시,서구,35-39세,9404,5163,4241
202008,27170,대구광역시,서구,35-39세,9325,5114,4211
202009,27170,대구광역시,서구,35-39세,9235,5055,4180
202010,27170,대구광역시,서구,35-39세,9156,5023,4133
202011,27170,대구광역시,서구,35-39세,9109,5003,4106
202012,27170,대구광역시,서구,35-39세,9036,4964,4072
202101,27170,대구광역시,서구,35-39세,8946,4907,4039
202102,27170,대구광역시,서구,35-39세,8844,4845,3999
202103,27170,대구광역시,서구,35-39세,8769,4807,3962
202104,27170,대구광역시,서구,35-39세,8711,4762,3949
202105,27170,대구광역시,서구,35-39세,8686,4769,3917
202106,27170,대구광역시,서구,35-39세,8584,4712,3872
202007,27170,대구광역시,서구,40-44세,10134,5511,4623
202008,27170,대구광역시,서구,40-44세,10135,5502,4633
202009,27170,대구광역시,서구,40-44세,10095,5459,4636
202010,27170,대구광역시,서구,40-44세,10069,5441,4628
202011,27170,대구광역시,서구,40-44세,10022,5425,4597
202012,27170,대구광역시,서구,40-44세,9994,5413,4581
202101,27170,대구광역시,서구,40-44세,9955,5401,4554
202102,27170,대구광역시,서구,40-44세,9964,5396,4568
202103,27170,대구광역시,서구,40-44세,9935,5375,4560
202104,27170,대구광역시,서구,40-44세,9912,5373,4539
202105,27170,대구광역시,서구,40-44세,9882,5349,4533
202106,27170,대구광역시,서구,40-44세,9895,5369,4526
202007,27170,대구광역시,서구,45-49세,13293,7065,6228
202008,27170,대구광역시,서구,45-49세,13206,7025,6181
202009,27170,대구광역시,서구,45-49세,13107,6980,6127
202010,27170,대구광역시,서구,45-49세,13065,6951,6114
202011,27170,대구광역시,서구,45-49세,12934,6880,6054
202012,27170,대구광역시,서구,45-49세,12831,6846,5985
202101,27170,대구광역시,서구,45-49세,12762,6815,5947
202102,27170,대구광역시,서구,45-49세,12699,6787,5912
202103,27170,대구광역시,서구,45-49세,12588,6734,5854
202104,27170,대구광역시,서구,45-49세,12501,6678,5823
202105,27170,대구광역시,서구,45-49세,12336,6584,5752
202106,27170,대구광역시,서구,45-49세,12216,6517,5699
202007,27170,대구광역시,서구,50-54세,16415,8293,8122
202008,27170,대구광역시,서구,50-54세,16347,8263,8084
202009,27170,대구광역시,서구,50-54세,16253,8217,8036
202010,27170,대구광역시,서구,50-54세,16175,8203,7972
202011,27170,대구광역시,서구,50-54세,16086,8155,7931
202012,27170,대구광역시,서구,50-54세,16004,8125,7879
202101,27170,대구광역시,서구,50-54세,16019,8135,7884
202102,27170,대구광역시,서구,50-54세,15958,8114,7844
202103,27170,대구광역시,서구,50-54세,15766,8012,7754
202104,27170,대구광역시,서구,50-54세,15662,7949,7713
202105,27170,대구광역시,서구,50-54세,15694,7978,7716
202106,27170,대구광역시,서구,50-54세,15634,7959,7675
202007,27170,대구광역시,서구,55-59세,18481,9219,9262
202008,27170,대구광역시,서구,55-59세,18480,9212,9268
202009,27170,대구광역시,서구,55-59세,18427,9193,9234
202010,27170,대구광역시,서구,55-59세,18387,9176,9211
202011,27170,대구광역시,서구,55-59세,18356,9162,9194
202012,27170,대구광역시,서구,55-59세,18317,9144,9173
202101,27170,대구광역시,서구,55-59세,18116,9076,9040
202102,27170,대구광역시,서구,55-59세,17979,9000,8979
202103,27170,대구광역시,서구,55-59세,17962,9028,8934
202104,27170,대구광역시,서구,55-59세,17860,8971,8889
202105,27170,대구광역시,서구,55-59세,17734,8919,8815
202106,27170,대구광역시,서구,55-59세,17519,8788,8731
202007,27170,대구광역시,서구,60-64세,17204,8203,9001
202008,27170,대구광역시,서구,60-64세,17237,8248,8989
202009,27170,대구광역시,서구,60-64세,17275,8277,8998
202010,27170,대구광역시,서구,60-64세,17285,8276,9009
202011,27170,대구광역시,서구,60-64세,17341,8325,9016
202012,27170,대구광역시,서구,60-64세,17425,8359,9066
202101,27170,대구광역시,서구,60-64세,17586,8425,9161
202102,27170,대구광역시,서구,60-64세,17726,8503,9223
202103,27170,대구광역시,서구,60-64세,17739,8502,9237
202104,27170,대구광역시,서구,60-64세,17756,8518,9238
202105,27170,대구광역시,서구,60-64세,17791,8520,9271
202106,27170,대구광역시,서구,60-64세,17824,8563,9261
202007,27170,대구광역시,서구,65-69세,13237,6067,7170
202008,27170,대구광역시,서구,65-69세,13381,6119,7262
202009,27170,대구광역시,서구,65-69세,13479,6145,7334
202010,27170,대구광역시,서구,65-69세,13548,6172,7376
202011,27170,대구광역시,서구,65-69세,13579,6167,7412
202012,27170,대구광역시,서구,65-69세,13660,6202,7458
202101,27170,대구광역시,서구,65-69세,13661,6203,7458
202102,27170,대구광역시,서구,65-69세,13725,6230,7495
202103,27170,대구광역시,서구,65-69세,13836,6276,7560
202104,27170,대구광역시,서구,65-69세,13901,6298,7603
202105,27170,대구광역시,서구,65-69세,14002,6357,7645
202106,27170,대구광역시,서구,65-69세,14006,6357,7649
202007,27170,대구광역시,서구,70-74세,9565,4340,5225
202008,27170,대구광역시,서구,70-74세,9583,4347,5236
202009,27170,대구광역시,서구,70-74세,9603,4360,5243
202010,27170,대구광역시,서구,70-74세,9638,4369,5269
202011,27170,대구광역시,서구,70-74세,9685,4393,5292
202012,27170,대구광역시,서구,70-74세,9742,4419,5323
202101,27170,대구광역시,서구,70-74세,9845,4449,5396
202102,27170,대구광역시,서구,70-74세,9916,4482,5434
202103,27170,대구광역시,서구,70-74세,9958,4488,5470
202104,27170,대구광역시,서구,70-74세,10009,4514,5495
202105,27170,대구광역시,서구,70-74세,10044,4533,5511
202106,27170,대구광역시,서구,70-74세,10024,4519,5505
202007,27170,대구광역시,서구,75-79세,7648,3191,4457
202008,27170,대구광역시,서구,75-79세,7647,3191,4456
202009,27170,대구광역시,서구,75-79세,7577,3178,4399
202010,27170,대구광역시,서구,75-79세,7529,3154,4375
202011,27170,대구광역시,서구,75-79세,7490,3138,4352
202012,27170,대구광역시,서구,75-79세,7431,3115,4316
202101,27170,대구광역시,서구,75-79세,7373,3100,4273
202102,27170,대구광역시,서구,75-79세,7313,3060,4253
202103,27170,대구광역시,서구,75-79세,7286,3065,4221
202104,27170,대구광역시,서구,75-79세,7247,3042,4205
202105,27170,대구광역시,서구,75-79세,7213,3020,4193
202106,27170,대구광역시,서구,75-79세,7153,2984,4169
202007,27170,대구광역시,서구,80-84세,4702,1737,2965
202008,27170,대구광역시,서구,80-84세,4727,1753,2974
202009,27170,대구광역시,서구,80-84세,4748,1747,3001
202010,27170,대구광역시,서구,80-84세,4779,1759,3020
202011,27170,대구광역시,서구,80-84세,4788,1762,3026
202012,27170,대구광역시,서구,80-84세,4788,1767,3021
202101,27170,대구광역시,서구,80-84세,4799,1762,3037
202102,27170,대구광역시,서구,80-84세,4841,1784,3057
202103,27170,대구광역시,서구,80-84세,4856,1783,3073
202104,27170,대구광역시,서구,80-84세,4867,1804,3063
202105,27170,대구광역시,서구,80-84세,4903,1814,3089
202106,27170,대구광역시,서구,80-84세,4877,1795,3082
202007,27170,대구광역시,서구,85-89세,1984,559,1425
202008,27170,대구광역시,서구,85-89세,2005,565,1440
202009,27170,대구광역시,서구,85-89세,2008,571,1437
202010,27170,대구광역시,서구,85-89세,2031,583,1448
202011,27170,대구광역시,서구,85-89세,2046,591,1455
202012,27170,대구광역시,서구,85-89세,2108,616,1492
202101,27170,대구광역시,서구,85-89세,2156,649,1507
202102,27170,대구광역시,서구,85-89세,2190,666,1524
202103,27170,대구광역시,서구,85-89세,2214,679,1535
202104,27170,대구광역시,서구,85-89세,2244,686,1558
202105,27170,대구광역시,서구,85-89세,2263,696,1567
202106,27170,대구광역시,서구,85-89세,2246,687,1559
202007,27170,대구광역시,서구,90-94세,617,121,496
202008,27170,대구광역시,서구,90-94세,613,118,495
202009,27170,대구광역시,서구,90-94세,622,118,504
202010,27170,대구광역시,서구,90-94세,619,117,502
202011,27170,대구광역시,서구,90-94세,624,118,506
202012,27170,대구광역시,서구,90-94세,620,114,506
202101,27170,대구광역시,서구,90-94세,620,112,508
202102,27170,대구광역시,서구,90-94세,619,111,508
202103,27170,대구광역시,서구,90-94세,633,112,521
202104,27170,대구광역시,서구,90-94세,630,107,523
202105,27170,대구광역시,서구,90-94세,635,106,529
202106,27170,대구광역시,서구,90-94세,616,100,516
202007,27170,대구광역시,서구,95-99세,138,23,115
202008,27170,대구광역시,서구,95-99세,139,23,116
202009,27170,대구광역시,서구,95-99세,142,25,117
202010,27170,대구광역시,서구,95-99세,139,26,113
202011,27170,대구광역시,서구,95-99세,134,23,111
202012,27170,대구광역시,서구,95-99세,135,24,111
202101,27170,대구광역시,서구,95-99세,134,23,111
202102,27170,대구광역시,서구,95-99세,132,24,108
202103,27170,대구광역시,서구,95-99세,124,23,101
202104,27170,대구광역시,서구,95-99세,125,23,102
202105,27170,대구광역시,서구,95-99세,126,23,103
202106,27170,대구광역시,서구,95-99세,110,19,91
202007,27170,대구광역시,서구,100+,100,23,77
202008,27170,대구광역시,서구,100+,99,23,76
202009,27170,대구광역시,서구,100+,100,23,77
202010,27170,대구광역시,서구,100+,102,23,79
202011,27170,대구광역시,서구,100+,102,24,78
202012,27170,대구광역시,서구,100+,103,25,78
202101,27170,대구광역시,서구,100+,103,25,78
202102,27170,대구광역시,서구,100+,104,25,79
202103,27170,대구광역시,서구,100+,58,14,44
202104,27170,대구광역시,서구,100+,59,15,44
202105,27170,대구광역시,서구,100+,60,15,45
202106,27170,대구광역시,서구,100+,32,5,27
202007,27200,대구광역시,남구,0-4세,3075,1596,1479
202008,27200,대구광역시,남구,0-4세,3036,1579,1457
202009,27200,대구광역시,남구,0-4세,2975,1546,1429
202010,27200,대구광역시,남구,0-4세,2946,1526,1420
202011,27200,대구광역시,남구,0-4세,2944,1521,1423
202012,27200,대구광역시,남구,0-4세,2949,1530,1419
202101,27200,대구광역시,남구,0-4세,2927,1527,1400
202102,27200,대구광역시,남구,0-4세,2885,1498,1387
202103,27200,대구광역시,남구,0-4세,2851,1479,1372
202104,27200,대구광역시,남구,0-4세,2861,1489,1372
202105,27200,대구광역시,남구,0-4세,2842,1489,1353
202106,27200,대구광역시,남구,0-4세,2825,1484,1341
202007,27200,대구광역시,남구,5-9세,3946,2038,1908
202008,27200,대구광역시,남구,5-9세,3930,2034,1896
202009,27200,대구광역시,남구,5-9세,3893,2012,1881
202010,27200,대구광역시,남구,5-9세,3876,2010,1866
202011,27200,대구광역시,남구,5-9세,3862,1993,1869
202012,27200,대구광역시,남구,5-9세,3872,1995,1877
202101,27200,대구광역시,남구,5-9세,3833,1969,1864
202102,27200,대구광역시,남구,5-9세,3835,1984,1851
202103,27200,대구광역시,남구,5-9세,3839,1973,1866
202104,27200,대구광역시,남구,5-9세,3829,1958,1871
202105,27200,대구광역시,남구,5-9세,3827,1956,1871
202106,27200,대구광역시,남구,5-9세,3839,1957,1882
202007,27200,대구광역시,남구,10-14세,4118,2163,1955
202008,27200,대구광역시,남구,10-14세,4101,2142,1959
202009,27200,대구광역시,남구,10-14세,4121,2160,1961
202010,27200,대구광역시,남구,10-14세,4120,2155,1965
202011,27200,대구광역시,남구,10-14세,4139,2155,1984
202012,27200,대구광역시,남구,10-14세,4132,2143,1989
202101,27200,대구광역시,남구,10-14세,4116,2145,1971
202102,27200,대구광역시,남구,10-14세,4091,2141,1950
202103,27200,대구광역시,남구,10-14세,4116,2152,1964
202104,27200,대구광역시,남구,10-14세,4134,2157,1977
202105,27200,대구광역시,남구,10-14세,4119,2139,1980
202106,27200,대구광역시,남구,10-14세,4095,2125,1970
202007,27200,대구광역시,남구,15-19세,5519,2915,2604
202008,27200,대구광역시,남구,15-19세,5484,2889,2595
202009,27200,대구광역시,남구,15-19세,5415,2862,2553
202010,27200,대구광역시,남구,15-19세,5340,2826,2514
202011,27200,대구광역시,남구,15-19세,5318,2824,2494
202012,27200,대구광역시,남구,15-19세,5287,2809,2478
202101,27200,대구광역시,남구,15-19세,5242,2796,2446
202102,27200,대구광역시,남구,15-19세,5214,2769,2445
202103,27200,대구광역시,남구,15-19세,5171,2749,2422
202104,27200,대구광역시,남구,15-19세,5162,2738,2424
202105,27200,대구광역시,남구,15-19세,5155,2736,2419
202106,27200,대구광역시,남구,15-19세,5111,2714,2397
202007,27200,대구광역시,남구,20-24세,9497,4628,4869
202008,27200,대구광역시,남구,20-24세,9512,4615,4897
202009,27200,대구광역시,남구,20-24세,9486,4585,4901
202010,27200,대구광역시,남구,20-24세,9388,4528,4860
202011,27200,대구광역시,남구,20-24세,9354,4505,4849
202012,27200,대구광역시,남구,20-24세,9352,4517,4835
202101,27200,대구광역시,남구,20-24세,9290,4448,4842
202102,27200,대구광역시,남구,20-24세,9290,4454,4836
202103,27200,대구광역시,남구,20-24세,9211,4422,4789
202104,27200,대구광역시,남구,20-24세,9204,4414,4790
202105,27200,대구광역시,남구,20-24세,9148,4384,4764
202106,27200,대구광역시,남구,20-24세,9084,4358,4726
202007,27200,대구광역시,남구,25-29세,10889,5638,5251
202008,27200,대구광역시,남구,25-29세,10947,5682,5265
202009,27200,대구광역시,남구,25-29세,10967,5695,5272
202010,27200,대구광역시,남구,25-29세,11039,5738,5301
202011,27200,대구광역시,남구,25-29세,11098,5759,5339
202012,27200,대구광역시,남구,25-29세,11105,5734,5371
202101,27200,대구광역시,남구,25-29세,11122,5720,5402
202102,27200,대구광역시,남구,25-29세,11108,5729,5379
202103,27200,대구광역시,남구,25-29세,11141,5758,5383
202104,27200,대구광역시,남구,25-29세,11203,5769,5434
202105,27200,대구광역시,남구,25-29세,11158,5738,5420
202106,27200,대구광역시,남구,25-29세,11177,5721,5456
202007,27200,대구광역시,남구,30-34세,8401,4532,3869
202008,27200,대구광역시,남구,30-34세,8377,4514,3863
202009,27200,대구광역시,남구,30-34세,8371,4509,3862
202010,27200,대구광역시,남구,30-34세,8347,4495,3852
202011,27200,대구광역시,남구,30-34세,8339,4488,3851
202012,27200,대구광역시,남구,30-34세,8330,4517,3813
202101,27200,대구광역시,남구,30-34세,8335,4533,3802
202102,27200,대구광역시,남구,30-34세,8279,4490,3789
202103,27200,대구광역시,남구,30-34세,8323,4519,3804
202104,27200,대구광역시,남구,30-34세,8379,4547,3832
202105,27200,대구광역시,남구,30-34세,8429,4577,3852
202106,27200,대구광역시,남구,30-34세,8451,4597,3854
202007,27200,대구광역시,남구,35-39세,9077,4614,4463
202008,27200,대구광역시,남구,35-39세,9001,4566,4435
202009,27200,대구광역시,남구,35-39세,8895,4506,4389
202010,27200,대구광역시,남구,35-39세,8846,4496,4350
202011,27200,대구광역시,남구,35-39세,8854,4506,4348
202012,27200,대구광역시,남구,35-39세,8848,4487,4361
202101,27200,대구광역시,남구,35-39세,8779,4472,4307
202102,27200,대구광역시,남구,35-39세,8737,4475,4262
202103,27200,대구광역시,남구,35-39세,8639,4426,4213
202104,27200,대구광역시,남구,35-39세,8658,4446,4212
202105,27200,대구광역시,남구,35-39세,8620,4419,4201
202106,27200,대구광역시,남구,35-39세,8520,4370,4150
202007,27200,대구광역시,남구,40-44세,9206,4651,4555
202008,27200,대구광역시,남구,40-44세,9210,4684,4526
202009,27200,대구광역시,남구,40-44세,9228,4705,4523
202010,27200,대구광역시,남구,40-44세,9232,4701,4531
202011,27200,대구광역시,남구,40-44세,9266,4722,4544
202012,27200,대구광역시,남구,40-44세,9268,4729,4539
202101,27200,대구광역시,남구,40-44세,9249,4712,4537
202102,27200,대구광역시,남구,40-44세,9219,4683,4536
202103,27200,대구광역시,남구,40-44세,9153,4639,4514
202104,27200,대구광역시,남구,40-44세,9154,4630,4524
202105,27200,대구광역시,남구,40-44세,9186,4648,4538
202106,27200,대구광역시,남구,40-44세,9154,4658,4496
202007,27200,대구광역시,남구,45-49세,11419,5723,5696
202008,27200,대구광역시,남구,45-49세,11383,5681,5702
202009,27200,대구광역시,남구,45-49세,11301,5650,5651
202010,27200,대구광역시,남구,45-49세,11197,5611,5586
202011,27200,대구광역시,남구,45-49세,11173,5572,5601
202012,27200,대구광역시,남구,45-49세,11135,5559,5576
202101,27200,대구광역시,남구,45-49세,11027,5512,5515
202102,27200,대구광역시,남구,45-49세,10983,5510,5473
202103,27200,대구광역시,남구,45-49세,10956,5519,5437
202104,27200,대구광역시,남구,45-49세,10937,5518,5419
202105,27200,대구광역시,남구,45-49세,10823,5468,5355
202106,27200,대구광역시,남구,45-49세,10689,5399,5290
202007,27200,대구광역시,남구,50-54세,12298,6135,6163
202008,27200,대구광역시,남구,50-54세,12300,6133,6167
202009,27200,대구광역시,남구,50-54세,12295,6136,6159
202010,27200,대구광역시,남구,50-54세,12269,6115,6154
202011,27200,대구광역시,남구,50-54세,12298,6131,6167
202012,27200,대구광역시,남구,50-54세,12279,6138,6141
202101,27200,대구광역시,남구,50-54세,12342,6155,6187
202102,27200,대구광역시,남구,50-54세,12348,6143,6205
202103,27200,대구광역시,남구,50-54세,12267,6091,6176
202104,27200,대구광역시,남구,50-54세,12297,6105,6192
202105,27200,대구광역시,남구,50-54세,12392,6131,6261
202106,27200,대구광역시,남구,50-54세,12385,6148,6237
202007,27200,대구광역시,남구,55-59세,12970,6130,6840
202008,27200,대구광역시,남구,55-59세,12905,6114,6791
202009,27200,대구광역시,남구,55-59세,12835,6087,6748
202010,27200,대구광역시,남구,55-59세,12771,6078,6693
202011,27200,대구광역시,남구,55-59세,12742,6061,6681
202012,27200,대구광역시,남구,55-59세,12688,6040,6648
202101,27200,대구광역시,남구,55-59세,12577,6014,6563
202102,27200,대구광역시,남구,55-59세,12508,5995,6513
202103,27200,대구광역시,남구,55-59세,12466,5995,6471
202104,27200,대구광역시,남구,55-59세,12444,5988,6456
202105,27200,대구광역시,남구,55-59세,12343,5933,6410
202106,27200,대구광역시,남구,55-59세,12186,5868,6318
202007,27200,대구광역시,남구,60-64세,13098,6077,7021
202008,27200,대구광역시,남구,60-64세,13113,6092,7021
202009,27200,대구광역시,남구,60-64세,13068,6055,7013
202010,27200,대구광역시,남구,60-64세,13076,6082,6994
202011,27200,대구광역시,남구,60-64세,13136,6093,7043
202012,27200,대구광역시,남구,60-64세,13200,6109,7091
202101,27200,대구광역시,남구,60-64세,13260,6128,7132
202102,27200,대구광역시,남구,60-64세,13301,6139,7162
202103,27200,대구광역시,남구,60-64세,13324,6135,7189
202104,27200,대구광역시,남구,60-64세,13358,6158,7200
202105,27200,대구광역시,남구,60-64세,13361,6176,7185
202106,27200,대구광역시,남구,60-64세,13274,6149,7125
202007,27200,대구광역시,남구,65-69세,10557,4724,5833
202008,27200,대구광역시,남구,65-69세,10620,4747,5873
202009,27200,대구광역시,남구,65-69세,10670,4780,5890
202010,27200,대구광역시,남구,65-69세,10732,4806,5926
202011,27200,대구광역시,남구,65-69세,10791,4855,5936
202012,27200,대구광역시,남구,65-69세,10794,4880,5914
202101,27200,대구광역시,남구,65-69세,10857,4911,5946
202102,27200,대구광역시,남구,65-69세,10912,4932,5980
202103,27200,대구광역시,남구,65-69세,10971,4961,6010
202104,27200,대구광역시,남구,65-69세,10986,4962,6024
202105,27200,대구광역시,남구,65-69세,11042,4987,6055
202106,27200,대구광역시,남구,65-69세,10991,4969,6022
202007,27200,대구광역시,남구,70-74세,8202,3590,4612
202008,27200,대구광역시,남구,70-74세,8231,3594,4637
202009,27200,대구광역시,남구,70-74세,8262,3618,4644
202010,27200,대구광역시,남구,70-74세,8292,3626,4666
202011,27200,대구광역시,남구,70-74세,8342,3646,4696
202012,27200,대구광역시,남구,70-74세,8378,3657,4721
202101,27200,대구광역시,남구,70-74세,8429,3680,4749
202102,27200,대구광역시,남구,70-74세,8471,3691,4780
202103,27200,대구광역시,남구,70-74세,8505,3694,4811
202104,27200,대구광역시,남구,70-74세,8523,3703,4820
202105,27200,대구광역시,남구,70-74세,8543,3704,4839
202106,27200,대구광역시,남구,70-74세,8493,3690,4803
202007,27200,대구광역시,남구,75-79세,6946,2847,4099
202008,27200,대구광역시,남구,75-79세,6925,2848,4077
202009,27200,대구광역시,남구,75-79세,6901,2841,4060
202010,27200,대구광역시,남구,75-79세,6836,2814,4022
202011,27200,대구광역시,남구,75-79세,6796,2790,4006
202012,27200,대구광역시,남구,75-79세,6757,2774,3983
202101,27200,대구광역시,남구,75-79세,6714,2758,3956
202102,27200,대구광역시,남구,75-79세,6654,2742,3912
202103,27200,대구광역시,남구,75-79세,6603,2733,3870
202104,27200,대구광역시,남구,75-79세,6540,2703,3837
202105,27200,대구광역시,남구,75-79세,6501,2681,3820
202106,27200,대구광역시,남구,75-79세,6411,2655,3756
202007,27200,대구광역시,남구,80-84세,4766,1783,2983
202008,27200,대구광역시,남구,80-84세,4767,1784,2983
202009,27200,대구광역시,남구,80-84세,4758,1784,2974
202010,27200,대구광역시,남구,80-84세,4772,1784,2988
202011,27200,대구광역시,남구,80-84세,4757,1782,2975
202012,27200,대구광역시,남구,80-84세,4775,1796,2979
202101,27200,대구광역시,남구,80-84세,4812,1801,3011
202102,27200,대구광역시,남구,80-84세,4858,1818,3040
202103,27200,대구광역시,남구,80-84세,4900,1840,3060
202104,27200,대구광역시,남구,80-84세,4915,1843,3072
202105,27200,대구광역시,남구,80-84세,4926,1846,3080
202106,27200,대구광역시,남구,80-84세,4900,1842,3058
202007,27200,대구광역시,남구,85-89세,2381,786,1595
202008,27200,대구광역시,남구,85-89세,2396,797,1599
202009,27200,대구광역시,남구,85-89세,2422,796,1626
202010,27200,대구광역시,남구,85-89세,2419,798,1621
202011,27200,대구광역시,남구,85-89세,2434,808,1626
202012,27200,대구광역시,남구,85-89세,2457,816,1641
202101,27200,대구광역시,남구,85-89세,2467,828,1639
202102,27200,대구광역시,남구,85-89세,2502,841,1661
202103,27200,대구광역시,남구,85-89세,2525,848,1677
202104,27200,대구광역시,남구,85-89세,2552,857,1695
202105,27200,대구광역시,남구,85-89세,2583,870,1713
202106,27200,대구광역시,남구,85-89세,2549,844,1705
202007,27200,대구광역시,남구,90-94세,741,191,550
202008,27200,대구광역시,남구,90-94세,750,194,556
202009,27200,대구광역시,남구,90-94세,753,194,559
202010,27200,대구광역시,남구,90-94세,763,188,575
202011,27200,대구광역시,남구,90-94세,761,183,578
202012,27200,대구광역시,남구,90-94세,766,183,583
202101,27200,대구광역시,남구,90-94세,780,188,592
202102,27200,대구광역시,남구,90-94세,784,186,598
202103,27200,대구광역시,남구,90-94세,793,185,608
202104,27200,대구광역시,남구,90-94세,800,186,614
202105,27200,대구광역시,남구,90-94세,814,190,624
202106,27200,대구광역시,남구,90-94세,801,184,617
202007,27200,대구광역시,남구,95-99세,166,37,129
202008,27200,대구광역시,남구,95-99세,163,37,126
202009,27200,대구광역시,남구,95-99세,163,37,126
202010,27200,대구광역시,남구,95-99세,167,38,129
202011,27200,대구광역시,남구,95-99세,169,38,131
202012,27200,대구광역시,남구,95-99세,173,40,133
202101,27200,대구광역시,남구,95-99세,181,40,141
202102,27200,대구광역시,남구,95-99세,187,41,146
202103,27200,대구광역시,남구,95-99세,184,38,146
202104,27200,대구광역시,남구,95-99세,183,34,149
202105,27200,대구광역시,남구,95-99세,184,32,152
202106,27200,대구광역시,남구,95-99세,149,20,129
202007,27200,대구광역시,남구,100+,83,18,65
202008,27200,대구광역시,남구,100+,84,18,66
202009,27200,대구광역시,남구,100+,85,18,67
202010,27200,대구광역시,남구,100+,85,18,67
202011,27200,대구광역시,남구,100+,85,18,67
202012,27200,대구광역시,남구,100+,87,18,69
202101,27200,대구광역시,남구,100+,89,18,71
202102,27200,대구광역시,남구,100+,89,18,71
202103,27200,대구광역시,남구,100+,68,13,55
202104,27200,대구광역시,남구,100+,69,14,55
202105,27200,대구광역시,남구,100+,70,14,56
202106,27200,대구광역시,남구,100+,21,3,18
202007,27230,대구광역시,북구,0-4세,15055,7649,7406
202008,27230,대구광역시,북구,0-4세,14982,7602,7380
202009,27230,대구광역시,북구,0-4세,14904,7562,7342
202010,27230,대구광역시,북구,0-4세,14763,7515,7248
202011,27230,대구광역시,북구,0-4세,14598,7427,7171
202012,27230,대구광역시,북구,0-4세,14470,7358,7112
202101,27230,대구광역시,북구,0-4세,14231,7199,7032
202102,27230,대구광역시,북구,0-4세,14102,7141,6961
202103,27230,대구광역시,북구,0-4세,13926,7077,6849
202104,27230,대구광역시,북구,0-4세,13812,7032,6780
202105,27230,대구광역시,북구,0-4세,13701,7000,6701
202106,27230,대구광역시,북구,0-4세,13609,6956,6653
202007,27230,대구광역시,북구,5-9세,19752,10172,9580
202008,27230,대구광역시,북구,5-9세,19711,10170,9541
202009,27230,대구광역시,북구,5-9세,19687,10155,9532
202010,27230,대구광역시,북구,5-9세,19676,10118,9558
202011,27230,대구광역시,북구,5-9세,19591,10069,9522
202012,27230,대구광역시,북구,5-9세,19561,10035,9526
202101,27230,대구광역시,북구,5-9세,19480,10021,9459
202102,27230,대구광역시,북구,5-9세,19374,9984,9390
202103,27230,대구광역시,북구,5-9세,19303,9933,9370
202104,27230,대구광역시,북구,5-9세,19307,9947,9360
202105,27230,대구광역시,북구,5-9세,19262,9897,9365
202106,27230,대구광역시,북구,5-9세,19210,9841,9369
202007,27230,대구광역시,북구,10-14세,19905,10253,9652
202008,27230,대구광역시,북구,10-14세,19870,10214,9656
202009,27230,대구광역시,북구,10-14세,19922,10245,9677
202010,27230,대구광역시,북구,10-14세,19961,10296,9665
202011,27230,대구광역시,북구,10-14세,19972,10320,9652
202012,27230,대구광역시,북구,10-14세,19942,10298,9644
202101,27230,대구광역시,북구,10-14세,19936,10292,9644
202102,27230,대구광역시,북구,10-14세,19915,10267,9648
202103,27230,대구광역시,북구,10-14세,19875,10256,9619
202104,27230,대구광역시,북구,10-14세,19893,10257,9636
202105,27230,대구광역시,북구,10-14세,19881,10268,9613
202106,27230,대구광역시,북구,10-14세,19905,10289,9616
202007,27230,대구광역시,북구,15-19세,24315,12722,11593
202008,27230,대구광역시,북구,15-19세,24113,12606,11507
202009,27230,대구광역시,북구,15-19세,23946,12508,11438
202010,27230,대구광역시,북구,15-19세,23751,12404,11347
202011,27230,대구광역시,북구,15-19세,23575,12313,11262
202012,27230,대구광역시,북구,15-19세,23362,12232,11130
202101,27230,대구광역시,북구,15-19세,23181,12145,11036
202102,27230,대구광역시,북구,15-19세,23027,12038,10989
202103,27230,대구광역시,북구,15-19세,22781,11911,10870
202104,27230,대구광역시,북구,15-19세,22708,11865,10843
202105,27230,대구광역시,북구,15-19세,22581,11794,10787
202106,27230,대구광역시,북구,15-19세,22498,11747,10751
202007,27230,대구광역시,북구,20-24세,32178,17245,14933
202008,27230,대구광역시,북구,20-24세,32312,17313,14999
202009,27230,대구광역시,북구,20-24세,32386,17338,15048
202010,27230,대구광역시,북구,20-24세,32318,17295,15023
202011,27230,대구광역시,북구,20-24세,32337,17255,15082
202012,27230,대구광역시,북구,20-24세,32197,17147,15050
202101,27230,대구광역시,북구,20-24세,32150,17096,15054
202102,27230,대구광역시,북구,20-24세,32057,17059,14998
202103,27230,대구광역시,북구,20-24세,32027,17030,14997
202104,27230,대구광역시,북구,20-24세,31893,16945,14948
202105,27230,대구광역시,북구,20-24세,31814,16900,14914
202106,27230,대구광역시,북구,20-24세,31711,16801,14910
202007,27230,대구광역시,북구,25-29세,29170,16174,12996
202008,27230,대구광역시,북구,25-29세,29368,16266,13102
202009,27230,대구광역시,북구,25-29세,29551,16376,13175
202010,27230,대구광역시,북구,25-29세,29746,16463,13283
202011,27230,대구광역시,북구,25-29세,29872,16536,13336
202012,27230,대구광역시,북구,25-29세,29939,16539,13400
202101,27230,대구광역시,북구,25-29세,29923,16468,13455
202102,27230,대구광역시,북구,25-29세,29894,16421,13473
202103,27230,대구광역시,북구,25-29세,29915,16418,13497
202104,27230,대구광역시,북구,25-29세,29933,16475,13458
202105,27230,대구광역시,북구,25-29세,29998,16517,13481
202106,27230,대구광역시,북구,25-29세,30005,16520,13485
202007,27230,대구광역시,북구,30-34세,24859,13324,11535
202008,27230,대구광역시,북구,30-34세,24946,13388,11558
202009,27230,대구광역시,북구,30-34세,25144,13489,11655
202010,27230,대구광역시,북구,30-34세,25127,13481,11646
202011,27230,대구광역시,북구,30-34세,25013,13455,11558
202012,27230,대구광역시,북구,30-34세,24951,13406,11545
202101,27230,대구광역시,북구,30-34세,24985,13424,11561
202102,27230,대구광역시,북구,30-34세,24907,13382,11525
202103,27230,대구광역시,북구,30-34세,24884,13382,11502
202104,27230,대구광역시,북구,30-34세,24914,13377,11537
202105,27230,대구광역시,북구,30-34세,24987,13415,11572
202106,27230,대구광역시,북구,30-34세,24987,13429,11558
202007,27230,대구광역시,북구,35-39세,29740,15096,14644
202008,27230,대구광역시,북구,35-39세,29586,15029,14557
202009,27230,대구광역시,북구,35-39세,29486,15034,14452
202010,27230,대구광역시,북구,35-39세,29349,14978,14371
202011,27230,대구광역시,북구,35-39세,29182,14893,14289
202012,27230,대구광역시,북구,35-39세,29059,14839,14220
202101,27230,대구광역시,북구,35-39세,28837,14780,14057
202102,27230,대구광역시,북구,35-39세,28612,14688,13924
202103,27230,대구광역시,북구,35-39세,28395,14605,13790
202104,27230,대구광역시,북구,35-39세,28266,14553,13713
202105,27230,대구광역시,북구,35-39세,28084,14476,13608
202106,27230,대구광역시,북구,35-39세,27950,14376,13574
202007,27230,대구광역시,북구,40-44세,32592,16116,16476
202008,27230,대구광역시,북구,40-44세,32525,16096,16429
202009,27230,대구광역시,북구,40-44세,32615,16144,16471
202010,27230,대구광역시,북구,40-44세,32689,16163,16526
202011,27230,대구광역시,북구,40-44세,32717,16219,16498
202012,27230,대구광역시,북구,40-44세,32556,16163,16393
202101,27230,대구광역시,북구,40-44세,32448,16089,16359
202102,27230,대구광역시,북구,40-44세,32466,16118,16348
202103,27230,대구광역시,북구,40-44세,32299,15998,16301
202104,27230,대구광역시,북구,40-44세,32288,16026,16262
202105,27230,대구광역시,북구,40-44세,32290,16025,16265
202106,27230,대구광역시,북구,40-44세,32368,16081,16287
202007,27230,대구광역시,북구,45-49세,40692,19818,20874
202008,27230,대구광역시,북구,45-49세,40613,19780,20833
202009,27230,대구광역시,북구,45-49세,40488,19696,20792
202010,27230,대구광역시,북구,45-49세,40305,19643,20662
202011,27230,대구광역시,북구,45-49세,40167,19533,20634
202012,27230,대구광역시,북구,45-49세,40101,19493,20608
202101,27230,대구광역시,북구,45-49세,39892,19400,20492
202102,27230,대구광역시,북구,45-49세,39582,19240,20342
202103,27230,대구광역시,북구,45-49세,39381,19156,20225
202104,27230,대구광역시,북구,45-49세,39300,19099,20201
202105,27230,대구광역시,북구,45-49세,38968,18968,20000
202106,27230,대구광역시,북구,45-49세,38743,18842,19901
202007,27230,대구광역시,북구,50-54세,40555,20201,20354
202008,27230,대구광역시,북구,50-54세,40618,20220,20398
202009,27230,대구광역시,북구,50-54세,40812,20312,20500
202010,27230,대구광역시,북구,50-54세,40987,20378,20609
202011,27230,대구광역시,북구,50-54세,41089,20439,20650
202012,27230,대구광역시,북구,50-54세,41020,20395,20625
202101,27230,대구광역시,북구,50-54세,41275,20528,20747
202102,27230,대구광역시,북구,50-54세,41332,20551,20781
202103,27230,대구광역시,북구,50-54세,41109,20466,20643
202104,27230,대구광역시,북구,50-54세,41132,20460,20672
202105,27230,대구광역시,북구,50-54세,41319,20536,20783
202106,27230,대구광역시,북구,50-54세,41338,20537,20801
202007,27230,대구광역시,북구,55-59세,37215,18416,18799
202008,27230,대구광역시,북구,55-59세,37170,18356,18814
202009,27230,대구광역시,북구,55-59세,37199,18360,18839
202010,27230,대구광역시,북구,55-59세,37185,18372,18813
202011,27230,대구광역시,북구,55-59세,37170,18340,18830
202012,27230,대구광역시,북구,55-59세,37182,18354,18828
202101,27230,대구광역시,북구,55-59세,37021,18285,18736
202102,27230,대구광역시,북구,55-59세,36877,18223,18654
202103,27230,대구광역시,북구,55-59세,36807,18204,18603
202104,27230,대구광역시,북구,55-59세,36750,18185,18565
202105,27230,대구광역시,북구,55-59세,36568,18133,18435
202106,27230,대구광역시,북구,55-59세,36301,18024,18277
202007,27230,대구광역시,북구,60-64세,30826,15319,15507
202008,27230,대구광역시,북구,60-64세,31048,15449,15599
202009,27230,대구광역시,북구,60-64세,31244,15533,15711
202010,27230,대구광역시,북구,60-64세,31539,15655,15884
202011,27230,대구광역시,북구,60-64세,31679,15725,15954
202012,27230,대구광역시,북구,60-64세,31869,15815,16054
202101,27230,대구광역시,북구,60-64세,32114,15932,16182
202102,27230,대구광역시,북구,60-64세,32377,16048,16329
202103,27230,대구광역시,북구,60-64세,32596,16143,16453
202104,27230,대구광역시,북구,60-64세,32793,16247,16546
202105,27230,대구광역시,북구,60-64세,33072,16372,16700
202106,27230,대구광역시,북구,60-64세,33281,16455,16826
202007,27230,대구광역시,북구,65-69세,21309,10041,11268
202008,27230,대구광역시,북구,65-69세,21463,10112,11351
202009,27230,대구광역시,북구,65-69세,21629,10206,11423
202010,27230,대구광역시,북구,65-69세,21760,10291,11469
202011,27230,대구광역시,북구,65-69세,21930,10362,11568
202012,27230,대구광역시,북구,65-69세,22054,10394,11660
202101,27230,대구광역시,북구,65-69세,22238,10498,11740
202102,27230,대구광역시,북구,65-69세,22330,10570,11760
202103,27230,대구광역시,북구,65-69세,22550,10646,11904
202104,27230,대구광역시,북구,65-69세,22638,10654,11984
202105,27230,대구광역시,북구,65-69세,22701,10693,12008
202106,27230,대구광역시,북구,65-69세,22790,10760,12030
202007,27230,대구광역시,북구,70-74세,15362,6841,8521
202008,27230,대구광역시,북구,70-74세,15407,6868,8539
202009,27230,대구광역시,북구,70-74세,15513,6917,8596
202010,27230,대구광역시,북구,70-74세,15692,6992,8700
202011,27230,대구광역시,북구,70-74세,15812,7055,8757
202012,27230,대구광역시,북구,70-74세,15967,7139,8828
202101,27230,대구광역시,북구,70-74세,16111,7193,8918
202102,27230,대구광역시,북구,70-74세,16225,7240,8985
202103,27230,대구광역시,북구,70-74세,16299,7287,9012
202104,27230,대구광역시,북구,70-74세,16381,7338,9043
202105,27230,대구광역시,북구,70-74세,16433,7354,9079
202106,27230,대구광역시,북구,70-74세,16433,7353,9080
202007,27230,대구광역시,북구,75-79세,12642,5124,7518
202008,27230,대구광역시,북구,75-79세,12611,5120,7491
202009,27230,대구광역시,북구,75-79세,12545,5079,7466
202010,27230,대구광역시,북구,75-79세,12489,5076,7413
202011,27230,대구광역시,북구,75-79세,12441,5059,7382
202012,27230,대구광역시,북구,75-79세,12349,5021,7328
202101,27230,대구광역시,북구,75-79세,12253,4992,7261
202102,27230,대구광역시,북구,75-79세,12158,4969,7189
202103,27230,대구광역시,북구,75-79세,12156,4985,7171
202104,27230,대구광역시,북구,75-79세,12079,4956,7123
202105,27230,대구광역시,북구,75-79세,12045,4952,7093
202106,27230,대구광역시,북구,75-79세,12046,4936,7110
202007,27230,대구광역시,북구,80-84세,8083,2994,5089
202008,27230,대구광역시,북구,80-84세,8129,3011,5118
202009,27230,대구광역시,북구,80-84세,8164,3033,5131
202010,27230,대구광역시,북구,80-84세,8191,3044,5147
202011,27230,대구광역시,북구,80-84세,8234,3060,5174
202012,27230,대구광역시,북구,80-84세,8274,3088,5186
202101,27230,대구광역시,북구,80-84세,8356,3121,5235
202102,27230,대구광역시,북구,80-84세,8423,3152,5271
202103,27230,대구광역시,북구,80-84세,8454,3152,5302
202104,27230,대구광역시,북구,80-84세,8493,3172,5321
202105,27230,대구광역시,북구,80-84세,8526,3179,5347
202106,27230,대구광역시,북구,80-84세,8541,3178,5363
202007,27230,대구광역시,북구,85-89세,3773,1123,2650
202008,27230,대구광역시,북구,85-89세,3794,1125,2669
202009,27230,대구광역시,북구,85-89세,3827,1133,2694
202010,27230,대구광역시,북구,85-89세,3851,1140,2711
202011,27230,대구광역시,북구,85-89세,3881,1148,2733
202012,27230,대구광역시,북구,85-89세,3913,1168,2745
202101,27230,대구광역시,북구,85-89세,3951,1193,2758
202102,27230,대구광역시,북구,85-89세,4006,1211,2795
202103,27230,대구광역시,북구,85-89세,4054,1230,2824
202104,27230,대구광역시,북구,85-89세,4104,1235,2869
202105,27230,대구광역시,북구,85-89세,4135,1249,2886
202106,27230,대구광역시,북구,85-89세,4112,1249,2863
202007,27230,대구광역시,북구,90-94세,1104,227,877
202008,27230,대구광역시,북구,90-94세,1117,232,885
202009,27230,대구광역시,북구,90-94세,1123,235,888
202010,27230,대구광역시,북구,90-94세,1130,236,894
202011,27230,대구광역시,북구,90-94세,1152,241,911
202012,27230,대구광역시,북구,90-94세,1171,249,922
202101,27230,대구광역시,북구,90-94세,1196,254,942
202102,27230,대구광역시,북구,90-94세,1223,259,964
202103,27230,대구광역시,북구,90-94세,1229,261,968
202104,27230,대구광역시,북구,90-94세,1241,264,977
202105,27230,대구광역시,북구,90-94세,1232,258,974
202106,27230,대구광역시,북구,90-94세,1239,252,987
202007,27230,대구광역시,북구,95-99세,220,42,178
202008,27230,대구광역시,북구,95-99세,219,42,177
202009,27230,대구광역시,북구,95-99세,223,42,181
202010,27230,대구광역시,북구,95-99세,227,43,184
202011,27230,대구광역시,북구,95-99세,227,42,185
202012,27230,대구광역시,북구,95-99세,232,43,189
202101,27230,대구광역시,북구,95-99세,231,44,187
202102,27230,대구광역시,북구,95-99세,234,44,190
202103,27230,대구광역시,북구,95-99세,233,41,192
202104,27230,대구광역시,북구,95-99세,233,41,192
202105,27230,대구광역시,북구,95-99세,228,37,191
202106,27230,대구광역시,북구,95-99세,216,35,181
202007,27230,대구광역시,북구,100+,85,17,68
202008,27230,대구광역시,북구,100+,88,17,71
202009,27230,대구광역시,북구,100+,92,19,73
202010,27230,대구광역시,북구,100+,96,20,76
202011,27230,대구광역시,북구,100+,97,21,76
202012,27230,대구광역시,북구,100+,94,21,73
202101,27230,대구광역시,북구,100+,97,21,76
202102,27230,대구광역시,북구,100+,97,20,77
202103,27230,대구광역시,북구,100+,92,16,76
202104,27230,대구광역시,북구,100+,90,16,74
202105,27230,대구광역시,북구,100+,67,13,54
202106,27230,대구광역시,북구,100+,50,8,42
202007,27260,대구광역시,수성구,0-4세,10836,5605,5231
202008,27260,대구광역시,수성구,0-4세,10694,5526,5168
202009,27260,대구광역시,수성구,0-4세,10620,5476,5144
202010,27260,대구광역시,수성구,0-4세,10504,5401,5103
202011,27260,대구광역시,수성구,0-4세,10374,5344,5030
202012,27260,대구광역시,수성구,0-4세,10360,5339,5021
202101,27260,대구광역시,수성구,0-4세,10241,5276,4965
202102,27260,대구광역시,수성구,0-4세,10248,5303,4945
202103,27260,대구광역시,수성구,0-4세,10156,5247,4909
202104,27260,대구광역시,수성구,0-4세,10078,5207,4871
202105,27260,대구광역시,수성구,0-4세,10006,5180,4826
202106,27260,대구광역시,수성구,0-4세,9997,5156,4841
202007,27260,대구광역시,수성구,5-9세,19639,10090,9549
202008,27260,대구광역시,수성구,5-9세,19612,10084,9528
202009,27260,대구광역시,수성구,5-9세,19506,10020,9486
202010,27260,대구광역시,수성구,5-9세,19416,9981,9435
202011,27260,대구광역시,수성구,5-9세,19342,9940,9402
202012,27260,대구광역시,수성구,5-9세,19424,9981,9443
202101,27260,대구광역시,수성구,5-9세,19427,9975,9452
202102,27260,대구광역시,수성구,5-9세,19522,10034,9488
202103,27260,대구광역시,수성구,5-9세,19424,10008,9416
202104,27260,대구광역시,수성구,5-9세,19351,9955,9396
202105,27260,대구광역시,수성구,5-9세,19306,9934,9372
202106,27260,대구광역시,수성구,5-9세,19297,9942,9355
202007,27260,대구광역시,수성구,10-14세,24293,12691,11602
202008,27260,대구광역시,수성구,10-14세,24265,12688,11577
202009,27260,대구광역시,수성구,10-14세,24227,12682,11545
202010,27260,대구광역시,수성구,10-14세,24354,12740,11614
202011,27260,대구광역시,수성구,10-14세,24339,12716,11623
202012,27260,대구광역시,수성구,10-14세,24344,12730,11614
202101,27260,대구광역시,수성구,10-14세,24404,12746,11658
202102,27260,대구광역시,수성구,10-14세,24406,12758,11648
202103,27260,대구광역시,수성구,10-14세,24397,12717,11680
202104,27260,대구광역시,수성구,10-14세,24337,12686,11651
202105,27260,대구광역시,수성구,10-14세,24335,12681,11654
202106,27260,대구광역시,수성구,10-14세,24244,12629,11615
202007,27260,대구광역시,수성구,15-19세,27887,14873,13014
202008,27260,대구광역시,수성구,15-19세,27721,14766,12955
202009,27260,대구광역시,수성구,15-19세,27627,14707,12920
202010,27260,대구광역시,수성구,15-19세,27489,14625,12864
202011,27260,대구광역시,수성구,15-19세,27354,14576,12778
202012,27260,대구광역시,수성구,15-19세,27151,14507,12644
202101,27260,대구광역시,수성구,15-19세,26937,14362,12575
202102,27260,대구광역시,수성구,15-19세,26654,14208,12446
202103,27260,대구광역시,수성구,15-19세,26278,14021,12257
202104,27260,대구광역시,수성구,15-19세,26058,13917,12141
202105,27260,대구광역시,수성구,15-19세,25787,13768,12019
202106,27260,대구광역시,수성구,15-19세,25640,13682,11958
202007,27260,대구광역시,수성구,20-24세,30568,16503,14065
202008,27260,대구광역시,수성구,20-24세,30512,16476,14036
202009,27260,대구광역시,수성구,20-24세,30437,16405,14032
202010,27260,대구광역시,수성구,20-24세,30278,16310,13968
202011,27260,대구광역시,수성구,20-24세,30127,16202,13925
202012,27260,대구광역시,수성구,20-24세,30007,16107,13900
202101,27260,대구광역시,수성구,20-24세,29966,16094,13872
202102,27260,대구광역시,수성구,20-24세,29742,15964,13778
202103,27260,대구광역시,수성구,20-24세,29543,15882,13661
202104,27260,대구광역시,수성구,20-24세,29452,15835,13617
202105,27260,대구광역시,수성구,20-24세,29260,15736,13524
202106,27260,대구광역시,수성구,20-24세,29144,15653,13491
202007,27260,대구광역시,수성구,25-29세,25288,13585,11703
202008,27260,대구광역시,수성구,25-29세,25412,13628,11784
202009,27260,대구광역시,수성구,25-29세,25444,13673,11771
202010,27260,대구광역시,수성구,25-29세,25529,13732,11797
202011,27260,대구광역시,수성구,25-29세,25507,13683,11824
202012,27260,대구광역시,수성구,25-29세,25396,13589,11807
202101,27260,대구광역시,수성구,25-29세,25346,13611,11735
202102,27260,대구광역시,수성구,25-29세,25208,13524,11684
202103,27260,대구광역시,수성구,25-29세,25189,13514,11675
202104,27260,대구광역시,수성구,25-29세,25142,13447,11695
202105,27260,대구광역시,수성구,25-29세,25160,13411,11749
202106,27260,대구광역시,수성구,25-29세,25090,13382,11708
202007,27260,대구광역시,수성구,30-34세,18716,9748,8968
202008,27260,대구광역시,수성구,30-34세,18788,9779,9009
202009,27260,대구광역시,수성구,30-34세,18762,9734,9028
202010,27260,대구광역시,수성구,30-34세,18721,9679,9042
202011,27260,대구광역시,수성구,30-34세,18723,9709,9014
202012,27260,대구광역시,수성구,30-34세,18636,9654,8982
202101,27260,대구광역시,수성구,30-34세,18682,9667,9015
202102,27260,대구광역시,수성구,30-34세,18744,9692,9052
202103,27260,대구광역시,수성구,30-34세,18764,9690,9074
202104,27260,대구광역시,수성구,30-34세,18796,9699,9097
202105,27260,대구광역시,수성구,30-34세,18873,9794,9079
202106,27260,대구광역시,수성구,30-34세,18974,9885,9089
202007,27260,대구광역시,수성구,35-39세,24961,11474,13487
202008,27260,대구광역시,수성구,35-39세,24765,11382,13383
202009,27260,대구광역시,수성구,35-39세,24594,11311,13283
202010,27260,대구광역시,수성구,35-39세,24423,11262,13161
202011,27260,대구광역시,수성구,35-39세,24230,11181,13049
202012,27260,대구광역시,수성구,35-39세,24190,11165,13025
202101,27260,대구광역시,수성구,35-39세,24028,11102,12926
202102,27260,대구광역시,수성구,35-39세,23897,11088,12809
202103,27260,대구광역시,수성구,35-39세,23682,11012,12670
202104,27260,대구광역시,수성구,35-39세,23504,10918,12586
202105,27260,대구광역시,수성구,35-39세,23289,10796,12493
202106,27260,대구광역시,수성구,35-39세,23208,10772,12436
202007,27260,대구광역시,수성구,40-44세,32219,14604,17615
202008,27260,대구광역시,수성구,40-44세,32202,14593,17609
202009,27260,대구광역시,수성구,40-44세,32232,14604,17628
202010,27260,대구광역시,수성구,40-44세,32248,14613,17635
202011,27260,대구광역시,수성구,40-44세,32191,14559,17632
202012,27260,대구광역시,수성구,40-44세,32159,14577,17582
202101,27260,대구광역시,수성구,40-44세,32168,14567,17601
202102,27260,대구광역시,수성구,40-44세,32325,14677,17648
202103,27260,대구광역시,수성구,40-44세,32312,14693,17619
202104,27260,대구광역시,수성구,40-44세,32238,14674,17564
202105,27260,대구광역시,수성구,40-44세,32185,14666,17519
202106,27260,대구광역시,수성구,40-44세,32194,14675,17519
202007,27260,대구광역시,수성구,45-49세,41601,19026,22575
202008,27260,대구광역시,수성구,45-49세,41474,18980,22494
202009,27260,대구광역시,수성구,45-49세,41194,18848,22346
202010,27260,대구광역시,수성구,45-49세,41057,18784,22273
202011,27260,대구광역시,수성구,45-49세,40909,18729,22180
202012,27260,대구광역시,수성구,45-49세,40707,18624,22083
202101,27260,대구광역시,수성구,45-49세,40536,18575,21961
202102,27260,대구광역시,수성구,45-49세,40313,18465,21848
202103,27260,대구광역시,수성구,45-49세,39981,18280,21701
202104,27260,대구광역시,수성구,45-49세,39763,18175,21588
202105,27260,대구광역시,수성구,45-49세,39360,17977,21383
202106,27260,대구광역시,수성구,45-49세,39132,17886,21246
202007,27260,대구광역시,수성구,50-54세,40486,19620,20866
202008,27260,대구광역시,수성구,50-54세,40532,19628,20904
202009,27260,대구광역시,수성구,50-54세,40631,19656,20975
202010,27260,대구광역시,수성구,50-54세,40676,19652,21024
202011,27260,대구광역시,수성구,50-54세,40690,19653,21037
202012,27260,대구광역시,수성구,50-54세,40534,19593,20941
202101,27260,대구광역시,수성구,50-54세,40720,19674,21046
202102,27260,대구광역시,수성구,50-54세,40872,19696,21176
202103,27260,대구광역시,수성구,50-54세,40731,19644,21087
202104,27260,대구광역시,수성구,50-54세,40754,19632,21122
202105,27260,대구광역시,수성구,50-54세,40866,19658,21208
202106,27260,대구광역시,수성구,50-54세,40850,19612,21238
202007,27260,대구광역시,수성구,55-59세,34917,17000,17917
202008,27260,대구광역시,수성구,55-59세,34889,16983,17906
202009,27260,대구광역시,수성구,55-59세,34752,16879,17873
202010,27260,대구광역시,수성구,55-59세,34672,16820,17852
202011,27260,대구광역시,수성구,55-59세,34599,16814,17785
202012,27260,대구광역시,수성구,55-59세,34617,16790,17827
202101,27260,대구광역시,수성구,55-59세,34374,16700,17674
202102,27260,대구광역시,수성구,55-59세,34295,16663,17632
202103,27260,대구광역시,수성구,55-59세,34273,16650,17623
202104,27260,대구광역시,수성구,55-59세,34120,16592,17528
202105,27260,대구광역시,수성구,55-59세,33990,16560,17430
202106,27260,대구광역시,수성구,55-59세,33746,16459,17287
202007,27260,대구광역시,수성구,60-64세,29648,14165,15483
202008,27260,대구광역시,수성구,60-64세,29743,14206,15537
202009,27260,대구광역시,수성구,60-64세,29880,14319,15561
202010,27260,대구광역시,수성구,60-64세,30043,14384,15659
202011,27260,대구광역시,수성구,60-64세,30139,14428,15711
202012,27260,대구광역시,수성구,60-64세,30225,14491,15734
202101,27260,대구광역시,수성구,60-64세,30394,14542,15852
202102,27260,대구광역시,수성구,60-64세,30508,14615,15893
202103,27260,대구광역시,수성구,60-64세,30543,14627,15916
202104,27260,대구광역시,수성구,60-64세,30559,14641,15918
202105,27260,대구광역시,수성구,60-64세,30574,14633,15941
202106,27260,대구광역시,수성구,60-64세,30669,14679,15990
202007,27260,대구광역시,수성구,65-69세,21372,9844,11528
202008,27260,대구광역시,수성구,65-69세,21563,9941,11622
202009,27260,대구광역시,수성구,65-69세,21698,10003,11695
202010,27260,대구광역시,수성구,65-69세,21772,10052,11720
202011,27260,대구광역시,수성구,65-69세,21853,10074,11779
202012,27260,대구광역시,수성구,65-69세,21907,10108,11799
202101,27260,대구광역시,수성구,65-69세,22025,10190,11835
202102,27260,대구광역시,수성구,65-69세,22146,10248,11898
202103,27260,대구광역시,수성구,65-69세,22324,10333,11991
202104,27260,대구광역시,수성구,65-69세,22492,10405,12087
202105,27260,대구광역시,수성구,65-69세,22605,10466,12139
202106,27260,대구광역시,수성구,65-69세,22634,10485,12149
202007,27260,대구광역시,수성구,70-74세,15731,7044,8687
202008,27260,대구광역시,수성구,70-74세,15744,7037,8707
202009,27260,대구광역시,수성구,70-74세,15867,7099,8768
202010,27260,대구광역시,수성구,70-74세,15962,7122,8840
202011,27260,대구광역시,수성구,70-74세,16089,7185,8904
202012,27260,대구광역시,수성구,70-74세,16214,7218,8996
202101,27260,대구광역시,수성구,70-74세,16377,7282,9095
202102,27260,대구광역시,수성구,70-74세,16525,7345,9180
202103,27260,대구광역시,수성구,70-74세,16583,7346,9237
202104,27260,대구광역시,수성구,70-74세,16639,7359,9280
202105,27260,대구광역시,수성구,70-74세,16683,7350,9333
202106,27260,대구광역시,수성구,70-74세,16673,7340,9333
202007,27260,대구광역시,수성구,75-79세,12926,5446,7480
202008,27260,대구광역시,수성구,75-79세,12901,5442,7459
202009,27260,대구광역시,수성구,75-79세,12790,5399,7391
202010,27260,대구광역시,수성구,75-79세,12739,5376,7363
202011,27260,대구광역시,수성구,75-79세,12660,5332,7328
202012,27260,대구광역시,수성구,75-79세,12559,5296,7263
202101,27260,대구광역시,수성구,75-79세,12506,5280,7226
202102,27260,대구광역시,수성구,75-79세,12395,5246,7149
202103,27260,대구광역시,수성구,75-79세,12347,5243,7104
202104,27260,대구광역시,수성구,75-79세,12250,5221,7029
202105,27260,대구광역시,수성구,75-79세,12233,5234,6999
202106,27260,대구광역시,수성구,75-79세,12170,5207,6963
202007,27260,대구광역시,수성구,80-84세,8940,3415,5525
202008,27260,대구광역시,수성구,80-84세,8982,3433,5549
202009,27260,대구광역시,수성구,80-84세,8993,3430,5563
202010,27260,대구광역시,수성구,80-84세,9013,3452,5561
202011,27260,대구광역시,수성구,80-84세,9056,3467,5589
202012,27260,대구광역시,수성구,80-84세,9068,3471,5597
202101,27260,대구광역시,수성구,80-84세,9105,3491,5614
202102,27260,대구광역시,수성구,80-84세,9186,3526,5660
202103,27260,대구광역시,수성구,80-84세,9229,3558,5671
202104,27260,대구광역시,수성구,80-84세,9238,3568,5670
202105,27260,대구광역시,수성구,80-84세,9246,3583,5663
202106,27260,대구광역시,수성구,80-84세,9282,3602,5680
202007,27260,대구광역시,수성구,85-89세,4707,1524,3183
202008,27260,대구광역시,수성구,85-89세,4751,1542,3209
202009,27260,대구광역시,수성구,85-89세,4784,1566,3218
202010,27260,대구광역시,수성구,85-89세,4811,1575,3236
202011,27260,대구광역시,수성구,85-89세,4832,1580,3252
202012,27260,대구광역시,수성구,85-89세,4875,1596,3279
202101,27260,대구광역시,수성구,85-89세,4908,1613,3295
202102,27260,대구광역시,수성구,85-89세,4957,1630,3327
202103,27260,대구광역시,수성구,85-89세,5009,1653,3356
202104,27260,대구광역시,수성구,85-89세,5059,1667,3392
202105,27260,대구광역시,수성구,85-89세,5059,1669,3390
202106,27260,대구광역시,수성구,85-89세,5066,1678,3388
202007,27260,대구광역시,수성구,90-94세,1479,347,1132
202008,27260,대구광역시,수성구,90-94세,1487,346,1141
202009,27260,대구광역시,수성구,90-94세,1504,354,1150
202010,27260,대구광역시,수성구,90-94세,1511,354,1157
202011,27260,대구광역시,수성구,90-94세,1506,358,1148
202012,27260,대구광역시,수성구,90-94세,1515,357,1158
202101,27260,대구광역시,수성구,90-94세,1534,362,1172
202102,27260,대구광역시,수성구,90-94세,1558,371,1187
202103,27260,대구광역시,수성구,90-94세,1578,376,1202
202104,27260,대구광역시,수성구,90-94세,1602,383,1219
202105,27260,대구광역시,수성구,90-94세,1609,385,1224
202106,27260,대구광역시,수성구,90-94세,1590,385,1205
202007,27260,대구광역시,수성구,95-99세,298,70,228
202008,27260,대구광역시,수성구,95-99세,300,69,231
202009,27260,대구광역시,수성구,95-99세,311,70,241
202010,27260,대구광역시,수성구,95-99세,321,74,247
202011,27260,대구광역시,수성구,95-99세,327,75,252
202012,27260,대구광역시,수성구,95-99세,326,74,252
202101,27260,대구광역시,수성구,95-99세,333,75,258
202102,27260,대구광역시,수성구,95-99세,338,77,261
202103,27260,대구광역시,수성구,95-99세,333,71,262
202104,27260,대구광역시,수성구,95-99세,326,74,252
202105,27260,대구광역시,수성구,95-99세,318,71,247
202106,27260,대구광역시,수성구,95-99세,314,70,244
202007,27260,대구광역시,수성구,100+,99,26,73
202008,27260,대구광역시,수성구,100+,100,26,74
202009,27260,대구광역시,수성구,100+,96,27,69
202010,27260,대구광역시,수성구,100+,100,27,73
202011,27260,대구광역시,수성구,100+,100,27,73
202012,27260,대구광역시,수성구,100+,100,26,74
202101,27260,대구광역시,수성구,100+,101,26,75
202102,27260,대구광역시,수성구,100+,98,25,73
202103,27260,대구광역시,수성구,100+,83,21,62
202104,27260,대구광역시,수성구,100+,82,21,61
202105,27260,대구광역시,수성구,100+,76,21,55
202106,27260,대구광역시,수성구,100+,65,16,49
202007,27290,대구광역시,달서구,0-4세,17101,8847,8254
202008,27290,대구광역시,달서구,0-4세,16900,8752,8148
202009,27290,대구광역시,달서구,0-4세,16759,8678,8081
202010,27290,대구광역시,달서구,0-4세,16521,8571,7950
202011,27290,대구광역시,달서구,0-4세,16325,8448,7877
202012,27290,대구광역시,달서구,0-4세,16116,8335,7781
202101,27290,대구광역시,달서구,0-4세,15865,8204,7661
202102,27290,대구광역시,달서구,0-4세,15600,8049,7551
202103,27290,대구광역시,달서구,0-4세,15386,7940,7446
202104,27290,대구광역시,달서구,0-4세,15115,7793,7322
202105,27290,대구광역시,달서구,0-4세,14925,7670,7255
202106,27290,대구광역시,달서구,0-4세,14774,7590,7184
202007,27290,대구광역시,달서구,5-9세,24676,12561,12115
202008,27290,대구광역시,달서구,5-9세,24547,12488,12059
202009,27290,대구광역시,달서구,5-9세,24467,12448,12019
202010,27290,대구광역시,달서구,5-9세,24320,12373,11947
202011,27290,대구광역시,달서구,5-9세,24227,12332,11895
202012,27290,대구광역시,달서구,5-9세,24157,12282,11875
202101,27290,대구광역시,달서구,5-9세,24018,12192,11826
202102,27290,대구광역시,달서구,5-9세,23866,12118,11748
202103,27290,대구광역시,달서구,5-9세,23809,12116,11693
202104,27290,대구광역시,달서구,5-9세,23734,12067,11667
202105,27290,대구광역시,달서구,5-9세,23670,12056,11614
202106,27290,대구광역시,달서구,5-9세,23618,12032,11586
202007,27290,대구광역시,달서구,10-14세,25699,13275,12424
202008,27290,대구광역시,달서구,10-14세,25649,13245,12404
202009,27290,대구광역시,달서구,10-14세,25685,13270,12415
202010,27290,대구광역시,달서구,10-14세,25674,13271,12403
202011,27290,대구광역시,달서구,10-14세,25719,13304,12415
202012,27290,대구광역시,달서구,10-14세,25645,13269,12376
202101,27290,대구광역시,달서구,10-14세,25689,13282,12407
202102,27290,대구광역시,달서구,10-14세,25643,13252,12391
202103,27290,대구광역시,달서구,10-14세,25554,13209,12345
202104,27290,대구광역시,달서구,10-14세,25541,13224,12317
202105,27290,대구광역시,달서구,10-14세,25536,13230,12306
202106,27290,대구광역시,달서구,10-14세,25538,13219,12319
202007,27290,대구광역시,달서구,15-19세,30991,16142,14849
202008,27290,대구광역시,달서구,15-19세,30733,16007,14726
202009,27290,대구광역시,달서구,15-19세,30465,15875,14590
202010,27290,대구광역시,달서구,15-19세,30169,15685,14484
202011,27290,대구광역시,달서구,15-19세,29902,15540,14362
202012,27290,대구광역시,달서구,15-19세,29595,15392,14203
202101,27290,대구광역시,달서구,15-19세,29281,15237,14044
202102,27290,대구광역시,달서구,15-19세,29063,15134,13929
202103,27290,대구광역시,달서구,15-19세,28779,14945,13834
202104,27290,대구광역시,달서구,15-19세,28547,14816,13731
202105,27290,대구광역시,달서구,15-19세,28355,14739,13616
202106,27290,대구광역시,달서구,15-19세,28200,14662,13538
202007,27290,대구광역시,달서구,20-24세,41090,21694,19396
202008,27290,대구광역시,달서구,20-24세,41078,21678,19400
202009,27290,대구광역시,달서구,20-24세,40999,21621,19378
202010,27290,대구광역시,달서구,20-24세,40851,21571,19280
202011,27290,대구광역시,달서구,20-24세,40611,21444,19167
202012,27290,대구광역시,달서구,20-24세,40323,21266,19057
202101,27290,대구광역시,달서구,20-24세,40141,21140,19001
202102,27290,대구광역시,달서구,20-24세,39915,21019,18896
202103,27290,대구광역시,달서구,20-24세,39563,20875,18688
202104,27290,대구광역시,달서구,20-24세,39369,20791,18578
202105,27290,대구광역시,달서구,20-24세,39191,20673,18518
202106,27290,대구광역시,달서구,20-24세,39013,20574,18439
202007,27290,대구광역시,달서구,25-29세,39182,21198,17984
202008,27290,대구광역시,달서구,25-29세,39210,21208,18002
202009,27290,대구광역시,달서구,25-29세,39225,21186,18039
202010,27290,대구광역시,달서구,25-29세,39167,21108,18059
202011,27290,대구광역시,달서구,25-29세,39125,21073,18052
202012,27290,대구광역시,달서구,25-29세,38950,20960,17990
202101,27290,대구광역시,달서구,25-29세,38771,20859,17912
202102,27290,대구광역시,달서구,25-29세,38496,20684,17812
202103,27290,대구광역시,달서구,25-29세,38469,20693,17776
202104,27290,대구광역시,달서구,25-29세,38344,20648,17696
202105,27290,대구광역시,달서구,25-29세,38425,20686,17739
202106,27290,대구광역시,달서구,25-29세,38426,20689,17737
202007,27290,대구광역시,달서구,30-34세,31470,17056,14414
202008,27290,대구광역시,달서구,30-34세,31461,17088,14373
202009,27290,대구광역시,달서구,30-34세,31396,17083,14313
202010,27290,대구광역시,달서구,30-34세,31278,17011,14267
202011,27290,대구광역시,달서구,30-34세,31170,16918,14252
202012,27290,대구광역시,달서구,30-34세,30904,16778,14126
202101,27290,대구광역시,달서구,30-34세,30784,16696,14088
202102,27290,대구광역시,달서구,30-34세,30753,16689,14064
202103,27290,대구광역시,달서구,30-34세,30690,16624,14066
202104,27290,대구광역시,달서구,30-34세,30600,16560,14040
202105,27290,대구광역시,달서구,30-34세,30540,16530,14010
202106,27290,대구광역시,달서구,30-34세,30519,16551,13968
202007,27290,대구광역시,달서구,35-39세,36790,18333,18457
202008,27290,대구광역시,달서구,35-39세,36534,18239,18295
202009,27290,대구광역시,달서구,35-39세,36320,18148,18172
202010,27290,대구광역시,달서구,35-39세,36075,18044,18031
202011,27290,대구광역시,달서구,35-39세,35797,17935,17862
202012,27290,대구광역시,달서구,35-39세,35675,17861,17814
202101,27290,대구광역시,달서구,35-39세,35381,17716,17665
202102,27290,대구광역시,달서구,35-39세,34977,17553,17424
202103,27290,대구광역시,달서구,35-39세,34659,17424,17235
202104,27290,대구광역시,달서구,35-39세,34419,17351,17068
202105,27290,대구광역시,달서구,35-39세,34193,17268,16925
202106,27290,대구광역시,달서구,35-39세,33865,17090,16775
202007,27290,대구광역시,달서구,40-44세,41010,20057,20953
202008,27290,대구광역시,달서구,40-44세,40877,19987,20890
202009,27290,대구광역시,달서구,40-44세,40853,20003,20850
202010,27290,대구광역시,달서구,40-44세,40805,19977,20828
202011,27290,대구광역시,달서구,40-44세,40750,19912,20838
202012,27290,대구광역시,달서구,40-44세,40458,19794,20664
202101,27290,대구광역시,달서구,40-44세,40397,19772,20625
202102,27290,대구광역시,달서구,40-44세,40361,19777,20584
202103,27290,대구광역시,달서구,40-44세,40225,19700,20525
202104,27290,대구광역시,달서구,40-44세,40152,19681,20471
202105,27290,대구광역시,달서구,40-44세,40098,19609,20489
202106,27290,대구광역시,달서구,40-44세,40134,19650,20484
202007,27290,대구광역시,달서구,45-49세,50054,24061,25993
202008,27290,대구광역시,달서구,45-49세,49841,23923,25918
202009,27290,대구광역시,달서구,45-49세,49600,23817,25783
202010,27290,대구광역시,달서구,45-49세,49294,23657,25637
202011,27290,대구광역시,달서구,45-49세,49099,23582,25517
202012,27290,대구광역시,달서구,45-49세,48983,23521,25462
202101,27290,대구광역시,달서구,45-49세,48678,23398,25280
202102,27290,대구광역시,달서구,45-49세,48354,23271,25083
202103,27290,대구광역시,달서구,45-49세,48005,23111,24894
202104,27290,대구광역시,달서구,45-49세,47803,23017,24786
202105,27290,대구광역시,달서구,45-49세,47410,22888,24522
202106,27290,대구광역시,달서구,45-49세,47172,22755,24417
202007,27290,대구광역시,달서구,50-54세,53661,25721,27940
202008,27290,대구광역시,달서구,50-54세,53551,25684,27867
202009,27290,대구광역시,달서구,50-54세,53476,25637,27839
202010,27290,대구광역시,달서구,50-54세,53330,25619,27711
202011,27290,대구광역시,달서구,50-54세,53215,25578,27637
202012,27290,대구광역시,달서구,50-54세,52982,25514,27468
202101,27290,대구광역시,달서구,50-54세,53131,25558,27573
202102,27290,대구광역시,달서구,50-54세,53102,25506,27596
202103,27290,대구광역시,달서구,50-54세,52738,25336,27402
202104,27290,대구광역시,달서구,50-54세,52709,25288,27421
202105,27290,대구광역시,달서구,50-54세,52779,25298,27481
202106,27290,대구광역시,달서구,50-54세,52933,25371,27562
202007,27290,대구광역시,달서구,55-59세,51219,25004,26215
202008,27290,대구광역시,달서구,55-59세,51119,24948,26171
202009,27290,대구광역시,달서구,55-59세,50985,24867,26118
202010,27290,대구광역시,달서구,55-59세,50888,24775,26113
202011,27290,대구광역시,달서구,55-59세,50743,24699,26044
202012,27290,대구광역시,달서구,55-59세,50682,24645,26037
202101,27290,대구광역시,달서구,55-59세,50310,24478,25832
202102,27290,대구광역시,달서구,55-59세,50137,24413,25724
202103,27290,대구광역시,달서구,55-59세,49937,24312,25625
202104,27290,대구광역시,달서구,55-59세,49750,24252,25498
202105,27290,대구광역시,달서구,55-59세,49568,24150,25418
202106,27290,대구광역시,달서구,55-59세,49185,23927,25258
202007,27290,대구광역시,달서구,60-64세,42637,20943,21694
202008,27290,대구광역시,달서구,60-64세,42873,21038,21835
202009,27290,대구광역시,달서구,60-64세,43000,21101,21899
202010,27290,대구광역시,달서구,60-64세,43126,21146,21980
202011,27290,대구광역시,달서구,60-64세,43326,21217,22109
202012,27290,대구광역시,달서구,60-64세,43515,21305,22210
202101,27290,대구광역시,달서구,60-64세,43867,21442,22425
202102,27290,대구광역시,달서구,60-64세,44128,21559,22569
202103,27290,대구광역시,달서구,60-64세,44405,21643,22762
202104,27290,대구광역시,달서구,60-64세,44596,21720,22876
202105,27290,대구광역시,달서구,60-64세,44854,21827,23027
202106,27290,대구광역시,달서구,60-64세,45170,21980,23190
202007,27290,대구광역시,달서구,65-69세,28996,13673,15323
202008,27290,대구광역시,달서구,65-69세,29148,13728,15420
202009,27290,대구광역시,달서구,65-69세,29386,13850,15536
202010,27290,대구광역시,달서구,65-69세,29531,13928,15603
202011,27290,대구광역시,달서구,65-69세,29686,14017,15669
202012,27290,대구광역시,달서구,65-69세,29818,14054,15764
202101,27290,대구광역시,달서구,65-69세,30011,14161,15850
202102,27290,대구광역시,달서구,65-69세,30217,14233,15984
202103,27290,대구광역시,달서구,65-69세,30550,14446,16104
202104,27290,대구광역시,달서구,65-69세,30708,14519,16189
202105,27290,대구광역시,달서구,65-69세,30934,14627,16307
202106,27290,대구광역시,달서구,65-69세,31133,14761,16372
202007,27290,대구광역시,달서구,70-74세,19301,8944,10357
202008,27290,대구광역시,달서구,70-74세,19426,9011,10415
202009,27290,대구광역시,달서구,70-74세,19531,9063,10468
202010,27290,대구광역시,달서구,70-74세,19719,9151,10568
202011,27290,대구광역시,달서구,70-74세,19865,9213,10652
202012,27290,대구광역시,달서구,70-74세,20058,9304,10754
202101,27290,대구광역시,달서구,70-74세,20270,9402,10868
202102,27290,대구광역시,달서구,70-74세,20469,9501,10968
202103,27290,대구광역시,달서구,70-74세,20492,9498,10994
202104,27290,대구광역시,달서구,70-74세,20600,9531,11069
202105,27290,대구광역시,달서구,70-74세,20672,9539,11133
202106,27290,대구광역시,달서구,70-74세,20715,9541,11174
202007,27290,대구광역시,달서구,75-79세,14655,6098,8557
202008,27290,대구광역시,달서구,75-79세,14604,6076,8528
202009,27290,대구광역시,달서구,75-79세,14537,6057,8480
202010,27290,대구광역시,달서구,75-79세,14444,6030,8414
202011,27290,대구광역시,달서구,75-79세,14346,5991,8355
202012,27290,대구광역시,달서구,75-79세,14247,5968,8279
202101,27290,대구광역시,달서구,75-79세,14153,5928,8225
202102,27290,대구광역시,달서구,75-79세,14058,5914,8144
202103,27290,대구광역시,달서구,75-79세,14046,5914,8132
202104,27290,대구광역시,달서구,75-79세,13977,5907,8070
202105,27290,대구광역시,달서구,75-79세,13947,5913,8034
202106,27290,대구광역시,달서구,75-79세,13911,5902,8009
202007,27290,대구광역시,달서구,80-84세,9794,3473,6321
202008,27290,대구광역시,달서구,80-84세,9809,3488,6321
202009,27290,대구광역시,달서구,80-84세,9851,3493,6358
202010,27290,대구광역시,달서구,80-84세,9904,3523,6381
202011,27290,대구광역시,달서구,80-84세,9927,3549,6378
202012,27290,대구광역시,달서구,80-84세,9915,3569,6346
202101,27290,대구광역시,달서구,80-84세,9993,3625,6368
202102,27290,대구광역시,달서구,80-84세,10030,3637,6393
202103,27290,대구광역시,달서구,80-84세,10028,3646,6382
202104,27290,대구광역시,달서구,80-84세,10072,3667,6405
202105,27290,대구광역시,달서구,80-84세,10133,3703,6430
202106,27290,대구광역시,달서구,80-84세,10177,3725,6452
202007,27290,대구광역시,달서구,85-89세,4568,1357,3211
202008,27290,대구광역시,달서구,85-89세,4616,1377,3239
202009,27290,대구광역시,달서구,85-89세,4656,1392,3264
202010,27290,대구광역시,달서구,85-89세,4689,1400,3289
202011,27290,대구광역시,달서구,85-89세,4716,1414,3302
202012,27290,대구광역시,달서구,85-89세,4791,1420,3371
202101,27290,대구광역시,달서구,85-89세,4820,1425,3395
202102,27290,대구광역시,달서구,85-89세,4895,1460,3435
202103,27290,대구광역시,달서구,85-89세,4982,1481,3501
202104,27290,대구광역시,달서구,85-89세,5071,1515,3556
202105,27290,대구광역시,달서구,85-89세,5096,1516,3580
202106,27290,대구광역시,달서구,85-89세,5132,1531,3601
202007,27290,대구광역시,달서구,90-94세,1381,307,1074
202008,27290,대구광역시,달서구,90-94세,1385,305,1080
202009,27290,대구광역시,달서구,90-94세,1394,314,1080
202010,27290,대구광역시,달서구,90-94세,1397,314,1083
202011,27290,대구광역시,달서구,90-94세,1409,309,1100
202012,27290,대구광역시,달서구,90-94세,1413,307,1106
202101,27290,대구광역시,달서구,90-94세,1435,311,1124
202102,27290,대구광역시,달서구,90-94세,1475,319,1156
202103,27290,대구광역시,달서구,90-94세,1503,328,1175
202104,27290,대구광역시,달서구,90-94세,1514,330,1184
202105,27290,대구광역시,달서구,90-94세,1511,337,1174
202106,27290,대구광역시,달서구,90-94세,1523,339,1184
202007,27290,대구광역시,달서구,95-99세,279,51,228
202008,27290,대구광역시,달서구,95-99세,283,53,230
202009,27290,대구광역시,달서구,95-99세,300,58,242
202010,27290,대구광역시,달서구,95-99세,298,59,239
202011,27290,대구광역시,달서구,95-99세,305,61,244
202012,27290,대구광역시,달서구,95-99세,313,63,250
202101,27290,대구광역시,달서구,95-99세,319,66,253
202102,27290,대구광역시,달서구,95-99세,315,67,248
202103,27290,대구광역시,달서구,95-99세,305,61,244
202104,27290,대구광역시,달서구,95-99세,302,59,243
202105,27290,대구광역시,달서구,95-99세,301,57,244
202106,27290,대구광역시,달서구,95-99세,295,55,240
202007,27290,대구광역시,달서구,100+,85,18,67
202008,27290,대구광역시,달서구,100+,86,18,68
202009,27290,대구광역시,달서구,100+,87,18,69
202010,27290,대구광역시,달서구,100+,88,18,70
202011,27290,대구광역시,달서구,100+,91,19,72
202012,27290,대구광역시,달서구,100+,91,19,72
202101,27290,대구광역시,달서구,100+,90,19,71
202102,27290,대구광역시,달서구,100+,94,20,74
202103,27290,대구광역시,달서구,100+,52,9,43
202104,27290,대구광역시,달서구,100+,52,9,43
202105,27290,대구광역시,달서구,100+,54,9,45
202106,27290,대구광역시,달서구,100+,57,9,48
202007,27710,대구광역시,달성군,0-4세,14318,7284,7034
202008,27710,대구광역시,달성군,0-4세,14289,7268,7021
202009,27710,대구광역시,달성군,0-4세,14145,7190,6955
202010,27710,대구광역시,달성군,0-4세,14046,7144,6902
202011,27710,대구광역시,달성군,0-4세,13933,7068,6865
202012,27710,대구광역시,달성군,0-4세,13849,7054,6795
202101,27710,대구광역시,달성군,0-4세,13709,6998,6711
202102,27710,대구광역시,달성군,0-4세,13623,6958,6665
202103,27710,대구광역시,달성군,0-4세,13531,6938,6593
202104,27710,대구광역시,달성군,0-4세,13427,6884,6543
202105,27710,대구광역시,달성군,0-4세,13348,6833,6515
202106,27710,대구광역시,달성군,0-4세,13225,6752,6473
202007,27710,대구광역시,달성군,5-9세,15534,7912,7622
202008,27710,대구광역시,달성군,5-9세,15551,7946,7605
202009,27710,대구광역시,달성군,5-9세,15542,7952,7590
202010,27710,대구광역시,달성군,5-9세,15546,7926,7620
202011,27710,대구광역시,달성군,5-9세,15558,7950,7608
202012,27710,대구광역시,달성군,5-9세,15569,7942,7627
202101,27710,대구광역시,달성군,5-9세,15632,7956,7676
202102,27710,대구광역시,달성군,5-9세,15638,7960,7678
202103,27710,대구광역시,달성군,5-9세,15665,7963,7702
202104,27710,대구광역시,달성군,5-9세,15674,7971,7703
202105,27710,대구광역시,달성군,5-9세,15740,8003,7737
202106,27710,대구광역시,달성군,5-9세,15804,8044,7760
202007,27710,대구광역시,달성군,10-14세,12243,6307,5936
202008,27710,대구광역시,달성군,10-14세,12312,6336,5976
202009,27710,대구광역시,달성군,10-14세,12419,6383,6036
202010,27710,대구광역시,달성군,10-14세,12519,6451,6068
202011,27710,대구광역시,달성군,10-14세,12621,6478,6143
202012,27710,대구광역시,달성군,10-14세,12689,6508,6181
202101,27710,대구광역시,달성군,10-14세,12733,6539,6194
202102,27710,대구광역시,달성군,10-14세,12787,6568,6219
202103,27710,대구광역시,달성군,10-14세,12836,6585,6251
202104,27710,대구광역시,달성군,10-14세,12932,6641,6291
202105,27710,대구광역시,달성군,10-14세,13007,6663,6344
202106,27710,대구광역시,달성군,10-14세,13066,6707,6359
202007,27710,대구광역시,달성군,15-19세,11385,6081,5304
202008,27710,대구광역시,달성군,15-19세,11359,6083,5276
202009,27710,대구광역시,달성군,15-19세,11350,6081,5269
202010,27710,대구광역시,달성군,15-19세,11342,6034,5308
202011,27710,대구광역시,달성군,15-19세,11295,6033,5262
202012,27710,대구광역시,달성군,15-19세,11234,5998,5236
202101,27710,대구광역시,달성군,15-19세,11237,5973,5264
202102,27710,대구광역시,달성군,15-19세,11195,5966,5229
202103,27710,대구광역시,달성군,15-19세,11139,5934,5205
202104,27710,대구광역시,달성군,15-19세,11101,5891,5210
202105,27710,대구광역시,달성군,15-19세,11057,5889,5168
202106,27710,대구광역시,달성군,15-19세,11036,5858,5178
202007,27710,대구광역시,달성군,20-24세,13785,7658,6127
202008,27710,대구광역시,달성군,20-24세,13786,7656,6130
202009,27710,대구광역시,달성군,20-24세,13758,7622,6136
202010,27710,대구광역시,달성군,20-24세,13762,7621,6141
202011,27710,대구광역시,달성군,20-24세,13715,7565,6150
202012,27710,대구광역시,달성군,20-24세,13687,7530,6157
202101,27710,대구광역시,달성군,20-24세,13609,7514,6095
202102,27710,대구광역시,달성군,20-24세,13584,7481,6103
202103,27710,대구광역시,달성군,20-24세,13503,7438,6065
202104,27710,대구광역시,달성군,20-24세,13483,7445,6038
202105,27710,대구광역시,달성군,20-24세,13451,7401,6050
202106,27710,대구광역시,달성군,20-24세,13448,7412,6036
202007,27710,대구광역시,달성군,25-29세,15309,8317,6992
202008,27710,대구광역시,달성군,25-29세,15398,8380,7018
202009,27710,대구광역시,달성군,25-29세,15309,8349,6960
202010,27710,대구광역시,달성군,25-29세,15337,8401,6936
202011,27710,대구광역시,달성군,25-29세,15346,8391,6955
202012,27710,대구광역시,달성군,25-29세,15357,8390,6967
202101,27710,대구광역시,달성군,25-29세,15343,8379,6964
202102,27710,대구광역시,달성군,25-29세,15289,8349,6940
202103,27710,대구광역시,달성군,25-29세,15290,8340,6950
202104,27710,대구광역시,달성군,25-29세,15320,8349,6971
202105,27710,대구광역시,달성군,25-29세,15321,8389,6932
202106,27710,대구광역시,달성군,25-29세,15264,8387,6877
202007,27710,대구광역시,달성군,30-34세,18297,9609,8688
202008,27710,대구광역시,달성군,30-34세,18272,9589,8683
202009,27710,대구광역시,달성군,30-34세,18212,9550,8662
202010,27710,대구광역시,달성군,30-34세,18120,9508,8612
202011,27710,대구광역시,달성군,30-34세,18094,9501,8593
202012,27710,대구광역시,달성군,30-34세,18059,9504,8555
202101,27710,대구광역시,달성군,30-34세,18017,9491,8526
202102,27710,대구광역시,달성군,30-34세,17956,9480,8476
202103,27710,대구광역시,달성군,30-34세,17971,9504,8467
202104,27710,대구광역시,달성군,30-34세,17961,9514,8447
202105,27710,대구광역시,달성군,30-34세,17921,9495,8426
202106,27710,대구광역시,달성군,30-34세,17875,9440,8435
202007,27710,대구광역시,달성군,35-39세,23913,12374,11539
202008,27710,대구광역시,달성군,35-39세,23908,12364,11544
202009,27710,대구광역시,달성군,35-39세,23771,12313,11458
202010,27710,대구광역시,달성군,35-39세,23658,12261,11397
202011,27710,대구광역시,달성군,35-39세,23559,12238,11321
202012,27710,대구광역시,달성군,35-39세,23639,12273,11366
202101,27710,대구광역시,달성군,35-39세,23532,12214,11318
202102,27710,대구광역시,달성군,35-39세,23516,12188,11328
202103,27710,대구광역시,달성군,35-39세,23360,12097,11263
202104,27710,대구광역시,달성군,35-39세,23274,12043,11231
202105,27710,대구광역시,달성군,35-39세,23145,11970,11175
202106,27710,대구광역시,달성군,35-39세,23053,11935,11118
202007,27710,대구광역시,달성군,40-44세,22029,11520,10509
202008,27710,대구광역시,달성군,40-44세,22143,11585,10558
202009,27710,대구광역시,달성군,40-44세,22304,11658,10646
202010,27710,대구광역시,달성군,40-44세,22438,11721,10717
202011,27710,대구광역시,달성군,40-44세,22616,11787,10829
202012,27710,대구광역시,달성군,40-44세,22567,11785,10782
202101,27710,대구광역시,달성군,40-44세,22676,11823,10853
202102,27710,대구광역시,달성군,40-44세,22804,11886,10918
202103,27710,대구광역시,달성군,40-44세,22869,11936,10933
202104,27710,대구광역시,달성군,40-44세,23028,12025,11003
202105,27710,대구광역시,달성군,40-44세,23160,12074,11086
202106,27710,대구광역시,달성군,40-44세,23321,12157,11164
202007,27710,대구광역시,달성군,45-49세,20804,10817,9987
202008,27710,대구광역시,달성군,45-49세,20800,10818,9982
202009,27710,대구광역시,달성군,45-49세,20807,10841,9966
202010,27710,대구광역시,달성군,45-49세,20775,10833,9942
202011,27710,대구광역시,달성군,45-49세,20809,10874,9935
202012,27710,대구광역시,달성군,45-49세,20904,10897,10007
202101,27710,대구광역시,달성군,45-49세,20955,10924,10031
202102,27710,대구광역시,달성군,45-49세,20891,10896,9995
202103,27710,대구광역시,달성군,45-49세,20829,10871,9958
202104,27710,대구광역시,달성군,45-49세,20859,10875,9984
202105,27710,대구광역시,달성군,45-49세,20761,10855,9906
202106,27710,대구광역시,달성군,45-49세,20719,10829,9890
202007,27710,대구광역시,달성군,50-54세,20463,10130,10333
202008,27710,대구광역시,달성군,50-54세,20531,10178,10353
202009,27710,대구광역시,달성군,50-54세,20499,10174,10325
202010,27710,대구광역시,달성군,50-54세,20553,10182,10371
202011,27710,대구광역시,달성군,50-54세,20535,10189,10346
202012,27710,대구광역시,달성군,50-54세,20556,10217,10339
202101,27710,대구광역시,달성군,50-54세,20648,10268,10380
202102,27710,대구광역시,달성군,50-54세,20766,10308,10458
202103,27710,대구광역시,달성군,50-54세,20660,10255,10405
202104,27710,대구광역시,달성군,50-54세,20652,10262,10390
202105,27710,대구광역시,달성군,50-54세,20780,10314,10466
202106,27710,대구광역시,달성군,50-54세,20799,10314,10485
202007,27710,대구광역시,달성군,55-59세,20201,10146,10055
202008,27710,대구광역시,달성군,55-59세,20203,10130,10073
202009,27710,대구광역시,달성군,55-59세,20278,10143,10135
202010,27710,대구광역시,달성군,55-59세,20283,10155,10128
202011,27710,대구광역시,달성군,55-59세,20262,10143,10119
202012,27710,대구광역시,달성군,55-59세,20295,10112,10183
202101,27710,대구광역시,달성군,55-59세,20211,10062,10149
202102,27710,대구광역시,달성군,55-59세,20143,10035,10108
202103,27710,대구광역시,달성군,55-59세,20050,9983,10067
202104,27710,대구광역시,달성군,55-59세,20028,9990,10038
202105,27710,대구광역시,달성군,55-59세,19955,9957,9998
202106,27710,대구광역시,달성군,55-59세,19854,9932,9922
202007,27710,대구광역시,달성군,60-64세,17223,8615,8608
202008,27710,대구광역시,달성군,60-64세,17363,8697,8666
202009,27710,대구광역시,달성군,60-64세,17439,8764,8675
202010,27710,대구광역시,달성군,60-64세,17536,8833,8703
202011,27710,대구광역시,달성군,60-64세,17717,8902,8815
202012,27710,대구광역시,달성군,60-64세,17845,8984,8861
202101,27710,대구광역시,달성군,60-64세,18063,9080,8983
202102,27710,대구광역시,달성군,60-64세,18271,9185,9086
202103,27710,대구광역시,달성군,60-64세,18416,9247,9169
202104,27710,대구광역시,달성군,60-64세,18527,9291,9236
202105,27710,대구광역시,달성군,60-64세,18681,9374,9307
202106,27710,대구광역시,달성군,60-64세,18851,9432,9419
202007,27710,대구광역시,달성군,65-69세,11477,5638,5839
202008,27710,대구광역시,달성군,65-69세,11575,5675,5900
202009,27710,대구광역시,달성군,65-69세,11681,5721,5960
202010,27710,대구광역시,달성군,65-69세,11821,5778,6043
202011,27710,대구광역시,달성군,65-69세,11898,5824,6074
202012,27710,대구광역시,달성군,65-69세,12000,5866,6134
202101,27710,대구광역시,달성군,65-69세,12105,5910,6195
202102,27710,대구광역시,달성군,65-69세,12209,5962,6247
202103,27710,대구광역시,달성군,65-69세,12357,6022,6335
202104,27710,대구광역시,달성군,65-69세,12487,6093,6394
202105,27710,대구광역시,달성군,65-69세,12587,6135,6452
202106,27710,대구광역시,달성군,65-69세,12672,6181,6491
202007,27710,대구광역시,달성군,70-74세,7833,3829,4004
202008,27710,대구광역시,달성군,70-74세,7905,3864,4041
202009,27710,대구광역시,달성군,70-74세,7985,3894,4091
202010,27710,대구광역시,달성군,70-74세,8044,3906,4138
202011,27710,대구광역시,달성군,70-74세,8124,3944,4180
202012,27710,대구광역시,달성군,70-74세,8214,3993,4221
202101,27710,대구광역시,달성군,70-74세,8311,4048,4263
202102,27710,대구광역시,달성군,70-74세,8372,4063,4309
202103,27710,대구광역시,달성군,70-74세,8420,4076,4344
202104,27710,대구광역시,달성군,70-74세,8449,4091,4358
202105,27710,대구광역시,달성군,70-74세,8484,4112,4372
202106,27710,대구광역시,달성군,70-74세,8536,4137,4399
202007,27710,대구광역시,달성군,75-79세,5901,2419,3482
202008,27710,대구광역시,달성군,75-79세,5903,2444,3459
202009,27710,대구광역시,달성군,75-79세,5881,2438,3443
202010,27710,대구광역시,달성군,75-79세,5853,2442,3411
202011,27710,대구광역시,달성군,75-79세,5811,2431,3380
202012,27710,대구광역시,달성군,75-79세,5774,2426,3348
202101,27710,대구광역시,달성군,75-79세,5746,2430,3316
202102,27710,대구광역시,달성군,75-79세,5739,2437,3302
202103,27710,대구광역시,달성군,75-79세,5722,2445,3277
202104,27710,대구광역시,달성군,75-79세,5696,2444,3252
202105,27710,대구광역시,달성군,75-79세,5693,2454,3239
202106,27710,대구광역시,달성군,75-79세,5677,2446,3231
202007,27710,대구광역시,달성군,80-84세,4053,1407,2646
202008,27710,대구광역시,달성군,80-84세,4073,1409,2664
202009,27710,대구광역시,달성군,80-84세,4079,1412,2667
202010,27710,대구광역시,달성군,80-84세,4090,1407,2683
202011,27710,대구광역시,달성군,80-84세,4106,1420,2686
202012,27710,대구광역시,달성군,80-84세,4153,1426,2727
202101,27710,대구광역시,달성군,80-84세,4193,1449,2744
202102,27710,대구광역시,달성군,80-84세,4214,1456,2758
202103,27710,대구광역시,달성군,80-84세,4214,1453,2761
202104,27710,대구광역시,달성군,80-84세,4238,1454,2784
202105,27710,대구광역시,달성군,80-84세,4261,1456,2805
202106,27710,대구광역시,달성군,80-84세,4291,1471,2820
202007,27710,대구광역시,달성군,85-89세,2066,597,1469
202008,27710,대구광역시,달성군,85-89세,2083,597,1486
202009,27710,대구광역시,달성군,85-89세,2097,602,1495
202010,27710,대구광역시,달성군,85-89세,2107,611,1496
202011,27710,대구광역시,달성군,85-89세,2119,612,1507
202012,27710,대구광역시,달성군,85-89세,2122,619,1503
202101,27710,대구광역시,달성군,85-89세,2147,627,1520
202102,27710,대구광역시,달성군,85-89세,2169,639,1530
202103,27710,대구광역시,달성군,85-89세,2173,627,1546
202104,27710,대구광역시,달성군,85-89세,2206,642,1564
202105,27710,대구광역시,달성군,85-89세,2194,647,1547
202106,27710,대구광역시,달성군,85-89세,2203,645,1558
202007,27710,대구광역시,달성군,90-94세,629,125,504
202008,27710,대구광역시,달성군,90-94세,626,125,501
202009,27710,대구광역시,달성군,90-94세,643,131,512
202010,27710,대구광역시,달성군,90-94세,655,135,520
202011,27710,대구광역시,달성군,90-94세,667,145,522
202012,27710,대구광역시,달성군,90-94세,667,145,522
202101,27710,대구광역시,달성군,90-94세,671,141,530
202102,27710,대구광역시,달성군,90-94세,680,142,538
202103,27710,대구광역시,달성군,90-94세,683,135,548
202104,27710,대구광역시,달성군,90-94세,694,138,556
202105,27710,대구광역시,달성군,90-94세,701,137,564
202106,27710,대구광역시,달성군,90-94세,698,134,564
202007,27710,대구광역시,달성군,95-99세,119,28,91
202008,27710,대구광역시,달성군,95-99세,127,31,96
202009,27710,대구광역시,달성군,95-99세,128,31,97
202010,27710,대구광역시,달성군,95-99세,128,30,98
202011,27710,대구광역시,달성군,95-99세,131,29,102
202012,27710,대구광역시,달성군,95-99세,129,30,99
202101,27710,대구광역시,달성군,95-99세,129,32,97
202102,27710,대구광역시,달성군,95-99세,130,32,98
202103,27710,대구광역시,달성군,95-99세,124,26,98
202104,27710,대구광역시,달성군,95-99세,132,26,106
202105,27710,대구광역시,달성군,95-99세,135,26,109
202106,27710,대구광역시,달성군,95-99세,133,27,106
202007,27710,대구광역시,달성군,100+,27,8,19
202008,27710,대구광역시,달성군,100+,27,8,19
202009,27710,대구광역시,달성군,100+,27,8,19
202010,27710,대구광역시,달성군,100+,29,9,20
202011,27710,대구광역시,달성군,100+,29,9,20
202012,27710,대구광역시,달성군,100+,30,9,21
202101,27710,대구광역시,달성군,100+,33,9,24
202102,27710,대구광역시,달성군,100+,32,9,23
202103,27710,대구광역시,달성군,100+,21,3,18
202104,27710,대구광역시,달성군,100+,21,3,18
202105,27710,대구광역시,달성군,100+,21,3,18
202106,27710,대구광역시,달성군,100+,21,3,18
202007,28110,인천광역시,중구,0-4세,5356,2777,2579
202008,28110,인천광역시,중구,0-4세,5302,2754,2548
202009,28110,인천광역시,중구,0-4세,5266,2734,2532
202010,28110,인천광역시,중구,0-4세,5229,2723,2506
202011,28110,인천광역시,중구,0-4세,5191,2717,2474
202012,28110,인천광역시,중구,0-4세,5133,2690,2443
202101,28110,인천광역시,중구,0-4세,5113,2683,2430
202102,28110,인천광역시,중구,0-4세,5052,2666,2386
202103,28110,인천광역시,중구,0-4세,5015,2645,2370
202104,28110,인천광역시,중구,0-4세,4971,2611,2360
202105,28110,인천광역시,중구,0-4세,4956,2608,2348
202106,28110,인천광역시,중구,0-4세,4913,2584,2329
202007,28110,인천광역시,중구,5-9세,6834,3494,3340
202008,28110,인천광역시,중구,5-9세,6812,3469,3343
202009,28110,인천광역시,중구,5-9세,6796,3476,3320
202010,28110,인천광역시,중구,5-9세,6788,3469,3319
202011,28110,인천광역시,중구,5-9세,6768,3444,3324
202012,28110,인천광역시,중구,5-9세,6762,3438,3324
202101,28110,인천광역시,중구,5-9세,6733,3428,3305
202102,28110,인천광역시,중구,5-9세,6719,3413,3306
202103,28110,인천광역시,중구,5-9세,6719,3424,3295
202104,28110,인천광역시,중구,5-9세,6715,3422,3293
202105,28110,인천광역시,중구,5-9세,6732,3437,3295
202106,28110,인천광역시,중구,5-9세,6754,3445,3309
202007,28110,인천광역시,중구,10-14세,6537,3337,3200
202008,28110,인천광역시,중구,10-14세,6558,3347,3211
202009,28110,인천광역시,중구,10-14세,6582,3355,3227
202010,28110,인천광역시,중구,10-14세,6605,3371,3234
202011,28110,인천광역시,중구,10-14세,6644,3383,3261
202012,28110,인천광역시,중구,10-14세,6652,3401,3251
202101,28110,인천광역시,중구,10-14세,6710,3441,3269
202102,28110,인천광역시,중구,10-14세,6705,3440,3265
202103,28110,인천광역시,중구,10-14세,6727,3438,3289
202104,28110,인천광역시,중구,10-14세,6743,3433,3310
202105,28110,인천광역시,중구,10-14세,6744,3429,3315
202106,28110,인천광역시,중구,10-14세,6755,3436,3319
202007,28110,인천광역시,중구,15-19세,6009,3172,2837
202008,28110,인천광역시,중구,15-19세,5977,3155,2822
202009,28110,인천광역시,중구,15-19세,5984,3149,2835
202010,28110,인천광역시,중구,15-19세,5968,3143,2825
202011,28110,인천광역시,중구,15-19세,5971,3160,2811
202012,28110,인천광역시,중구,15-19세,5997,3161,2836
202101,28110,인천광역시,중구,15-19세,5952,3147,2805
202102,28110,인천광역시,중구,15-19세,5964,3151,2813
202103,28110,인천광역시,중구,15-19세,5960,3154,2806
202104,28110,인천광역시,중구,15-19세,5978,3162,2816
202105,28110,인천광역시,중구,15-19세,6005,3175,2830
202106,28110,인천광역시,중구,15-19세,6018,3177,2841
202007,28110,인천광역시,중구,20-24세,7836,3725,4111
202008,28110,인천광역시,중구,20-24세,7763,3685,4078
202009,28110,인천광역시,중구,20-24세,7728,3689,4039
202010,28110,인천광역시,중구,20-24세,7644,3668,3976
202011,28110,인천광역시,중구,20-24세,7590,3630,3960
202012,28110,인천광역시,중구,20-24세,7535,3606,3929
202101,28110,인천광역시,중구,20-24세,7471,3596,3875
202102,28110,인천광역시,중구,20-24세,7387,3570,3817
202103,28110,인천광역시,중구,20-24세,7358,3574,3784
202104,28110,인천광역시,중구,20-24세,7332,3572,3760
202105,28110,인천광역시,중구,20-24세,7300,3567,3733
202106,28110,인천광역시,중구,20-24세,7302,3583,3719
202007,28110,인천광역시,중구,25-29세,11479,6028,5451
202008,28110,인천광역시,중구,25-29세,11528,6076,5452
202009,28110,인천광역시,중구,25-29세,11512,6076,5436
202010,28110,인천광역시,중구,25-29세,11554,6083,5471
202011,28110,인천광역시,중구,25-29세,11594,6096,5498
202012,28110,인천광역시,중구,25-29세,11598,6098,5500
202101,28110,인천광역시,중구,25-29세,11575,6087,5488
202102,28110,인천광역시,중구,25-29세,11487,6007,5480
202103,28110,인천광역시,중구,25-29세,11465,5989,5476
202104,28110,인천광역시,중구,25-29세,11484,6008,5476
202105,28110,인천광역시,중구,25-29세,11463,6011,5452
202106,28110,인천광역시,중구,25-29세,11461,5999,5462
202007,28110,인천광역시,중구,30-34세,9744,5350,4394
202008,28110,인천광역시,중구,30-34세,9803,5389,4414
202009,28110,인천광역시,중구,30-34세,9878,5445,4433
202010,28110,인천광역시,중구,30-34세,9881,5464,4417
202011,28110,인천광역시,중구,30-34세,9939,5515,4424
202012,28110,인천광역시,중구,30-34세,9925,5508,4417
202101,28110,인천광역시,중구,30-34세,9940,5512,4428
202102,28110,인천광역시,중구,30-34세,9983,5553,4430
202103,28110,인천광역시,중구,30-34세,10027,5583,4444
202104,28110,인천광역시,중구,30-34세,10093,5628,4465
202105,28110,인천광역시,중구,30-34세,10206,5673,4533
202106,28110,인천광역시,중구,30-34세,10209,5705,4504
202007,28110,인천광역시,중구,35-39세,11587,6170,5417
202008,28110,인천광역시,중구,35-39세,11528,6141,5387
202009,28110,인천광역시,중구,35-39세,11435,6079,5356
202010,28110,인천광역시,중구,35-39세,11395,6055,5340
202011,28110,인천광역시,중구,35-39세,11380,6039,5341
202012,28110,인천광역시,중구,35-39세,11384,6064,5320
202101,28110,인천광역시,중구,35-39세,11293,6006,5287
202102,28110,인천광역시,중구,35-39세,11208,5961,5247
202103,28110,인천광역시,중구,35-39세,11152,5926,5226
202104,28110,인천광역시,중구,35-39세,11117,5911,5206
202105,28110,인천광역시,중구,35-39세,11081,5890,5191
202106,28110,인천광역시,중구,35-39세,11098,5898,5200
202007,28110,인천광역시,중구,40-44세,12075,6493,5582
202008,28110,인천광역시,중구,40-44세,12094,6492,5602
202009,28110,인천광역시,중구,40-44세,12160,6535,5625
202010,28110,인천광역시,중구,40-44세,12212,6556,5656
202011,28110,인천광역시,중구,40-44세,12231,6552,5679
202012,28110,인천광역시,중구,40-44세,12217,6537,5680
202101,28110,인천광역시,중구,40-44세,12252,6524,5728
202102,28110,인천광역시,중구,40-44세,12277,6547,5730
202103,28110,인천광역시,중구,40-44세,12252,6532,5720
202104,28110,인천광역시,중구,40-44세,12233,6534,5699
202105,28110,인천광역시,중구,40-44세,12264,6556,5708
202106,28110,인천광역시,중구,40-44세,12331,6584,5747
202007,28110,인천광역시,중구,45-49세,12344,6906,5438
202008,28110,인천광역시,중구,45-49세,12336,6887,5449
202009,28110,인천광역시,중구,45-49세,12323,6875,5448
202010,28110,인천광역시,중구,45-49세,12271,6838,5433
202011,28110,인천광역시,중구,45-49세,12310,6853,5457
202012,28110,인천광역시,중구,45-49세,12379,6907,5472
202101,28110,인천광역시,중구,45-49세,12349,6903,5446
202102,28110,인천광역시,중구,45-49세,12357,6897,5460
202103,28110,인천광역시,중구,45-49세,12293,6862,5431
202104,28110,인천광역시,중구,45-49세,12322,6879,5443
202105,28110,인천광역시,중구,45-49세,12321,6875,5446
202106,28110,인천광역시,중구,45-49세,12294,6857,5437
202007,28110,인천광역시,중구,50-54세,10576,5852,4724
202008,28110,인천광역시,중구,50-54세,10602,5877,4725
202009,28110,인천광역시,중구,50-54세,10652,5896,4756
202010,28110,인천광역시,중구,50-54세,10722,5968,4754
202011,28110,인천광역시,중구,50-54세,10784,6007,4777
202012,28110,인천광역시,중구,50-54세,10813,6028,4785
202101,28110,인천광역시,중구,50-54세,10901,6068,4833
202102,28110,인천광역시,중구,50-54세,10977,6135,4842
202103,28110,인천광역시,중구,50-54세,10905,6096,4809
202104,28110,인천광역시,중구,50-54세,10940,6127,4813
202105,28110,인천광역시,중구,50-54세,11086,6216,4870
202106,28110,인천광역시,중구,50-54세,11093,6217,4876
202007,28110,인천광역시,중구,55-59세,9616,5205,4411
202008,28110,인천광역시,중구,55-59세,9640,5219,4421
202009,28110,인천광역시,중구,55-59세,9639,5221,4418
202010,28110,인천광역시,중구,55-59세,9631,5202,4429
202011,28110,인천광역시,중구,55-59세,9615,5203,4412
202012,28110,인천광역시,중구,55-59세,9633,5233,4400
202101,28110,인천광역시,중구,55-59세,9580,5213,4367
202102,28110,인천광역시,중구,55-59세,9600,5216,4384
202103,28110,인천광역시,중구,55-59세,9618,5253,4365
202104,28110,인천광역시,중구,55-59세,9585,5232,4353
202105,28110,인천광역시,중구,55-59세,9568,5208,4360
202106,28110,인천광역시,중구,55-59세,9526,5195,4331
202007,28110,인천광역시,중구,60-64세,9023,4553,4470
202008,28110,인천광역시,중구,60-64세,9060,4584,4476
202009,28110,인천광역시,중구,60-64세,9108,4621,4487
202010,28110,인천광역시,중구,60-64세,9159,4663,4496
202011,28110,인천광역시,중구,60-64세,9200,4683,4517
202012,28110,인천광역시,중구,60-64세,9170,4668,4502
202101,28110,인천광역시,중구,60-64세,9221,4691,4530
202102,28110,인천광역시,중구,60-64세,9269,4710,4559
202103,28110,인천광역시,중구,60-64세,9227,4697,4530
202104,28110,인천광역시,중구,60-64세,9322,4737,4585
202105,28110,인천광역시,중구,60-64세,9397,4790,4607
202106,28110,인천광역시,중구,60-64세,9494,4843,4651
202007,28110,인천광역시,중구,65-69세,6521,3180,3341
202008,28110,인천광역시,중구,65-69세,6580,3209,3371
202009,28110,인천광역시,중구,65-69세,6595,3209,3386
202010,28110,인천광역시,중구,65-69세,6644,3234,3410
202011,28110,인천광역시,중구,65-69세,6696,3261,3435
202012,28110,인천광역시,중구,65-69세,6756,3287,3469
202101,28110,인천광역시,중구,65-69세,6810,3319,3491
202102,28110,인천광역시,중구,65-69세,6886,3372,3514
202103,28110,인천광역시,중구,65-69세,6928,3393,3535
202104,28110,인천광역시,중구,65-69세,7001,3431,3570
202105,28110,인천광역시,중구,65-69세,7060,3457,3603
202106,28110,인천광역시,중구,65-69세,7125,3495,3630
202007,28110,인천광역시,중구,70-74세,5265,2471,2794
202008,28110,인천광역시,중구,70-74세,5272,2483,2789
202009,28110,인천광역시,중구,70-74세,5296,2504,2792
202010,28110,인천광역시,중구,70-74세,5323,2506,2817
202011,28110,인천광역시,중구,70-74세,5352,2520,2832
202012,28110,인천광역시,중구,70-74세,5374,2533,2841
202101,28110,인천광역시,중구,70-74세,5407,2546,2861
202102,28110,인천광역시,중구,70-74세,5418,2548,2870
202103,28110,인천광역시,중구,70-74세,5314,2510,2804
202104,28110,인천광역시,중구,70-74세,5301,2505,2796
202105,28110,인천광역시,중구,70-74세,5286,2490,2796
202106,28110,인천광역시,중구,70-74세,5305,2495,2810
202007,28110,인천광역시,중구,75-79세,3940,1796,2144
202008,28110,인천광역시,중구,75-79세,3960,1809,2151
202009,28110,인천광역시,중구,75-79세,3978,1814,2164
202010,28110,인천광역시,중구,75-79세,3975,1821,2154
202011,28110,인천광역시,중구,75-79세,3962,1812,2150
202012,28110,인천광역시,중구,75-79세,3946,1800,2146
202101,28110,인천광역시,중구,75-79세,3953,1805,2148
202102,28110,인천광역시,중구,75-79세,3949,1802,2147
202103,28110,인천광역시,중구,75-79세,3913,1778,2135
202104,28110,인천광역시,중구,75-79세,3943,1784,2159
202105,28110,인천광역시,중구,75-79세,3979,1803,2176
202106,28110,인천광역시,중구,75-79세,3986,1808,2178
202007,28110,인천광역시,중구,80-84세,2388,947,1441
202008,28110,인천광역시,중구,80-84세,2394,943,1451
202009,28110,인천광역시,중구,80-84세,2409,950,1459
202010,28110,인천광역시,중구,80-84세,2420,955,1465
202011,28110,인천광역시,중구,80-84세,2438,964,1474
202012,28110,인천광역시,중구,80-84세,2458,975,1483
202101,28110,인천광역시,중구,80-84세,2482,996,1486
202102,28110,인천광역시,중구,80-84세,2513,1008,1505
202103,28110,인천광역시,중구,80-84세,2510,1009,1501
202104,28110,인천광역시,중구,80-84세,2500,1012,1488
202105,28110,인천광역시,중구,80-84세,2509,1016,1493
202106,28110,인천광역시,중구,80-84세,2523,1014,1509
202007,28110,인천광역시,중구,85-89세,1221,354,867
202008,28110,인천광역시,중구,85-89세,1255,363,892
202009,28110,인천광역시,중구,85-89세,1264,368,896
202010,28110,인천광역시,중구,85-89세,1290,372,918
202011,28110,인천광역시,중구,85-89세,1294,370,924
202012,28110,인천광역시,중구,85-89세,1304,373,931
202101,28110,인천광역시,중구,85-89세,1312,379,933
202102,28110,인천광역시,중구,85-89세,1308,380,928
202103,28110,인천광역시,중구,85-89세,1307,385,922
202104,28110,인천광역시,중구,85-89세,1322,390,932
202105,28110,인천광역시,중구,85-89세,1337,397,940
202106,28110,인천광역시,중구,85-89세,1343,401,942
202007,28110,인천광역시,중구,90-94세,468,109,359
202008,28110,인천광역시,중구,90-94세,468,110,358
202009,28110,인천광역시,중구,90-94세,473,114,359
202010,28110,인천광역시,중구,90-94세,459,113,346
202011,28110,인천광역시,중구,90-94세,469,112,357
202012,28110,인천광역시,중구,90-94세,471,112,359
202101,28110,인천광역시,중구,90-94세,480,112,368
202102,28110,인천광역시,중구,90-94세,487,117,370
202103,28110,인천광역시,중구,90-94세,478,107,371
202104,28110,인천광역시,중구,90-94세,482,106,376
202105,28110,인천광역시,중구,90-94세,474,102,372
202106,28110,인천광역시,중구,90-94세,481,105,376
202007,28110,인천광역시,중구,95-99세,143,40,103
202008,28110,인천광역시,중구,95-99세,144,41,103
202009,28110,인천광역시,중구,95-99세,144,39,105
202010,28110,인천광역시,중구,95-99세,143,37,106
202011,28110,인천광역시,중구,95-99세,139,38,101
202012,28110,인천광역시,중구,95-99세,141,40,101
202101,28110,인천광역시,중구,95-99세,146,41,105
202102,28110,인천광역시,중구,95-99세,147,41,106
202103,28110,인천광역시,중구,95-99세,134,38,96
202104,28110,인천광역시,중구,95-99세,142,38,104
202105,28110,인천광역시,중구,95-99세,139,38,101
202106,28110,인천광역시,중구,95-99세,141,38,103
202007,28110,인천광역시,중구,100+,80,26,54
202008,28110,인천광역시,중구,100+,78,25,53
202009,28110,인천광역시,중구,100+,77,25,52
202010,28110,인천광역시,중구,100+,78,26,52
202011,28110,인천광역시,중구,100+,79,26,53
202012,28110,인천광역시,중구,100+,81,26,55
202101,28110,인천광역시,중구,100+,82,27,55
202102,28110,인천광역시,중구,100+,83,27,56
202103,28110,인천광역시,중구,100+,23,7,16
202104,28110,인천광역시,중구,100+,22,7,15
202105,28110,인천광역시,중구,100+,23,7,16
202106,28110,인천광역시,중구,100+,23,7,16
202007,28140,인천광역시,동구,0-4세,1594,841,753
202008,28140,인천광역시,동구,0-4세,1567,825,742
202009,28140,인천광역시,동구,0-4세,1553,819,734
202010,28140,인천광역시,동구,0-4세,1531,805,726
202011,28140,인천광역시,동구,0-4세,1507,784,723
202012,28140,인천광역시,동구,0-4세,1472,756,716
202101,28140,인천광역시,동구,0-4세,1455,746,709
202102,28140,인천광역시,동구,0-4세,1442,743,699
202103,28140,인천광역시,동구,0-4세,1429,739,690
202104,28140,인천광역시,동구,0-4세,1421,728,693
202105,28140,인천광역시,동구,0-4세,1390,712,678
202106,28140,인천광역시,동구,0-4세,1372,702,670
202007,28140,인천광역시,동구,5-9세,2419,1275,1144
202008,28140,인천광역시,동구,5-9세,2374,1255,1119
202009,28140,인천광역시,동구,5-9세,2354,1248,1106
202010,28140,인천광역시,동구,5-9세,2328,1244,1084
202011,28140,인천광역시,동구,5-9세,2305,1239,1066
202012,28140,인천광역시,동구,5-9세,2270,1208,1062
202101,28140,인천광역시,동구,5-9세,2235,1180,1055
202102,28140,인천광역시,동구,5-9세,2207,1171,1036
202103,28140,인천광역시,동구,5-9세,2196,1158,1038
202104,28140,인천광역시,동구,5-9세,2185,1155,1030
202105,28140,인천광역시,동구,5-9세,2179,1146,1033
202106,28140,인천광역시,동구,5-9세,2178,1150,1028
202007,28140,인천광역시,동구,10-14세,2490,1292,1198
202008,28140,인천광역시,동구,10-14세,2481,1287,1194
202009,28140,인천광역시,동구,10-14세,2472,1276,1196
202010,28140,인천광역시,동구,10-14세,2485,1281,1204
202011,28140,인천광역시,동구,10-14세,2486,1286,1200
202012,28140,인천광역시,동구,10-14세,2465,1282,1183
202101,28140,인천광역시,동구,10-14세,2470,1286,1184
202102,28140,인천광역시,동구,10-14세,2483,1289,1194
202103,28140,인천광역시,동구,10-14세,2476,1283,1193
202104,28140,인천광역시,동구,10-14세,2479,1285,1194
202105,28140,인천광역시,동구,10-14세,2473,1284,1189
202106,28140,인천광역시,동구,10-14세,2470,1288,1182
202007,28140,인천광역시,동구,15-19세,2679,1374,1305
202008,28140,인천광역시,동구,15-19세,2654,1366,1288
202009,28140,인천광역시,동구,15-19세,2632,1356,1276
202010,28140,인천광역시,동구,15-19세,2622,1357,1265
202011,28140,인천광역시,동구,15-19세,2608,1345,1263
202012,28140,인천광역시,동구,15-19세,2564,1326,1238
202101,28140,인천광역시,동구,15-19세,2535,1311,1224
202102,28140,인천광역시,동구,15-19세,2513,1310,1203
202103,28140,인천광역시,동구,15-19세,2486,1303,1183
202104,28140,인천광역시,동구,15-19세,2490,1299,1191
202105,28140,인천광역시,동구,15-19세,2479,1291,1188
202106,28140,인천광역시,동구,15-19세,2460,1279,1181
202007,28140,인천광역시,동구,20-24세,3394,1813,1581
202008,28140,인천광역시,동구,20-24세,3376,1797,1579
202009,28140,인천광역시,동구,20-24세,3349,1786,1563
202010,28140,인천광역시,동구,20-24세,3338,1788,1550
202011,28140,인천광역시,동구,20-24세,3347,1792,1555
202012,28140,인천광역시,동구,20-24세,3326,1786,1540
202101,28140,인천광역시,동구,20-24세,3345,1798,1547
202102,28140,인천광역시,동구,20-24세,3314,1772,1542
202103,28140,인천광역시,동구,20-24세,3279,1761,1518
202104,28140,인천광역시,동구,20-24세,3256,1750,1506
202105,28140,인천광역시,동구,20-24세,3243,1744,1499
202106,28140,인천광역시,동구,20-24세,3224,1739,1485
202007,28140,인천광역시,동구,25-29세,3319,1838,1481
202008,28140,인천광역시,동구,25-29세,3323,1831,1492
202009,28140,인천광역시,동구,25-29세,3318,1822,1496
202010,28140,인천광역시,동구,25-29세,3308,1824,1484
202011,28140,인천광역시,동구,25-29세,3298,1827,1471
202012,28140,인천광역시,동구,25-29세,3314,1830,1484
202101,28140,인천광역시,동구,25-29세,3283,1805,1478
202102,28140,인천광역시,동구,25-29세,3266,1801,1465
202103,28140,인천광역시,동구,25-29세,3267,1795,1472
202104,28140,인천광역시,동구,25-29세,3264,1791,1473
202105,28140,인천광역시,동구,25-29세,3241,1778,1463
202106,28140,인천광역시,동구,25-29세,3229,1773,1456
202007,28140,인천광역시,동구,30-34세,3008,1628,1380
202008,28140,인천광역시,동구,30-34세,2964,1610,1354
202009,28140,인천광역시,동구,30-34세,2955,1595,1360
202010,28140,인천광역시,동구,30-34세,2921,1571,1350
202011,28140,인천광역시,동구,30-34세,2903,1561,1342
202012,28140,인천광역시,동구,30-34세,2890,1565,1325
202101,28140,인천광역시,동구,30-34세,2910,1589,1321
202102,28140,인천광역시,동구,30-34세,2901,1593,1308
202103,28140,인천광역시,동구,30-34세,2895,1585,1310
202104,28140,인천광역시,동구,30-34세,2897,1582,1315
202105,28140,인천광역시,동구,30-34세,2876,1570,1306
202106,28140,인천광역시,동구,30-34세,2889,1571,1318
202007,28140,인천광역시,동구,35-39세,4193,2207,1986
202008,28140,인천광역시,동구,35-39세,4148,2179,1969
202009,28140,인천광역시,동구,35-39세,4101,2160,1941
202010,28140,인천광역시,동구,35-39세,4067,2130,1937
202011,28140,인천광역시,동구,35-39세,4024,2110,1914
202012,28140,인천광역시,동구,35-39세,3973,2090,1883
202101,28140,인천광역시,동구,35-39세,3916,2064,1852
202102,28140,인천광역시,동구,35-39세,3871,2033,1838
202103,28140,인천광역시,동구,35-39세,3817,2010,1807
202104,28140,인천광역시,동구,35-39세,3781,1993,1788
202105,28140,인천광역시,동구,35-39세,3760,1998,1762
202106,28140,인천광역시,동구,35-39세,3741,1989,1752
202007,28140,인천광역시,동구,40-44세,4827,2652,2175
202008,28140,인천광역시,동구,40-44세,4814,2646,2168
202009,28140,인천광역시,동구,40-44세,4812,2628,2184
202010,28140,인천광역시,동구,40-44세,4784,2615,2169
202011,28140,인천광역시,동구,40-44세,4793,2625,2168
202012,28140,인천광역시,동구,40-44세,4725,2584,2141
202101,28140,인천광역시,동구,40-44세,4704,2565,2139
202102,28140,인천광역시,동구,40-44세,4710,2561,2149
202103,28140,인천광역시,동구,40-44세,4658,2535,2123
202104,28140,인천광역시,동구,40-44세,4655,2536,2119
202105,28140,인천광역시,동구,40-44세,4676,2523,2153
202106,28140,인천광역시,동구,40-44세,4689,2533,2156
202007,28140,인천광역시,동구,45-49세,5397,2870,2527
202008,28140,인천광역시,동구,45-49세,5380,2855,2525
202009,28140,인천광역시,동구,45-49세,5334,2834,2500
202010,28140,인천광역시,동구,45-49세,5310,2829,2481
202011,28140,인천광역시,동구,45-49세,5293,2821,2472
202012,28140,인천광역시,동구,45-49세,5268,2810,2458
202101,28140,인천광역시,동구,45-49세,5249,2805,2444
202102,28140,인천광역시,동구,45-49세,5228,2812,2416
202103,28140,인천광역시,동구,45-49세,5147,2772,2375
202104,28140,인천광역시,동구,45-49세,5131,2762,2369
202105,28140,인천광역시,동구,45-49세,5070,2731,2339
202106,28140,인천광역시,동구,45-49세,5032,2701,2331
202007,28140,인천광역시,동구,50-54세,4977,2691,2286
202008,28140,인천광역시,동구,50-54세,4969,2695,2274
202009,28140,인천광역시,동구,50-54세,4983,2710,2273
202010,28140,인천광역시,동구,50-54세,4995,2718,2277
202011,28140,인천광역시,동구,50-54세,4981,2702,2279
202012,28140,인천광역시,동구,50-54세,4984,2703,2281
202101,28140,인천광역시,동구,50-54세,5027,2725,2302
202102,28140,인천광역시,동구,50-54세,5017,2716,2301
202103,28140,인천광역시,동구,50-54세,4975,2689,2286
202104,28140,인천광역시,동구,50-54세,4983,2709,2274
202105,28140,인천광역시,동구,50-54세,4989,2713,2276
202106,28140,인천광역시,동구,50-54세,4993,2722,2271
202007,28140,인천광역시,동구,55-59세,5262,2734,2528
202008,28140,인천광역시,동구,55-59세,5225,2712,2513
202009,28140,인천광역시,동구,55-59세,5191,2697,2494
202010,28140,인천광역시,동구,55-59세,5159,2679,2480
202011,28140,인천광역시,동구,55-59세,5184,2712,2472
202012,28140,인천광역시,동구,55-59세,5187,2712,2475
202101,28140,인천광역시,동구,55-59세,5154,2701,2453
202102,28140,인천광역시,동구,55-59세,5124,2696,2428
202103,28140,인천광역시,동구,55-59세,5057,2661,2396
202104,28140,인천광역시,동구,55-59세,5007,2628,2379
202105,28140,인천광역시,동구,55-59세,4989,2614,2375
202106,28140,인천광역시,동구,55-59세,4935,2586,2349
202007,28140,인천광역시,동구,60-64세,5607,2748,2859
202008,28140,인천광역시,동구,60-64세,5623,2766,2857
202009,28140,인천광역시,동구,60-64세,5625,2760,2865
202010,28140,인천광역시,동구,60-64세,5623,2753,2870
202011,28140,인천광역시,동구,60-64세,5639,2752,2887
202012,28140,인천광역시,동구,60-64세,5651,2756,2895
202101,28140,인천광역시,동구,60-64세,5658,2759,2899
202102,28140,인천광역시,동구,60-64세,5699,2777,2922
202103,28140,인천광역시,동구,60-64세,5643,2756,2887
202104,28140,인천광역시,동구,60-64세,5640,2773,2867
202105,28140,인천광역시,동구,60-64세,5634,2787,2847
202106,28140,인천광역시,동구,60-64세,5666,2809,2857
202007,28140,인천광역시,동구,65-69세,4245,1996,2249
202008,28140,인천광역시,동구,65-69세,4271,2002,2269
202009,28140,인천광역시,동구,65-69세,4305,2025,2280
202010,28140,인천광역시,동구,65-69세,4332,2040,2292
202011,28140,인천광역시,동구,65-69세,4348,2050,2298
202012,28140,인천광역시,동구,65-69세,4377,2067,2310
202101,28140,인천광역시,동구,65-69세,4424,2105,2319
202102,28140,인천광역시,동구,65-69세,4453,2118,2335
202103,28140,인천광역시,동구,65-69세,4485,2125,2360
202104,28140,인천광역시,동구,65-69세,4533,2143,2390
202105,28140,인천광역시,동구,65-69세,4557,2150,2407
202106,28140,인천광역시,동구,65-69세,4594,2175,2419
202007,28140,인천광역시,동구,70-74세,3661,1657,2004
202008,28140,인천광역시,동구,70-74세,3673,1662,2011
202009,28140,인천광역시,동구,70-74세,3679,1653,2026
202010,28140,인천광역시,동구,70-74세,3697,1661,2036
202011,28140,인천광역시,동구,70-74세,3723,1671,2052
202012,28140,인천광역시,동구,70-74세,3735,1673,2062
202101,28140,인천광역시,동구,70-74세,3752,1671,2081
202102,28140,인천광역시,동구,70-74세,3764,1678,2086
202103,28140,인천광역시,동구,70-74세,3684,1649,2035
202104,28140,인천광역시,동구,70-74세,3680,1647,2033
202105,28140,인천광역시,동구,70-74세,3671,1637,2034
202106,28140,인천광역시,동구,70-74세,3652,1628,2024
202007,28140,인천광역시,동구,75-79세,2970,1269,1701
202008,28140,인천광역시,동구,75-79세,2970,1272,1698
202009,28140,인천광역시,동구,75-79세,2976,1290,1686
202010,28140,인천광역시,동구,75-79세,2978,1293,1685
202011,28140,인천광역시,동구,75-79세,2975,1294,1681
202012,28140,인천광역시,동구,75-79세,2975,1291,1684
202101,28140,인천광역시,동구,75-79세,2978,1290,1688
202102,28140,인천광역시,동구,75-79세,2947,1283,1664
202103,28140,인천광역시,동구,75-79세,2924,1269,1655
202104,28140,인천광역시,동구,75-79세,2917,1264,1653
202105,28140,인천광역시,동구,75-79세,2904,1252,1652
202106,28140,인천광역시,동구,75-79세,2917,1265,1652
202007,28140,인천광역시,동구,80-84세,1860,709,1151
202008,28140,인천광역시,동구,80-84세,1856,706,1150
202009,28140,인천광역시,동구,80-84세,1878,715,1163
202010,28140,인천광역시,동구,80-84세,1870,715,1155
202011,28140,인천광역시,동구,80-84세,1874,720,1154
202012,28140,인천광역시,동구,80-84세,1886,726,1160
202101,28140,인천광역시,동구,80-84세,1900,733,1167
202102,28140,인천광역시,동구,80-84세,1935,742,1193
202103,28140,인천광역시,동구,80-84세,1917,733,1184
202104,28140,인천광역시,동구,80-84세,1935,738,1197
202105,28140,인천광역시,동구,80-84세,1952,752,1200
202106,28140,인천광역시,동구,80-84세,1957,755,1202
202007,28140,인천광역시,동구,85-89세,908,253,655
202008,28140,인천광역시,동구,85-89세,921,259,662
202009,28140,인천광역시,동구,85-89세,928,262,666
202010,28140,인천광역시,동구,85-89세,939,265,674
202011,28140,인천광역시,동구,85-89세,947,266,681
202012,28140,인천광역시,동구,85-89세,960,277,683
202101,28140,인천광역시,동구,85-89세,975,283,692
202102,28140,인천광역시,동구,85-89세,986,287,699
202103,28140,인천광역시,동구,85-89세,964,273,691
202104,28140,인천광역시,동구,85-89세,972,272,700
202105,28140,인천광역시,동구,85-89세,991,279,712
202106,28140,인천광역시,동구,85-89세,986,274,712
202007,28140,인천광역시,동구,90-94세,334,85,249
202008,28140,인천광역시,동구,90-94세,337,84,253
202009,28140,인천광역시,동구,90-94세,346,84,262
202010,28140,인천광역시,동구,90-94세,346,85,261
202011,28140,인천광역시,동구,90-94세,344,85,259
202012,28140,인천광역시,동구,90-94세,350,85,265
202101,28140,인천광역시,동구,90-94세,348,85,263
202102,28140,인천광역시,동구,90-94세,353,85,268
202103,28140,인천광역시,동구,90-94세,343,78,265
202104,28140,인천광역시,동구,90-94세,337,78,259
202105,28140,인천광역시,동구,90-94세,337,79,258
202106,28140,인천광역시,동구,90-94세,338,77,261
202007,28140,인천광역시,동구,95-99세,92,24,68
202008,28140,인천광역시,동구,95-99세,94,24,70
202009,28140,인천광역시,동구,95-99세,93,24,69
202010,28140,인천광역시,동구,95-99세,96,25,71
202011,28140,인천광역시,동구,95-99세,95,25,70
202012,28140,인천광역시,동구,95-99세,97,25,72
202101,28140,인천광역시,동구,95-99세,93,25,68
202102,28140,인천광역시,동구,95-99세,93,25,68
202103,28140,인천광역시,동구,95-99세,79,18,61
202104,28140,인천광역시,동구,95-99세,82,18,64
202105,28140,인천광역시,동구,95-99세,81,17,64
202106,28140,인천광역시,동구,95-99세,76,15,61
202007,28140,인천광역시,동구,100+,73,23,50
202008,28140,인천광역시,동구,100+,73,23,50
202009,28140,인천광역시,동구,100+,73,23,50
202010,28140,인천광역시,동구,100+,73,23,50
202011,28140,인천광역시,동구,100+,73,23,50
202012,28140,인천광역시,동구,100+,73,23,50
202101,28140,인천광역시,동구,100+,74,23,51
202102,28140,인천광역시,동구,100+,75,23,52
202103,28140,인천광역시,동구,100+,34,8,26
202104,28140,인천광역시,동구,100+,35,8,27
202105,28140,인천광역시,동구,100+,38,9,29
202106,28140,인천광역시,동구,100+,38,9,29
202007,28177,인천광역시,미추홀구,0-4세,12274,6258,6016
202008,28177,인천광역시,미추홀구,0-4세,12136,6191,5945
202009,28177,인천광역시,미추홀구,0-4세,11973,6111,5862
202010,28177,인천광역시,미추홀구,0-4세,11821,6032,5789
202011,28177,인천광역시,미추홀구,0-4세,11727,5981,5746
202012,28177,인천광역시,미추홀구,0-4세,11821,6003,5818
202101,28177,인천광역시,미추홀구,0-4세,11721,5972,5749
202102,28177,인천광역시,미추홀구,0-4세,11671,5958,5713
202103,28177,인천광역시,미추홀구,0-4세,11637,5964,5673
202104,28177,인천광역시,미추홀구,0-4세,11484,5870,5614
202105,28177,인천광역시,미추홀구,0-4세,11437,5848,5589
202106,28177,인천광역시,미추홀구,0-4세,11393,5812,5581
202007,28177,인천광역시,미추홀구,5-9세,15634,8009,7625
202008,28177,인천광역시,미추홀구,5-9세,15495,7924,7571
202009,28177,인천광역시,미추홀구,5-9세,15471,7930,7541
202010,28177,인천광역시,미추홀구,5-9세,15323,7850,7473
202011,28177,인천광역시,미추홀구,5-9세,15261,7826,7435
202012,28177,인천광역시,미추홀구,5-9세,15372,7909,7463
202101,28177,인천광역시,미추홀구,5-9세,15379,7892,7487
202102,28177,인천광역시,미추홀구,5-9세,15404,7904,7500
202103,28177,인천광역시,미추홀구,5-9세,15358,7866,7492
202104,28177,인천광역시,미추홀구,5-9세,15297,7831,7466
202105,28177,인천광역시,미추홀구,5-9세,15287,7809,7478
202106,28177,인천광역시,미추홀구,5-9세,15276,7811,7465
202007,28177,인천광역시,미추홀구,10-14세,14988,7754,7234
202008,28177,인천광역시,미추홀구,10-14세,14905,7712,7193
202009,28177,인천광역시,미추홀구,10-14세,14864,7692,7172
202010,28177,인천광역시,미추홀구,10-14세,14904,7722,7182
202011,28177,인천광역시,미추홀구,10-14세,14936,7718,7218
202012,28177,인천광역시,미추홀구,10-14세,15001,7744,7257
202101,28177,인천광역시,미추홀구,10-14세,15093,7816,7277
202102,28177,인천광역시,미추홀구,10-14세,15105,7812,7293
202103,28177,인천광역시,미추홀구,10-14세,15151,7814,7337
202104,28177,인천광역시,미추홀구,10-14세,15215,7872,7343
202105,28177,인천광역시,미추홀구,10-14세,15222,7882,7340
202106,28177,인천광역시,미추홀구,10-14세,15285,7910,7375
202007,28177,인천광역시,미추홀구,15-19세,17218,8848,8370
202008,28177,인천광역시,미추홀구,15-19세,17094,8761,8333
202009,28177,인천광역시,미추홀구,15-19세,16938,8678,8260
202010,28177,인천광역시,미추홀구,15-19세,16742,8566,8176
202011,28177,인천광역시,미추홀구,15-19세,16666,8535,8131
202012,28177,인천광역시,미추홀구,15-19세,16657,8540,8117
202101,28177,인천광역시,미추홀구,15-19세,16547,8490,8057
202102,28177,인천광역시,미추홀구,15-19세,16516,8480,8036
202103,28177,인천광역시,미추홀구,15-19세,16466,8459,8007
202104,28177,인천광역시,미추홀구,15-19세,16369,8405,7964
202105,28177,인천광역시,미추홀구,15-19세,16320,8387,7933
202106,28177,인천광역시,미추홀구,15-19세,16259,8353,7906
202007,28177,인천광역시,미추홀구,20-24세,26558,13879,12679
202008,28177,인천광역시,미추홀구,20-24세,26467,13821,12646
202009,28177,인천광역시,미추홀구,20-24세,26440,13790,12650
202010,28177,인천광역시,미추홀구,20-24세,26342,13732,12610
202011,28177,인천광역시,미추홀구,20-24세,26236,13675,12561
202012,28177,인천광역시,미추홀구,20-24세,26227,13636,12591
202101,28177,인천광역시,미추홀구,20-24세,26134,13516,12618
202102,28177,인천광역시,미추홀구,20-24세,26122,13546,12576
202103,28177,인천광역시,미추홀구,20-24세,25911,13435,12476
202104,28177,인천광역시,미추홀구,20-24세,25796,13360,12436
202105,28177,인천광역시,미추홀구,20-24세,25719,13288,12431
202106,28177,인천광역시,미추홀구,20-24세,25655,13253,12402
202007,28177,인천광역시,미추홀구,25-29세,30706,16420,14286
202008,28177,인천광역시,미추홀구,25-29세,30728,16449,14279
202009,28177,인천광역시,미추홀구,25-29세,30678,16433,14245
202010,28177,인천광역시,미추홀구,25-29세,30658,16403,14255
202011,28177,인천광역시,미추홀구,25-29세,30737,16441,14296
202012,28177,인천광역시,미추홀구,25-29세,31104,16626,14478
202101,28177,인천광역시,미추홀구,25-29세,31032,16581,14451
202102,28177,인천광역시,미추홀구,25-29세,30943,16478,14465
202103,28177,인천광역시,미추홀구,25-29세,31018,16558,14460
202104,28177,인천광역시,미추홀구,25-29세,31096,16646,14450
202105,28177,인천광역시,미추홀구,25-29세,31105,16657,14448
202106,28177,인천광역시,미추홀구,25-29세,31116,16634,14482
202007,28177,인천광역시,미추홀구,30-34세,25980,14053,11927
202008,28177,인천광역시,미추홀구,30-34세,25822,13972,11850
202009,28177,인천광역시,미추홀구,30-34세,25770,13979,11791
202010,28177,인천광역시,미추홀구,30-34세,25720,13979,11741
202011,28177,인천광역시,미추홀구,30-34세,25719,13964,11755
202012,28177,인천광역시,미추홀구,30-34세,25940,14078,11862
202101,28177,인천광역시,미추홀구,30-34세,26042,14123,11919
202102,28177,인천광역시,미추홀구,30-34세,26029,14122,11907
202103,28177,인천광역시,미추홀구,30-34세,26096,14131,11965
202104,28177,인천광역시,미추홀구,30-34세,26147,14113,12034
202105,28177,인천광역시,미추홀구,30-34세,26261,14121,12140
202106,28177,인천광역시,미추홀구,30-34세,26402,14216,12186
202007,28177,인천광역시,미추홀구,35-39세,30327,16166,14161
202008,28177,인천광역시,미추홀구,35-39세,30037,15999,14038
202009,28177,인천광역시,미추홀구,35-39세,29797,15874,13923
202010,28177,인천광역시,미추홀구,35-39세,29605,15778,13827
202011,28177,인천광역시,미추홀구,35-39세,29472,15717,13755
202012,28177,인천광역시,미추홀구,35-39세,29757,15847,13910
202101,28177,인천광역시,미추홀구,35-39세,29741,15886,13855
202102,28177,인천광역시,미추홀구,35-39세,29654,15861,13793
202103,28177,인천광역시,미추홀구,35-39세,29485,15761,13724
202104,28177,인천광역시,미추홀구,35-39세,29264,15636,13628
202105,28177,인천광역시,미추홀구,35-39세,29157,15631,13526
202106,28177,인천광역시,미추홀구,35-39세,29037,15560,13477
202007,28177,인천광역시,미추홀구,40-44세,29948,15954,13994
202008,28177,인천광역시,미추홀구,40-44세,29905,15919,13986
202009,28177,인천광역시,미추홀구,40-44세,29898,15872,14026
202010,28177,인천광역시,미추홀구,40-44세,29891,15874,14017
202011,28177,인천광역시,미추홀구,40-44세,29963,15957,14006
202012,28177,인천광역시,미추홀구,40-44세,30133,16071,14062
202101,28177,인천광역시,미추홀구,40-44세,30286,16136,14150
202102,28177,인천광역시,미추홀구,40-44세,30369,16166,14203
202103,28177,인천광역시,미추홀구,40-44세,30326,16163,14163
202104,28177,인천광역시,미추홀구,40-44세,30341,16167,14174
202105,28177,인천광역시,미추홀구,40-44세,30453,16210,14243
202106,28177,인천광역시,미추홀구,40-44세,30759,16395,14364
202007,28177,인천광역시,미추홀구,45-49세,33840,17708,16132
202008,28177,인천광역시,미추홀구,45-49세,33676,17675,16001
202009,28177,인천광역시,미추홀구,45-49세,33486,17594,15892
202010,28177,인천광역시,미추홀구,45-49세,33324,17537,15787
202011,28177,인천광역시,미추홀구,45-49세,33167,17453,15714
202012,28177,인천광역시,미추홀구,45-49세,33274,17522,15752
202101,28177,인천광역시,미추홀구,45-49세,33253,17494,15759
202102,28177,인천광역시,미추홀구,45-49세,33209,17483,15726
202103,28177,인천광역시,미추홀구,45-49세,33018,17412,15606
202104,28177,인천광역시,미추홀구,45-49세,32973,17350,15623
202105,28177,인천광역시,미추홀구,45-49세,32732,17218,15514
202106,28177,인천광역시,미추홀구,45-49세,32552,17123,15429
202007,28177,인천광역시,미추홀구,50-54세,33344,16970,16374
202008,28177,인천광역시,미추홀구,50-54세,33320,16967,16353
202009,28177,인천광역시,미추홀구,50-54세,33293,16940,16353
202010,28177,인천광역시,미추홀구,50-54세,33336,16954,16382
202011,28177,인천광역시,미추홀구,50-54세,33352,16972,16380
202012,28177,인천광역시,미추홀구,50-54세,33377,16979,16398
202101,28177,인천광역시,미추홀구,50-54세,33521,17053,16468
202102,28177,인천광역시,미추홀구,50-54세,33575,17072,16503
202103,28177,인천광역시,미추홀구,50-54세,33430,17051,16379
202104,28177,인천광역시,미추홀구,50-54세,33567,17116,16451
202105,28177,인천광역시,미추홀구,50-54세,33767,17216,16551
202106,28177,인천광역시,미추홀구,50-54세,33901,17269,16632
202007,28177,인천광역시,미추홀구,55-59세,34381,17024,17357
202008,28177,인천광역시,미추홀구,55-59세,34227,16935,17292
202009,28177,인천광역시,미추홀구,55-59세,34070,16873,17197
202010,28177,인천광역시,미추홀구,55-59세,33854,16789,17065
202011,28177,인천광역시,미추홀구,55-59세,33733,16716,17017
202012,28177,인천광역시,미추홀구,55-59세,33810,16739,17071
202101,28177,인천광역시,미추홀구,55-59세,33606,16670,16936
202102,28177,인천광역시,미추홀구,55-59세,33546,16650,16896
202103,28177,인천광역시,미추홀구,55-59세,33367,16573,16794
202104,28177,인천광역시,미추홀구,55-59세,33173,16491,16682
202105,28177,인천광역시,미추홀구,55-59세,33065,16463,16602
202106,28177,인천광역시,미추홀구,55-59세,32880,16382,16498
202007,28177,인천광역시,미추홀구,60-64세,32349,15648,16701
202008,28177,인천광역시,미추홀구,60-64세,32397,15681,16716
202009,28177,인천광역시,미추홀구,60-64세,32434,15700,16734
202010,28177,인천광역시,미추홀구,60-64세,32588,15772,16816
202011,28177,인천광역시,미추홀구,60-64세,32661,15792,16869
202012,28177,인천광역시,미추홀구,60-64세,32796,15865,16931
202101,28177,인천광역시,미추홀구,60-64세,32963,15947,17016
202102,28177,인천광역시,미추홀구,60-64세,33121,16037,17084
202103,28177,인천광역시,미추홀구,60-64세,33123,16025,17098
202104,28177,인천광역시,미추홀구,60-64세,33288,16130,17158
202105,28177,인천광역시,미추홀구,60-64세,33398,16164,17234
202106,28177,인천광역시,미추홀구,60-64세,33633,16256,17377
202007,28177,인천광역시,미추홀구,65-69세,22144,10485,11659
202008,28177,인천광역시,미추홀구,65-69세,22276,10527,11749
202009,28177,인천광역시,미추홀구,65-69세,22454,10637,11817
202010,28177,인천광역시,미추홀구,65-69세,22487,10638,11849
202011,28177,인천광역시,미추홀구,65-69세,22613,10696,11917
202012,28177,인천광역시,미추홀구,65-69세,22833,10793,12040
202101,28177,인천광역시,미추홀구,65-69세,23074,10881,12193
202102,28177,인천광역시,미추홀구,65-69세,23264,10965,12299
202103,28177,인천광역시,미추홀구,65-69세,23474,11064,12410
202104,28177,인천광역시,미추홀구,65-69세,23618,11108,12510
202105,28177,인천광역시,미추홀구,65-69세,23820,11207,12613
202106,28177,인천광역시,미추홀구,65-69세,23919,11287,12632
202007,28177,인천광역시,미추홀구,70-74세,17587,8161,9426
202008,28177,인천광역시,미추홀구,70-74세,17542,8154,9388
202009,28177,인천광역시,미추홀구,70-74세,17593,8163,9430
202010,28177,인천광역시,미추홀구,70-74세,17675,8200,9475
202011,28177,인천광역시,미추홀구,70-74세,17707,8220,9487
202012,28177,인천광역시,미추홀구,70-74세,17797,8278,9519
202101,28177,인천광역시,미추홀구,70-74세,17923,8361,9562
202102,28177,인천광역시,미추홀구,70-74세,18007,8402,9605
202103,28177,인천광역시,미추홀구,70-74세,17857,8348,9509
202104,28177,인천광역시,미추홀구,70-74세,17786,8297,9489
202105,28177,인천광역시,미추홀구,70-74세,17780,8296,9484
202106,28177,인천광역시,미추홀구,70-74세,17792,8285,9507
202007,28177,인천광역시,미추홀구,75-79세,13577,5944,7633
202008,28177,인천광역시,미추홀구,75-79세,13607,5953,7654
202009,28177,인천광역시,미추홀구,75-79세,13533,5909,7624
202010,28177,인천광역시,미추홀구,75-79세,13494,5888,7606
202011,28177,인천광역시,미추홀구,75-79세,13501,5893,7608
202012,28177,인천광역시,미추홀구,75-79세,13460,5873,7587
202101,28177,인천광역시,미추홀구,75-79세,13428,5837,7591
202102,28177,인천광역시,미추홀구,75-79세,13377,5815,7562
202103,28177,인천광역시,미추홀구,75-79세,13371,5829,7542
202104,28177,인천광역시,미추홀구,75-79세,13379,5832,7547
202105,28177,인천광역시,미추홀구,75-79세,13412,5864,7548
202106,28177,인천광역시,미추홀구,75-79세,13381,5864,7517
202007,28177,인천광역시,미추홀구,80-84세,8499,3307,5192
202008,28177,인천광역시,미추홀구,80-84세,8517,3318,5199
202009,28177,인천광역시,미추홀구,80-84세,8548,3328,5220
202010,28177,인천광역시,미추홀구,80-84세,8592,3352,5240
202011,28177,인천광역시,미추홀구,80-84세,8624,3362,5262
202012,28177,인천광역시,미추홀구,80-84세,8607,3351,5256
202101,28177,인천광역시,미추홀구,80-84세,8650,3389,5261
202102,28177,인천광역시,미추홀구,80-84세,8720,3423,5297
202103,28177,인천광역시,미추홀구,80-84세,8714,3425,5289
202104,28177,인천광역시,미추홀구,80-84세,8773,3455,5318
202105,28177,인천광역시,미추홀구,80-84세,8826,3477,5349
202106,28177,인천광역시,미추홀구,80-84세,8912,3502,5410
202007,28177,인천광역시,미추홀구,85-89세,4021,1193,2828
202008,28177,인천광역시,미추홀구,85-89세,4058,1210,2848
202009,28177,인천광역시,미추홀구,85-89세,4099,1229,2870
202010,28177,인천광역시,미추홀구,85-89세,4140,1248,2892
202011,28177,인천광역시,미추홀구,85-89세,4144,1245,2899
202012,28177,인천광역시,미추홀구,85-89세,4219,1274,2945
202101,28177,인천광역시,미추홀구,85-89세,4262,1296,2966
202102,28177,인천광역시,미추홀구,85-89세,4306,1308,2998
202103,28177,인천광역시,미추홀구,85-89세,4314,1307,3007
202104,28177,인천광역시,미추홀구,85-89세,4367,1337,3030
202105,28177,인천광역시,미추홀구,85-89세,4401,1348,3053
202106,28177,인천광역시,미추홀구,85-89세,4403,1352,3051
202007,28177,인천광역시,미추홀구,90-94세,1561,354,1207
202008,28177,인천광역시,미추홀구,90-94세,1575,357,1218
202009,28177,인천광역시,미추홀구,90-94세,1586,368,1218
202010,28177,인천광역시,미추홀구,90-94세,1587,364,1223
202011,28177,인천광역시,미추홀구,90-94세,1590,369,1221
202012,28177,인천광역시,미추홀구,90-94세,1579,377,1202
202101,28177,인천광역시,미추홀구,90-94세,1601,380,1221
202102,28177,인천광역시,미추홀구,90-94세,1607,383,1224
202103,28177,인천광역시,미추홀구,90-94세,1585,373,1212
202104,28177,인천광역시,미추홀구,90-94세,1599,375,1224
202105,28177,인천광역시,미추홀구,90-94세,1595,374,1221
202106,28177,인천광역시,미추홀구,90-94세,1579,372,1207
202007,28177,인천광역시,미추홀구,95-99세,383,89,294
202008,28177,인천광역시,미추홀구,95-99세,398,92,306
202009,28177,인천광역시,미추홀구,95-99세,396,88,308
202010,28177,인천광역시,미추홀구,95-99세,400,93,307
202011,28177,인천광역시,미추홀구,95-99세,403,90,313
202012,28177,인천광역시,미추홀구,95-99세,402,86,316
202101,28177,인천광역시,미추홀구,95-99세,410,87,323
202102,28177,인천광역시,미추홀구,95-99세,404,89,315
202103,28177,인천광역시,미추홀구,95-99세,388,81,307
202104,28177,인천광역시,미추홀구,95-99세,378,79,299
202105,28177,인천광역시,미추홀구,95-99세,391,79,312
202106,28177,인천광역시,미추홀구,95-99세,392,79,313
202007,28177,인천광역시,미추홀구,100+,179,48,131
202008,28177,인천광역시,미추홀구,100+,178,46,132
202009,28177,인천광역시,미추홀구,100+,179,45,134
202010,28177,인천광역시,미추홀구,100+,179,45,134
202011,28177,인천광역시,미추홀구,100+,180,47,133
202012,28177,인천광역시,미추홀구,100+,177,47,130
202101,28177,인천광역시,미추홀구,100+,177,47,130
202102,28177,인천광역시,미추홀구,100+,176,48,128
202103,28177,인천광역시,미추홀구,100+,86,25,61
202104,28177,인천광역시,미추홀구,100+,89,25,64
202105,28177,인천광역시,미추홀구,100+,88,25,63
202106,28177,인천광역시,미추홀구,100+,92,27,65
202007,28185,인천광역시,연수구,0-4세,15822,8012,7810
202008,28185,인천광역시,연수구,0-4세,15968,8076,7892
202009,28185,인천광역시,연수구,0-4세,16075,8146,7929
202010,28185,인천광역시,연수구,0-4세,16077,8135,7942
202011,28185,인천광역시,연수구,0-4세,16173,8190,7983
202012,28185,인천광역시,연수구,0-4세,16232,8253,7979
202101,28185,인천광역시,연수구,0-4세,16148,8205,7943
202102,28185,인천광역시,연수구,0-4세,16134,8237,7897
202103,28185,인천광역시,연수구,0-4세,16072,8232,7840
202104,28185,인천광역시,연수구,0-4세,16024,8244,7780
202105,28185,인천광역시,연수구,0-4세,15876,8169,7707
202106,28185,인천광역시,연수구,0-4세,15783,8120,7663
202007,28185,인천광역시,연수구,5-9세,21322,10948,10374
202008,28185,인천광역시,연수구,5-9세,21682,11125,10557
202009,28185,인천광역시,연수구,5-9세,21830,11178,10652
202010,28185,인천광역시,연수구,5-9세,21966,11226,10740
202011,28185,인천광역시,연수구,5-9세,22065,11270,10795
202012,28185,인천광역시,연수구,5-9세,22183,11301,10882
202101,28185,인천광역시,연수구,5-9세,22276,11381,10895
202102,28185,인천광역시,연수구,5-9세,22445,11433,11012
202103,28185,인천광역시,연수구,5-9세,22439,11433,11006
202104,28185,인천광역시,연수구,5-9세,22425,11403,11022
202105,28185,인천광역시,연수구,5-9세,22416,11405,11011
202106,28185,인천광역시,연수구,5-9세,22407,11390,11017
202007,28185,인천광역시,연수구,10-14세,20933,10657,10276
202008,28185,인천광역시,연수구,10-14세,21185,10792,10393
202009,28185,인천광역시,연수구,10-14세,21344,10909,10435
202010,28185,인천광역시,연수구,10-14세,21500,11022,10478
202011,28185,인천광역시,연수구,10-14세,21720,11161,10559
202012,28185,인천광역시,연수구,10-14세,21845,11223,10622
202101,28185,인천광역시,연수구,10-14세,21989,11302,10687
202102,28185,인천광역시,연수구,10-14세,22144,11401,10743
202103,28185,인천광역시,연수구,10-14세,22201,11441,10760
202104,28185,인천광역시,연수구,10-14세,22272,11478,10794
202105,28185,인천광역시,연수구,10-14세,22372,11520,10852
202106,28185,인천광역시,연수구,10-14세,22421,11554,10867
202007,28185,인천광역시,연수구,15-19세,20692,10710,9982
202008,28185,인천광역시,연수구,15-19세,20762,10757,10005
202009,28185,인천광역시,연수구,15-19세,20778,10726,10052
202010,28185,인천광역시,연수구,15-19세,20969,10799,10170
202011,28185,인천광역시,연수구,15-19세,20955,10769,10186
202012,28185,인천광역시,연수구,15-19세,20867,10720,10147
202101,28185,인천광역시,연수구,15-19세,20778,10659,10119
202102,28185,인천광역시,연수구,15-19세,20713,10595,10118
202103,28185,인천광역시,연수구,15-19세,20907,10704,10203
202104,28185,인천광역시,연수구,15-19세,20856,10672,10184
202105,28185,인천광역시,연수구,15-19세,20767,10617,10150
202106,28185,인천광역시,연수구,15-19세,20666,10554,10112
202007,28185,인천광역시,연수구,20-24세,24582,12713,11869
202008,28185,인천광역시,연수구,20-24세,24691,12785,11906
202009,28185,인천광역시,연수구,20-24세,24916,12910,12006
202010,28185,인천광역시,연수구,20-24세,25282,13083,12199
202011,28185,인천광역시,연수구,20-24세,25344,13126,12218
202012,28185,인천광역시,연수구,20-24세,25248,13098,12150
202101,28185,인천광역시,연수구,20-24세,25154,13043,12111
202102,28185,인천광역시,연수구,20-24세,25016,12983,12033
202103,28185,인천광역시,연수구,20-24세,25251,13102,12149
202104,28185,인천광역시,연수구,20-24세,25229,13114,12115
202105,28185,인천광역시,연수구,20-24세,25213,13091,12122
202106,28185,인천광역시,연수구,20-24세,25098,13029,12069
202007,28185,인천광역시,연수구,25-29세,26269,13624,12645
202008,28185,인천광역시,연수구,25-29세,26402,13694,12708
202009,28185,인천광역시,연수구,25-29세,26617,13779,12838
202010,28185,인천광역시,연수구,25-29세,26752,13862,12890
202011,28185,인천광역시,연수구,25-29세,26916,13910,13006
202012,28185,인천광역시,연수구,25-29세,27114,14026,13088
202101,28185,인천광역시,연수구,25-29세,27108,14026,13082
202102,28185,인천광역시,연수구,25-29세,27045,13997,13048
202103,28185,인천광역시,연수구,25-29세,27103,14049,13054
202104,28185,인천광역시,연수구,25-29세,27025,13993,13032
202105,28185,인천광역시,연수구,25-29세,26950,13983,12967
202106,28185,인천광역시,연수구,25-29세,26865,13959,12906
202007,28185,인천광역시,연수구,30-34세,24762,12382,12380
202008,28185,인천광역시,연수구,30-34세,25068,12497,12571
202009,28185,인천광역시,연수구,30-34세,25287,12606,12681
202010,28185,인천광역시,연수구,30-34세,25412,12667,12745
202011,28185,인천광역시,연수구,30-34세,25631,12800,12831
202012,28185,인천광역시,연수구,30-34세,25738,12800,12938
202101,28185,인천광역시,연수구,30-34세,25832,12797,13035
202102,28185,인천광역시,연수구,30-34세,25887,12823,13064
202103,28185,인천광역시,연수구,30-34세,25972,12863,13109
202104,28185,인천광역시,연수구,30-34세,26020,12892,13128
202105,28185,인천광역시,연수구,30-34세,26031,12934,13097
202106,28185,인천광역시,연수구,30-34세,26001,12896,13105
202007,28185,인천광역시,연수구,35-39세,30906,15109,15797
202008,28185,인천광역시,연수구,35-39세,31384,15343,16041
202009,28185,인천광역시,연수구,35-39세,31574,15446,16128
202010,28185,인천광역시,연수구,35-39세,31716,15503,16213
202011,28185,인천광역시,연수구,35-39세,32000,15634,16366
202012,28185,인천광역시,연수구,35-39세,32197,15746,16451
202101,28185,인천광역시,연수구,35-39세,32169,15742,16427
202102,28185,인천광역시,연수구,35-39세,32120,15704,16416
202103,28185,인천광역시,연수구,35-39세,32038,15673,16365
202104,28185,인천광역시,연수구,35-39세,31954,15648,16306
202105,28185,인천광역시,연수구,35-39세,31828,15542,16286
202106,28185,인천광역시,연수구,35-39세,31664,15462,16202
202007,28185,인천광역시,연수구,40-44세,31522,15628,15894
202008,28185,인천광역시,연수구,40-44세,31945,15838,16107
202009,28185,인천광역시,연수구,40-44세,32391,16043,16348
202010,28185,인천광역시,연수구,40-44세,32702,16218,16484
202011,28185,인천광역시,연수구,40-44세,32963,16357,16606
202012,28185,인천광역시,연수구,40-44세,33041,16371,16670
202101,28185,인천광역시,연수구,40-44세,33249,16464,16785
202102,28185,인천광역시,연수구,40-44세,33601,16638,16963
202103,28185,인천광역시,연수구,40-44세,33639,16641,16998
202104,28185,인천광역시,연수구,40-44세,33749,16714,17035
202105,28185,인천광역시,연수구,40-44세,33905,16793,17112
202106,28185,인천광역시,연수구,40-44세,34111,16881,17230
202007,28185,인천광역시,연수구,45-49세,34798,17008,17790
202008,28185,인천광역시,연수구,45-49세,35010,17154,17856
202009,28185,인천광역시,연수구,45-49세,35084,17223,17861
202010,28185,인천광역시,연수구,45-49세,35139,17220,17919
202011,28185,인천광역시,연수구,45-49세,35300,17303,17997
202012,28185,인천광역시,연수구,45-49세,35444,17408,18036
202101,28185,인천광역시,연수구,45-49세,35435,17416,18019
202102,28185,인천광역시,연수구,45-49세,35438,17414,18024
202103,28185,인천광역시,연수구,45-49세,35355,17377,17978
202104,28185,인천광역시,연수구,45-49세,35274,17312,17962
202105,28185,인천광역시,연수구,45-49세,35108,17224,17884
202106,28185,인천광역시,연수구,45-49세,34986,17144,17842
202007,28185,인천광역시,연수구,50-54세,32280,15773,16507
202008,28185,인천광역시,연수구,50-54세,32615,15917,16698
202009,28185,인천광역시,연수구,50-54세,32813,16005,16808
202010,28185,인천광역시,연수구,50-54세,33040,16126,16914
202011,28185,인천광역시,연수구,50-54세,33160,16179,16981
202012,28185,인천광역시,연수구,50-54세,33107,16160,16947
202101,28185,인천광역시,연수구,50-54세,33329,16267,17062
202102,28185,인천광역시,연수구,50-54세,33456,16345,17111
202103,28185,인천광역시,연수구,50-54세,33465,16374,17091
202104,28185,인천광역시,연수구,50-54세,33590,16443,17147
202105,28185,인천광역시,연수구,50-54세,33725,16504,17221
202106,28185,인천광역시,연수구,50-54세,33853,16578,17275
202007,28185,인천광역시,연수구,55-59세,30665,15381,15284
202008,28185,인천광역시,연수구,55-59세,30817,15465,15352
202009,28185,인천광역시,연수구,55-59세,30983,15545,15438
202010,28185,인천광역시,연수구,55-59세,31098,15588,15510
202011,28185,인천광역시,연수구,55-59세,31227,15638,15589
202012,28185,인천광역시,연수구,55-59세,31362,15669,15693
202101,28185,인천광역시,연수구,55-59세,31273,15593,15680
202102,28185,인천광역시,연수구,55-59세,31251,15572,15679
202103,28185,인천광역시,연수구,55-59세,31259,15541,15718
202104,28185,인천광역시,연수구,55-59세,31156,15501,15655
202105,28185,인천광역시,연수구,55-59세,31110,15452,15658
202106,28185,인천광역시,연수구,55-59세,30931,15348,15583
202007,28185,인천광역시,연수구,60-64세,23356,12130,11226
202008,28185,인천광역시,연수구,60-64세,23738,12307,11431
202009,28185,인천광역시,연수구,60-64세,24068,12465,11603
202010,28185,인천광역시,연수구,60-64세,24327,12602,11725
202011,28185,인천광역시,연수구,60-64세,24645,12751,11894
202012,28185,인천광역시,연수구,60-64세,24882,12872,12010
202101,28185,인천광역시,연수구,60-64세,25134,12998,12136
202102,28185,인천광역시,연수구,60-64세,25396,13123,12273
202103,28185,인천광역시,연수구,60-64세,25673,13260,12413
202104,28185,인천광역시,연수구,60-64세,25896,13350,12546
202105,28185,인천광역시,연수구,60-64세,26095,13493,12602
202106,28185,인천광역시,연수구,60-64세,26310,13591,12719
202007,28185,인천광역시,연수구,65-69세,12866,6519,6347
202008,28185,인천광역시,연수구,65-69세,13098,6655,6443
202009,28185,인천광역시,연수구,65-69세,13353,6791,6562
202010,28185,인천광역시,연수구,65-69세,13540,6871,6669
202011,28185,인천광역시,연수구,65-69세,13718,6956,6762
202012,28185,인천광역시,연수구,65-69세,13893,7041,6852
202101,28185,인천광역시,연수구,65-69세,14134,7175,6959
202102,28185,인천광역시,연수구,65-69세,14356,7296,7060
202103,28185,인천광역시,연수구,65-69세,14556,7388,7168
202104,28185,인천광역시,연수구,65-69세,14726,7484,7242
202105,28185,인천광역시,연수구,65-69세,14906,7561,7345
202106,28185,인천광역시,연수구,65-69세,15032,7641,7391
202007,28185,인천광역시,연수구,70-74세,8745,4148,4597
202008,28185,인천광역시,연수구,70-74세,8796,4171,4625
202009,28185,인천광역시,연수구,70-74세,8872,4213,4659
202010,28185,인천광역시,연수구,70-74세,8936,4261,4675
202011,28185,인천광역시,연수구,70-74세,9022,4310,4712
202012,28185,인천광역시,연수구,70-74세,9124,4357,4767
202101,28185,인천광역시,연수구,70-74세,9192,4373,4819
202102,28185,인천광역시,연수구,70-74세,9232,4395,4837
202103,28185,인천광역시,연수구,70-74세,9218,4390,4828
202104,28185,인천광역시,연수구,70-74세,9244,4396,4848
202105,28185,인천광역시,연수구,70-74세,9255,4408,4847
202106,28185,인천광역시,연수구,70-74세,9230,4374,4856
202007,28185,인천광역시,연수구,75-79세,6484,2829,3655
202008,28185,인천광역시,연수구,75-79세,6514,2844,3670
202009,28185,인천광역시,연수구,75-79세,6521,2852,3669
202010,28185,인천광역시,연수구,75-79세,6522,2849,3673
202011,28185,인천광역시,연수구,75-79세,6537,2846,3691
202012,28185,인천광역시,연수구,75-79세,6520,2853,3667
202101,28185,인천광역시,연수구,75-79세,6507,2873,3634
202102,28185,인천광역시,연수구,75-79세,6528,2882,3646
202103,28185,인천광역시,연수구,75-79세,6538,2884,3654
202104,28185,인천광역시,연수구,75-79세,6538,2891,3647
202105,28185,인천광역시,연수구,75-79세,6537,2905,3632
202106,28185,인천광역시,연수구,75-79세,6576,2937,3639
202007,28185,인천광역시,연수구,80-84세,4546,1580,2966
202008,28185,인천광역시,연수구,80-84세,4582,1599,2983
202009,28185,인천광역시,연수구,80-84세,4585,1612,2973
202010,28185,인천광역시,연수구,80-84세,4604,1619,2985
202011,28185,인천광역시,연수구,80-84세,4601,1621,2980
202012,28185,인천광역시,연수구,80-84세,4629,1627,3002
202101,28185,인천광역시,연수구,80-84세,4654,1643,3011
202102,28185,인천광역시,연수구,80-84세,4677,1653,3024
202103,28185,인천광역시,연수구,80-84세,4679,1657,3022
202104,28185,인천광역시,연수구,80-84세,4697,1678,3019
202105,28185,인천광역시,연수구,80-84세,4739,1693,3046
202106,28185,인천광역시,연수구,80-84세,4759,1699,3060
202007,28185,인천광역시,연수구,85-89세,2525,686,1839
202008,28185,인천광역시,연수구,85-89세,2545,693,1852
202009,28185,인천광역시,연수구,85-89세,2565,688,1877
202010,28185,인천광역시,연수구,85-89세,2602,701,1901
202011,28185,인천광역시,연수구,85-89세,2640,717,1923
202012,28185,인천광역시,연수구,85-89세,2643,729,1914
202101,28185,인천광역시,연수구,85-89세,2649,730,1919
202102,28185,인천광역시,연수구,85-89세,2669,739,1930
202103,28185,인천광역시,연수구,85-89세,2704,759,1945
202104,28185,인천광역시,연수구,85-89세,2712,763,1949
202105,28185,인천광역시,연수구,85-89세,2716,759,1957
202106,28185,인천광역시,연수구,85-89세,2713,762,1951
202007,28185,인천광역시,연수구,90-94세,965,222,743
202008,28185,인천광역시,연수구,90-94세,973,221,752
202009,28185,인천광역시,연수구,90-94세,998,229,769
202010,28185,인천광역시,연수구,90-94세,1017,238,779
202011,28185,인천광역시,연수구,90-94세,1023,241,782
202012,28185,인천광역시,연수구,90-94세,1041,244,797
202101,28185,인천광역시,연수구,90-94세,1058,249,809
202102,28185,인천광역시,연수구,90-94세,1066,247,819
202103,28185,인천광역시,연수구,90-94세,1071,238,833
202104,28185,인천광역시,연수구,90-94세,1078,244,834
202105,28185,인천광역시,연수구,90-94세,1083,241,842
202106,28185,인천광역시,연수구,90-94세,1079,241,838
202007,28185,인천광역시,연수구,95-99세,261,61,200
202008,28185,인천광역시,연수구,95-99세,265,62,203
202009,28185,인천광역시,연수구,95-99세,268,59,209
202010,28185,인천광역시,연수구,95-99세,269,56,213
202011,28185,인천광역시,연수구,95-99세,270,57,213
202012,28185,인천광역시,연수구,95-99세,276,55,221
202101,28185,인천광역시,연수구,95-99세,277,53,224
202102,28185,인천광역시,연수구,95-99세,286,54,232
202103,28185,인천광역시,연수구,95-99세,287,52,235
202104,28185,인천광역시,연수구,95-99세,295,52,243
202105,28185,인천광역시,연수구,95-99세,291,47,244
202106,28185,인천광역시,연수구,95-99세,293,45,248
202007,28185,인천광역시,연수구,100+,52,13,39
202008,28185,인천광역시,연수구,100+,53,13,40
202009,28185,인천광역시,연수구,100+,58,15,43
202010,28185,인천광역시,연수구,100+,59,16,43
202011,28185,인천광역시,연수구,100+,63,17,46
202012,28185,인천광역시,연수구,100+,64,17,47
202101,28185,인천광역시,연수구,100+,64,17,47
202102,28185,인천광역시,연수구,100+,67,17,50
202103,28185,인천광역시,연수구,100+,50,11,39
202104,28185,인천광역시,연수구,100+,47,10,37
202105,28185,인천광역시,연수구,100+,48,10,38
202106,28185,인천광역시,연수구,100+,49,10,39
202007,28200,인천광역시,남동구,0-4세,18285,9470,8815
202008,28200,인천광역시,남동구,0-4세,18001,9289,8712
202009,28200,인천광역시,남동구,0-4세,17758,9165,8593
202010,28200,인천광역시,남동구,0-4세,17534,9047,8487
202011,28200,인천광역시,남동구,0-4세,17343,8954,8389
202012,28200,인천광역시,남동구,0-4세,17083,8815,8268
202101,28200,인천광역시,남동구,0-4세,16879,8707,8172
202102,28200,인천광역시,남동구,0-4세,16685,8600,8085
202103,28200,인천광역시,남동구,0-4세,16447,8474,7973
202104,28200,인천광역시,남동구,0-4세,16234,8372,7862
202105,28200,인천광역시,남동구,0-4세,16065,8273,7792
202106,28200,인천광역시,남동구,0-4세,15891,8169,7722
202007,28200,인천광역시,남동구,5-9세,25377,12986,12391
202008,28200,인천광역시,남동구,5-9세,25221,12920,12301
202009,28200,인천광역시,남동구,5-9세,25137,12875,12262
202010,28200,인천광역시,남동구,5-9세,25001,12822,12179
202011,28200,인천광역시,남동구,5-9세,24843,12749,12094
202012,28200,인천광역시,남동구,5-9세,24731,12686,12045
202101,28200,인천광역시,남동구,5-9세,24484,12561,11923
202102,28200,인천광역시,남동구,5-9세,24283,12481,11802
202103,28200,인천광역시,남동구,5-9세,24201,12422,11779
202104,28200,인천광역시,남동구,5-9세,24117,12393,11724
202105,28200,인천광역시,남동구,5-9세,23970,12337,11633
202106,28200,인천광역시,남동구,5-9세,23875,12296,11579
202007,28200,인천광역시,남동구,10-14세,24830,12688,12142
202008,28200,인천광역시,남동구,10-14세,24812,12681,12131
202009,28200,인천광역시,남동구,10-14세,24759,12664,12095
202010,28200,인천광역시,남동구,10-14세,24797,12648,12149
202011,28200,인천광역시,남동구,10-14세,24803,12664,12139
202012,28200,인천광역시,남동구,10-14세,24764,12664,12100
202101,28200,인천광역시,남동구,10-14세,24829,12699,12130
202102,28200,인천광역시,남동구,10-14세,24829,12691,12138
202103,28200,인천광역시,남동구,10-14세,24879,12734,12145
202104,28200,인천광역시,남동구,10-14세,24919,12741,12178
202105,28200,인천광역시,남동구,10-14세,24922,12731,12191
202106,28200,인천광역시,남동구,10-14세,24949,12760,12189
202007,28200,인천광역시,남동구,15-19세,25792,13189,12603
202008,28200,인천광역시,남동구,15-19세,25647,13128,12519
202009,28200,인천광역시,남동구,15-19세,25564,13073,12491
202010,28200,인천광역시,남동구,15-19세,25455,13029,12426
202011,28200,인천광역시,남동구,15-19세,25295,12949,12346
202012,28200,인천광역시,남동구,15-19세,25088,12856,12232
202101,28200,인천광역시,남동구,15-19세,24933,12776,12157
202102,28200,인천광역시,남동구,15-19세,24714,12675,12039
202103,28200,인천광역시,남동구,15-19세,24540,12571,11969
202104,28200,인천광역시,남동구,15-19세,24413,12508,11905
202105,28200,인천광역시,남동구,15-19세,24361,12465,11896
202106,28200,인천광역시,남동구,15-19세,24296,12443,11853
202007,28200,인천광역시,남동구,20-24세,33496,17159,16337
202008,28200,인천광역시,남동구,20-24세,33399,17074,16325
202009,28200,인천광역시,남동구,20-24세,33172,16971,16201
202010,28200,인천광역시,남동구,20-24세,32984,16867,16117
202011,28200,인천광역시,남동구,20-24세,32897,16821,16076
202012,28200,인천광역시,남동구,20-24세,32878,16808,16070
202101,28200,인천광역시,남동구,20-24세,32770,16767,16003
202102,28200,인천광역시,남동구,20-24세,32627,16668,15959
202103,28200,인천광역시,남동구,20-24세,32457,16556,15901
202104,28200,인천광역시,남동구,20-24세,32326,16475,15851
202105,28200,인천광역시,남동구,20-24세,32211,16445,15766
202106,28200,인천광역시,남동구,20-24세,32121,16387,15734
202007,28200,인천광역시,남동구,25-29세,38175,19883,18292
202008,28200,인천광역시,남동구,25-29세,38094,19869,18225
202009,28200,인천광역시,남동구,25-29세,38070,19824,18246
202010,28200,인천광역시,남동구,25-29세,38171,19869,18302
202011,28200,인천광역시,남동구,25-29세,38122,19820,18302
202012,28200,인천광역시,남동구,25-29세,38142,19829,18313
202101,28200,인천광역시,남동구,25-29세,38088,19804,18284
202102,28200,인천광역시,남동구,25-29세,38014,19774,18240
202103,28200,인천광역시,남동구,25-29세,37914,19730,18184
202104,28200,인천광역시,남동구,25-29세,37906,19717,18189
202105,28200,인천광역시,남동구,25-29세,37853,19688,18165
202106,28200,인천광역시,남동구,25-29세,37790,19684,18106
202007,28200,인천광역시,남동구,30-34세,33224,17216,16008
202008,28200,인천광역시,남동구,30-34세,33022,17064,15958
202009,28200,인천광역시,남동구,30-34세,32943,17026,15917
202010,28200,인천광역시,남동구,30-34세,32877,16981,15896
202011,28200,인천광역시,남동구,30-34세,32726,16930,15796
202012,28200,인천광역시,남동구,30-34세,32620,16885,15735
202101,28200,인천광역시,남동구,30-34세,32628,16866,15762
202102,28200,인천광역시,남동구,30-34세,32528,16833,15695
202103,28200,인천광역시,남동구,30-34세,32610,16899,15711
202104,28200,인천광역시,남동구,30-34세,32693,16949,15744
202105,28200,인천광역시,남동구,30-34세,32687,16986,15701
202106,28200,인천광역시,남동구,30-34세,32732,17011,15721
202007,28200,인천광역시,남동구,35-39세,41339,21135,20204
202008,28200,인천광역시,남동구,35-39세,40963,20938,20025
202009,28200,인천광역시,남동구,35-39세,40558,20772,19786
202010,28200,인천광역시,남동구,35-39세,40242,20624,19618
202011,28200,인천광역시,남동구,35-39세,40043,20518,19525
202012,28200,인천광역시,남동구,35-39세,39774,20377,19397
202101,28200,인천광역시,남동구,35-39세,39440,20237,19203
202102,28200,인천광역시,남동구,35-39세,39072,20044,19028
202103,28200,인천광역시,남동구,35-39세,38692,19812,18880
202104,28200,인천광역시,남동구,35-39세,38411,19683,18728
202105,28200,인천광역시,남동구,35-39세,38055,19463,18592
202106,28200,인천광역시,남동구,35-39세,37796,19351,18445
202007,28200,인천광역시,남동구,40-44세,43248,22130,21118
202008,28200,인천광역시,남동구,40-44세,43170,22065,21105
202009,28200,인천광역시,남동구,40-44세,43283,22085,21198
202010,28200,인천광역시,남동구,40-44세,43374,22109,21265
202011,28200,인천광역시,남동구,40-44세,43351,22122,21229
202012,28200,인천광역시,남동구,40-44세,43125,22005,21120
202101,28200,인천광역시,남동구,40-44세,43069,21975,21094
202102,28200,인천광역시,남동구,40-44세,43157,22021,21136
202103,28200,인천광역시,남동구,40-44세,43050,21971,21079
202104,28200,인천광역시,남동구,40-44세,43052,21958,21094
202105,28200,인천광역시,남동구,40-44세,43095,21977,21118
202106,28200,인천광역시,남동구,40-44세,43305,22068,21237
202007,28200,인천광역시,남동구,45-49세,46500,23539,22961
202008,28200,인천광역시,남동구,45-49세,46319,23436,22883
202009,28200,인천광역시,남동구,45-49세,46086,23334,22752
202010,28200,인천광역시,남동구,45-49세,45830,23225,22605
202011,28200,인천광역시,남동구,45-49세,45670,23122,22548
202012,28200,인천광역시,남동구,45-49세,45647,23103,22544
202101,28200,인천광역시,남동구,45-49세,45508,23043,22465
202102,28200,인천광역시,남동구,45-49세,45303,22970,22333
202103,28200,인천광역시,남동구,45-49세,45022,22829,22193
202104,28200,인천광역시,남동구,45-49세,44956,22804,22152
202105,28200,인천광역시,남동구,45-49세,44625,22679,21946
202106,28200,인천광역시,남동구,45-49세,44334,22549,21785
202007,28200,인천광역시,남동구,50-54세,45391,22173,23218
202008,28200,인천광역시,남동구,50-54세,45472,22244,23228
202009,28200,인천광역시,남동구,50-54세,45543,22283,23260
202010,28200,인천광역시,남동구,50-54세,45632,22301,23331
202011,28200,인천광역시,남동구,50-54세,45622,22313,23309
202012,28200,인천광역시,남동구,50-54세,45448,22244,23204
202101,28200,인천광역시,남동구,50-54세,45637,22342,23295
202102,28200,인천광역시,남동구,50-54세,45769,22387,23382
202103,28200,인천광역시,남동구,50-54세,45607,22336,23271
202104,28200,인천광역시,남동구,50-54세,45575,22349,23226
202105,28200,인천광역시,남동구,50-54세,45729,22420,23309
202106,28200,인천광역시,남동구,50-54세,45846,22461,23385
202007,28200,인천광역시,남동구,55-59세,45409,22577,22832
202008,28200,인천광역시,남동구,55-59세,45152,22428,22724
202009,28200,인천광역시,남동구,55-59세,45065,22387,22678
202010,28200,인천광역시,남동구,55-59세,45000,22375,22625
202011,28200,인천광역시,남동구,55-59세,44875,22321,22554
202012,28200,인천광역시,남동구,55-59세,44703,22242,22461
202101,28200,인천광역시,남동구,55-59세,44398,22078,22320
202102,28200,인천광역시,남동구,55-59세,44195,21942,22253
202103,28200,인천광역시,남동구,55-59세,44026,21842,22184
202104,28200,인천광역시,남동구,55-59세,43872,21746,22126
202105,28200,인천광역시,남동구,55-59세,43636,21637,21999
202106,28200,인천광역시,남동구,55-59세,43231,21443,21788
202007,28200,인천광역시,남동구,60-64세,38696,18819,19877
202008,28200,인천광역시,남동구,60-64세,38934,18925,20009
202009,28200,인천광역시,남동구,60-64세,39152,19004,20148
202010,28200,인천광역시,남동구,60-64세,39386,19134,20252
202011,28200,인천광역시,남동구,60-64세,39595,19228,20367
202012,28200,인천광역시,남동구,60-64세,39883,19346,20537
202101,28200,인천광역시,남동구,60-64세,40204,19513,20691
202102,28200,인천광역시,남동구,60-64세,40445,19647,20798
202103,28200,인천광역시,남동구,60-64세,40640,19723,20917
202104,28200,인천광역시,남동구,60-64세,40933,19862,21071
202105,28200,인천광역시,남동구,60-64세,41210,20017,21193
202106,28200,인천광역시,남동구,60-64세,41591,20238,21353
202007,28200,인천광역시,남동구,65-69세,24924,11902,13022
202008,28200,인천광역시,남동구,65-69세,25173,12047,13126
202009,28200,인천광역시,남동구,65-69세,25382,12176,13206
202010,28200,인천광역시,남동구,65-69세,25570,12234,13336
202011,28200,인천광역시,남동구,65-69세,25768,12329,13439
202012,28200,인천광역시,남동구,65-69세,25928,12405,13523
202101,28200,인천광역시,남동구,65-69세,26151,12503,13648
202102,28200,인천광역시,남동구,65-69세,26466,12632,13834
202103,28200,인천광역시,남동구,65-69세,26771,12792,13979
202104,28200,인천광역시,남동구,65-69세,26969,12895,14074
202105,28200,인천광역시,남동구,65-69세,27209,12984,14225
202106,28200,인천광역시,남동구,65-69세,27375,13029,14346
202007,28200,인천광역시,남동구,70-74세,17655,8377,9278
202008,28200,인천광역시,남동구,70-74세,17676,8374,9302
202009,28200,인천광역시,남동구,70-74세,17773,8391,9382
202010,28200,인천광역시,남동구,70-74세,17926,8478,9448
202011,28200,인천광역시,남동구,70-74세,18037,8531,9506
202012,28200,인천광역시,남동구,70-74세,18113,8557,9556
202101,28200,인천광역시,남동구,70-74세,18279,8645,9634
202102,28200,인천광역시,남동구,70-74세,18296,8671,9625
202103,28200,인천광역시,남동구,70-74세,18277,8673,9604
202104,28200,인천광역시,남동구,70-74세,18252,8638,9614
202105,28200,인천광역시,남동구,70-74세,18250,8623,9627
202106,28200,인천광역시,남동구,70-74세,18275,8645,9630
202007,28200,인천광역시,남동구,75-79세,12791,5394,7397
202008,28200,인천광역시,남동구,75-79세,12855,5443,7412
202009,28200,인천광역시,남동구,75-79세,12845,5447,7398
202010,28200,인천광역시,남동구,75-79세,12792,5415,7377
202011,28200,인천광역시,남동구,75-79세,12746,5403,7343
202012,28200,인천광역시,남동구,75-79세,12716,5394,7322
202101,28200,인천광역시,남동구,75-79세,12672,5399,7273
202102,28200,인천광역시,남동구,75-79세,12689,5410,7279
202103,28200,인천광역시,남동구,75-79세,12722,5423,7299
202104,28200,인천광역시,남동구,75-79세,12743,5451,7292
202105,28200,인천광역시,남동구,75-79세,12785,5489,7296
202106,28200,인천광역시,남동구,75-79세,12790,5489,7301
202007,28200,인천광역시,남동구,80-84세,8171,2991,5180
202008,28200,인천광역시,남동구,80-84세,8205,3009,5196
202009,28200,인천광역시,남동구,80-84세,8237,3024,5213
202010,28200,인천광역시,남동구,80-84세,8277,3051,5226
202011,28200,인천광역시,남동구,80-84세,8310,3052,5258
202012,28200,인천광역시,남동구,80-84세,8365,3078,5287
202101,28200,인천광역시,남동구,80-84세,8430,3103,5327
202102,28200,인천광역시,남동구,80-84세,8468,3121,5347
202103,28200,인천광역시,남동구,80-84세,8474,3122,5352
202104,28200,인천광역시,남동구,80-84세,8527,3142,5385
202105,28200,인천광역시,남동구,80-84세,8573,3163,5410
202106,28200,인천광역시,남동구,80-84세,8645,3184,5461
202007,28200,인천광역시,남동구,85-89세,4015,1115,2900
202008,28200,인천광역시,남동구,85-89세,4044,1122,2922
202009,28200,인천광역시,남동구,85-89세,4073,1139,2934
202010,28200,인천광역시,남동구,85-89세,4096,1140,2956
202011,28200,인천광역시,남동구,85-89세,4127,1161,2966
202012,28200,인천광역시,남동구,85-89세,4177,1188,2989
202101,28200,인천광역시,남동구,85-89세,4223,1198,3025
202102,28200,인천광역시,남동구,85-89세,4271,1221,3050
202103,28200,인천광역시,남동구,85-89세,4290,1228,3062
202104,28200,인천광역시,남동구,85-89세,4341,1247,3094
202105,28200,인천광역시,남동구,85-89세,4387,1259,3128
202106,28200,인천광역시,남동구,85-89세,4405,1274,3131
202007,28200,인천광역시,남동구,90-94세,1593,345,1248
202008,28200,인천광역시,남동구,90-94세,1589,339,1250
202009,28200,인천광역시,남동구,90-94세,1604,337,1267
202010,28200,인천광역시,남동구,90-94세,1609,341,1268
202011,28200,인천광역시,남동구,90-94세,1631,343,1288
202012,28200,인천광역시,남동구,90-94세,1637,351,1286
202101,28200,인천광역시,남동구,90-94세,1649,350,1299
202102,28200,인천광역시,남동구,90-94세,1659,349,1310
202103,28200,인천광역시,남동구,90-94세,1640,347,1293
202104,28200,인천광역시,남동구,90-94세,1631,342,1289
202105,28200,인천광역시,남동구,90-94세,1639,334,1305
202106,28200,인천광역시,남동구,90-94세,1634,328,1306
202007,28200,인천광역시,남동구,95-99세,372,58,314
202008,28200,인천광역시,남동구,95-99세,373,57,316
202009,28200,인천광역시,남동구,95-99세,379,61,318
202010,28200,인천광역시,남동구,95-99세,393,64,329
202011,28200,인천광역시,남동구,95-99세,396,61,335
202012,28200,인천광역시,남동구,95-99세,391,57,334
202101,28200,인천광역시,남동구,95-99세,389,56,333
202102,28200,인천광역시,남동구,95-99세,390,55,335
202103,28200,인천광역시,남동구,95-99세,374,48,326
202104,28200,인천광역시,남동구,95-99세,378,50,328
202105,28200,인천광역시,남동구,95-99세,373,51,322
202106,28200,인천광역시,남동구,95-99세,375,54,321
202007,28200,인천광역시,남동구,100+,130,30,100
202008,28200,인천광역시,남동구,100+,134,31,103
202009,28200,인천광역시,남동구,100+,132,30,102
202010,28200,인천광역시,남동구,100+,134,31,103
202011,28200,인천광역시,남동구,100+,137,32,105
202012,28200,인천광역시,남동구,100+,141,33,108
202101,28200,인천광역시,남동구,100+,140,32,108
202102,28200,인천광역시,남동구,100+,144,35,109
202103,28200,인천광역시,남동구,100+,80,13,67
202104,28200,인천광역시,남동구,100+,82,13,69
202105,28200,인천광역시,남동구,100+,84,14,70
202106,28200,인천광역시,남동구,100+,84,13,71
202007,28237,인천광역시,부평구,0-4세,14934,7701,7233
202008,28237,인천광역시,부평구,0-4세,14736,7608,7128
202009,28237,인천광역시,부평구,0-4세,14512,7473,7039
202010,28237,인천광역시,부평구,0-4세,14352,7425,6927
202011,28237,인천광역시,부평구,0-4세,14143,7312,6831
202012,28237,인천광역시,부평구,0-4세,13968,7227,6741
202101,28237,인천광역시,부평구,0-4세,13750,7098,6652
202102,28237,인천광역시,부평구,0-4세,13567,7011,6556
202103,28237,인천광역시,부평구,0-4세,13429,6930,6499
202104,28237,인천광역시,부평구,0-4세,13298,6869,6429
202105,28237,인천광역시,부평구,0-4세,13193,6822,6371
202106,28237,인천광역시,부평구,0-4세,13094,6781,6313
202007,28237,인천광역시,부평구,5-9세,19517,9917,9600
202008,28237,인천광역시,부평구,5-9세,19368,9860,9508
202009,28237,인천광역시,부평구,5-9세,19260,9809,9451
202010,28237,인천광역시,부평구,5-9세,19127,9726,9401
202011,28237,인천광역시,부평구,5-9세,19026,9666,9360
202012,28237,인천광역시,부평구,5-9세,18937,9619,9318
202101,28237,인천광역시,부평구,5-9세,18863,9605,9258
202102,28237,인천광역시,부평구,5-9세,18728,9519,9209
202103,28237,인천광역시,부평구,5-9세,18643,9461,9182
202104,28237,인천광역시,부평구,5-9세,18588,9414,9174
202105,28237,인천광역시,부평구,5-9세,18590,9410,9180
202106,28237,인천광역시,부평구,5-9세,18558,9396,9162
202007,28237,인천광역시,부평구,10-14세,20441,10564,9877
202008,28237,인천광역시,부평구,10-14세,20339,10524,9815
202009,28237,인천광역시,부평구,10-14세,20296,10502,9794
202010,28237,인천광역시,부평구,10-14세,20347,10540,9807
202011,28237,인천광역시,부평구,10-14세,20336,10528,9808
202012,28237,인천광역시,부평구,10-14세,20288,10500,9788
202101,28237,인천광역시,부평구,10-14세,20252,10481,9771
202102,28237,인천광역시,부평구,10-14세,20218,10474,9744
202103,28237,인천광역시,부평구,10-14세,20256,10509,9747
202104,28237,인천광역시,부평구,10-14세,20264,10524,9740
202105,28237,인천광역시,부평구,10-14세,20245,10512,9733
202106,28237,인천광역시,부평구,10-14세,20240,10509,9731
202007,28237,인천광역시,부평구,15-19세,23922,12398,11524
202008,28237,인천광역시,부평구,15-19세,23672,12257,11415
202009,28237,인천광역시,부평구,15-19세,23445,12150,11295
202010,28237,인천광역시,부평구,15-19세,23261,12051,11210
202011,28237,인천광역시,부평구,15-19세,23098,11982,11116
202012,28237,인천광역시,부평구,15-19세,22922,11891,11031
202101,28237,인천광역시,부평구,15-19세,22727,11777,10950
202102,28237,인천광역시,부평구,15-19세,22587,11708,10879
202103,28237,인천광역시,부평구,15-19세,22360,11574,10786
202104,28237,인천광역시,부평구,15-19세,22184,11474,10710
202105,28237,인천광역시,부평구,15-19세,22081,11408,10673
202106,28237,인천광역시,부평구,15-19세,21931,11344,10587
202007,28237,인천광역시,부평구,20-24세,32843,16867,15976
202008,28237,인천광역시,부평구,20-24세,32619,16752,15867
202009,28237,인천광역시,부평구,20-24세,32414,16648,15766
202010,28237,인천광역시,부평구,20-24세,32127,16467,15660
202011,28237,인천광역시,부평구,20-24세,31928,16390,15538
202012,28237,인천광역시,부평구,20-24세,31764,16319,15445
202101,28237,인천광역시,부평구,20-24세,31648,16254,15394
202102,28237,인천광역시,부평구,20-24세,31447,16135,15312
202103,28237,인천광역시,부평구,20-24세,31161,15995,15166
202104,28237,인천광역시,부평구,20-24세,31009,15892,15117
202105,28237,인천광역시,부평구,20-24세,30848,15815,15033
202106,28237,인천광역시,부평구,20-24세,30699,15719,14980
202007,28237,인천광역시,부평구,25-29세,38548,19899,18649
202008,28237,인천광역시,부평구,25-29세,38416,19819,18597
202009,28237,인천광역시,부평구,25-29세,38310,19737,18573
202010,28237,인천광역시,부평구,25-29세,38373,19803,18570
202011,28237,인천광역시,부평구,25-29세,38368,19819,18549
202012,28237,인천광역시,부평구,25-29세,38421,19827,18594
202101,28237,인천광역시,부평구,25-29세,38368,19773,18595
202102,28237,인천광역시,부평구,25-29세,38215,19677,18538
202103,28237,인천광역시,부평구,25-29세,38083,19567,18516
202104,28237,인천광역시,부평구,25-29세,38120,19620,18500
202105,28237,인천광역시,부평구,25-29세,38090,19623,18467
202106,28237,인천광역시,부평구,25-29세,38111,19640,18471
202007,28237,인천광역시,부평구,30-34세,32623,16878,15745
202008,28237,인천광역시,부평구,30-34세,32524,16819,15705
202009,28237,인천광역시,부평구,30-34세,32433,16763,15670
202010,28237,인천광역시,부평구,30-34세,32312,16671,15641
202011,28237,인천광역시,부평구,30-34세,32200,16588,15612
202012,28237,인천광역시,부평구,30-34세,32231,16629,15602
202101,28237,인천광역시,부평구,30-34세,32211,16607,15604
202102,28237,인천광역시,부평구,30-34세,32145,16572,15573
202103,28237,인천광역시,부평구,30-34세,32149,16575,15574
202104,28237,인천광역시,부평구,30-34세,32235,16643,15592
202105,28237,인천광역시,부평구,30-34세,32358,16731,15627
202106,28237,인천광역시,부평구,30-34세,32422,16751,15671
202007,28237,인천광역시,부평구,35-39세,36707,18990,17717
202008,28237,인천광역시,부평구,35-39세,36285,18776,17509
202009,28237,인천광역시,부평구,35-39세,36007,18614,17393
202010,28237,인천광역시,부평구,35-39세,35676,18441,17235
202011,28237,인천광역시,부평구,35-39세,35398,18286,17112
202012,28237,인천광역시,부평구,35-39세,35205,18174,17031
202101,28237,인천광역시,부평구,35-39세,35002,18083,16919
202102,28237,인천광역시,부평구,35-39세,34710,17944,16766
202103,28237,인천광역시,부평구,35-39세,34443,17794,16649
202104,28237,인천광역시,부평구,35-39세,34262,17681,16581
202105,28237,인천광역시,부평구,35-39세,34130,17609,16521
202106,28237,인천광역시,부평구,35-39세,34000,17569,16431
202007,28237,인천광역시,부평구,40-44세,36239,18493,17746
202008,28237,인천광역시,부평구,40-44세,36120,18429,17691
202009,28237,인천광역시,부평구,40-44세,36167,18463,17704
202010,28237,인천광역시,부평구,40-44세,36334,18525,17809
202011,28237,인천광역시,부평구,40-44세,36399,18591,17808
202012,28237,인천광역시,부평구,40-44세,36201,18494,17707
202101,28237,인천광역시,부평구,40-44세,36214,18476,17738
202102,28237,인천광역시,부평구,40-44세,36243,18506,17737
202103,28237,인천광역시,부평구,40-44세,36032,18432,17600
202104,28237,인천광역시,부평구,40-44세,36031,18435,17596
202105,28237,인천광역시,부평구,40-44세,36190,18556,17634
202106,28237,인천광역시,부평구,40-44세,36355,18619,17736
202007,28237,인천광역시,부평구,45-49세,42559,21072,21487
202008,28237,인천광역시,부평구,45-49세,42264,20969,21295
202009,28237,인천광역시,부평구,45-49세,41941,20807,21134
202010,28237,인천광역시,부평구,45-49세,41541,20631,20910
202011,28237,인천광역시,부평구,45-49세,41291,20477,20814
202012,28237,인천광역시,부평구,45-49세,41215,20456,20759
202101,28237,인천광역시,부평구,45-49세,40955,20342,20613
202102,28237,인천광역시,부평구,45-49세,40671,20210,20461
202103,28237,인천광역시,부평구,45-49세,40295,20041,20254
202104,28237,인천광역시,부평구,45-49세,40188,19976,20212
202105,28237,인천광역시,부평구,45-49세,39861,19807,20054
202106,28237,인천광역시,부평구,45-49세,39591,19706,19885
202007,28237,인천광역시,부평구,50-54세,45304,21906,23398
202008,28237,인천광역시,부평구,50-54세,45156,21797,23359
202009,28237,인천광역시,부평구,50-54세,45030,21705,23325
202010,28237,인천광역시,부평구,50-54세,45029,21731,23298
202011,28237,인천광역시,부평구,50-54세,44986,21700,23286
202012,28237,인천광역시,부평구,50-54세,44709,21562,23147
202101,28237,인천광역시,부평구,50-54세,44799,21625,23174
202102,28237,인천광역시,부평구,50-54세,44867,21634,23233
202103,28237,인천광역시,부평구,50-54세,44483,21454,23029
202104,28237,인천광역시,부평구,50-54세,44358,21377,22981
202105,28237,인천광역시,부평구,50-54세,44501,21438,23063
202106,28237,인천광역시,부평구,50-54세,44537,21425,23112
202007,28237,인천광역시,부평구,55-59세,46084,22962,23122
202008,28237,인천광역시,부평구,55-59세,45892,22868,23024
202009,28237,인천광역시,부평구,55-59세,45759,22827,22932
202010,28237,인천광역시,부평구,55-59세,45598,22674,22924
202011,28237,인천광역시,부평구,55-59세,45423,22604,22819
202012,28237,인천광역시,부평구,55-59세,45445,22591,22854
202101,28237,인천광역시,부평구,55-59세,45211,22457,22754
202102,28237,인천광역시,부평구,55-59세,45000,22364,22636
202103,28237,인천광역시,부평구,55-59세,44805,22204,22601
202104,28237,인천광역시,부평구,55-59세,44649,22140,22509
202105,28237,인천광역시,부평구,55-59세,44551,22109,22442
202106,28237,인천광역시,부평구,55-59세,44273,21946,22327
202007,28237,인천광역시,부평구,60-64세,39464,19369,20095
202008,28237,인천광역시,부평구,60-64세,39696,19479,20217
202009,28237,인천광역시,부평구,60-64세,39795,19505,20290
202010,28237,인천광역시,부평구,60-64세,40037,19647,20390
202011,28237,인천광역시,부평구,60-64세,40149,19714,20435
202012,28237,인천광역시,부평구,60-64세,40232,19785,20447
202101,28237,인천광역시,부평구,60-64세,40628,19982,20646
202102,28237,인천광역시,부평구,60-64세,40960,20160,20800
202103,28237,인천광역시,부평구,60-64세,41098,20237,20861
202104,28237,인천광역시,부평구,60-64세,41384,20401,20983
202105,28237,인천광역시,부평구,60-64세,41607,20463,21144
202106,28237,인천광역시,부평구,60-64세,41894,20631,21263
202007,28237,인천광역시,부평구,65-69세,24767,11890,12877
202008,28237,인천광역시,부평구,65-69세,24956,11991,12965
202009,28237,인천광역시,부평구,65-69세,25175,12104,13071
202010,28237,인천광역시,부평구,65-69세,25345,12180,13165
202011,28237,인천광역시,부평구,65-69세,25533,12233,13300
202012,28237,인천광역시,부평구,65-69세,25776,12323,13453
202101,28237,인천광역시,부평구,65-69세,25991,12409,13582
202102,28237,인천광역시,부평구,65-69세,26234,12497,13737
202103,28237,인천광역시,부평구,65-69세,26420,12620,13800
202104,28237,인천광역시,부평구,65-69세,26615,12703,13912
202105,28237,인천광역시,부평구,65-69세,26807,12840,13967
202106,28237,인천광역시,부평구,65-69세,26914,12886,14028
202007,28237,인천광역시,부평구,70-74세,17758,8324,9434
202008,28237,인천광역시,부평구,70-74세,17763,8337,9426
202009,28237,인천광역시,부평구,70-74세,17852,8377,9475
202010,28237,인천광역시,부평구,70-74세,17982,8436,9546
202011,28237,인천광역시,부평구,70-74세,18068,8468,9600
202012,28237,인천광역시,부평구,70-74세,18120,8483,9637
202101,28237,인천광역시,부평구,70-74세,18276,8563,9713
202102,28237,인천광역시,부평구,70-74세,18332,8595,9737
202103,28237,인천광역시,부평구,70-74세,18266,8565,9701
202104,28237,인천광역시,부평구,70-74세,18252,8543,9709
202105,28237,인천광역시,부평구,70-74세,18302,8541,9761
202106,28237,인천광역시,부평구,70-74세,18294,8536,9758
202007,28237,인천광역시,부평구,75-79세,13529,5746,7783
202008,28237,인천광역시,부평구,75-79세,13540,5742,7798
202009,28237,인천광역시,부평구,75-79세,13477,5715,7762
202010,28237,인천광역시,부평구,75-79세,13399,5689,7710
202011,28237,인천광역시,부평구,75-79세,13364,5685,7679
202012,28237,인천광역시,부평구,75-79세,13267,5653,7614
202101,28237,인천광역시,부평구,75-79세,13221,5651,7570
202102,28237,인천광역시,부평구,75-79세,13188,5649,7539
202103,28237,인천광역시,부평구,75-79세,13086,5614,7472
202104,28237,인천광역시,부평구,75-79세,13072,5630,7442
202105,28237,인천광역시,부평구,75-79세,13118,5649,7469
202106,28237,인천광역시,부평구,75-79세,13137,5660,7477
202007,28237,인천광역시,부평구,80-84세,9076,3238,5838
202008,28237,인천광역시,부평구,80-84세,9076,3236,5840
202009,28237,인천광역시,부평구,80-84세,9114,3251,5863
202010,28237,인천광역시,부평구,80-84세,9156,3257,5899
202011,28237,인천광역시,부평구,80-84세,9132,3258,5874
202012,28237,인천광역시,부평구,80-84세,9161,3274,5887
202101,28237,인천광역시,부평구,80-84세,9235,3310,5925
202102,28237,인천광역시,부평구,80-84세,9311,3324,5987
202103,28237,인천광역시,부평구,80-84세,9315,3328,5987
202104,28237,인천광역시,부평구,80-84세,9370,3357,6013
202105,28237,인천광역시,부평구,80-84세,9351,3367,5984
202106,28237,인천광역시,부평구,80-84세,9402,3382,6020
202007,28237,인천광역시,부평구,85-89세,4548,1338,3210
202008,28237,인천광역시,부평구,85-89세,4578,1357,3221
202009,28237,인천광역시,부평구,85-89세,4614,1371,3243
202010,28237,인천광역시,부평구,85-89세,4659,1394,3265
202011,28237,인천광역시,부평구,85-89세,4728,1421,3307
202012,28237,인천광역시,부평구,85-89세,4779,1442,3337
202101,28237,인천광역시,부평구,85-89세,4818,1457,3361
202102,28237,인천광역시,부평구,85-89세,4837,1480,3357
202103,28237,인천광역시,부평구,85-89세,4835,1469,3366
202104,28237,인천광역시,부평구,85-89세,4861,1474,3387
202105,28237,인천광역시,부평구,85-89세,4919,1495,3424
202106,28237,인천광역시,부평구,85-89세,4929,1507,3422
202007,28237,인천광역시,부평구,90-94세,1645,341,1304
202008,28237,인천광역시,부평구,90-94세,1662,340,1322
202009,28237,인천광역시,부평구,90-94세,1675,342,1333
202010,28237,인천광역시,부평구,90-94세,1678,338,1340
202011,28237,인천광역시,부평구,90-94세,1695,337,1358
202012,28237,인천광역시,부평구,90-94세,1700,337,1363
202101,28237,인천광역시,부평구,90-94세,1698,335,1363
202102,28237,인천광역시,부평구,90-94세,1724,348,1376
202103,28237,인천광역시,부평구,90-94세,1707,348,1359
202104,28237,인천광역시,부평구,90-94세,1722,352,1370
202105,28237,인천광역시,부평구,90-94세,1723,353,1370
202106,28237,인천광역시,부평구,90-94세,1733,354,1379
202007,28237,인천광역시,부평구,95-99세,424,93,331
202008,28237,인천광역시,부평구,95-99세,434,91,343
202009,28237,인천광역시,부평구,95-99세,426,89,337
202010,28237,인천광역시,부평구,95-99세,423,86,337
202011,28237,인천광역시,부평구,95-99세,415,82,333
202012,28237,인천광역시,부평구,95-99세,418,82,336
202101,28237,인천광역시,부평구,95-99세,414,80,334
202102,28237,인천광역시,부평구,95-99세,421,81,340
202103,28237,인천광역시,부평구,95-99세,393,78,315
202104,28237,인천광역시,부평구,95-99세,394,79,315
202105,28237,인천광역시,부평구,95-99세,390,77,313
202106,28237,인천광역시,부평구,95-99세,379,77,302
202007,28237,인천광역시,부평구,100+,196,44,152
202008,28237,인천광역시,부평구,100+,194,43,151
202009,28237,인천광역시,부평구,100+,200,44,156
202010,28237,인천광역시,부평구,100+,202,44,158
202011,28237,인천광역시,부평구,100+,202,45,157
202012,28237,인천광역시,부평구,100+,203,45,158
202101,28237,인천광역시,부평구,100+,206,47,159
202102,28237,인천광역시,부평구,100+,205,46,159
202103,28237,인천광역시,부평구,100+,111,22,89
202104,28237,인천광역시,부평구,100+,112,21,91
202105,28237,인천광역시,부평구,100+,115,22,93
202106,28237,인천광역시,부평구,100+,116,22,94
202007,28245,인천광역시,계양구,0-4세,8123,4119,4004
202008,28245,인천광역시,계양구,0-4세,7978,4049,3929
202009,28245,인천광역시,계양구,0-4세,7866,3978,3888
202010,28245,인천광역시,계양구,0-4세,7738,3935,3803
202011,28245,인천광역시,계양구,0-4세,7697,3899,3798
202012,28245,인천광역시,계양구,0-4세,7603,3871,3732
202101,28245,인천광역시,계양구,0-4세,7504,3843,3661
202102,28245,인천광역시,계양구,0-4세,7470,3832,3638
202103,28245,인천광역시,계양구,0-4세,7475,3831,3644
202104,28245,인천광역시,계양구,0-4세,7426,3800,3626
202105,28245,인천광역시,계양구,0-4세,7353,3767,3586
202106,28245,인천광역시,계양구,0-4세,7335,3752,3583
202007,28245,인천광역시,계양구,5-9세,11251,5748,5503
202008,28245,인천광역시,계양구,5-9세,11129,5666,5463
202009,28245,인천광역시,계양구,5-9세,11078,5624,5454
202010,28245,인천광역시,계양구,5-9세,11036,5598,5438
202011,28245,인천광역시,계양구,5-9세,10935,5560,5375
202012,28245,인천광역시,계양구,5-9세,10887,5514,5373
202101,28245,인천광역시,계양구,5-9세,10816,5461,5355
202102,28245,인천광역시,계양구,5-9세,10831,5474,5357
202103,28245,인천광역시,계양구,5-9세,10821,5463,5358
202104,28245,인천광역시,계양구,5-9세,10796,5469,5327
202105,28245,인천광역시,계양구,5-9세,10710,5437,5273
202106,28245,인천광역시,계양구,5-9세,10660,5413,5247
202007,28245,인천광역시,계양구,10-14세,12411,6365,6046
202008,28245,인천광역시,계양구,10-14세,12384,6336,6048
202009,28245,인천광역시,계양구,10-14세,12360,6336,6024
202010,28245,인천광역시,계양구,10-14세,12369,6347,6022
202011,28245,인천광역시,계양구,10-14세,12391,6352,6039
202012,28245,인천광역시,계양구,10-14세,12380,6336,6044
202101,28245,인천광역시,계양구,10-14세,12376,6325,6051
202102,28245,인천광역시,계양구,10-14세,12379,6303,6076
202103,28245,인천광역시,계양구,10-14세,12390,6312,6078
202104,28245,인천광역시,계양구,10-14세,12381,6319,6062
202105,28245,인천광역시,계양구,10-14세,12404,6316,6088
202106,28245,인천광역시,계양구,10-14세,12379,6309,6070
202007,28245,인천광역시,계양구,15-19세,14970,7768,7202
202008,28245,인천광역시,계양구,15-19세,14838,7704,7134
202009,28245,인천광역시,계양구,15-19세,14703,7633,7070
202010,28245,인천광역시,계양구,15-19세,14582,7532,7050
202011,28245,인천광역시,계양구,15-19세,14433,7451,6982
202012,28245,인천광역시,계양구,15-19세,14326,7397,6929
202101,28245,인천광역시,계양구,15-19세,14156,7320,6836
202102,28245,인천광역시,계양구,15-19세,14071,7262,6809
202103,28245,인천광역시,계양구,15-19세,13979,7227,6752
202104,28245,인천광역시,계양구,15-19세,13892,7161,6731
202105,28245,인천광역시,계양구,15-19세,13778,7103,6675
202106,28245,인천광역시,계양구,15-19세,13700,7054,6646
202007,28245,인천광역시,계양구,20-24세,21288,11145,10143
202008,28245,인천광역시,계양구,20-24세,21103,11054,10049
202009,28245,인천광역시,계양구,20-24세,20935,10974,9961
202010,28245,인천광역시,계양구,20-24세,20821,10936,9885
202011,28245,인천광역시,계양구,20-24세,20727,10895,9832
202012,28245,인천광역시,계양구,20-24세,20607,10829,9778
202101,28245,인천광역시,계양구,20-24세,20520,10770,9750
202102,28245,인천광역시,계양구,20-24세,20420,10741,9679
202103,28245,인천광역시,계양구,20-24세,20282,10668,9614
202104,28245,인천광역시,계양구,20-24세,20251,10654,9597
202105,28245,인천광역시,계양구,20-24세,20160,10625,9535
202106,28245,인천광역시,계양구,20-24세,20038,10554,9484
202007,28245,인천광역시,계양구,25-29세,23563,12285,11278
202008,28245,인천광역시,계양구,25-29세,23549,12268,11281
202009,28245,인천광역시,계양구,25-29세,23549,12299,11250
202010,28245,인천광역시,계양구,25-29세,23530,12298,11232
202011,28245,인천광역시,계양구,25-29세,23587,12340,11247
202012,28245,인천광역시,계양구,25-29세,23587,12328,11259
202101,28245,인천광역시,계양구,25-29세,23515,12300,11215
202102,28245,인천광역시,계양구,25-29세,23430,12250,11180
202103,28245,인천광역시,계양구,25-29세,23523,12286,11237
202104,28245,인천광역시,계양구,25-29세,23482,12251,11231
202105,28245,인천광역시,계양구,25-29세,23411,12218,11193
202106,28245,인천광역시,계양구,25-29세,23332,12186,11146
202007,28245,인천광역시,계양구,30-34세,18420,9585,8835
202008,28245,인천광역시,계양구,30-34세,18296,9531,8765
202009,28245,인천광역시,계양구,30-34세,18245,9501,8744
202010,28245,인천광역시,계양구,30-34세,18304,9529,8775
202011,28245,인천광역시,계양구,30-34세,18270,9518,8752
202012,28245,인천광역시,계양구,30-34세,18250,9533,8717
202101,28245,인천광역시,계양구,30-34세,18194,9501,8693
202102,28245,인천광역시,계양구,30-34세,18293,9559,8734
202103,28245,인천광역시,계양구,30-34세,18369,9611,8758
202104,28245,인천광역시,계양구,30-34세,18439,9650,8789
202105,28245,인천광역시,계양구,30-34세,18511,9707,8804
202106,28245,인천광역시,계양구,30-34세,18556,9729,8827
202007,28245,인천광역시,계양구,35-39세,20170,10435,9735
202008,28245,인천광역시,계양구,35-39세,19962,10338,9624
202009,28245,인천광역시,계양구,35-39세,19813,10268,9545
202010,28245,인천광역시,계양구,35-39세,19646,10209,9437
202011,28245,인천광역시,계양구,35-39세,19630,10216,9414
202012,28245,인천광역시,계양구,35-39세,19608,10192,9416
202101,28245,인천광역시,계양구,35-39세,19490,10128,9362
202102,28245,인천광역시,계양구,35-39세,19436,10088,9348
202103,28245,인천광역시,계양구,35-39세,19406,10089,9317
202104,28245,인천광역시,계양구,35-39세,19440,10098,9342
202105,28245,인천광역시,계양구,35-39세,19331,10021,9310
202106,28245,인천광역시,계양구,35-39세,19233,9978,9255
202007,28245,인천광역시,계양구,40-44세,20815,10476,10339
202008,28245,인천광역시,계양구,40-44세,20759,10456,10303
202009,28245,인천광역시,계양구,40-44세,20749,10440,10309
202010,28245,인천광역시,계양구,40-44세,20768,10437,10331
202011,28245,인천광역시,계양구,40-44세,20753,10431,10322
202012,28245,인천광역시,계양구,40-44세,20620,10369,10251
202101,28245,인천광역시,계양구,40-44세,20580,10363,10217
202102,28245,인천광역시,계양구,40-44세,20722,10446,10276
202103,28245,인천광역시,계양구,40-44세,20709,10445,10264
202104,28245,인천광역시,계양구,40-44세,20686,10443,10243
202105,28245,인천광역시,계양구,40-44세,20733,10487,10246
202106,28245,인천광역시,계양구,40-44세,20855,10537,10318
202007,28245,인천광역시,계양구,45-49세,25882,12742,13140
202008,28245,인천광역시,계양구,45-49세,25736,12676,13060
202009,28245,인천광역시,계양구,45-49세,25570,12617,12953
202010,28245,인천광역시,계양구,45-49세,25415,12523,12892
202011,28245,인천광역시,계양구,45-49세,25250,12429,12821
202012,28245,인천광역시,계양구,45-49세,25164,12392,12772
202101,28245,인천광역시,계양구,45-49세,25002,12330,12672
202102,28245,인천광역시,계양구,45-49세,24932,12326,12606
202103,28245,인천광역시,계양구,45-49세,24842,12268,12574
202104,28245,인천광역시,계양구,45-49세,24769,12208,12561
202105,28245,인천광역시,계양구,45-49세,24519,12089,12430
202106,28245,인천광역시,계양구,45-49세,24364,12041,12323
202007,28245,인천광역시,계양구,50-54세,29886,14382,15504
202008,28245,인천광역시,계양구,50-54세,29777,14341,15436
202009,28245,인천광역시,계양구,50-54세,29709,14288,15421
202010,28245,인천광역시,계양구,50-54세,29673,14255,15418
202011,28245,인천광역시,계양구,50-54세,29652,14250,15402
202012,28245,인천광역시,계양구,50-54세,29474,14153,15321
202101,28245,인천광역시,계양구,50-54세,29507,14154,15353
202102,28245,인천광역시,계양구,50-54세,29524,14170,15354
202103,28245,인천광역시,계양구,50-54세,29409,14089,15320
202104,28245,인천광역시,계양구,50-54세,29385,14074,15311
202105,28245,인천광역시,계양구,50-54세,29441,14073,15368
202106,28245,인천광역시,계양구,50-54세,29449,14101,15348
202007,28245,인천광역시,계양구,55-59세,31488,15635,15853
202008,28245,인천광역시,계양구,55-59세,31362,15586,15776
202009,28245,인천광역시,계양구,55-59세,31210,15478,15732
202010,28245,인천광역시,계양구,55-59세,31203,15471,15732
202011,28245,인천광역시,계양구,55-59세,31149,15414,15735
202012,28245,인천광역시,계양구,55-59세,31135,15388,15747
202101,28245,인천광역시,계양구,55-59세,30994,15300,15694
202102,28245,인천광역시,계양구,55-59세,30954,15262,15692
202103,28245,인천광역시,계양구,55-59세,30931,15274,15657
202104,28245,인천광역시,계양구,55-59세,30893,15253,15640
202105,28245,인천광역시,계양구,55-59세,30689,15170,15519
202106,28245,인천광역시,계양구,55-59세,30417,15029,15388
202007,28245,인천광역시,계양구,60-64세,24063,12468,11595
202008,28245,인천광역시,계양구,60-64세,24236,12511,11725
202009,28245,인천광역시,계양구,60-64세,24467,12634,11833
202010,28245,인천광역시,계양구,60-64세,24713,12772,11941
202011,28245,인천광역시,계양구,60-64세,24954,12899,12055
202012,28245,인천광역시,계양구,60-64세,25162,12982,12180
202101,28245,인천광역시,계양구,60-64세,25352,13070,12282
202102,28245,인천광역시,계양구,60-64세,25640,13206,12434
202103,28245,인천광역시,계양구,60-64세,25960,13331,12629
202104,28245,인천광역시,계양구,60-64세,26178,13410,12768
202105,28245,인천광역시,계양구,60-64세,26510,13558,12952
202106,28245,인천광역시,계양구,60-64세,26766,13663,13103
202007,28245,인천광역시,계양구,65-69세,13235,6733,6502
202008,28245,인천광역시,계양구,65-69세,13378,6805,6573
202009,28245,인천광역시,계양구,65-69세,13529,6894,6635
202010,28245,인천광역시,계양구,65-69세,13631,6932,6699
202011,28245,인천광역시,계양구,65-69세,13771,7002,6769
202012,28245,인천광역시,계양구,65-69세,13927,7105,6822
202101,28245,인천광역시,계양구,65-69세,14123,7206,6917
202102,28245,인천광역시,계양구,65-69세,14271,7291,6980
202103,28245,인천광역시,계양구,65-69세,14552,7435,7117
202104,28245,인천광역시,계양구,65-69세,14723,7529,7194
202105,28245,인천광역시,계양구,65-69세,14828,7573,7255
202106,28245,인천광역시,계양구,65-69세,14958,7622,7336
202007,28245,인천광역시,계양구,70-74세,8695,4191,4504
202008,28245,인천광역시,계양구,70-74세,8707,4194,4513
202009,28245,인천광역시,계양구,70-74세,8736,4213,4523
202010,28245,인천광역시,계양구,70-74세,8792,4242,4550
202011,28245,인천광역시,계양구,70-74세,8885,4278,4607
202012,28245,인천광역시,계양구,70-74세,8932,4297,4635
202101,28245,인천광역시,계양구,70-74세,8987,4330,4657
202102,28245,인천광역시,계양구,70-74세,9033,4343,4690
202103,28245,인천광역시,계양구,70-74세,9020,4349,4671
202104,28245,인천광역시,계양구,70-74세,9068,4369,4699
202105,28245,인천광역시,계양구,70-74세,9094,4387,4707
202106,28245,인천광역시,계양구,70-74세,9089,4397,4692
202007,28245,인천광역시,계양구,75-79세,6671,2710,3961
202008,28245,인천광역시,계양구,75-79세,6664,2705,3959
202009,28245,인천광역시,계양구,75-79세,6658,2712,3946
202010,28245,인천광역시,계양구,75-79세,6643,2705,3938
202011,28245,인천광역시,계양구,75-79세,6628,2696,3932
202012,28245,인천광역시,계양구,75-79세,6619,2691,3928
202101,28245,인천광역시,계양구,75-79세,6563,2660,3903
202102,28245,인천광역시,계양구,75-79세,6557,2666,3891
202103,28245,인천광역시,계양구,75-79세,6532,2651,3881
202104,28245,인천광역시,계양구,75-79세,6534,2656,3878
202105,28245,인천광역시,계양구,75-79세,6528,2665,3863
202106,28245,인천광역시,계양구,75-79세,6557,2670,3887
202007,28245,인천광역시,계양구,80-84세,4714,1604,3110
202008,28245,인천광역시,계양구,80-84세,4730,1615,3115
202009,28245,인천광역시,계양구,80-84세,4730,1606,3124
202010,28245,인천광역시,계양구,80-84세,4764,1618,3146
202011,28245,인천광역시,계양구,80-84세,4767,1635,3132
202012,28245,인천광역시,계양구,80-84세,4785,1643,3142
202101,28245,인천광역시,계양구,80-84세,4832,1667,3165
202102,28245,인천광역시,계양구,80-84세,4855,1678,3177
202103,28245,인천광역시,계양구,80-84세,4857,1689,3168
202104,28245,인천광역시,계양구,80-84세,4842,1673,3169
202105,28245,인천광역시,계양구,80-84세,4862,1667,3195
202106,28245,인천광역시,계양구,80-84세,4886,1686,3200
202007,28245,인천광역시,계양구,85-89세,2430,672,1758
202008,28245,인천광역시,계양구,85-89세,2448,684,1764
202009,28245,인천광역시,계양구,85-89세,2467,689,1778
202010,28245,인천광역시,계양구,85-89세,2470,690,1780
202011,28245,인천광역시,계양구,85-89세,2485,699,1786
202012,28245,인천광역시,계양구,85-89세,2492,695,1797
202101,28245,인천광역시,계양구,85-89세,2486,698,1788
202102,28245,인천광역시,계양구,85-89세,2501,706,1795
202103,28245,인천광역시,계양구,85-89세,2535,716,1819
202104,28245,인천광역시,계양구,85-89세,2584,728,1856
202105,28245,인천광역시,계양구,85-89세,2646,750,1896
202106,28245,인천광역시,계양구,85-89세,2658,742,1916
202007,28245,인천광역시,계양구,90-94세,861,188,673
202008,28245,인천광역시,계양구,90-94세,872,191,681
202009,28245,인천광역시,계양구,90-94세,888,201,687
202010,28245,인천광역시,계양구,90-94세,909,203,706
202011,28245,인천광역시,계양구,90-94세,905,203,702
202012,28245,인천광역시,계양구,90-94세,910,200,710
202101,28245,인천광역시,계양구,90-94세,920,201,719
202102,28245,인천광역시,계양구,90-94세,934,206,728
202103,28245,인천광역시,계양구,90-94세,946,207,739
202104,28245,인천광역시,계양구,90-94세,947,201,746
202105,28245,인천광역시,계양구,90-94세,966,205,761
202106,28245,인천광역시,계양구,90-94세,979,209,770
202007,28245,인천광역시,계양구,95-99세,206,39,167
202008,28245,인천광역시,계양구,95-99세,208,41,167
202009,28245,인천광역시,계양구,95-99세,209,41,168
202010,28245,인천광역시,계양구,95-99세,205,39,166
202011,28245,인천광역시,계양구,95-99세,208,40,168
202012,28245,인천광역시,계양구,95-99세,211,43,168
202101,28245,인천광역시,계양구,95-99세,211,45,166
202102,28245,인천광역시,계양구,95-99세,210,44,166
202103,28245,인천광역시,계양구,95-99세,205,39,166
202104,28245,인천광역시,계양구,95-99세,205,40,165
202105,28245,인천광역시,계양구,95-99세,202,39,163
202106,28245,인천광역시,계양구,95-99세,201,40,161
202007,28245,인천광역시,계양구,100+,68,16,52
202008,28245,인천광역시,계양구,100+,68,16,52
202009,28245,인천광역시,계양구,100+,69,17,52
202010,28245,인천광역시,계양구,100+,70,17,53
202011,28245,인천광역시,계양구,100+,71,18,53
202012,28245,인천광역시,계양구,100+,71,18,53
202101,28245,인천광역시,계양구,100+,72,18,54
202102,28245,인천광역시,계양구,100+,71,18,53
202103,28245,인천광역시,계양구,100+,28,7,21
202104,28245,인천광역시,계양구,100+,26,7,19
202105,28245,인천광역시,계양구,100+,29,7,22
202106,28245,인천광역시,계양구,100+,30,7,23
202007,28260,인천광역시,서구,0-4세,22297,11501,10796
202008,28260,인천광역시,서구,0-4세,22124,11436,10688
202009,28260,인천광역시,서구,0-4세,21881,11296,10585
202010,28260,인천광역시,서구,0-4세,21623,11165,10458
202011,28260,인천광역시,서구,0-4세,21381,11038,10343
202012,28260,인천광역시,서구,0-4세,21127,10912,10215
202101,28260,인천광역시,서구,0-4세,20876,10782,10094
202102,28260,인천광역시,서구,0-4세,20650,10663,9987
202103,28260,인천광역시,서구,0-4세,20384,10513,9871
202104,28260,인천광역시,서구,0-4세,20249,10464,9785
202105,28260,인천광역시,서구,0-4세,20137,10403,9734
202106,28260,인천광역시,서구,0-4세,20010,10325,9685
202007,28260,인천광역시,서구,5-9세,29301,15136,14165
202008,28260,인천광역시,서구,5-9세,29227,15104,14123
202009,28260,인천광역시,서구,5-9세,29086,15039,14047
202010,28260,인천광역시,서구,5-9세,28948,14983,13965
202011,28260,인천광역시,서구,5-9세,28826,14941,13885
202012,28260,인천광역시,서구,5-9세,28780,14918,13862
202101,28260,인천광역시,서구,5-9세,28632,14832,13800
202102,28260,인천광역시,서구,5-9세,28501,14780,13721
202103,28260,인천광역시,서구,5-9세,28473,14761,13712
202104,28260,인천광역시,서구,5-9세,28342,14680,13662
202105,28260,인천광역시,서구,5-9세,28245,14616,13629
202106,28260,인천광역시,서구,5-9세,28188,14591,13597
202007,28260,인천광역시,서구,10-14세,28174,14395,13779
202008,28260,인천광역시,서구,10-14세,28181,14392,13789
202009,28260,인천광역시,서구,10-14세,28265,14450,13815
202010,28260,인천광역시,서구,10-14세,28296,14448,13848
202011,28260,인천광역시,서구,10-14세,28330,14474,13856
202012,28260,인천광역시,서구,10-14세,28324,14461,13863
202101,28260,인천광역시,서구,10-14세,28363,14475,13888
202102,28260,인천광역시,서구,10-14세,28390,14498,13892
202103,28260,인천광역시,서구,10-14세,28474,14518,13956
202104,28260,인천광역시,서구,10-14세,28503,14529,13974
202105,28260,인천광역시,서구,10-14세,28565,14562,14003
202106,28260,인천광역시,서구,10-14세,28604,14579,14025
202007,28260,인천광역시,서구,15-19세,28845,14793,14052
202008,28260,인천광역시,서구,15-19세,28751,14732,14019
202009,28260,인천광역시,서구,15-19세,28600,14662,13938
202010,28260,인천광역시,서구,15-19세,28484,14617,13867
202011,28260,인천광역시,서구,15-19세,28347,14572,13775
202012,28260,인천광역시,서구,15-19세,28303,14560,13743
202101,28260,인천광역시,서구,15-19세,28211,14512,13699
202102,28260,인천광역시,서구,15-19세,28034,14438,13596
202103,28260,인천광역시,서구,15-19세,27842,14345,13497
202104,28260,인천광역시,서구,15-19세,27762,14269,13493
202105,28260,인천광역시,서구,15-19세,27687,14255,13432
202106,28260,인천광역시,서구,15-19세,27653,14231,13422
202007,28260,인천광역시,서구,20-24세,34697,17903,16794
202008,28260,인천광역시,서구,20-24세,34579,17839,16740
202009,28260,인천광역시,서구,20-24세,34451,17730,16721
202010,28260,인천광역시,서구,20-24세,34387,17730,16657
202011,28260,인천광역시,서구,20-24세,34353,17693,16660
202012,28260,인천광역시,서구,20-24세,34152,17607,16545
202101,28260,인천광역시,서구,20-24세,34051,17523,16528
202102,28260,인천광역시,서구,20-24세,33886,17450,16436
202103,28260,인천광역시,서구,20-24세,33707,17375,16332
202104,28260,인천광역시,서구,20-24세,33671,17375,16296
202105,28260,인천광역시,서구,20-24세,33613,17311,16302
202106,28260,인천광역시,서구,20-24세,33596,17303,16293
202007,28260,인천광역시,서구,25-29세,38448,20084,18364
202008,28260,인천광역시,서구,25-29세,38397,20031,18366
202009,28260,인천광역시,서구,25-29세,38442,20122,18320
202010,28260,인천광역시,서구,25-29세,38459,20107,18352
202011,28260,인천광역시,서구,25-29세,38399,20055,18344
202012,28260,인천광역시,서구,25-29세,38451,20059,18392
202101,28260,인천광역시,서구,25-29세,38395,20062,18333
202102,28260,인천광역시,서구,25-29세,38198,19960,18238
202103,28260,인천광역시,서구,25-29세,38194,19975,18219
202104,28260,인천광역시,서구,25-29세,38156,19923,18233
202105,28260,인천광역시,서구,25-29세,38164,19931,18233
202106,28260,인천광역시,서구,25-29세,38134,19934,18200
202007,28260,인천광역시,서구,30-34세,35358,17959,17399
202008,28260,인천광역시,서구,30-34세,35255,17939,17316
202009,28260,인천광역시,서구,30-34세,35209,17898,17311
202010,28260,인천광역시,서구,30-34세,35134,17880,17254
202011,28260,인천광역시,서구,30-34세,35091,17848,17243
202012,28260,인천광역시,서구,30-34세,35015,17846,17169
202101,28260,인천광역시,서구,30-34세,34925,17818,17107
202102,28260,인천광역시,서구,30-34세,34779,17742,17037
202103,28260,인천광역시,서구,30-34세,34764,17745,17019
202104,28260,인천광역시,서구,30-34세,34767,17762,17005
202105,28260,인천광역시,서구,30-34세,34925,17846,17079
202106,28260,인천광역시,서구,30-34세,35071,17945,17126
202007,28260,인천광역시,서구,35-39세,45677,23418,22259
202008,28260,인천광역시,서구,35-39세,45450,23296,22154
202009,28260,인천광역시,서구,35-39세,45164,23201,21963
202010,28260,인천광역시,서구,35-39세,44903,23018,21885
202011,28260,인천광역시,서구,35-39세,44715,22902,21813
202012,28260,인천광역시,서구,35-39세,44424,22726,21698
202101,28260,인천광역시,서구,35-39세,44145,22568,21577
202102,28260,인천광역시,서구,35-39세,43827,22383,21444
202103,28260,인천광역시,서구,35-39세,43509,22243,21266
202104,28260,인천광역시,서구,35-39세,43370,22188,21182
202105,28260,인천광역시,서구,35-39세,43100,22045,21055
202106,28260,인천광역시,서구,35-39세,42844,21895,20949
202007,28260,인천광역시,서구,40-44세,46087,23561,22526
202008,28260,인천광역시,서구,40-44세,46053,23514,22539
202009,28260,인천광역시,서구,40-44세,46229,23570,22659
202010,28260,인천광역시,서구,40-44세,46296,23633,22663
202011,28260,인천광역시,서구,40-44세,46314,23666,22648
202012,28260,인천광역시,서구,40-44세,46230,23632,22598
202101,28260,인천광역시,서구,40-44세,46225,23639,22586
202102,28260,인천광역시,서구,40-44세,46367,23761,22606
202103,28260,인천광역시,서구,40-44세,46306,23717,22589
202104,28260,인천광역시,서구,40-44세,46351,23766,22585
202105,28260,인천광역시,서구,40-44세,46508,23872,22636
202106,28260,인천광역시,서구,40-44세,46825,24048,22777
202007,28260,인천광역시,서구,45-49세,50039,25431,24608
202008,28260,인천광역시,서구,45-49세,49847,25358,24489
202009,28260,인천광역시,서구,45-49세,49567,25257,24310
202010,28260,인천광역시,서구,45-49세,49294,25116,24178
202011,28260,인천광역시,서구,45-49세,49203,25036,24167
202012,28260,인천광역시,서구,45-49세,49121,25005,24116
202101,28260,인천광역시,서구,45-49세,49020,24953,24067
202102,28260,인천광역시,서구,45-49세,48880,24857,24023
202103,28260,인천광역시,서구,45-49세,48734,24765,23969
202104,28260,인천광역시,서구,45-49세,48699,24742,23957
202105,28260,인천광역시,서구,45-49세,48377,24575,23802
202106,28260,인천광역시,서구,45-49세,48209,24536,23673
202007,28260,인천광역시,서구,50-54세,48187,24158,24029
202008,28260,인천광역시,서구,50-54세,48279,24206,24073
202009,28260,인천광역시,서구,50-54세,48330,24234,24096
202010,28260,인천광역시,서구,50-54세,48397,24287,24110
202011,28260,인천광역시,서구,50-54세,48434,24338,24096
202012,28260,인천광역시,서구,50-54세,48259,24252,24007
202101,28260,인천광역시,서구,50-54세,48586,24440,24146
202102,28260,인천광역시,서구,50-54세,48621,24460,24161
202103,28260,인천광역시,서구,50-54세,48533,24424,24109
202104,28260,인천광역시,서구,50-54세,48525,24445,24080
202105,28260,인천광역시,서구,50-54세,48806,24566,24240
202106,28260,인천광역시,서구,50-54세,49012,24673,24339
202007,28260,인천광역시,서구,55-59세,45054,23137,21917
202008,28260,인천광역시,서구,55-59세,44936,23095,21841
202009,28260,인천광역시,서구,55-59세,45012,23128,21884
202010,28260,인천광역시,서구,55-59세,45063,23188,21875
202011,28260,인천광역시,서구,55-59세,44993,23120,21873
202012,28260,인천광역시,서구,55-59세,45153,23156,21997
202101,28260,인천광역시,서구,55-59세,44894,23030,21864
202102,28260,인천광역시,서구,55-59세,44858,22975,21883
202103,28260,인천광역시,서구,55-59세,44812,22902,21910
202104,28260,인천광역시,서구,55-59세,44754,22852,21902
202105,28260,인천광역시,서구,55-59세,44629,22766,21863
202106,28260,인천광역시,서구,55-59세,44434,22659,21775
202007,28260,인천광역시,서구,60-64세,35575,18295,17280
202008,28260,인천광역시,서구,60-64세,35822,18450,17372
202009,28260,인천광역시,서구,60-64세,35994,18548,17446
202010,28260,인천광역시,서구,60-64세,36203,18621,17582
202011,28260,인천광역시,서구,60-64세,36437,18770,17667
202012,28260,인천광역시,서구,60-64세,36614,18877,17737
202101,28260,인천광역시,서구,60-64세,36998,19062,17936
202102,28260,인천광역시,서구,60-64세,37244,19201,18043
202103,28260,인천광역시,서구,60-64세,37541,19345,18196
202104,28260,인천광역시,서구,60-64세,37778,19462,18316
202105,28260,인천광역시,서구,60-64세,38083,19642,18441
202106,28260,인천광역시,서구,60-64세,38519,19858,18661
202007,28260,인천광역시,서구,65-69세,20629,10349,10280
202008,28260,인천광역시,서구,65-69세,20805,10397,10408
202009,28260,인천광역시,서구,65-69세,21092,10535,10557
202010,28260,인천광역시,서구,65-69세,21314,10638,10676
202011,28260,인천광역시,서구,65-69세,21498,10716,10782
202012,28260,인천광역시,서구,65-69세,21698,10801,10897
202101,28260,인천광역시,서구,65-69세,21934,10934,11000
202102,28260,인천광역시,서구,65-69세,22213,11088,11125
202103,28260,인천광역시,서구,65-69세,22530,11259,11271
202104,28260,인천광역시,서구,65-69세,22767,11384,11383
202105,28260,인천광역시,서구,65-69세,22996,11478,11518
202106,28260,인천광역시,서구,65-69세,23151,11537,11614
202007,28260,인천광역시,서구,70-74세,14079,6769,7310
202008,28260,인천광역시,서구,70-74세,14111,6790,7321
202009,28260,인천광역시,서구,70-74세,14203,6831,7372
202010,28260,인천광역시,서구,70-74세,14270,6870,7400
202011,28260,인천광역시,서구,70-74세,14364,6920,7444
202012,28260,인천광역시,서구,70-74세,14457,6953,7504
202101,28260,인천광역시,서구,70-74세,14566,7032,7534
202102,28260,인천광역시,서구,70-74세,14613,7044,7569
202103,28260,인천광역시,서구,70-74세,14639,7058,7581
202104,28260,인천광역시,서구,70-74세,14683,7078,7605
202105,28260,인천광역시,서구,70-74세,14700,7098,7602
202106,28260,인천광역시,서구,70-74세,14731,7127,7604
202007,28260,인천광역시,서구,75-79세,9927,4252,5675
202008,28260,인천광역시,서구,75-79세,9945,4254,5691
202009,28260,인천광역시,서구,75-79세,9910,4262,5648
202010,28260,인천광역시,서구,75-79세,9926,4291,5635
202011,28260,인천광역시,서구,75-79세,9923,4286,5637
202012,28260,인천광역시,서구,75-79세,9898,4272,5626
202101,28260,인천광역시,서구,75-79세,9909,4275,5634
202102,28260,인천광역시,서구,75-79세,9905,4293,5612
202103,28260,인천광역시,서구,75-79세,9895,4283,5612
202104,28260,인천광역시,서구,75-79세,9878,4288,5590
202105,28260,인천광역시,서구,75-79세,9880,4287,5593
202106,28260,인천광역시,서구,75-79세,9906,4301,5605
202007,28260,인천광역시,서구,80-84세,6678,2346,4332
202008,28260,인천광역시,서구,80-84세,6718,2377,4341
202009,28260,인천광역시,서구,80-84세,6728,2383,4345
202010,28260,인천광역시,서구,80-84세,6711,2370,4341
202011,28260,인천광역시,서구,80-84세,6702,2376,4326
202012,28260,인천광역시,서구,80-84세,6692,2381,4311
202101,28260,인천광역시,서구,80-84세,6703,2386,4317
202102,28260,인천광역시,서구,80-84세,6710,2380,4330
202103,28260,인천광역시,서구,80-84세,6705,2398,4307
202104,28260,인천광역시,서구,80-84세,6738,2407,4331
202105,28260,인천광역시,서구,80-84세,6791,2449,4342
202106,28260,인천광역시,서구,80-84세,6839,2466,4373
202007,28260,인천광역시,서구,85-89세,3372,922,2450
202008,28260,인천광역시,서구,85-89세,3399,931,2468
202009,28260,인천광역시,서구,85-89세,3430,940,2490
202010,28260,인천광역시,서구,85-89세,3498,970,2528
202011,28260,인천광역시,서구,85-89세,3525,979,2546
202012,28260,인천광역시,서구,85-89세,3563,998,2565
202101,28260,인천광역시,서구,85-89세,3602,1007,2595
202102,28260,인천광역시,서구,85-89세,3668,1031,2637
202103,28260,인천광역시,서구,85-89세,3699,1028,2671
202104,28260,인천광역시,서구,85-89세,3743,1038,2705
202105,28260,인천광역시,서구,85-89세,3779,1043,2736
202106,28260,인천광역시,서구,85-89세,3780,1044,2736
202007,28260,인천광역시,서구,90-94세,1309,250,1059
202008,28260,인천광역시,서구,90-94세,1327,247,1080
202009,28260,인천광역시,서구,90-94세,1344,255,1089
202010,28260,인천광역시,서구,90-94세,1351,260,1091
202011,28260,인천광역시,서구,90-94세,1355,263,1092
202012,28260,인천광역시,서구,90-94세,1357,269,1088
202101,28260,인천광역시,서구,90-94세,1359,271,1088
202102,28260,인천광역시,서구,90-94세,1383,272,1111
202103,28260,인천광역시,서구,90-94세,1394,276,1118
202104,28260,인천광역시,서구,90-94세,1395,278,1117
202105,28260,인천광역시,서구,90-94세,1403,283,1120
202106,28260,인천광역시,서구,90-94세,1401,282,1119
202007,28260,인천광역시,서구,95-99세,313,63,250
202008,28260,인천광역시,서구,95-99세,321,66,255
202009,28260,인천광역시,서구,95-99세,322,65,257
202010,28260,인천광역시,서구,95-99세,319,63,256
202011,28260,인천광역시,서구,95-99세,314,62,252
202012,28260,인천광역시,서구,95-99세,312,56,256
202101,28260,인천광역시,서구,95-99세,318,56,262
202102,28260,인천광역시,서구,95-99세,320,56,264
202103,28260,인천광역시,서구,95-99세,319,54,265
202104,28260,인천광역시,서구,95-99세,327,54,273
202105,28260,인천광역시,서구,95-99세,327,55,272
202106,28260,인천광역시,서구,95-99세,320,53,267
202007,28260,인천광역시,서구,100+,101,33,68
202008,28260,인천광역시,서구,100+,100,33,67
202009,28260,인천광역시,서구,100+,106,35,71
202010,28260,인천광역시,서구,100+,106,35,71
202011,28260,인천광역시,서구,100+,107,35,72
202012,28260,인천광역시,서구,100+,110,37,73
202101,28260,인천광역시,서구,100+,111,36,75
202102,28260,인천광역시,서구,100+,117,37,80
202103,28260,인천광역시,서구,100+,78,24,54
202104,28260,인천광역시,서구,100+,74,23,51
202105,28260,인천광역시,서구,100+,75,23,52
202106,28260,인천광역시,서구,100+,77,24,53
202007,28710,인천광역시,강화군,0-4세,1404,737,667
202008,28710,인천광역시,강화군,0-4세,1396,732,664
202009,28710,인천광역시,강화군,0-4세,1415,750,665
202010,28710,인천광역시,강화군,0-4세,1427,758,669
202011,28710,인천광역시,강화군,0-4세,1424,751,673
202012,28710,인천광역시,강화군,0-4세,1440,756,684
202101,28710,인천광역시,강화군,0-4세,1448,762,686
202102,28710,인천광역시,강화군,0-4세,1428,758,670
202103,28710,인천광역시,강화군,0-4세,1419,750,669
202104,28710,인천광역시,강화군,0-4세,1418,753,665
202105,28710,인천광역시,강화군,0-4세,1418,755,663
202106,28710,인천광역시,강화군,0-4세,1421,753,668
202007,28710,인천광역시,강화군,5-9세,1907,995,912
202008,28710,인천광역시,강화군,5-9세,1920,1002,918
202009,28710,인천광역시,강화군,5-9세,1933,1012,921
202010,28710,인천광역시,강화군,5-9세,1923,1001,922
202011,28710,인천광역시,강화군,5-9세,1906,1001,905
202012,28710,인천광역시,강화군,5-9세,1894,998,896
202101,28710,인천광역시,강화군,5-9세,1891,1001,890
202102,28710,인천광역시,강화군,5-9세,1882,991,891
202103,28710,인천광역시,강화군,5-9세,1889,999,890
202104,28710,인천광역시,강화군,5-9세,1882,990,892
202105,28710,인천광역시,강화군,5-9세,1882,982,900
202106,28710,인천광역시,강화군,5-9세,1887,987,900
202007,28710,인천광역시,강화군,10-14세,2261,1163,1098
202008,28710,인천광역시,강화군,10-14세,2248,1164,1084
202009,28710,인천광역시,강화군,10-14세,2242,1161,1081
202010,28710,인천광역시,강화군,10-14세,2250,1172,1078
202011,28710,인천광역시,강화군,10-14세,2261,1170,1091
202012,28710,인천광역시,강화군,10-14세,2256,1165,1091
202101,28710,인천광역시,강화군,10-14세,2262,1165,1097
202102,28710,인천광역시,강화군,10-14세,2280,1171,1109
202103,28710,인천광역시,강화군,10-14세,2254,1152,1102
202104,28710,인천광역시,강화군,10-14세,2259,1158,1101
202105,28710,인천광역시,강화군,10-14세,2263,1170,1093
202106,28710,인천광역시,강화군,10-14세,2264,1171,1093
202007,28710,인천광역시,강화군,15-19세,2383,1224,1159
202008,28710,인천광역시,강화군,15-19세,2377,1217,1160
202009,28710,인천광역시,강화군,15-19세,2367,1213,1154
202010,28710,인천광역시,강화군,15-19세,2363,1210,1153
202011,28710,인천광역시,강화군,15-19세,2369,1212,1157
202012,28710,인천광역시,강화군,15-19세,2361,1205,1156
202101,28710,인천광역시,강화군,15-19세,2342,1199,1143
202102,28710,인천광역시,강화군,15-19세,2339,1203,1136
202103,28710,인천광역시,강화군,15-19세,2313,1183,1130
202104,28710,인천광역시,강화군,15-19세,2288,1169,1119
202105,28710,인천광역시,강화군,15-19세,2284,1166,1118
202106,28710,인천광역시,강화군,15-19세,2274,1152,1122
202007,28710,인천광역시,강화군,20-24세,2809,1590,1219
202008,28710,인천광역시,강화군,20-24세,2788,1585,1203
202009,28710,인천광역시,강화군,20-24세,2774,1567,1207
202010,28710,인천광역시,강화군,20-24세,2757,1558,1199
202011,28710,인천광역시,강화군,20-24세,2748,1550,1198
202012,28710,인천광역시,강화군,20-24세,2741,1549,1192
202101,28710,인천광역시,강화군,20-24세,2728,1540,1188
202102,28710,인천광역시,강화군,20-24세,2697,1524,1173
202103,28710,인천광역시,강화군,20-24세,2691,1517,1174
202104,28710,인천광역시,강화군,20-24세,2668,1504,1164
202105,28710,인천광역시,강화군,20-24세,2660,1498,1162
202106,28710,인천광역시,강화군,20-24세,2654,1495,1159
202007,28710,인천광역시,강화군,25-29세,2655,1556,1099
202008,28710,인천광역시,강화군,25-29세,2634,1540,1094
202009,28710,인천광역시,강화군,25-29세,2625,1528,1097
202010,28710,인천광역시,강화군,25-29세,2610,1509,1101
202011,28710,인천광역시,강화군,25-29세,2599,1508,1091
202012,28710,인천광역시,강화군,25-29세,2615,1511,1104
202101,28710,인천광역시,강화군,25-29세,2602,1500,1102
202102,28710,인천광역시,강화군,25-29세,2555,1467,1088
202103,28710,인천광역시,강화군,25-29세,2522,1449,1073
202104,28710,인천광역시,강화군,25-29세,2539,1451,1088
202105,28710,인천광역시,강화군,25-29세,2536,1438,1098
202106,28710,인천광역시,강화군,25-29세,2530,1443,1087
202007,28710,인천광역시,강화군,30-34세,2371,1285,1086
202008,28710,인천광역시,강화군,30-34세,2370,1296,1074
202009,28710,인천광역시,강화군,30-34세,2368,1285,1083
202010,28710,인천광역시,강화군,30-34세,2357,1290,1067
202011,28710,인천광역시,강화군,30-34세,2354,1290,1064
202012,28710,인천광역시,강화군,30-34세,2363,1290,1073
202101,28710,인천광역시,강화군,30-34세,2384,1302,1082
202102,28710,인천광역시,강화군,30-34세,2400,1309,1091
202103,28710,인천광역시,강화군,30-34세,2384,1289,1095
202104,28710,인천광역시,강화군,30-34세,2391,1303,1088
202105,28710,인천광역시,강화군,30-34세,2403,1314,1089
202106,28710,인천광역시,강화군,30-34세,2433,1324,1109
202007,28710,인천광역시,강화군,35-39세,3017,1541,1476
202008,28710,인천광역시,강화군,35-39세,3014,1534,1480
202009,28710,인천광역시,강화군,35-39세,2985,1522,1463
202010,28710,인천광역시,강화군,35-39세,2970,1505,1465
202011,28710,인천광역시,강화군,35-39세,2982,1515,1467
202012,28710,인천광역시,강화군,35-39세,2963,1508,1455
202101,28710,인천광역시,강화군,35-39세,2941,1493,1448
202102,28710,인천광역시,강화군,35-39세,2919,1471,1448
202103,28710,인천광역시,강화군,35-39세,2913,1474,1439
202104,28710,인천광역시,강화군,35-39세,2890,1466,1424
202105,28710,인천광역시,강화군,35-39세,2892,1469,1423
202106,28710,인천광역시,강화군,35-39세,2884,1468,1416
202007,28710,인천광역시,강화군,40-44세,3341,1781,1560
202008,28710,인천광역시,강화군,40-44세,3335,1775,1560
202009,28710,인천광역시,강화군,40-44세,3373,1790,1583
202010,28710,인천광역시,강화군,40-44세,3389,1804,1585
202011,28710,인천광역시,강화군,40-44세,3373,1775,1598
202012,28710,인천광역시,강화군,40-44세,3400,1801,1599
202101,28710,인천광역시,강화군,40-44세,3412,1799,1613
202102,28710,인천광역시,강화군,40-44세,3433,1819,1614
202103,28710,인천광역시,강화군,40-44세,3411,1812,1599
202104,28710,인천광역시,강화군,40-44세,3423,1816,1607
202105,28710,인천광역시,강화군,40-44세,3432,1830,1602
202106,28710,인천광역시,강화군,40-44세,3450,1842,1608
202007,28710,인천광역시,강화군,45-49세,4482,2482,2000
202008,28710,인천광역시,강화군,45-49세,4436,2460,1976
202009,28710,인천광역시,강화군,45-49세,4394,2435,1959
202010,28710,인천광역시,강화군,45-49세,4374,2425,1949
202011,28710,인천광역시,강화군,45-49세,4367,2428,1939
202012,28710,인천광역시,강화군,45-49세,4364,2420,1944
202101,28710,인천광역시,강화군,45-49세,4358,2426,1932
202102,28710,인천광역시,강화군,45-49세,4331,2404,1927
202103,28710,인천광역시,강화군,45-49세,4271,2359,1912
202104,28710,인천광역시,강화군,45-49세,4255,2352,1903
202105,28710,인천광역시,강화군,45-49세,4237,2339,1898
202106,28710,인천광역시,강화군,45-49세,4220,2314,1906
202007,28710,인천광역시,강화군,50-54세,5264,2751,2513
202008,28710,인천광역시,강화군,50-54세,5248,2740,2508
202009,28710,인천광역시,강화군,50-54세,5245,2746,2499
202010,28710,인천광역시,강화군,50-54세,5234,2740,2494
202011,28710,인천광역시,강화군,50-54세,5225,2736,2489
202012,28710,인천광역시,강화군,50-54세,5216,2722,2494
202101,28710,인천광역시,강화군,50-54세,5207,2708,2499
202102,28710,인천광역시,강화군,50-54세,5211,2703,2508
202103,28710,인천광역시,강화군,50-54세,5169,2697,2472
202104,28710,인천광역시,강화군,50-54세,5180,2703,2477
202105,28710,인천광역시,강화군,50-54세,5207,2716,2491
202106,28710,인천광역시,강화군,50-54세,5209,2731,2478
202007,28710,인천광역시,강화군,55-59세,6817,3459,3358
202008,28710,인천광역시,강화군,55-59세,6818,3467,3351
202009,28710,인천광역시,강화군,55-59세,6787,3444,3343
202010,28710,인천광역시,강화군,55-59세,6771,3446,3325
202011,28710,인천광역시,강화군,55-59세,6738,3427,3311
202012,28710,인천광역시,강화군,55-59세,6747,3432,3315
202101,28710,인천광역시,강화군,55-59세,6713,3411,3302
202102,28710,인천광역시,강화군,55-59세,6670,3405,3265
202103,28710,인천광역시,강화군,55-59세,6613,3357,3256
202104,28710,인천광역시,강화군,55-59세,6584,3337,3247
202105,28710,인천광역시,강화군,55-59세,6563,3329,3234
202106,28710,인천광역시,강화군,55-59세,6504,3301,3203
202007,28710,인천광역시,강화군,60-64세,7833,3872,3961
202008,28710,인천광역시,강화군,60-64세,7860,3889,3971
202009,28710,인천광역시,강화군,60-64세,7925,3934,3991
202010,28710,인천광역시,강화군,60-64세,7947,3933,4014
202011,28710,인천광역시,강화군,60-64세,7983,3975,4008
202012,28710,인천광역시,강화군,60-64세,8019,3992,4027
202101,28710,인천광역시,강화군,60-64세,8041,4001,4040
202102,28710,인천광역시,강화군,60-64세,8079,4031,4048
202103,28710,인천광역시,강화군,60-64세,8120,4063,4057
202104,28710,인천광역시,강화군,60-64세,8163,4071,4092
202105,28710,인천광역시,강화군,60-64세,8215,4101,4114
202106,28710,인천광역시,강화군,60-64세,8281,4115,4166
202007,28710,인천광역시,강화군,65-69세,6009,2996,3013
202008,28710,인천광역시,강화군,65-69세,6055,3016,3039
202009,28710,인천광역시,강화군,65-69세,6108,3040,3068
202010,28710,인천광역시,강화군,65-69세,6160,3081,3079
202011,28710,인천광역시,강화군,65-69세,6192,3092,3100
202012,28710,인천광역시,강화군,65-69세,6258,3122,3136
202101,28710,인천광역시,강화군,65-69세,6320,3161,3159
202102,28710,인천광역시,강화군,65-69세,6387,3188,3199
202103,28710,인천광역시,강화군,65-69세,6460,3221,3239
202104,28710,인천광역시,강화군,65-69세,6544,3268,3276
202105,28710,인천광역시,강화군,65-69세,6596,3304,3292
202106,28710,인천광역시,강화군,65-69세,6618,3317,3301
202007,28710,인천광역시,강화군,70-74세,5369,2629,2740
202008,28710,인천광역시,강화군,70-74세,5386,2639,2747
202009,28710,인천광역시,강화군,70-74세,5410,2651,2759
202010,28710,인천광역시,강화군,70-74세,5425,2646,2779
202011,28710,인천광역시,강화군,70-74세,5462,2674,2788
202012,28710,인천광역시,강화군,70-74세,5475,2685,2790
202101,28710,인천광역시,강화군,70-74세,5490,2691,2799
202102,28710,인천광역시,강화군,70-74세,5489,2693,2796
202103,28710,인천광역시,강화군,70-74세,5465,2684,2781
202104,28710,인천광역시,강화군,70-74세,5457,2685,2772
202105,28710,인천광역시,강화군,70-74세,5455,2678,2777
202106,28710,인천광역시,강화군,70-74세,5471,2693,2778
202007,28710,인천광역시,강화군,75-79세,4744,2136,2608
202008,28710,인천광역시,강화군,75-79세,4717,2123,2594
202009,28710,인천광역시,강화군,75-79세,4696,2126,2570
202010,28710,인천광역시,강화군,75-79세,4666,2107,2559
202011,28710,인천광역시,강화군,75-79세,4640,2085,2555
202012,28710,인천광역시,강화군,75-79세,4604,2052,2552
202101,28710,인천광역시,강화군,75-79세,4567,2043,2524
202102,28710,인천광역시,강화군,75-79세,4531,2022,2509
202103,28710,인천광역시,강화군,75-79세,4532,2034,2498
202104,28710,인천광역시,강화군,75-79세,4531,2035,2496
202105,28710,인천광역시,강화군,75-79세,4524,2039,2485
202106,28710,인천광역시,강화군,75-79세,4521,2030,2491
202007,28710,인천광역시,강화군,80-84세,3546,1504,2042
202008,28710,인천광역시,강화군,80-84세,3562,1518,2044
202009,28710,인천광역시,강화군,80-84세,3569,1513,2056
202010,28710,인천광역시,강화군,80-84세,3576,1516,2060
202011,28710,인천광역시,강화군,80-84세,3557,1506,2051
202012,28710,인천광역시,강화군,80-84세,3573,1510,2063
202101,28710,인천광역시,강화군,80-84세,3586,1512,2074
202102,28710,인천광역시,강화군,80-84세,3605,1539,2066
202103,28710,인천광역시,강화군,80-84세,3598,1536,2062
202104,28710,인천광역시,강화군,80-84세,3618,1543,2075
202105,28710,인천광역시,강화군,80-84세,3627,1546,2081
202106,28710,인천광역시,강화군,80-84세,3630,1548,2082
202007,28710,인천광역시,강화군,85-89세,2007,684,1323
202008,28710,인천광역시,강화군,85-89세,2019,688,1331
202009,28710,인천광역시,강화군,85-89세,2018,690,1328
202010,28710,인천광역시,강화군,85-89세,2026,697,1329
202011,28710,인천광역시,강화군,85-89세,2050,704,1346
202012,28710,인천광역시,강화군,85-89세,2070,721,1349
202101,28710,인천광역시,강화군,85-89세,2098,741,1357
202102,28710,인천광역시,강화군,85-89세,2129,744,1385
202103,28710,인천광역시,강화군,85-89세,2124,739,1385
202104,28710,인천광역시,강화군,85-89세,2139,745,1394
202105,28710,인천광역시,강화군,85-89세,2153,746,1407
202106,28710,인천광역시,강화군,85-89세,2166,754,1412
202007,28710,인천광역시,강화군,90-94세,608,142,466
202008,28710,인천광역시,강화군,90-94세,612,146,466
202009,28710,인천광역시,강화군,90-94세,624,151,473
202010,28710,인천광역시,강화군,90-94세,633,149,484
202011,28710,인천광역시,강화군,90-94세,635,154,481
202012,28710,인천광역시,강화군,90-94세,632,151,481
202101,28710,인천광역시,강화군,90-94세,643,155,488
202102,28710,인천광역시,강화군,90-94세,656,159,497
202103,28710,인천광역시,강화군,90-94세,667,158,509
202104,28710,인천광역시,강화군,90-94세,668,163,505
202105,28710,인천광역시,강화군,90-94세,673,163,510
202106,28710,인천광역시,강화군,90-94세,673,163,510
202007,28710,인천광역시,강화군,95-99세,167,46,121
202008,28710,인천광역시,강화군,95-99세,171,44,127
202009,28710,인천광역시,강화군,95-99세,175,45,130
202010,28710,인천광역시,강화군,95-99세,176,47,129
202011,28710,인천광역시,강화군,95-99세,174,45,129
202012,28710,인천광역시,강화군,95-99세,177,45,132
202101,28710,인천광역시,강화군,95-99세,174,44,130
202102,28710,인천광역시,강화군,95-99세,175,42,133
202103,28710,인천광역시,강화군,95-99세,174,41,133
202104,28710,인천광역시,강화군,95-99세,172,39,133
202105,28710,인천광역시,강화군,95-99세,173,37,136
202106,28710,인천광역시,강화군,95-99세,177,38,139
202007,28710,인천광역시,강화군,100+,38,9,29
202008,28710,인천광역시,강화군,100+,37,10,27
202009,28710,인천광역시,강화군,100+,37,10,27
202010,28710,인천광역시,강화군,100+,35,9,26
202011,28710,인천광역시,강화군,100+,35,9,26
202012,28710,인천광역시,강화군,100+,35,9,26
202101,28710,인천광역시,강화군,100+,38,10,28
202102,28710,인천광역시,강화군,100+,40,12,28
202103,28710,인천광역시,강화군,100+,19,5,14
202104,28710,인천광역시,강화군,100+,20,6,14
202105,28710,인천광역시,강화군,100+,19,6,13
202106,28710,인천광역시,강화군,100+,18,5,13
202007,28720,인천광역시,옹진군,0-4세,456,237,219
202008,28720,인천광역시,옹진군,0-4세,451,236,215
202009,28720,인천광역시,옹진군,0-4세,449,233,216
202010,28720,인천광역시,옹진군,0-4세,444,230,214
202011,28720,인천광역시,옹진군,0-4세,436,226,210
202012,28720,인천광역시,옹진군,0-4세,441,228,213
202101,28720,인천광역시,옹진군,0-4세,439,225,214
202102,28720,인천광역시,옹진군,0-4세,433,215,218
202103,28720,인천광역시,옹진군,0-4세,426,210,216
202104,28720,인천광역시,옹진군,0-4세,421,207,214
202105,28720,인천광역시,옹진군,0-4세,418,205,213
202106,28720,인천광역시,옹진군,0-4세,412,204,208
202007,28720,인천광역시,옹진군,5-9세,511,259,252
202008,28720,인천광역시,옹진군,5-9세,520,267,253
202009,28720,인천광역시,옹진군,5-9세,515,266,249
202010,28720,인천광역시,옹진군,5-9세,517,272,245
202011,28720,인천광역시,옹진군,5-9세,512,264,248
202012,28720,인천광역시,옹진군,5-9세,498,254,244
202101,28720,인천광역시,옹진군,5-9세,506,257,249
202102,28720,인천광역시,옹진군,5-9세,505,260,245
202103,28720,인천광역시,옹진군,5-9세,498,259,239
202104,28720,인천광역시,옹진군,5-9세,496,260,236
202105,28720,인천광역시,옹진군,5-9세,498,259,239
202106,28720,인천광역시,옹진군,5-9세,501,261,240
202007,28720,인천광역시,옹진군,10-14세,513,265,248
202008,28720,인천광역시,옹진군,10-14세,506,256,250
202009,28720,인천광역시,옹진군,10-14세,519,263,256
202010,28720,인천광역시,옹진군,10-14세,524,261,263
202011,28720,인천광역시,옹진군,10-14세,527,268,259
202012,28720,인천광역시,옹진군,10-14세,528,264,264
202101,28720,인천광역시,옹진군,10-14세,528,264,264
202102,28720,인천광역시,옹진군,10-14세,518,257,261
202103,28720,인천광역시,옹진군,10-14세,516,255,261
202104,28720,인천광역시,옹진군,10-14세,519,261,258
202105,28720,인천광역시,옹진군,10-14세,522,265,257
202106,28720,인천광역시,옹진군,10-14세,521,269,252
202007,28720,인천광역시,옹진군,15-19세,621,358,263
202008,28720,인천광역시,옹진군,15-19세,623,354,269
202009,28720,인천광역시,옹진군,15-19세,602,339,263
202010,28720,인천광역시,옹진군,15-19세,597,342,255
202011,28720,인천광역시,옹진군,15-19세,589,336,253
202012,28720,인천광역시,옹진군,15-19세,574,329,245
202101,28720,인천광역시,옹진군,15-19세,563,324,239
202102,28720,인천광역시,옹진군,15-19세,557,323,234
202103,28720,인천광역시,옹진군,15-19세,554,320,234
202104,28720,인천광역시,옹진군,15-19세,549,315,234
202105,28720,인천광역시,옹진군,15-19세,553,316,237
202106,28720,인천광역시,옹진군,15-19세,556,315,241
202007,28720,인천광역시,옹진군,20-24세,1372,1028,344
202008,28720,인천광역시,옹진군,20-24세,1367,1031,336
202009,28720,인천광역시,옹진군,20-24세,1388,1054,334
202010,28720,인천광역시,옹진군,20-24세,1412,1064,348
202011,28720,인천광역시,옹진군,20-24세,1420,1068,352
202012,28720,인천광역시,옹진군,20-24세,1427,1068,359
202101,28720,인천광역시,옹진군,20-24세,1403,1049,354
202102,28720,인천광역시,옹진군,20-24세,1384,1034,350
202103,28720,인천광역시,옹진군,20-24세,1368,1013,355
202104,28720,인천광역시,옹진군,20-24세,1352,997,355
202105,28720,인천광역시,옹진군,20-24세,1324,972,352
202106,28720,인천광역시,옹진군,20-24세,1333,976,357
202007,28720,인천광역시,옹진군,25-29세,1298,913,385
202008,28720,인천광역시,옹진군,25-29세,1281,904,377
202009,28720,인천광역시,옹진군,25-29세,1278,909,369
202010,28720,인천광역시,옹진군,25-29세,1297,918,379
202011,28720,인천광역시,옹진군,25-29세,1299,920,379
202012,28720,인천광역시,옹진군,25-29세,1295,923,372
202101,28720,인천광역시,옹진군,25-29세,1289,913,376
202102,28720,인천광역시,옹진군,25-29세,1281,916,365
202103,28720,인천광역시,옹진군,25-29세,1263,894,369
202104,28720,인천광역시,옹진군,25-29세,1268,902,366
202105,28720,인천광역시,옹진군,25-29세,1277,911,366
202106,28720,인천광역시,옹진군,25-29세,1281,913,368
202007,28720,인천광역시,옹진군,30-34세,931,607,324
202008,28720,인천광역시,옹진군,30-34세,933,604,329
202009,28720,인천광역시,옹진군,30-34세,942,611,331
202010,28720,인천광역시,옹진군,30-34세,939,611,328
202011,28720,인천광역시,옹진군,30-34세,927,602,325
202012,28720,인천광역시,옹진군,30-34세,921,593,328
202101,28720,인천광역시,옹진군,30-34세,938,606,332
202102,28720,인천광역시,옹진군,30-34세,934,599,335
202103,28720,인천광역시,옹진군,30-34세,932,597,335
202104,28720,인천광역시,옹진군,30-34세,927,589,338
202105,28720,인천광역시,옹진군,30-34세,918,585,333
202106,28720,인천광역시,옹진군,30-34세,903,581,322
202007,28720,인천광역시,옹진군,35-39세,984,583,401
202008,28720,인천광역시,옹진군,35-39세,981,586,395
202009,28720,인천광역시,옹진군,35-39세,972,577,395
202010,28720,인천광역시,옹진군,35-39세,965,573,392
202011,28720,인천광역시,옹진군,35-39세,969,570,399
202012,28720,인천광역시,옹진군,35-39세,968,574,394
202101,28720,인천광역시,옹진군,35-39세,957,563,394
202102,28720,인천광역시,옹진군,35-39세,947,552,395
202103,28720,인천광역시,옹진군,35-39세,937,548,389
202104,28720,인천광역시,옹진군,35-39세,925,549,376
202105,28720,인천광역시,옹진군,35-39세,924,544,380
202106,28720,인천광역시,옹진군,35-39세,902,531,371
202007,28720,인천광역시,옹진군,40-44세,1144,705,439
202008,28720,인천광역시,옹진군,40-44세,1144,700,444
202009,28720,인천광역시,옹진군,40-44세,1136,694,442
202010,28720,인천광역시,옹진군,40-44세,1149,702,447
202011,28720,인천광역시,옹진군,40-44세,1139,698,441
202012,28720,인천광역시,옹진군,40-44세,1118,687,431
202101,28720,인천광역시,옹진군,40-44세,1101,672,429
202102,28720,인천광역시,옹진군,40-44세,1086,668,418
202103,28720,인천광역시,옹진군,40-44세,1069,658,411
202104,28720,인천광역시,옹진군,40-44세,1070,647,423
202105,28720,인천광역시,옹진군,40-44세,1067,650,417
202106,28720,인천광역시,옹진군,40-44세,1088,664,424
202007,28720,인천광역시,옹진군,45-49세,1307,849,458
202008,28720,인천광역시,옹진군,45-49세,1305,850,455
202009,28720,인천광역시,옹진군,45-49세,1308,848,460
202010,28720,인천광역시,옹진군,45-49세,1295,838,457
202011,28720,인천광역시,옹진군,45-49세,1297,835,462
202012,28720,인천광역시,옹진군,45-49세,1291,828,463
202101,28720,인천광역시,옹진군,45-49세,1273,815,458
202102,28720,인천광역시,옹진군,45-49세,1267,813,454
202103,28720,인천광역시,옹진군,45-49세,1268,818,450
202104,28720,인천광역시,옹진군,45-49세,1264,816,448
202105,28720,인천광역시,옹진군,45-49세,1282,828,454
202106,28720,인천광역시,옹진군,45-49세,1277,831,446
202007,28720,인천광역시,옹진군,50-54세,1531,913,618
202008,28720,인천광역시,옹진군,50-54세,1541,919,622
202009,28720,인천광역시,옹진군,50-54세,1523,920,603
202010,28720,인천광역시,옹진군,50-54세,1506,912,594
202011,28720,인천광역시,옹진군,50-54세,1497,902,595
202012,28720,인천광역시,옹진군,50-54세,1483,891,592
202101,28720,인천광역시,옹진군,50-54세,1479,884,595
202102,28720,인천광역시,옹진군,50-54세,1491,888,603
202103,28720,인천광역시,옹진군,50-54세,1506,900,606
202104,28720,인천광역시,옹진군,50-54세,1487,887,600
202105,28720,인천광역시,옹진군,50-54세,1486,893,593
202106,28720,인천광역시,옹진군,50-54세,1493,896,597
202007,28720,인천광역시,옹진군,55-59세,2127,1196,931
202008,28720,인천광역시,옹진군,55-59세,2107,1176,931
202009,28720,인천광역시,옹진군,55-59세,2101,1168,933
202010,28720,인천광역시,옹진군,55-59세,2112,1172,940
202011,28720,인천광역시,옹진군,55-59세,2125,1177,948
202012,28720,인천광역시,옹진군,55-59세,2122,1181,941
202101,28720,인천광역시,옹진군,55-59세,2118,1191,927
202102,28720,인천광역시,옹진군,55-59세,2087,1176,911
202103,28720,인천광역시,옹진군,55-59세,2070,1172,898
202104,28720,인천광역시,옹진군,55-59세,2072,1173,899
202105,28720,인천광역시,옹진군,55-59세,2055,1161,894
202106,28720,인천광역시,옹진군,55-59세,2044,1161,883
202007,28720,인천광역시,옹진군,60-64세,2275,1229,1046
202008,28720,인천광역시,옹진군,60-64세,2288,1242,1046
202009,28720,인천광역시,옹진군,60-64세,2274,1239,1035
202010,28720,인천광역시,옹진군,60-64세,2283,1244,1039
202011,28720,인천광역시,옹진군,60-64세,2288,1245,1043
202012,28720,인천광역시,옹진군,60-64세,2304,1255,1049
202101,28720,인천광역시,옹진군,60-64세,2292,1254,1038
202102,28720,인천광역시,옹진군,60-64세,2317,1269,1048
202103,28720,인천광역시,옹진군,60-64세,2349,1286,1063
202104,28720,인천광역시,옹진군,60-64세,2356,1287,1069
202105,28720,인천광역시,옹진군,60-64세,2362,1289,1073
202106,28720,인천광역시,옹진군,60-64세,2372,1296,1076
202007,28720,인천광역시,옹진군,65-69세,1624,863,761
202008,28720,인천광역시,옹진군,65-69세,1639,871,768
202009,28720,인천광역시,옹진군,65-69세,1664,883,781
202010,28720,인천광역시,옹진군,65-69세,1674,885,789
202011,28720,인천광역시,옹진군,65-69세,1699,905,794
202012,28720,인천광역시,옹진군,65-69세,1720,919,801
202101,28720,인천광역시,옹진군,65-69세,1739,927,812
202102,28720,인천광역시,옹진군,65-69세,1758,938,820
202103,28720,인천광역시,옹진군,65-69세,1793,954,839
202104,28720,인천광역시,옹진군,65-69세,1824,974,850
202105,28720,인천광역시,옹진군,65-69세,1849,988,861
202106,28720,인천광역시,옹진군,65-69세,1863,993,870
202007,28720,인천광역시,옹진군,70-74세,1384,703,681
202008,28720,인천광역시,옹진군,70-74세,1388,706,682
202009,28720,인천광역시,옹진군,70-74세,1389,705,684
202010,28720,인천광역시,옹진군,70-74세,1398,717,681
202011,28720,인천광역시,옹진군,70-74세,1402,720,682
202012,28720,인천광역시,옹진군,70-74세,1398,721,677
202101,28720,인천광역시,옹진군,70-74세,1413,729,684
202102,28720,인천광역시,옹진군,70-74세,1407,725,682
202103,28720,인천광역시,옹진군,70-74세,1397,722,675
202104,28720,인천광역시,옹진군,70-74세,1388,722,666
202105,28720,인천광역시,옹진군,70-74세,1376,708,668
202106,28720,인천광역시,옹진군,70-74세,1370,708,662
202007,28720,인천광역시,옹진군,75-79세,980,463,517
202008,28720,인천광역시,옹진군,75-79세,978,460,518
202009,28720,인천광역시,옹진군,75-79세,980,460,520
202010,28720,인천광역시,옹진군,75-79세,981,458,523
202011,28720,인천광역시,옹진군,75-79세,984,463,521
202012,28720,인천광역시,옹진군,75-79세,973,452,521
202101,28720,인천광역시,옹진군,75-79세,962,446,516
202102,28720,인천광역시,옹진군,75-79세,971,456,515
202103,28720,인천광역시,옹진군,75-79세,982,461,521
202104,28720,인천광역시,옹진군,75-79세,996,471,525
202105,28720,인천광역시,옹진군,75-79세,1004,477,527
202106,28720,인천광역시,옹진군,75-79세,1008,479,529
202007,28720,인천광역시,옹진군,80-84세,709,270,439
202008,28720,인천광역시,옹진군,80-84세,716,278,438
202009,28720,인천광역시,옹진군,80-84세,716,281,435
202010,28720,인천광역시,옹진군,80-84세,719,285,434
202011,28720,인천광역시,옹진군,80-84세,720,283,437
202012,28720,인천광역시,옹진군,80-84세,717,284,433
202101,28720,인천광역시,옹진군,80-84세,716,283,433
202102,28720,인천광역시,옹진군,80-84세,714,279,435
202103,28720,인천광역시,옹진군,80-84세,705,276,429
202104,28720,인천광역시,옹진군,80-84세,706,277,429
202105,28720,인천광역시,옹진군,80-84세,707,279,428
202106,28720,인천광역시,옹진군,80-84세,702,278,424
202007,28720,인천광역시,옹진군,85-89세,417,127,290
202008,28720,인천광역시,옹진군,85-89세,413,128,285
202009,28720,인천광역시,옹진군,85-89세,411,128,283
202010,28720,인천광역시,옹진군,85-89세,410,129,281
202011,28720,인천광역시,옹진군,85-89세,413,132,281
202012,28720,인천광역시,옹진군,85-89세,424,136,288
202101,28720,인천광역시,옹진군,85-89세,433,140,293
202102,28720,인천광역시,옹진군,85-89세,435,142,293
202103,28720,인천광역시,옹진군,85-89세,443,143,300
202104,28720,인천광역시,옹진군,85-89세,436,140,296
202105,28720,인천광역시,옹진군,85-89세,435,139,296
202106,28720,인천광역시,옹진군,85-89세,438,138,300
202007,28720,인천광역시,옹진군,90-94세,175,38,137
202008,28720,인천광역시,옹진군,90-94세,175,37,138
202009,28720,인천광역시,옹진군,90-94세,181,37,144
202010,28720,인천광역시,옹진군,90-94세,181,37,144
202011,28720,인천광역시,옹진군,90-94세,179,37,142
202012,28720,인천광역시,옹진군,90-94세,177,38,139
202101,28720,인천광역시,옹진군,90-94세,171,35,136
202102,28720,인천광역시,옹진군,90-94세,178,37,141
202103,28720,인천광역시,옹진군,90-94세,183,39,144
202104,28720,인천광역시,옹진군,90-94세,185,39,146
202105,28720,인천광역시,옹진군,90-94세,188,39,149
202106,28720,인천광역시,옹진군,90-94세,194,42,152
202007,28720,인천광역시,옹진군,95-99세,63,9,54
202008,28720,인천광역시,옹진군,95-99세,63,10,53
202009,28720,인천광역시,옹진군,95-99세,64,11,53
202010,28720,인천광역시,옹진군,95-99세,62,12,50
202011,28720,인천광역시,옹진군,95-99세,61,12,49
202012,28720,인천광역시,옹진군,95-99세,62,12,50
202101,28720,인천광역시,옹진군,95-99세,64,12,52
202102,28720,인천광역시,옹진군,95-99세,65,12,53
202103,28720,인천광역시,옹진군,95-99세,63,12,51
202104,28720,인천광역시,옹진군,95-99세,60,11,49
202105,28720,인천광역시,옹진군,95-99세,60,12,48
202106,28720,인천광역시,옹진군,95-99세,62,12,50
202007,28720,인천광역시,옹진군,100+,11,4,7
202008,28720,인천광역시,옹진군,100+,13,4,9
202009,28720,인천광역시,옹진군,100+,13,4,9
202010,28720,인천광역시,옹진군,100+,13,4,9
202011,28720,인천광역시,옹진군,100+,14,4,10
202012,28720,인천광역시,옹진군,100+,14,4,10
202101,28720,인천광역시,옹진군,100+,14,4,10
202102,28720,인천광역시,옹진군,100+,13,4,9
202103,28720,인천광역시,옹진군,100+,13,4,9
202104,28720,인천광역시,옹진군,100+,13,4,9
202105,28720,인천광역시,옹진군,100+,14,4,10
202106,28720,인천광역시,옹진군,100+,11,3,8
202007,29110,광주광역시,동구,0-4세,3061,1610,1451
202008,29110,광주광역시,동구,0-4세,3019,1595,1424
202009,29110,광주광역시,동구,0-4세,3174,1672,1502
202010,29110,광주광역시,동구,0-4세,3287,1719,1568
202011,29110,광주광역시,동구,0-4세,3317,1718,1599
202012,29110,광주광역시,동구,0-4세,3327,1721,1606
202101,29110,광주광역시,동구,0-4세,3314,1711,1603
202102,29110,광주광역시,동구,0-4세,3314,1714,1600
202103,29110,광주광역시,동구,0-4세,3320,1726,1594
202104,29110,광주광역시,동구,0-4세,3366,1743,1623
202105,29110,광주광역시,동구,0-4세,3372,1737,1635
202106,29110,광주광역시,동구,0-4세,3388,1745,1643
202007,29110,광주광역시,동구,5-9세,3572,1838,1734
202008,29110,광주광역시,동구,5-9세,3583,1847,1736
202009,29110,광주광역시,동구,5-9세,3732,1919,1813
202010,29110,광주광역시,동구,5-9세,3791,1967,1824
202011,29110,광주광역시,동구,5-9세,3808,1976,1832
202012,29110,광주광역시,동구,5-9세,3846,1990,1856
202101,29110,광주광역시,동구,5-9세,3839,1991,1848
202102,29110,광주광역시,동구,5-9세,3820,1966,1854
202103,29110,광주광역시,동구,5-9세,3798,1961,1837
202104,29110,광주광역시,동구,5-9세,3848,1989,1859
202105,29110,광주광역시,동구,5-9세,3890,2007,1883
202106,29110,광주광역시,동구,5-9세,3891,2010,1881
202007,29110,광주광역시,동구,10-14세,3078,1583,1495
202008,29110,광주광역시,동구,10-14세,3099,1590,1509
202009,29110,광주광역시,동구,10-14세,3186,1636,1550
202010,29110,광주광역시,동구,10-14세,3248,1665,1583
202011,29110,광주광역시,동구,10-14세,3266,1682,1584
202012,29110,광주광역시,동구,10-14세,3295,1704,1591
202101,29110,광주광역시,동구,10-14세,3309,1709,1600
202102,29110,광주광역시,동구,10-14세,3330,1719,1611
202103,29110,광주광역시,동구,10-14세,3340,1723,1617
202104,29110,광주광역시,동구,10-14세,3375,1742,1633
202105,29110,광주광역시,동구,10-14세,3375,1750,1625
202106,29110,광주광역시,동구,10-14세,3405,1759,1646
202007,29110,광주광역시,동구,15-19세,4131,2170,1961
202008,29110,광주광역시,동구,15-19세,4080,2140,1940
202009,29110,광주광역시,동구,15-19세,4071,2134,1937
202010,29110,광주광역시,동구,15-19세,4038,2129,1909
202011,29110,광주광역시,동구,15-19세,4043,2132,1911
202012,29110,광주광역시,동구,15-19세,4029,2109,1920
202101,29110,광주광역시,동구,15-19세,3992,2075,1917
202102,29110,광주광역시,동구,15-19세,3962,2044,1918
202103,29110,광주광역시,동구,15-19세,3960,2048,1912
202104,29110,광주광역시,동구,15-19세,3940,2023,1917
202105,29110,광주광역시,동구,15-19세,3936,2022,1914
202106,29110,광주광역시,동구,15-19세,3914,2007,1907
202007,29110,광주광역시,동구,20-24세,7028,3590,3438
202008,29110,광주광역시,동구,20-24세,7024,3609,3415
202009,29110,광주광역시,동구,20-24세,7177,3687,3490
202010,29110,광주광역시,동구,20-24세,7271,3733,3538
202011,29110,광주광역시,동구,20-24세,7349,3774,3575
202012,29110,광주광역시,동구,20-24세,7346,3806,3540
202101,29110,광주광역시,동구,20-24세,7341,3807,3534
202102,29110,광주광역시,동구,20-24세,7326,3795,3531
202103,29110,광주광역시,동구,20-24세,7278,3774,3504
202104,29110,광주광역시,동구,20-24세,7249,3751,3498
202105,29110,광주광역시,동구,20-24세,7252,3754,3498
202106,29110,광주광역시,동구,20-24세,7225,3740,3485
202007,29110,광주광역시,동구,25-29세,7181,3699,3482
202008,29110,광주광역시,동구,25-29세,7204,3686,3518
202009,29110,광주광역시,동구,25-29세,7371,3775,3596
202010,29110,광주광역시,동구,25-29세,7443,3791,3652
202011,29110,광주광역시,동구,25-29세,7450,3765,3685
202012,29110,광주광역시,동구,25-29세,7490,3779,3711
202101,29110,광주광역시,동구,25-29세,7509,3805,3704
202102,29110,광주광역시,동구,25-29세,7420,3767,3653
202103,29110,광주광역시,동구,25-29세,7426,3770,3656
202104,29110,광주광역시,동구,25-29세,7471,3780,3691
202105,29110,광주광역시,동구,25-29세,7516,3808,3708
202106,29110,광주광역시,동구,25-29세,7582,3841,3741
202007,29110,광주광역시,동구,30-34세,5831,3002,2829
202008,29110,광주광역시,동구,30-34세,5835,3004,2831
202009,29110,광주광역시,동구,30-34세,6056,3113,2943
202010,29110,광주광역시,동구,30-34세,6217,3191,3026
202011,29110,광주광역시,동구,30-34세,6301,3237,3064
202012,29110,광주광역시,동구,30-34세,6295,3224,3071
202101,29110,광주광역시,동구,30-34세,6280,3213,3067
202102,29110,광주광역시,동구,30-34세,6269,3197,3072
202103,29110,광주광역시,동구,30-34세,6253,3190,3063
202104,29110,광주광역시,동구,30-34세,6331,3253,3078
202105,29110,광주광역시,동구,30-34세,6381,3287,3094
202106,29110,광주광역시,동구,30-34세,6397,3298,3099
202007,29110,광주광역시,동구,35-39세,6663,3513,3150
202008,29110,광주광역시,동구,35-39세,6622,3495,3127
202009,29110,광주광역시,동구,35-39세,6873,3630,3243
202010,29110,광주광역시,동구,35-39세,7047,3739,3308
202011,29110,광주광역시,동구,35-39세,7062,3744,3318
202012,29110,광주광역시,동구,35-39세,7121,3776,3345
202101,29110,광주광역시,동구,35-39세,7104,3769,3335
202102,29110,광주광역시,동구,35-39세,7060,3731,3329
202103,29110,광주광역시,동구,35-39세,7025,3699,3326
202104,29110,광주광역시,동구,35-39세,7089,3725,3364
202105,29110,광주광역시,동구,35-39세,7073,3696,3377
202106,29110,광주광역시,동구,35-39세,7104,3698,3406
202007,29110,광주광역시,동구,40-44세,6378,3386,2992
202008,29110,광주광역시,동구,40-44세,6384,3390,2994
202009,29110,광주광역시,동구,40-44세,6547,3477,3070
202010,29110,광주광역시,동구,40-44세,6614,3525,3089
202011,29110,광주광역시,동구,40-44세,6698,3571,3127
202012,29110,광주광역시,동구,40-44세,6712,3574,3138
202101,29110,광주광역시,동구,40-44세,6706,3562,3144
202102,29110,광주광역시,동구,40-44세,6750,3582,3168
202103,29110,광주광역시,동구,40-44세,6769,3595,3174
202104,29110,광주광역시,동구,40-44세,6834,3628,3206
202105,29110,광주광역시,동구,40-44세,6900,3677,3223
202106,29110,광주광역시,동구,40-44세,6914,3683,3231
202007,29110,광주광역시,동구,45-49세,7229,3731,3498
202008,29110,광주광역시,동구,45-49세,7212,3719,3493
202009,29110,광주광역시,동구,45-49세,7242,3733,3509
202010,29110,광주광역시,동구,45-49세,7316,3753,3563
202011,29110,광주광역시,동구,45-49세,7307,3734,3573
202012,29110,광주광역시,동구,45-49세,7288,3731,3557
202101,29110,광주광역시,동구,45-49세,7254,3708,3546
202102,29110,광주광역시,동구,45-49세,7249,3703,3546
202103,29110,광주광역시,동구,45-49세,7179,3663,3516
202104,29110,광주광역시,동구,45-49세,7185,3663,3522
202105,29110,광주광역시,동구,45-49세,7142,3653,3489
202106,29110,광주광역시,동구,45-49세,7114,3652,3462
202007,29110,광주광역시,동구,50-54세,7566,3815,3751
202008,29110,광주광역시,동구,50-54세,7573,3828,3745
202009,29110,광주광역시,동구,50-54세,7703,3886,3817
202010,29110,광주광역시,동구,50-54세,7758,3908,3850
202011,29110,광주광역시,동구,50-54세,7803,3927,3876
202012,29110,광주광역시,동구,50-54세,7785,3911,3874
202101,29110,광주광역시,동구,50-54세,7824,3944,3880
202102,29110,광주광역시,동구,50-54세,7823,3948,3875
202103,29110,광주광역시,동구,50-54세,7746,3925,3821
202104,29110,광주광역시,동구,50-54세,7758,3924,3834
202105,29110,광주광역시,동구,50-54세,7767,3925,3842
202106,29110,광주광역시,동구,50-54세,7770,3924,3846
202007,29110,광주광역시,동구,55-59세,7824,3792,4032
202008,29110,광주광역시,동구,55-59세,7816,3784,4032
202009,29110,광주광역시,동구,55-59세,7820,3762,4058
202010,29110,광주광역시,동구,55-59세,7872,3795,4077
202011,29110,광주광역시,동구,55-59세,7883,3810,4073
202012,29110,광주광역시,동구,55-59세,7880,3798,4082
202101,29110,광주광역시,동구,55-59세,7840,3780,4060
202102,29110,광주광역시,동구,55-59세,7804,3758,4046
202103,29110,광주광역시,동구,55-59세,7794,3748,4046
202104,29110,광주광역시,동구,55-59세,7777,3760,4017
202105,29110,광주광역시,동구,55-59세,7734,3754,3980
202106,29110,광주광역시,동구,55-59세,7714,3745,3969
202007,29110,광주광역시,동구,60-64세,8031,3884,4147
202008,29110,광주광역시,동구,60-64세,8013,3878,4135
202009,29110,광주광역시,동구,60-64세,8151,3955,4196
202010,29110,광주광역시,동구,60-64세,8226,3981,4245
202011,29110,광주광역시,동구,60-64세,8233,3994,4239
202012,29110,광주광역시,동구,60-64세,8287,4021,4266
202101,29110,광주광역시,동구,60-64세,8320,4027,4293
202102,29110,광주광역시,동구,60-64세,8358,4047,4311
202103,29110,광주광역시,동구,60-64세,8347,4030,4317
202104,29110,광주광역시,동구,60-64세,8406,4048,4358
202105,29110,광주광역시,동구,60-64세,8396,4037,4359
202106,29110,광주광역시,동구,60-64세,8427,4059,4368
202007,29110,광주광역시,동구,65-69세,6259,2865,3394
202008,29110,광주광역시,동구,65-69세,6279,2864,3415
202009,29110,광주광역시,동구,65-69세,6391,2933,3458
202010,29110,광주광역시,동구,65-69세,6432,2942,3490
202011,29110,광주광역시,동구,65-69세,6482,2959,3523
202012,29110,광주광역시,동구,65-69세,6486,2960,3526
202101,29110,광주광역시,동구,65-69세,6489,2961,3528
202102,29110,광주광역시,동구,65-69세,6486,2966,3520
202103,29110,광주광역시,동구,65-69세,6478,2973,3505
202104,29110,광주광역시,동구,65-69세,6505,2979,3526
202105,29110,광주광역시,동구,65-69세,6510,2996,3514
202106,29110,광주광역시,동구,65-69세,6518,3001,3517
202007,29110,광주광역시,동구,70-74세,5498,2420,3078
202008,29110,광주광역시,동구,70-74세,5497,2415,3082
202009,29110,광주광역시,동구,70-74세,5533,2425,3108
202010,29110,광주광역시,동구,70-74세,5597,2450,3147
202011,29110,광주광역시,동구,70-74세,5625,2462,3163
202012,29110,광주광역시,동구,70-74세,5652,2472,3180
202101,29110,광주광역시,동구,70-74세,5694,2497,3197
202102,29110,광주광역시,동구,70-74세,5712,2497,3215
202103,29110,광주광역시,동구,70-74세,5726,2518,3208
202104,29110,광주광역시,동구,70-74세,5771,2545,3226
202105,29110,광주광역시,동구,70-74세,5749,2523,3226
202106,29110,광주광역시,동구,70-74세,5745,2518,3227
202007,29110,광주광역시,동구,75-79세,4650,2057,2593
202008,29110,광주광역시,동구,75-79세,4637,2053,2584
202009,29110,광주광역시,동구,75-79세,4646,2060,2586
202010,29110,광주광역시,동구,75-79세,4650,2081,2569
202011,29110,광주광역시,동구,75-79세,4656,2076,2580
202012,29110,광주광역시,동구,75-79세,4644,2072,2572
202101,29110,광주광역시,동구,75-79세,4604,2055,2549
202102,29110,광주광역시,동구,75-79세,4596,2062,2534
202103,29110,광주광역시,동구,75-79세,4561,2038,2523
202104,29110,광주광역시,동구,75-79세,4550,2027,2523
202105,29110,광주광역시,동구,75-79세,4529,2028,2501
202106,29110,광주광역시,동구,75-79세,4522,2030,2492
202007,29110,광주광역시,동구,80-84세,3115,1355,1760
202008,29110,광주광역시,동구,80-84세,3149,1374,1775
202009,29110,광주광역시,동구,80-84세,3170,1387,1783
202010,29110,광주광역시,동구,80-84세,3181,1385,1796
202011,29110,광주광역시,동구,80-84세,3178,1392,1786
202012,29110,광주광역시,동구,80-84세,3195,1398,1797
202101,29110,광주광역시,동구,80-84세,3219,1404,1815
202102,29110,광주광역시,동구,80-84세,3212,1402,1810
202103,29110,광주광역시,동구,80-84세,3213,1399,1814
202104,29110,광주광역시,동구,80-84세,3204,1399,1805
202105,29110,광주광역시,동구,80-84세,3205,1397,1808
202106,29110,광주광역시,동구,80-84세,3240,1416,1824
202007,29110,광주광역시,동구,85-89세,1430,547,883
202008,29110,광주광역시,동구,85-89세,1432,548,884
202009,29110,광주광역시,동구,85-89세,1447,552,895
202010,29110,광주광역시,동구,85-89세,1458,552,906
202011,29110,광주광역시,동구,85-89세,1475,559,916
202012,29110,광주광역시,동구,85-89세,1500,563,937
202101,29110,광주광역시,동구,85-89세,1517,571,946
202102,29110,광주광역시,동구,85-89세,1531,577,954
202103,29110,광주광역시,동구,85-89세,1544,598,946
202104,29110,광주광역시,동구,85-89세,1552,600,952
202105,29110,광주광역시,동구,85-89세,1577,605,972
202106,29110,광주광역시,동구,85-89세,1576,603,973
202007,29110,광주광역시,동구,90-94세,513,145,368
202008,29110,광주광역시,동구,90-94세,511,145,366
202009,29110,광주광역시,동구,90-94세,517,145,372
202010,29110,광주광역시,동구,90-94세,516,147,369
202011,29110,광주광역시,동구,90-94세,517,151,366
202012,29110,광주광역시,동구,90-94세,526,157,369
202101,29110,광주광역시,동구,90-94세,528,156,372
202102,29110,광주광역시,동구,90-94세,530,154,376
202103,29110,광주광역시,동구,90-94세,541,160,381
202104,29110,광주광역시,동구,90-94세,552,164,388
202105,29110,광주광역시,동구,90-94세,544,164,380
202106,29110,광주광역시,동구,90-94세,543,163,380
202007,29110,광주광역시,동구,95-99세,121,27,94
202008,29110,광주광역시,동구,95-99세,120,26,94
202009,29110,광주광역시,동구,95-99세,119,27,92
202010,29110,광주광역시,동구,95-99세,122,27,95
202011,29110,광주광역시,동구,95-99세,125,27,98
202012,29110,광주광역시,동구,95-99세,126,28,98
202101,29110,광주광역시,동구,95-99세,125,27,98
202102,29110,광주광역시,동구,95-99세,123,28,95
202103,29110,광주광역시,동구,95-99세,122,26,96
202104,29110,광주광역시,동구,95-99세,128,26,102
202105,29110,광주광역시,동구,95-99세,123,24,99
202106,29110,광주광역시,동구,95-99세,124,25,99
202007,29110,광주광역시,동구,100+,69,14,55
202008,29110,광주광역시,동구,100+,70,15,55
202009,29110,광주광역시,동구,100+,67,15,52
202010,29110,광주광역시,동구,100+,67,15,52
202011,29110,광주광역시,동구,100+,67,15,52
202012,29110,광주광역시,동구,100+,67,16,51
202101,29110,광주광역시,동구,100+,69,17,52
202102,29110,광주광역시,동구,100+,70,17,53
202103,29110,광주광역시,동구,100+,47,13,34
202104,29110,광주광역시,동구,100+,48,14,34
202105,29110,광주광역시,동구,100+,36,9,27
202106,29110,광주광역시,동구,100+,33,9,24
202007,29140,광주광역시,서구,0-4세,9185,4729,4456
202008,29140,광주광역시,서구,0-4세,9105,4695,4410
202009,29140,광주광역시,서구,0-4세,8999,4638,4361
202010,29140,광주광역시,서구,0-4세,8858,4568,4290
202011,29140,광주광역시,서구,0-4세,8794,4547,4247
202012,29140,광주광역시,서구,0-4세,8721,4512,4209
202101,29140,광주광역시,서구,0-4세,8578,4426,4152
202102,29140,광주광역시,서구,0-4세,8458,4359,4099
202103,29140,광주광역시,서구,0-4세,8395,4336,4059
202104,29140,광주광역시,서구,0-4세,8311,4286,4025
202105,29140,광주광역시,서구,0-4세,8229,4251,3978
202106,29140,광주광역시,서구,0-4세,8180,4227,3953
202007,29140,광주광역시,서구,5-9세,13393,6985,6408
202008,29140,광주광역시,서구,5-9세,13339,6960,6379
202009,29140,광주광역시,서구,5-9세,13201,6911,6290
202010,29140,광주광역시,서구,5-9세,13162,6884,6278
202011,29140,광주광역시,서구,5-9세,13089,6829,6260
202012,29140,광주광역시,서구,5-9세,13054,6810,6244
202101,29140,광주광역시,서구,5-9세,12945,6753,6192
202102,29140,광주광역시,서구,5-9세,12888,6733,6155
202103,29140,광주광역시,서구,5-9세,12861,6693,6168
202104,29140,광주광역시,서구,5-9세,12785,6653,6132
202105,29140,광주광역시,서구,5-9세,12703,6617,6086
202106,29140,광주광역시,서구,5-9세,12656,6575,6081
202007,29140,광주광역시,서구,10-14세,14556,7643,6913
202008,29140,광주광역시,서구,10-14세,14535,7634,6901
202009,29140,광주광역시,서구,10-14세,14586,7636,6950
202010,29140,광주광역시,서구,10-14세,14585,7654,6931
202011,29140,광주광역시,서구,10-14세,14593,7634,6959
202012,29140,광주광역시,서구,10-14세,14547,7617,6930
202101,29140,광주광역시,서구,10-14세,14557,7619,6938
202102,29140,광주광역시,서구,10-14세,14452,7547,6905
202103,29140,광주광역시,서구,10-14세,14438,7547,6891
202104,29140,광주광역시,서구,10-14세,14480,7584,6896
202105,29140,광주광역시,서구,10-14세,14443,7554,6889
202106,29140,광주광역시,서구,10-14세,14408,7532,6876
202007,29140,광주광역시,서구,15-19세,17863,9352,8511
202008,29140,광주광역시,서구,15-19세,17725,9298,8427
202009,29140,광주광역시,서구,15-19세,17506,9178,8328
202010,29140,광주광역시,서구,15-19세,17322,9089,8233
202011,29140,광주광역시,서구,15-19세,17160,9040,8120
202012,29140,광주광역시,서구,15-19세,17020,8974,8046
202101,29140,광주광역시,서구,15-19세,16821,8877,7944
202102,29140,광주광역시,서구,15-19세,16702,8827,7875
202103,29140,광주광역시,서구,15-19세,16468,8729,7739
202104,29140,광주광역시,서구,15-19세,16333,8664,7669
202105,29140,광주광역시,서구,15-19세,16209,8604,7605
202106,29140,광주광역시,서구,15-19세,16107,8550,7557
202007,29140,광주광역시,서구,20-24세,23398,12126,11272
202008,29140,광주광역시,서구,20-24세,23316,12065,11251
202009,29140,광주광역시,서구,20-24세,23289,12045,11244
202010,29140,광주광역시,서구,20-24세,23212,11996,11216
202011,29140,광주광역시,서구,20-24세,23120,11940,11180
202012,29140,광주광역시,서구,20-24세,22965,11832,11133
202101,29140,광주광역시,서구,20-24세,22966,11847,11119
202102,29140,광주광역시,서구,20-24세,22935,11805,11130
202103,29140,광주광역시,서구,20-24세,22828,11720,11108
202104,29140,광주광역시,서구,20-24세,22709,11665,11044
202105,29140,광주광역시,서구,20-24세,22659,11646,11013
202106,29140,광주광역시,서구,20-24세,22626,11625,11001
202007,29140,광주광역시,서구,25-29세,21894,11141,10753
202008,29140,광주광역시,서구,25-29세,22030,11208,10822
202009,29140,광주광역시,서구,25-29세,22113,11274,10839
202010,29140,광주광역시,서구,25-29세,22154,11286,10868
202011,29140,광주광역시,서구,25-29세,22326,11389,10937
202012,29140,광주광역시,서구,25-29세,22383,11426,10957
202101,29140,광주광역시,서구,25-29세,22366,11398,10968
202102,29140,광주광역시,서구,25-29세,22243,11333,10910
202103,29140,광주광역시,서구,25-29세,22397,11425,10972
202104,29140,광주광역시,서구,25-29세,22417,11439,10978
202105,29140,광주광역시,서구,25-29세,22360,11412,10948
202106,29140,광주광역시,서구,25-29세,22377,11413,10964
202007,29140,광주광역시,서구,30-34세,17034,8764,8270
202008,29140,광주광역시,서구,30-34세,16978,8749,8229
202009,29140,광주광역시,서구,30-34세,16938,8709,8229
202010,29140,광주광역시,서구,30-34세,16880,8717,8163
202011,29140,광주광역시,서구,30-34세,16797,8678,8119
202012,29140,광주광역시,서구,30-34세,16683,8629,8054
202101,29140,광주광역시,서구,30-34세,16626,8580,8046
202102,29140,광주광역시,서구,30-34세,16609,8590,8019
202103,29140,광주광역시,서구,30-34세,16592,8594,7998
202104,29140,광주광역시,서구,30-34세,16577,8588,7989
202105,29140,광주광역시,서구,30-34세,16539,8594,7945
202106,29140,광주광역시,서구,30-34세,16519,8583,7936
202007,29140,광주광역시,서구,35-39세,20735,10306,10429
202008,29140,광주광역시,서구,35-39세,20609,10257,10352
202009,29140,광주광역시,서구,35-39세,20412,10176,10236
202010,29140,광주광역시,서구,35-39세,20249,10087,10162
202011,29140,광주광역시,서구,35-39세,20101,9990,10111
202012,29140,광주광역시,서구,35-39세,20002,9919,10083
202101,29140,광주광역시,서구,35-39세,19851,9868,9983
202102,29140,광주광역시,서구,35-39세,19741,9812,9929
202103,29140,광주광역시,서구,35-39세,19580,9721,9859
202104,29140,광주광역시,서구,35-39세,19408,9625,9783
202105,29140,광주광역시,서구,35-39세,19239,9548,9691
202106,29140,광주광역시,서구,35-39세,19123,9506,9617
202007,29140,광주광역시,서구,40-44세,22595,10877,11718
202008,29140,광주광역시,서구,40-44세,22607,10881,11726
202009,29140,광주광역시,서구,40-44세,22558,10856,11702
202010,29140,광주광역시,서구,40-44세,22561,10848,11713
202011,29140,광주광역시,서구,40-44세,22566,10874,11692
202012,29140,광주광역시,서구,40-44세,22489,10859,11630
202101,29140,광주광역시,서구,40-44세,22397,10810,11587
202102,29140,광주광역시,서구,40-44세,22345,10784,11561
202103,29140,광주광역시,서구,40-44세,22260,10792,11468
202104,29140,광주광역시,서구,40-44세,22224,10784,11440
202105,29140,광주광역시,서구,40-44세,22270,10839,11431
202106,29140,광주광역시,서구,40-44세,22336,10860,11476
202007,29140,광주광역시,서구,45-49세,27069,13044,14025
202008,29140,광주광역시,서구,45-49세,26972,12980,13992
202009,29140,광주광역시,서구,45-49세,26783,12892,13891
202010,29140,광주광역시,서구,45-49세,26591,12809,13782
202011,29140,광주광역시,서구,45-49세,26453,12738,13715
202012,29140,광주광역시,서구,45-49세,26275,12634,13641
202101,29140,광주광역시,서구,45-49세,26217,12575,13642
202102,29140,광주광역시,서구,45-49세,26124,12552,13572
202103,29140,광주광역시,서구,45-49세,25914,12436,13478
202104,29140,광주광역시,서구,45-49세,25820,12399,13421
202105,29140,광주광역시,서구,45-49세,25416,12211,13205
202106,29140,광주광역시,서구,45-49세,25285,12133,13152
202007,29140,광주광역시,서구,50-54세,26534,13075,13459
202008,29140,광주광역시,서구,50-54세,26547,13088,13459
202009,29140,광주광역시,서구,50-54세,26583,13079,13504
202010,29140,광주광역시,서구,50-54세,26597,13097,13500
202011,29140,광주광역시,서구,50-54세,26643,13104,13539
202012,29140,광주광역시,서구,50-54세,26630,13113,13517
202101,29140,광주광역시,서구,50-54세,26710,13158,13552
202102,29140,광주광역시,서구,50-54세,26744,13165,13579
202103,29140,광주광역시,서구,50-54세,26644,13105,13539
202104,29140,광주광역시,서구,50-54세,26639,13110,13529
202105,29140,광주광역시,서구,50-54세,26775,13168,13607
202106,29140,광주광역시,서구,50-54세,26778,13155,13623
202007,29140,광주광역시,서구,55-59세,23036,11215,11821
202008,29140,광주광역시,서구,55-59세,22990,11213,11777
202009,29140,광주광역시,서구,55-59세,22927,11194,11733
202010,29140,광주광역시,서구,55-59세,22933,11198,11735
202011,29140,광주광역시,서구,55-59세,22882,11184,11698
202012,29140,광주광역시,서구,55-59세,22880,11157,11723
202101,29140,광주광역시,서구,55-59세,22828,11135,11693
202102,29140,광주광역시,서구,55-59세,22778,11104,11674
202103,29140,광주광역시,서구,55-59세,22872,11177,11695
202104,29140,광주광역시,서구,55-59세,22734,11105,11629
202105,29140,광주광역시,서구,55-59세,22637,11078,11559
202106,29140,광주광역시,서구,55-59세,22524,11039,11485
202007,29140,광주광역시,서구,60-64세,19898,9392,10506
202008,29140,광주광역시,서구,60-64세,20026,9433,10593
202009,29140,광주광역시,서구,60-64세,20126,9483,10643
202010,29140,광주광역시,서구,60-64세,20259,9560,10699
202011,29140,광주광역시,서구,60-64세,20394,9620,10774
202012,29140,광주광역시,서구,60-64세,20456,9663,10793
202101,29140,광주광역시,서구,60-64세,20519,9693,10826
202102,29140,광주광역시,서구,60-64세,20561,9698,10863
202103,29140,광주광역시,서구,60-64세,20553,9671,10882
202104,29140,광주광역시,서구,60-64세,20722,9750,10972
202105,29140,광주광역시,서구,60-64세,20825,9802,11023
202106,29140,광주광역시,서구,60-64세,20968,9875,11093
202007,29140,광주광역시,서구,65-69세,13670,6399,7271
202008,29140,광주광역시,서구,65-69세,13714,6423,7291
202009,29140,광주광역시,서구,65-69세,13782,6442,7340
202010,29140,광주광역시,서구,65-69세,13819,6461,7358
202011,29140,광주광역시,서구,65-69세,13844,6459,7385
202012,29140,광주광역시,서구,65-69세,13900,6487,7413
202101,29140,광주광역시,서구,65-69세,13984,6536,7448
202102,29140,광주광역시,서구,65-69세,14030,6548,7482
202103,29140,광주광역시,서구,65-69세,14135,6605,7530
202104,29140,광주광역시,서구,65-69세,14186,6634,7552
202105,29140,광주광역시,서구,65-69세,14184,6622,7562
202106,29140,광주광역시,서구,65-69세,14264,6660,7604
202007,29140,광주광역시,서구,70-74세,10679,4815,5864
202008,29140,광주광역시,서구,70-74세,10742,4842,5900
202009,29140,광주광역시,서구,70-74세,10837,4901,5936
202010,29140,광주광역시,서구,70-74세,10930,4933,5997
202011,29140,광주광역시,서구,70-74세,11035,4994,6041
202012,29140,광주광역시,서구,70-74세,11109,5034,6075
202101,29140,광주광역시,서구,70-74세,11154,5066,6088
202102,29140,광주광역시,서구,70-74세,11199,5098,6101
202103,29140,광주광역시,서구,70-74세,11215,5106,6109
202104,29140,광주광역시,서구,70-74세,11233,5091,6142
202105,29140,광주광역시,서구,70-74세,11249,5089,6160
202106,29140,광주광역시,서구,70-74세,11231,5067,6164
202007,29140,광주광역시,서구,75-79세,8246,3588,4658
202008,29140,광주광역시,서구,75-79세,8259,3602,4657
202009,29140,광주광역시,서구,75-79세,8217,3583,4634
202010,29140,광주광역시,서구,75-79세,8195,3576,4619
202011,29140,광주광역시,서구,75-79세,8173,3562,4611
202012,29140,광주광역시,서구,75-79세,8162,3543,4619
202101,29140,광주광역시,서구,75-79세,8135,3506,4629
202102,29140,광주광역시,서구,75-79세,8107,3494,4613
202103,29140,광주광역시,서구,75-79세,8083,3489,4594
202104,29140,광주광역시,서구,75-79세,8042,3480,4562
202105,29140,광주광역시,서구,75-79세,8049,3492,4557
202106,29140,광주광역시,서구,75-79세,8101,3532,4569
202007,29140,광주광역시,서구,80-84세,5269,2012,3257
202008,29140,광주광역시,서구,80-84세,5272,2001,3271
202009,29140,광주광역시,서구,80-84세,5280,1994,3286
202010,29140,광주광역시,서구,80-84세,5322,2023,3299
202011,29140,광주광역시,서구,80-84세,5317,2024,3293
202012,29140,광주광역시,서구,80-84세,5339,2050,3289
202101,29140,광주광역시,서구,80-84세,5388,2077,3311
202102,29140,광주광역시,서구,80-84세,5414,2102,3312
202103,29140,광주광역시,서구,80-84세,5448,2101,3347
202104,29140,광주광역시,서구,80-84세,5481,2122,3359
202105,29140,광주광역시,서구,80-84세,5528,2137,3391
202106,29140,광주광역시,서구,80-84세,5566,2155,3411
202007,29140,광주광역시,서구,85-89세,2602,789,1813
202008,29140,광주광역시,서구,85-89세,2627,804,1823
202009,29140,광주광역시,서구,85-89세,2630,813,1817
202010,29140,광주광역시,서구,85-89세,2629,810,1819
202011,29140,광주광역시,서구,85-89세,2649,825,1824
202012,29140,광주광역시,서구,85-89세,2672,835,1837
202101,29140,광주광역시,서구,85-89세,2688,847,1841
202102,29140,광주광역시,서구,85-89세,2726,848,1878
202103,29140,광주광역시,서구,85-89세,2729,852,1877
202104,29140,광주광역시,서구,85-89세,2760,863,1897
202105,29140,광주광역시,서구,85-89세,2789,872,1917
202106,29140,광주광역시,서구,85-89세,2791,883,1908
202007,29140,광주광역시,서구,90-94세,940,224,716
202008,29140,광주광역시,서구,90-94세,944,224,720
202009,29140,광주광역시,서구,90-94세,949,221,728
202010,29140,광주광역시,서구,90-94세,959,224,735
202011,29140,광주광역시,서구,90-94세,964,231,733
202012,29140,광주광역시,서구,90-94세,979,239,740
202101,29140,광주광역시,서구,90-94세,997,238,759
202102,29140,광주광역시,서구,90-94세,1001,242,759
202103,29140,광주광역시,서구,90-94세,999,241,758
202104,29140,광주광역시,서구,90-94세,987,240,747
202105,29140,광주광역시,서구,90-94세,989,243,746
202106,29140,광주광역시,서구,90-94세,979,234,745
202007,29140,광주광역시,서구,95-99세,228,33,195
202008,29140,광주광역시,서구,95-99세,232,32,200
202009,29140,광주광역시,서구,95-99세,237,32,205
202010,29140,광주광역시,서구,95-99세,235,31,204
202011,29140,광주광역시,서구,95-99세,238,31,207
202012,29140,광주광역시,서구,95-99세,234,31,203
202101,29140,광주광역시,서구,95-99세,234,32,202
202102,29140,광주광역시,서구,95-99세,237,33,204
202103,29140,광주광역시,서구,95-99세,228,28,200
202104,29140,광주광역시,서구,95-99세,232,30,202
202105,29140,광주광역시,서구,95-99세,223,29,194
202106,29140,광주광역시,서구,95-99세,222,27,195
202007,29140,광주광역시,서구,100+,74,9,65
202008,29140,광주광역시,서구,100+,75,9,66
202009,29140,광주광역시,서구,100+,77,10,67
202010,29140,광주광역시,서구,100+,75,10,65
202011,29140,광주광역시,서구,100+,76,10,66
202012,29140,광주광역시,서구,100+,76,10,66
202101,29140,광주광역시,서구,100+,75,8,67
202102,29140,광주광역시,서구,100+,74,8,66
202103,29140,광주광역시,서구,100+,52,5,47
202104,29140,광주광역시,서구,100+,48,5,43
202105,29140,광주광역시,서구,100+,49,4,45
202106,29140,광주광역시,서구,100+,47,4,43
202007,29155,광주광역시,남구,0-4세,6915,3542,3373
202008,29155,광주광역시,남구,0-4세,6871,3522,3349
202009,29155,광주광역시,남구,0-4세,6729,3444,3285
202010,29155,광주광역시,남구,0-4세,6635,3412,3223
202011,29155,광주광역시,남구,0-4세,6587,3398,3189
202012,29155,광주광역시,남구,0-4세,6588,3399,3189
202101,29155,광주광역시,남구,0-4세,6514,3361,3153
202102,29155,광주광역시,남구,0-4세,6503,3364,3139
202103,29155,광주광역시,남구,0-4세,6461,3336,3125
202104,29155,광주광역시,남구,0-4세,6430,3326,3104
202105,29155,광주광역시,남구,0-4세,6393,3299,3094
202106,29155,광주광역시,남구,0-4세,6370,3277,3093
202007,29155,광주광역시,남구,5-9세,10799,5514,5285
202008,29155,광주광역시,남구,5-9세,10774,5495,5279
202009,29155,광주광역시,남구,5-9세,10747,5489,5258
202010,29155,광주광역시,남구,5-9세,10686,5447,5239
202011,29155,광주광역시,남구,5-9세,10664,5442,5222
202012,29155,광주광역시,남구,5-9세,10695,5457,5238
202101,29155,광주광역시,남구,5-9세,10705,5470,5235
202102,29155,광주광역시,남구,5-9세,10754,5472,5282
202103,29155,광주광역시,남구,5-9세,10731,5443,5288
202104,29155,광주광역시,남구,5-9세,10711,5419,5292
202105,29155,광주광역시,남구,5-9세,10702,5408,5294
202106,29155,광주광역시,남구,5-9세,10706,5416,5290
202007,29155,광주광역시,남구,10-14세,11087,5580,5507
202008,29155,광주광역시,남구,10-14세,11121,5588,5533
202009,29155,광주광역시,남구,10-14세,11146,5594,5552
202010,29155,광주광역시,남구,10-14세,11197,5612,5585
202011,29155,광주광역시,남구,10-14세,11207,5601,5606
202012,29155,광주광역시,남구,10-14세,11219,5611,5608
202101,29155,광주광역시,남구,10-14세,11238,5595,5643
202102,29155,광주광역시,남구,10-14세,11285,5613,5672
202103,29155,광주광역시,남구,10-14세,11285,5620,5665
202104,29155,광주광역시,남구,10-14세,11275,5640,5635
202105,29155,광주광역시,남구,10-14세,11284,5645,5639
202106,29155,광주광역시,남구,10-14세,11313,5655,5658
202007,29155,광주광역시,남구,15-19세,12001,6044,5957
202008,29155,광주광역시,남구,15-19세,11867,5969,5898
202009,29155,광주광역시,남구,15-19세,11762,5906,5856
202010,29155,광주광역시,남구,15-19세,11712,5887,5825
202011,29155,광주광역시,남구,15-19세,11632,5839,5793
202012,29155,광주광역시,남구,15-19세,11557,5783,5774
202101,29155,광주광역시,남구,15-19세,11483,5749,5734
202102,29155,광주광역시,남구,15-19세,11424,5736,5688
202103,29155,광주광역시,남구,15-19세,11356,5670,5686
202104,29155,광주광역시,남구,15-19세,11325,5648,5677
202105,29155,광주광역시,남구,15-19세,11288,5623,5665
202106,29155,광주광역시,남구,15-19세,11263,5634,5629
202007,29155,광주광역시,남구,20-24세,14792,7593,7199
202008,29155,광주광역시,남구,20-24세,14726,7566,7160
202009,29155,광주광역시,남구,20-24세,14698,7571,7127
202010,29155,광주광역시,남구,20-24세,14666,7549,7117
202011,29155,광주광역시,남구,20-24세,14553,7475,7078
202012,29155,광주광역시,남구,20-24세,14444,7424,7020
202101,29155,광주광역시,남구,20-24세,14413,7378,7035
202102,29155,광주광역시,남구,20-24세,14294,7353,6941
202103,29155,광주광역시,남구,20-24세,14249,7344,6905
202104,29155,광주광역시,남구,20-24세,14216,7317,6899
202105,29155,광주광역시,남구,20-24세,14209,7301,6908
202106,29155,광주광역시,남구,20-24세,14182,7280,6902
202007,29155,광주광역시,남구,25-29세,13426,6917,6509
202008,29155,광주광역시,남구,25-29세,13436,6932,6504
202009,29155,광주광역시,남구,25-29세,13501,6957,6544
202010,29155,광주광역시,남구,25-29세,13528,6963,6565
202011,29155,광주광역시,남구,25-29세,13564,7001,6563
202012,29155,광주광역시,남구,25-29세,13537,6982,6555
202101,29155,광주광역시,남구,25-29세,13530,6977,6553
202102,29155,광주광역시,남구,25-29세,13471,6955,6516
202103,29155,광주광역시,남구,25-29세,13434,6915,6519
202104,29155,광주광역시,남구,25-29세,13449,6927,6522
202105,29155,광주광역시,남구,25-29세,13435,6917,6518
202106,29155,광주광역시,남구,25-29세,13482,6953,6529
202007,29155,광주광역시,남구,30-34세,10999,5588,5411
202008,29155,광주광역시,남구,30-34세,10946,5561,5385
202009,29155,광주광역시,남구,30-34세,10888,5531,5357
202010,29155,광주광역시,남구,30-34세,10822,5493,5329
202011,29155,광주광역시,남구,30-34세,10766,5461,5305
202012,29155,광주광역시,남구,30-34세,10735,5465,5270
202101,29155,광주광역시,남구,30-34세,10747,5477,5270
202102,29155,광주광역시,남구,30-34세,10707,5455,5252
202103,29155,광주광역시,남구,30-34세,10695,5452,5243
202104,29155,광주광역시,남구,30-34세,10674,5437,5237
202105,29155,광주광역시,남구,30-34세,10752,5479,5273
202106,29155,광주광역시,남구,30-34세,10838,5523,5315
202007,29155,광주광역시,남구,35-39세,15230,7425,7805
202008,29155,광주광역시,남구,35-39세,15161,7387,7774
202009,29155,광주광역시,남구,35-39세,14983,7293,7690
202010,29155,광주광역시,남구,35-39세,14870,7244,7626
202011,29155,광주광역시,남구,35-39세,14799,7207,7592
202012,29155,광주광역시,남구,35-39세,14780,7193,7587
202101,29155,광주광역시,남구,35-39세,14745,7180,7565
202102,29155,광주광역시,남구,35-39세,14680,7146,7534
202103,29155,광주광역시,남구,35-39세,14564,7110,7454
202104,29155,광주광역시,남구,35-39세,14444,7054,7390
202105,29155,광주광역시,남구,35-39세,14336,7002,7334
202106,29155,광주광역시,남구,35-39세,14235,6945,7290
202007,29155,광주광역시,남구,40-44세,16448,8137,8311
202008,29155,광주광역시,남구,40-44세,16497,8181,8316
202009,29155,광주광역시,남구,40-44세,16466,8164,8302
202010,29155,광주광역시,남구,40-44세,16477,8145,8332
202011,29155,광주광역시,남구,40-44세,16495,8132,8363
202012,29155,광주광역시,남구,40-44세,16495,8138,8357
202101,29155,광주광역시,남구,40-44세,16508,8118,8390
202102,29155,광주광역시,남구,40-44세,16665,8204,8461
202103,29155,광주광역시,남구,40-44세,16633,8172,8461
202104,29155,광주광역시,남구,40-44세,16636,8190,8446
202105,29155,광주광역시,남구,40-44세,16671,8200,8471
202106,29155,광주광역시,남구,40-44세,16761,8229,8532
202007,29155,광주광역시,남구,45-49세,17820,8710,9110
202008,29155,광주광역시,남구,45-49세,17746,8672,9074
202009,29155,광주광역시,남구,45-49세,17704,8647,9057
202010,29155,광주광역시,남구,45-49세,17643,8646,8997
202011,29155,광주광역시,남구,45-49세,17571,8653,8918
202012,29155,광주광역시,남구,45-49세,17572,8650,8922
202101,29155,광주광역시,남구,45-49세,17558,8647,8911
202102,29155,광주광역시,남구,45-49세,17513,8639,8874
202103,29155,광주광역시,남구,45-49세,17405,8607,8798
202104,29155,광주광역시,남구,45-49세,17431,8613,8818
202105,29155,광주광역시,남구,45-49세,17291,8541,8750
202106,29155,광주광역시,남구,45-49세,17232,8523,8709
202007,29155,광주광역시,남구,50-54세,17061,8208,8853
202008,29155,광주광역시,남구,50-54세,17019,8165,8854
202009,29155,광주광역시,남구,50-54세,17000,8174,8826
202010,29155,광주광역시,남구,50-54세,17008,8156,8852
202011,29155,광주광역시,남구,50-54세,17009,8147,8862
202012,29155,광주광역시,남구,50-54세,16949,8136,8813
202101,29155,광주광역시,남구,50-54세,16964,8159,8805
202102,29155,광주광역시,남구,50-54세,17033,8196,8837
202103,29155,광주광역시,남구,50-54세,16946,8148,8798
202104,29155,광주광역시,남구,50-54세,16956,8153,8803
202105,29155,광주광역시,남구,50-54세,17106,8194,8912
202106,29155,광주광역시,남구,50-54세,17210,8249,8961
202007,29155,광주광역시,남구,55-59세,16298,7565,8733
202008,29155,광주광역시,남구,55-59세,16232,7556,8676
202009,29155,광주광역시,남구,55-59세,16172,7525,8647
202010,29155,광주광역시,남구,55-59세,16108,7511,8597
202011,29155,광주광역시,남구,55-59세,16077,7499,8578
202012,29155,광주광역시,남구,55-59세,16060,7477,8583
202101,29155,광주광역시,남구,55-59세,15950,7417,8533
202102,29155,광주광역시,남구,55-59세,15917,7397,8520
202103,29155,광주광역시,남구,55-59세,15822,7366,8456
202104,29155,광주광역시,남구,55-59세,15812,7379,8433
202105,29155,광주광역시,남구,55-59세,15754,7371,8383
202106,29155,광주광역시,남구,55-59세,15593,7305,8288
202007,29155,광주광역시,남구,60-64세,16005,7406,8599
202008,29155,광주광역시,남구,60-64세,16063,7404,8659
202009,29155,광주광역시,남구,60-64세,16091,7433,8658
202010,29155,광주광역시,남구,60-64세,16171,7481,8690
202011,29155,광주광역시,남구,60-64세,16201,7470,8731
202012,29155,광주광역시,남구,60-64세,16233,7461,8772
202101,29155,광주광역시,남구,60-64세,16301,7503,8798
202102,29155,광주광역시,남구,60-64세,16345,7528,8817
202103,29155,광주광역시,남구,60-64세,16329,7505,8824
202104,29155,광주광역시,남구,60-64세,16359,7496,8863
202105,29155,광주광역시,남구,60-64세,16405,7505,8900
202106,29155,광주광역시,남구,60-64세,16531,7541,8990
202007,29155,광주광역시,남구,65-69세,11576,5226,6350
202008,29155,광주광역시,남구,65-69세,11658,5282,6376
202009,29155,광주광역시,남구,65-69세,11699,5302,6397
202010,29155,광주광역시,남구,65-69세,11775,5336,6439
202011,29155,광주광역시,남구,65-69세,11849,5385,6464
202012,29155,광주광역시,남구,65-69세,11839,5398,6441
202101,29155,광주광역시,남구,65-69세,11875,5437,6438
202102,29155,광주광역시,남구,65-69세,11896,5443,6453
202103,29155,광주광역시,남구,65-69세,11922,5460,6462
202104,29155,광주광역시,남구,65-69세,11963,5492,6471
202105,29155,광주광역시,남구,65-69세,12008,5516,6492
202106,29155,광주광역시,남구,65-69세,12031,5532,6499
202007,29155,광주광역시,남구,70-74세,9739,4398,5341
202008,29155,광주광역시,남구,70-74세,9735,4394,5341
202009,29155,광주광역시,남구,70-74세,9793,4420,5373
202010,29155,광주광역시,남구,70-74세,9857,4439,5418
202011,29155,광주광역시,남구,70-74세,9885,4444,5441
202012,29155,광주광역시,남구,70-74세,10001,4488,5513
202101,29155,광주광역시,남구,70-74세,10081,4515,5566
202102,29155,광주광역시,남구,70-74세,10130,4536,5594
202103,29155,광주광역시,남구,70-74세,10072,4513,5559
202104,29155,광주광역시,남구,70-74세,10104,4512,5592
202105,29155,광주광역시,남구,70-74세,10098,4511,5587
202106,29155,광주광역시,남구,70-74세,10107,4505,5602
202007,29155,광주광역시,남구,75-79세,7496,3325,4171
202008,29155,광주광역시,남구,75-79세,7503,3317,4186
202009,29155,광주광역시,남구,75-79세,7487,3308,4179
202010,29155,광주광역시,남구,75-79세,7481,3316,4165
202011,29155,광주광역시,남구,75-79세,7447,3303,4144
202012,29155,광주광역시,남구,75-79세,7425,3304,4121
202101,29155,광주광역시,남구,75-79세,7417,3296,4121
202102,29155,광주광역시,남구,75-79세,7384,3287,4097
202103,29155,광주광역시,남구,75-79세,7309,3266,4043
202104,29155,광주광역시,남구,75-79세,7275,3252,4023
202105,29155,광주광역시,남구,75-79세,7290,3258,4032
202106,29155,광주광역시,남구,75-79세,7317,3256,4061
202007,29155,광주광역시,남구,80-84세,4772,1869,2903
202008,29155,광주광역시,남구,80-84세,4798,1894,2904
202009,29155,광주광역시,남구,80-84세,4831,1902,2929
202010,29155,광주광역시,남구,80-84세,4834,1901,2933
202011,29155,광주광역시,남구,80-84세,4842,1907,2935
202012,29155,광주광역시,남구,80-84세,4822,1885,2937
202101,29155,광주광역시,남구,80-84세,4846,1896,2950
202102,29155,광주광역시,남구,80-84세,4883,1905,2978
202103,29155,광주광역시,남구,80-84세,4899,1926,2973
202104,29155,광주광역시,남구,80-84세,4944,1956,2988
202105,29155,광주광역시,남구,80-84세,4974,1978,2996
202106,29155,광주광역시,남구,80-84세,5020,2008,3012
202007,29155,광주광역시,남구,85-89세,2338,706,1632
202008,29155,광주광역시,남구,85-89세,2355,702,1653
202009,29155,광주광역시,남구,85-89세,2359,709,1650
202010,29155,광주광역시,남구,85-89세,2390,725,1665
202011,29155,광주광역시,남구,85-89세,2398,735,1663
202012,29155,광주광역시,남구,85-89세,2412,747,1665
202101,29155,광주광역시,남구,85-89세,2431,757,1674
202102,29155,광주광역시,남구,85-89세,2464,769,1695
202103,29155,광주광역시,남구,85-89세,2493,786,1707
202104,29155,광주광역시,남구,85-89세,2508,790,1718
202105,29155,광주광역시,남구,85-89세,2534,802,1732
202106,29155,광주광역시,남구,85-89세,2539,804,1735
202007,29155,광주광역시,남구,90-94세,877,199,678
202008,29155,광주광역시,남구,90-94세,879,201,678
202009,29155,광주광역시,남구,90-94세,894,206,688
202010,29155,광주광역시,남구,90-94세,899,202,697
202011,29155,광주광역시,남구,90-94세,894,200,694
202012,29155,광주광역시,남구,90-94세,908,200,708
202101,29155,광주광역시,남구,90-94세,923,204,719
202102,29155,광주광역시,남구,90-94세,925,208,717
202103,29155,광주광역시,남구,90-94세,941,207,734
202104,29155,광주광역시,남구,90-94세,948,208,740
202105,29155,광주광역시,남구,90-94세,946,207,739
202106,29155,광주광역시,남구,90-94세,942,206,736
202007,29155,광주광역시,남구,95-99세,211,45,166
202008,29155,광주광역시,남구,95-99세,217,46,171
202009,29155,광주광역시,남구,95-99세,220,46,174
202010,29155,광주광역시,남구,95-99세,219,48,171
202011,29155,광주광역시,남구,95-99세,217,48,169
202012,29155,광주광역시,남구,95-99세,212,46,166
202101,29155,광주광역시,남구,95-99세,210,43,167
202102,29155,광주광역시,남구,95-99세,212,44,168
202103,29155,광주광역시,남구,95-99세,194,40,154
202104,29155,광주광역시,남구,95-99세,199,40,159
202105,29155,광주광역시,남구,95-99세,202,41,161
202106,29155,광주광역시,남구,95-99세,199,39,160
202007,29155,광주광역시,남구,100+,97,12,85
202008,29155,광주광역시,남구,100+,97,12,85
202009,29155,광주광역시,남구,100+,96,12,84
202010,29155,광주광역시,남구,100+,94,13,81
202011,29155,광주광역시,남구,100+,95,13,82
202012,29155,광주광역시,남구,100+,96,13,83
202101,29155,광주광역시,남구,100+,93,13,80
202102,29155,광주광역시,남구,100+,94,13,81
202103,29155,광주광역시,남구,100+,36,5,31
202104,29155,광주광역시,남구,100+,39,5,34
202105,29155,광주광역시,남구,100+,39,5,34
202106,29155,광주광역시,남구,100+,39,5,34
202007,29170,광주광역시,북구,0-4세,14883,7522,7361
202008,29170,광주광역시,북구,0-4세,14762,7443,7319
202009,29170,광주광역시,북구,0-4세,14621,7377,7244
202010,29170,광주광역시,북구,0-4세,14453,7291,7162
202011,29170,광주광역시,북구,0-4세,14268,7198,7070
202012,29170,광주광역시,북구,0-4세,14182,7165,7017
202101,29170,광주광역시,북구,0-4세,14041,7098,6943
202102,29170,광주광역시,북구,0-4세,13998,7084,6914
202103,29170,광주광역시,북구,0-4세,13926,7057,6869
202104,29170,광주광역시,북구,0-4세,13812,7011,6801
202105,29170,광주광역시,북구,0-4세,13717,6956,6761
202106,29170,광주광역시,북구,0-4세,13691,6947,6744
202007,29170,광주광역시,북구,5-9세,19605,10081,9524
202008,29170,광주광역시,북구,5-9세,19618,10081,9537
202009,29170,광주광역시,북구,5-9세,19529,10043,9486
202010,29170,광주광역시,북구,5-9세,19457,9987,9470
202011,29170,광주광역시,북구,5-9세,19432,10001,9431
202012,29170,광주광역시,북구,5-9세,19367,9970,9397
202101,29170,광주광역시,북구,5-9세,19306,9916,9390
202102,29170,광주광역시,북구,5-9세,19215,9892,9323
202103,29170,광주광역시,북구,5-9세,19163,9878,9285
202104,29170,광주광역시,북구,5-9세,19068,9825,9243
202105,29170,광주광역시,북구,5-9세,19017,9794,9223
202106,29170,광주광역시,북구,5-9세,18958,9769,9189
202007,29170,광주광역시,북구,10-14세,20047,10621,9426
202008,29170,광주광역시,북구,10-14세,20056,10611,9445
202009,29170,광주광역시,북구,10-14세,20054,10602,9452
202010,29170,광주광역시,북구,10-14세,20110,10620,9490
202011,29170,광주광역시,북구,10-14세,20098,10611,9487
202012,29170,광주광역시,북구,10-14세,20089,10604,9485
202101,29170,광주광역시,북구,10-14세,20119,10617,9502
202102,29170,광주광역시,북구,10-14세,20117,10615,9502
202103,29170,광주광역시,북구,10-14세,20105,10588,9517
202104,29170,광주광역시,북구,10-14세,20089,10573,9516
202105,29170,광주광역시,북구,10-14세,20044,10562,9482
202106,29170,광주광역시,북구,10-14세,20079,10579,9500
202007,29170,광주광역시,북구,15-19세,23781,12567,11214
202008,29170,광주광역시,북구,15-19세,23560,12434,11126
202009,29170,광주광역시,북구,15-19세,23405,12335,11070
202010,29170,광주광역시,북구,15-19세,23167,12210,10957
202011,29170,광주광역시,북구,15-19세,23054,12151,10903
202012,29170,광주광역시,북구,15-19세,22882,12044,10838
202101,29170,광주광역시,북구,15-19세,22710,11951,10759
202102,29170,광주광역시,북구,15-19세,22557,11864,10693
202103,29170,광주광역시,북구,15-19세,22329,11778,10551
202104,29170,광주광역시,북구,15-19세,22199,11705,10494
202105,29170,광주광역시,북구,15-19세,22084,11655,10429
202106,29170,광주광역시,북구,15-19세,21948,11578,10370
202007,29170,광주광역시,북구,20-24세,31900,16632,15268
202008,29170,광주광역시,북구,20-24세,31811,16627,15184
202009,29170,광주광역시,북구,20-24세,31769,16614,15155
202010,29170,광주광역시,북구,20-24세,31634,16538,15096
202011,29170,광주광역시,북구,20-24세,31477,16462,15015
202012,29170,광주광역시,북구,20-24세,31242,16364,14878
202101,29170,광주광역시,북구,20-24세,31173,16367,14806
202102,29170,광주광역시,북구,20-24세,31024,16289,14735
202103,29170,광주광역시,북구,20-24세,30797,16144,14653
202104,29170,광주광역시,북구,20-24세,30704,16058,14646
202105,29170,광주광역시,북구,20-24세,30544,15952,14592
202106,29170,광주광역시,북구,20-24세,30408,15851,14557
202007,29170,광주광역시,북구,25-29세,31086,16497,14589
202008,29170,광주광역시,북구,25-29세,31133,16529,14604
202009,29170,광주광역시,북구,25-29세,31165,16527,14638
202010,29170,광주광역시,북구,25-29세,31168,16508,14660
202011,29170,광주광역시,북구,25-29세,31241,16544,14697
202012,29170,광주광역시,북구,25-29세,31262,16572,14690
202101,29170,광주광역시,북구,25-29세,31187,16533,14654
202102,29170,광주광역시,북구,25-29세,31050,16464,14586
202103,29170,광주광역시,북구,25-29세,31203,16560,14643
202104,29170,광주광역시,북구,25-29세,31251,16595,14656
202105,29170,광주광역시,북구,25-29세,31276,16587,14689
202106,29170,광주광역시,북구,25-29세,31285,16574,14711
202007,29170,광주광역시,북구,30-34세,25574,13287,12287
202008,29170,광주광역시,북구,30-34세,25618,13305,12313
202009,29170,광주광역시,북구,30-34세,25556,13271,12285
202010,29170,광주광역시,북구,30-34세,25422,13188,12234
202011,29170,광주광역시,북구,30-34세,25387,13161,12226
202012,29170,광주광역시,북구,30-34세,25262,13069,12193
202101,29170,광주광역시,북구,30-34세,25362,13126,12236
202102,29170,광주광역시,북구,30-34세,25368,13141,12227
202103,29170,광주광역시,북구,30-34세,25415,13152,12263
202104,29170,광주광역시,북구,30-34세,25471,13215,12256
202105,29170,광주광역시,북구,30-34세,25488,13244,12244
202106,29170,광주광역시,북구,30-34세,25488,13257,12231
202007,29170,광주광역시,북구,35-39세,31139,16167,14972
202008,29170,광주광역시,북구,35-39세,30939,16088,14851
202009,29170,광주광역시,북구,35-39세,30632,15926,14706
202010,29170,광주광역시,북구,35-39세,30462,15840,14622
202011,29170,광주광역시,북구,35-39세,30301,15759,14542
202012,29170,광주광역시,북구,35-39세,30287,15778,14509
202101,29170,광주광역시,북구,35-39세,30197,15729,14468
202102,29170,광주광역시,북구,35-39세,30129,15722,14407
202103,29170,광주광역시,북구,35-39세,29905,15583,14322
202104,29170,광주광역시,북구,35-39세,29734,15503,14231
202105,29170,광주광역시,북구,35-39세,29521,15402,14119
202106,29170,광주광역시,북구,35-39세,29365,15352,14013
202007,29170,광주광역시,북구,40-44세,31757,16119,15638
202008,29170,광주광역시,북구,40-44세,31751,16099,15652
202009,29170,광주광역시,북구,40-44세,31809,16107,15702
202010,29170,광주광역시,북구,40-44세,31802,16066,15736
202011,29170,광주광역시,북구,40-44세,31792,16047,15745
202012,29170,광주광역시,북구,40-44세,31640,15955,15685
202101,29170,광주광역시,북구,40-44세,31659,15981,15678
202102,29170,광주광역시,북구,40-44세,31757,16008,15749
202103,29170,광주광역시,북구,40-44세,31695,15975,15720
202104,29170,광주광역시,북구,40-44세,31709,15990,15719
202105,29170,광주광역시,북구,40-44세,31728,15976,15752
202106,29170,광주광역시,북구,40-44세,31789,16005,15784
202007,29170,광주광역시,북구,45-49세,36684,18176,18508
202008,29170,광주광역시,북구,45-49세,36546,18108,18438
202009,29170,광주광역시,북구,45-49세,36287,17993,18294
202010,29170,광주광역시,북구,45-49세,36043,17926,18117
202011,29170,광주광역시,북구,45-49세,35893,17879,18014
202012,29170,광주광역시,북구,45-49세,35762,17833,17929
202101,29170,광주광역시,북구,45-49세,35775,17849,17926
202102,29170,광주광역시,북구,45-49세,35694,17804,17890
202103,29170,광주광역시,북구,45-49세,35572,17754,17818
202104,29170,광주광역시,북구,45-49세,35404,17672,17732
202105,29170,광주광역시,북구,45-49세,34879,17452,17427
202106,29170,광주광역시,북구,45-49세,34689,17347,17342
202007,29170,광주광역시,북구,50-54세,37283,18343,18940
202008,29170,광주광역시,북구,50-54세,37221,18323,18898
202009,29170,광주광역시,북구,50-54세,37227,18333,18894
202010,29170,광주광역시,북구,50-54세,37123,18288,18835
202011,29170,광주광역시,북구,50-54세,37118,18273,18845
202012,29170,광주광역시,북구,50-54세,37004,18224,18780
202101,29170,광주광역시,북구,50-54세,37105,18287,18818
202102,29170,광주광역시,북구,50-54세,37068,18252,18816
202103,29170,광주광역시,북구,50-54세,36855,18158,18697
202104,29170,광주광역시,북구,50-54세,36847,18161,18686
202105,29170,광주광역시,북구,50-54세,37009,18221,18788
202106,29170,광주광역시,북구,50-54세,37028,18230,18798
202007,29170,광주광역시,북구,55-59세,35075,17027,18048
202008,29170,광주광역시,북구,55-59세,35123,17042,18081
202009,29170,광주광역시,북구,55-59세,34983,16956,18027
202010,29170,광주광역시,북구,55-59세,34910,16915,17995
202011,29170,광주광역시,북구,55-59세,34825,16895,17930
202012,29170,광주광역시,북구,55-59세,34832,16875,17957
202101,29170,광주광역시,북구,55-59세,34780,16895,17885
202102,29170,광주광역시,북구,55-59세,34710,16887,17823
202103,29170,광주광역시,북구,55-59세,34776,16905,17871
202104,29170,광주광역시,북구,55-59세,34665,16887,17778
202105,29170,광주광역시,북구,55-59세,34478,16857,17621
202106,29170,광주광역시,북구,55-59세,34209,16732,17477
202007,29170,광주광역시,북구,60-64세,30878,14768,16110
202008,29170,광주광역시,북구,60-64세,31142,14940,16202
202009,29170,광주광역시,북구,60-64세,31330,15052,16278
202010,29170,광주광역시,북구,60-64세,31566,15174,16392
202011,29170,광주광역시,북구,60-64세,31733,15233,16500
202012,29170,광주광역시,북구,60-64세,31791,15263,16528
202101,29170,광주광역시,북구,60-64세,31946,15328,16618
202102,29170,광주광역시,북구,60-64세,32095,15410,16685
202103,29170,광주광역시,북구,60-64세,32204,15431,16773
202104,29170,광주광역시,북구,60-64세,32420,15487,16933
202105,29170,광주광역시,북구,60-64세,32622,15558,17064
202106,29170,광주광역시,북구,60-64세,32896,15677,17219
202007,29170,광주광역시,북구,65-69세,21137,9995,11142
202008,29170,광주광역시,북구,65-69세,21221,10014,11207
202009,29170,광주광역시,북구,65-69세,21295,10036,11259
202010,29170,광주광역시,북구,65-69세,21384,10074,11310
202011,29170,광주광역시,북구,65-69세,21487,10117,11370
202012,29170,광주광역시,북구,65-69세,21546,10135,11411
202101,29170,광주광역시,북구,65-69세,21660,10206,11454
202102,29170,광주광역시,북구,65-69세,21768,10260,11508
202103,29170,광주광역시,북구,65-69세,21925,10352,11573
202104,29170,광주광역시,북구,65-69세,21948,10356,11592
202105,29170,광주광역시,북구,65-69세,21923,10352,11571
202106,29170,광주광역시,북구,65-69세,21960,10382,11578
202007,29170,광주광역시,북구,70-74세,16557,7626,8931
202008,29170,광주광역시,북구,70-74세,16600,7654,8946
202009,29170,광주광역시,북구,70-74세,16664,7672,8992
202010,29170,광주광역시,북구,70-74세,16758,7720,9038
202011,29170,광주광역시,북구,70-74세,16885,7799,9086
202012,29170,광주광역시,북구,70-74세,17018,7847,9171
202101,29170,광주광역시,북구,70-74세,17138,7909,9229
202102,29170,광주광역시,북구,70-74세,17212,7946,9266
202103,29170,광주광역시,북구,70-74세,17189,7908,9281
202104,29170,광주광역시,북구,70-74세,17245,7923,9322
202105,29170,광주광역시,북구,70-74세,17314,7962,9352
202106,29170,광주광역시,북구,70-74세,17344,7980,9364
202007,29170,광주광역시,북구,75-79세,12468,5342,7126
202008,29170,광주광역시,북구,75-79세,12504,5368,7136
202009,29170,광주광역시,북구,75-79세,12489,5353,7136
202010,29170,광주광역시,북구,75-79세,12459,5342,7117
202011,29170,광주광역시,북구,75-79세,12452,5333,7119
202012,29170,광주광역시,북구,75-79세,12396,5322,7074
202101,29170,광주광역시,북구,75-79세,12389,5321,7068
202102,29170,광주광역시,북구,75-79세,12327,5293,7034
202103,29170,광주광역시,북구,75-79세,12346,5329,7017
202104,29170,광주광역시,북구,75-79세,12312,5338,6974
202105,29170,광주광역시,북구,75-79세,12298,5333,6965
202106,29170,광주광역시,북구,75-79세,12369,5354,7015
202007,29170,광주광역시,북구,80-84세,7893,2992,4901
202008,29170,광주광역시,북구,80-84세,7916,3003,4913
202009,29170,광주광역시,북구,80-84세,7928,3010,4918
202010,29170,광주광역시,북구,80-84세,7966,3035,4931
202011,29170,광주광역시,북구,80-84세,7981,3037,4944
202012,29170,광주광역시,북구,80-84세,8001,3038,4963
202101,29170,광주광역시,북구,80-84세,8063,3047,5016
202102,29170,광주광역시,북구,80-84세,8155,3089,5066
202103,29170,광주광역시,북구,80-84세,8216,3101,5115
202104,29170,광주광역시,북구,80-84세,8251,3120,5131
202105,29170,광주광역시,북구,80-84세,8285,3143,5142
202106,29170,광주광역시,북구,80-84세,8339,3184,5155
202007,29170,광주광역시,북구,85-89세,3926,1141,2785
202008,29170,광주광역시,북구,85-89세,3958,1148,2810
202009,29170,광주광역시,북구,85-89세,3982,1162,2820
202010,29170,광주광역시,북구,85-89세,3989,1162,2827
202011,29170,광주광역시,북구,85-89세,4012,1165,2847
202012,29170,광주광역시,북구,85-89세,4031,1200,2831
202101,29170,광주광역시,북구,85-89세,4044,1222,2822
202102,29170,광주광역시,북구,85-89세,4088,1243,2845
202103,29170,광주광역시,북구,85-89세,4110,1247,2863
202104,29170,광주광역시,북구,85-89세,4143,1252,2891
202105,29170,광주광역시,북구,85-89세,4184,1272,2912
202106,29170,광주광역시,북구,85-89세,4172,1273,2899
202007,29170,광주광역시,북구,90-94세,1380,293,1087
202008,29170,광주광역시,북구,90-94세,1382,294,1088
202009,29170,광주광역시,북구,90-94세,1374,290,1084
202010,29170,광주광역시,북구,90-94세,1384,295,1089
202011,29170,광주광역시,북구,90-94세,1396,300,1096
202012,29170,광주광역시,북구,90-94세,1412,298,1114
202101,29170,광주광역시,북구,90-94세,1432,307,1125
202102,29170,광주광역시,북구,90-94세,1438,300,1138
202103,29170,광주광역시,북구,90-94세,1454,305,1149
202104,29170,광주광역시,북구,90-94세,1462,304,1158
202105,29170,광주광역시,북구,90-94세,1472,305,1167
202106,29170,광주광역시,북구,90-94세,1464,305,1159
202007,29170,광주광역시,북구,95-99세,292,43,249
202008,29170,광주광역시,북구,95-99세,300,45,255
202009,29170,광주광역시,북구,95-99세,308,46,262
202010,29170,광주광역시,북구,95-99세,307,47,260
202011,29170,광주광역시,북구,95-99세,305,47,258
202012,29170,광주광역시,북구,95-99세,306,44,262
202101,29170,광주광역시,북구,95-99세,308,45,263
202102,29170,광주광역시,북구,95-99세,314,47,267
202103,29170,광주광역시,북구,95-99세,312,44,268
202104,29170,광주광역시,북구,95-99세,320,49,271
202105,29170,광주광역시,북구,95-99세,310,49,261
202106,29170,광주광역시,북구,95-99세,311,52,259
202007,29170,광주광역시,북구,100+,118,12,106
202008,29170,광주광역시,북구,100+,118,12,106
202009,29170,광주광역시,북구,100+,118,12,106
202010,29170,광주광역시,북구,100+,120,12,108
202011,29170,광주광역시,북구,100+,119,11,108
202012,29170,광주광역시,북구,100+,119,11,108
202101,29170,광주광역시,북구,100+,122,11,111
202102,29170,광주광역시,북구,100+,125,11,114
202103,29170,광주광역시,북구,100+,103,8,95
202104,29170,광주광역시,북구,100+,105,8,97
202105,29170,광주광역시,북구,100+,69,5,64
202106,29170,광주광역시,북구,100+,66,5,61
202007,29200,광주광역시,광산구,0-4세,16867,8576,8291
202008,29200,광주광역시,광산구,0-4세,16742,8493,8249
202009,29200,광주광역시,광산구,0-4세,16506,8369,8137
202010,29200,광주광역시,광산구,0-4세,16277,8276,8001
202011,29200,광주광역시,광산구,0-4세,16097,8166,7931
202012,29200,광주광역시,광산구,0-4세,15952,8093,7859
202101,29200,광주광역시,광산구,0-4세,15769,8010,7759
202102,29200,광주광역시,광산구,0-4세,15654,7943,7711
202103,29200,광주광역시,광산구,0-4세,15557,7883,7674
202104,29200,광주광역시,광산구,0-4세,15401,7814,7587
202105,29200,광주광역시,광산구,0-4세,15263,7758,7505
202106,29200,광주광역시,광산구,0-4세,15104,7687,7417
202007,29200,광주광역시,광산구,5-9세,24583,12728,11855
202008,29200,광주광역시,광산구,5-9세,24496,12708,11788
202009,29200,광주광역시,광산구,5-9세,24358,12633,11725
202010,29200,광주광역시,광산구,5-9세,24211,12514,11697
202011,29200,광주광역시,광산구,5-9세,24087,12441,11646
202012,29200,광주광역시,광산구,5-9세,23960,12370,11590
202101,29200,광주광역시,광산구,5-9세,23789,12291,11498
202102,29200,광주광역시,광산구,5-9세,23668,12225,11443
202103,29200,광주광역시,광산구,5-9세,23596,12205,11391
202104,29200,광주광역시,광산구,5-9세,23540,12149,11391
202105,29200,광주광역시,광산구,5-9세,23522,12116,11406
202106,29200,광주광역시,광산구,5-9세,23479,12098,11381
202007,29200,광주광역시,광산구,10-14세,25839,13184,12655
202008,29200,광주광역시,광산구,10-14세,25848,13194,12654
202009,29200,광주광역시,광산구,10-14세,25878,13221,12657
202010,29200,광주광역시,광산구,10-14세,25917,13259,12658
202011,29200,광주광역시,광산구,10-14세,25951,13283,12668
202012,29200,광주광역시,광산구,10-14세,25956,13285,12671
202101,29200,광주광역시,광산구,10-14세,25935,13284,12651
202102,29200,광주광역시,광산구,10-14세,25883,13255,12628
202103,29200,광주광역시,광산구,10-14세,25897,13258,12639
202104,29200,광주광역시,광산구,10-14세,25899,13274,12625
202105,29200,광주광역시,광산구,10-14세,25869,13260,12609
202106,29200,광주광역시,광산구,10-14세,25900,13277,12623
202007,29200,광주광역시,광산구,15-19세,27433,14265,13168
202008,29200,광주광역시,광산구,15-19세,27281,14161,13120
202009,29200,광주광역시,광산구,15-19세,27096,14029,13067
202010,29200,광주광역시,광산구,15-19세,26862,13879,12983
202011,29200,광주광역시,광산구,15-19세,26746,13815,12931
202012,29200,광주광역시,광산구,15-19세,26550,13727,12823
202101,29200,광주광역시,광산구,15-19세,26408,13636,12772
202102,29200,광주광역시,광산구,15-19세,26273,13568,12705
202103,29200,광주광역시,광산구,15-19세,26099,13480,12619
202104,29200,광주광역시,광산구,15-19세,26015,13417,12598
202105,29200,광주광역시,광산구,15-19세,25956,13376,12580
202106,29200,광주광역시,광산구,15-19세,25769,13267,12502
202007,29200,광주광역시,광산구,20-24세,31162,16485,14677
202008,29200,광주광역시,광산구,20-24세,31161,16490,14671
202009,29200,광주광역시,광산구,20-24세,31217,16544,14673
202010,29200,광주광역시,광산구,20-24세,31259,16558,14701
202011,29200,광주광역시,광산구,20-24세,31165,16520,14645
202012,29200,광주광역시,광산구,20-24세,31100,16456,14644
202101,29200,광주광역시,광산구,20-24세,31050,16456,14594
202102,29200,광주광역시,광산구,20-24세,30933,16353,14580
202103,29200,광주광역시,광산구,20-24세,30857,16303,14554
202104,29200,광주광역시,광산구,20-24세,30768,16273,14495
202105,29200,광주광역시,광산구,20-24세,30752,16251,14501
202106,29200,광주광역시,광산구,20-24세,30762,16240,14522
202007,29200,광주광역시,광산구,25-29세,27094,14339,12755
202008,29200,광주광역시,광산구,25-29세,27255,14452,12803
202009,29200,광주광역시,광산구,25-29세,27352,14537,12815
202010,29200,광주광역시,광산구,25-29세,27504,14647,12857
202011,29200,광주광역시,광산구,25-29세,27592,14698,12894
202012,29200,광주광역시,광산구,25-29세,27606,14694,12912
202101,29200,광주광역시,광산구,25-29세,27617,14731,12886
202102,29200,광주광역시,광산구,25-29세,27662,14800,12862
202103,29200,광주광역시,광산구,25-29세,27855,14906,12949
202104,29200,광주광역시,광산구,25-29세,27974,14957,13017
202105,29200,광주광역시,광산구,25-29세,27998,14991,13007
202106,29200,광주광역시,광산구,25-29세,28023,15012,13011
202007,29200,광주광역시,광산구,30-34세,23342,12010,11332
202008,29200,광주광역시,광산구,30-34세,23422,12041,11381
202009,29200,광주광역시,광산구,30-34세,23379,12007,11372
202010,29200,광주광역시,광산구,30-34세,23283,11958,11325
202011,29200,광주광역시,광산구,30-34세,23229,11931,11298
202012,29200,광주광역시,광산구,30-34세,23157,11913,11244
202101,29200,광주광역시,광산구,30-34세,23215,11935,11280
202102,29200,광주광역시,광산구,30-34세,23173,11897,11276
202103,29200,광주광역시,광산구,30-34세,23249,11972,11277
202104,29200,광주광역시,광산구,30-34세,23310,12004,11306
202105,29200,광주광역시,광산구,30-34세,23379,12026,11353
202106,29200,광주광역시,광산구,30-34세,23465,12081,11384
202007,29200,광주광역시,광산구,35-39세,32506,16298,16208
202008,29200,광주광역시,광산구,35-39세,32324,16244,16080
202009,29200,광주광역시,광산구,35-39세,32139,16173,15966
202010,29200,광주광역시,광산구,35-39세,31836,16031,15805
202011,29200,광주광역시,광산구,35-39세,31708,15988,15720
202012,29200,광주광역시,광산구,35-39세,31545,15903,15642
202101,29200,광주광역시,광산구,35-39세,31248,15729,15519
202102,29200,광주광역시,광산구,35-39세,31101,15670,15431
202103,29200,광주광역시,광산구,35-39세,30859,15588,15271
202104,29200,광주광역시,광산구,35-39세,30667,15493,15174
202105,29200,광주광역시,광산구,35-39세,30467,15375,15092
202106,29200,광주광역시,광산구,35-39세,30245,15252,14993
202007,29200,광주광역시,광산구,40-44세,36685,18007,18678
202008,29200,광주광역시,광산구,40-44세,36721,18035,18686
202009,29200,광주광역시,광산구,40-44세,36686,18036,18650
202010,29200,광주광역시,광산구,40-44세,36735,18058,18677
202011,29200,광주광역시,광산구,40-44세,36673,18013,18660
202012,29200,광주광역시,광산구,40-44세,36615,18016,18599
202101,29200,광주광역시,광산구,40-44세,36462,17966,18496
202102,29200,광주광역시,광산구,40-44세,36501,18004,18497
202103,29200,광주광역시,광산구,40-44세,36434,17953,18481
202104,29200,광주광역시,광산구,40-44세,36397,17944,18453
202105,29200,광주광역시,광산구,40-44세,36404,17962,18442
202106,29200,광주광역시,광산구,40-44세,36487,18011,18476
202007,29200,광주광역시,광산구,45-49세,40777,20637,20140
202008,29200,광주광역시,광산구,45-49세,40716,20563,20153
202009,29200,광주광역시,광산구,45-49세,40617,20496,20121
202010,29200,광주광역시,광산구,45-49세,40365,20348,20017
202011,29200,광주광역시,광산구,45-49세,40187,20278,19909
202012,29200,광주광역시,광산구,45-49세,40019,20155,19864
202101,29200,광주광역시,광산구,45-49세,39954,20097,19857
202102,29200,광주광역시,광산구,45-49세,39951,20078,19873
202103,29200,광주광역시,광산구,45-49세,39829,20007,19822
202104,29200,광주광역시,광산구,45-49세,39791,19974,19817
202105,29200,광주광역시,광산구,45-49세,39424,19780,19644
202106,29200,광주광역시,광산구,45-49세,39233,19694,19539
202007,29200,광주광역시,광산구,50-54세,35670,18226,17444
202008,29200,광주광역시,광산구,50-54세,35779,18325,17454
202009,29200,광주광역시,광산구,50-54세,35805,18346,17459
202010,29200,광주광역시,광산구,50-54세,35901,18399,17502
202011,29200,광주광역시,광산구,50-54세,35985,18422,17563
202012,29200,광주광역시,광산구,50-54세,36015,18475,17540
202101,29200,광주광역시,광산구,50-54세,36226,18591,17635
202102,29200,광주광역시,광산구,50-54세,36310,18636,17674
202103,29200,광주광역시,광산구,50-54세,36257,18599,17658
202104,29200,광주광역시,광산구,50-54세,36340,18613,17727
202105,29200,광주광역시,광산구,50-54세,36673,18775,17898
202106,29200,광주광역시,광산구,50-54세,36853,18862,17991
202007,29200,광주광역시,광산구,55-59세,27400,14599,12801
202008,29200,광주광역시,광산구,55-59세,27474,14583,12891
202009,29200,광주광역시,광산구,55-59세,27579,14623,12956
202010,29200,광주광역시,광산구,55-59세,27619,14661,12958
202011,29200,광주광역시,광산구,55-59세,27693,14687,13006
202012,29200,광주광역시,광산구,55-59세,27787,14694,13093
202101,29200,광주광역시,광산구,55-59세,27811,14696,13115
202102,29200,광주광역시,광산구,55-59세,27904,14742,13162
202103,29200,광주광역시,광산구,55-59세,28179,14903,13276
202104,29200,광주광역시,광산구,55-59세,28253,14941,13312
202105,29200,광주광역시,광산구,55-59세,28257,14956,13301
202106,29200,광주광역시,광산구,55-59세,28207,14912,13295
202007,29200,광주광역시,광산구,60-64세,20009,10260,9749
202008,29200,광주광역시,광산구,60-64세,20215,10373,9842
202009,29200,광주광역시,광산구,60-64세,20423,10490,9933
202010,29200,광주광역시,광산구,60-64세,20576,10552,10024
202011,29200,광주광역시,광산구,60-64세,20672,10607,10065
202012,29200,광주광역시,광산구,60-64세,20862,10709,10153
202101,29200,광주광역시,광산구,60-64세,21093,10820,10273
202102,29200,광주광역시,광산구,60-64세,21311,10916,10395
202103,29200,광주광역시,광산구,60-64세,21438,10974,10464
202104,29200,광주광역시,광산구,60-64세,21572,11042,10530
202105,29200,광주광역시,광산구,60-64세,21804,11166,10638
202106,29200,광주광역시,광산구,60-64세,21960,11236,10724
202007,29200,광주광역시,광산구,65-69세,12039,5722,6317
202008,29200,광주광역시,광산구,65-69세,12129,5800,6329
202009,29200,광주광역시,광산구,65-69세,12225,5845,6380
202010,29200,광주광역시,광산구,65-69세,12290,5878,6412
202011,29200,광주광역시,광산구,65-69세,12364,5943,6421
202012,29200,광주광역시,광산구,65-69세,12384,5954,6430
202101,29200,광주광역시,광산구,65-69세,12438,6004,6434
202102,29200,광주광역시,광산구,65-69세,12518,6053,6465
202103,29200,광주광역시,광산구,65-69세,12633,6137,6496
202104,29200,광주광역시,광산구,65-69세,12705,6183,6522
202105,29200,광주광역시,광산구,65-69세,12761,6212,6549
202106,29200,광주광역시,광산구,65-69세,12800,6246,6554
202007,29200,광주광역시,광산구,70-74세,9553,4339,5214
202008,29200,광주광역시,광산구,70-74세,9564,4335,5229
202009,29200,광주광역시,광산구,70-74세,9614,4356,5258
202010,29200,광주광역시,광산구,70-74세,9638,4360,5278
202011,29200,광주광역시,광산구,70-74세,9705,4371,5334
202012,29200,광주광역시,광산구,70-74세,9790,4411,5379
202101,29200,광주광역시,광산구,70-74세,9865,4449,5416
202102,29200,광주광역시,광산구,70-74세,9898,4455,5443
202103,29200,광주광역시,광산구,70-74세,9871,4435,5436
202104,29200,광주광역시,광산구,70-74세,9885,4422,5463
202105,29200,광주광역시,광산구,70-74세,9896,4424,5472
202106,29200,광주광역시,광산구,70-74세,9895,4424,5471
202007,29200,광주광역시,광산구,75-79세,7379,2927,4452
202008,29200,광주광역시,광산구,75-79세,7417,2937,4480
202009,29200,광주광역시,광산구,75-79세,7385,2933,4452
202010,29200,광주광역시,광산구,75-79세,7370,2944,4426
202011,29200,광주광역시,광산구,75-79세,7361,2941,4420
202012,29200,광주광역시,광산구,75-79세,7344,2941,4403
202101,29200,광주광역시,광산구,75-79세,7339,2958,4381
202102,29200,광주광역시,광산구,75-79세,7309,2974,4335
202103,29200,광주광역시,광산구,75-79세,7284,2983,4301
202104,29200,광주광역시,광산구,75-79세,7249,2984,4265
202105,29200,광주광역시,광산구,75-79세,7260,3007,4253
202106,29200,광주광역시,광산구,75-79세,7270,3026,4244
202007,29200,광주광역시,광산구,80-84세,5058,1597,3461
202008,29200,광주광역시,광산구,80-84세,5050,1604,3446
202009,29200,광주광역시,광산구,80-84세,5067,1605,3462
202010,29200,광주광역시,광산구,80-84세,5099,1608,3491
202011,29200,광주광역시,광산구,80-84세,5084,1612,3472
202012,29200,광주광역시,광산구,80-84세,5084,1625,3459
202101,29200,광주광역시,광산구,80-84세,5069,1618,3451
202102,29200,광주광역시,광산구,80-84세,5096,1633,3463
202103,29200,광주광역시,광산구,80-84세,5141,1650,3491
202104,29200,광주광역시,광산구,80-84세,5173,1666,3507
202105,29200,광주광역시,광산구,80-84세,5184,1665,3519
202106,29200,광주광역시,광산구,80-84세,5267,1694,3573
202007,29200,광주광역시,광산구,85-89세,2557,629,1928
202008,29200,광주광역시,광산구,85-89세,2576,634,1942
202009,29200,광주광역시,광산구,85-89세,2593,648,1945
202010,29200,광주광역시,광산구,85-89세,2597,649,1948
202011,29200,광주광역시,광산구,85-89세,2594,644,1950
202012,29200,광주광역시,광산구,85-89세,2615,654,1961
202101,29200,광주광역시,광산구,85-89세,2627,660,1967
202102,29200,광주광역시,광산구,85-89세,2659,663,1996
202103,29200,광주광역시,광산구,85-89세,2675,668,2007
202104,29200,광주광역시,광산구,85-89세,2700,674,2026
202105,29200,광주광역시,광산구,85-89세,2709,674,2035
202106,29200,광주광역시,광산구,85-89세,2692,674,2018
202007,29200,광주광역시,광산구,90-94세,913,175,738
202008,29200,광주광역시,광산구,90-94세,928,174,754
202009,29200,광주광역시,광산구,90-94세,945,176,769
202010,29200,광주광역시,광산구,90-94세,945,176,769
202011,29200,광주광역시,광산구,90-94세,961,184,777
202012,29200,광주광역시,광산구,90-94세,962,183,779
202101,29200,광주광역시,광산구,90-94세,965,185,780
202102,29200,광주광역시,광산구,90-94세,975,186,789
202103,29200,광주광역시,광산구,90-94세,974,185,789
202104,29200,광주광역시,광산구,90-94세,972,185,787
202105,29200,광주광역시,광산구,90-94세,977,186,791
202106,29200,광주광역시,광산구,90-94세,984,184,800
202007,29200,광주광역시,광산구,95-99세,203,31,172
202008,29200,광주광역시,광산구,95-99세,210,33,177
202009,29200,광주광역시,광산구,95-99세,210,33,177
202010,29200,광주광역시,광산구,95-99세,211,32,179
202011,29200,광주광역시,광산구,95-99세,209,30,179
202012,29200,광주광역시,광산구,95-99세,210,33,177
202101,29200,광주광역시,광산구,95-99세,208,33,175
202102,29200,광주광역시,광산구,95-99세,206,35,171
202103,29200,광주광역시,광산구,95-99세,201,33,168
202104,29200,광주광역시,광산구,95-99세,201,34,167
202105,29200,광주광역시,광산구,95-99세,199,31,168
202106,29200,광주광역시,광산구,95-99세,200,32,168
202007,29200,광주광역시,광산구,100+,64,5,59
202008,29200,광주광역시,광산구,100+,63,5,58
202009,29200,광주광역시,광산구,100+,64,5,59
202010,29200,광주광역시,광산구,100+,65,5,60
202011,29200,광주광역시,광산구,100+,63,5,58
202012,29200,광주광역시,광산구,100+,66,5,61
202101,29200,광주광역시,광산구,100+,66,5,61
202102,29200,광주광역시,광산구,100+,67,5,62
202103,29200,광주광역시,광산구,100+,54,6,48
202104,29200,광주광역시,광산구,100+,51,5,46
202105,29200,광주광역시,광산구,100+,50,5,45
202106,29200,광주광역시,광산구,100+,50,5,45
202007,30110,대전광역시,동구,0-4세,6483,3367,3116
202008,30110,대전광역시,동구,0-4세,6406,3312,3094
202009,30110,대전광역시,동구,0-4세,6334,3281,3053
202010,30110,대전광역시,동구,0-4세,6255,3254,3001
202011,30110,대전광역시,동구,0-4세,6192,3224,2968
202012,30110,대전광역시,동구,0-4세,6227,3229,2998
202101,30110,대전광역시,동구,0-4세,6235,3232,3003
202102,30110,대전광역시,동구,0-4세,6201,3229,2972
202103,30110,대전광역시,동구,0-4세,6154,3200,2954
202104,30110,대전광역시,동구,0-4세,6118,3185,2933
202105,30110,대전광역시,동구,0-4세,6081,3172,2909
202106,30110,대전광역시,동구,0-4세,6033,3154,2879
202007,30110,대전광역시,동구,5-9세,9028,4620,4408
202008,30110,대전광역시,동구,5-9세,8964,4609,4355
202009,30110,대전광역시,동구,5-9세,8900,4561,4339
202010,30110,대전광역시,동구,5-9세,8839,4517,4322
202011,30110,대전광역시,동구,5-9세,8786,4482,4304
202012,30110,대전광역시,동구,5-9세,8783,4496,4287
202101,30110,대전광역시,동구,5-9세,8806,4520,4286
202102,30110,대전광역시,동구,5-9세,8809,4526,4283
202103,30110,대전광역시,동구,5-9세,8789,4512,4277
202104,30110,대전광역시,동구,5-9세,8751,4500,4251
202105,30110,대전광역시,동구,5-9세,8711,4484,4227
202106,30110,대전광역시,동구,5-9세,8698,4487,4211
202007,30110,대전광역시,동구,10-14세,9346,4856,4490
202008,30110,대전광역시,동구,10-14세,9344,4844,4500
202009,30110,대전광역시,동구,10-14세,9389,4873,4516
202010,30110,대전광역시,동구,10-14세,9383,4861,4522
202011,30110,대전광역시,동구,10-14세,9370,4865,4505
202012,30110,대전광역시,동구,10-14세,9383,4881,4502
202101,30110,대전광역시,동구,10-14세,9430,4903,4527
202102,30110,대전광역시,동구,10-14세,9451,4913,4538
202103,30110,대전광역시,동구,10-14세,9469,4921,4548
202104,30110,대전광역시,동구,10-14세,9484,4921,4563
202105,30110,대전광역시,동구,10-14세,9478,4904,4574
202106,30110,대전광역시,동구,10-14세,9466,4893,4573
202007,30110,대전광역시,동구,15-19세,10974,5649,5325
202008,30110,대전광역시,동구,15-19세,10896,5612,5284
202009,30110,대전광역시,동구,15-19세,10776,5557,5219
202010,30110,대전광역시,동구,15-19세,10656,5512,5144
202011,30110,대전광역시,동구,15-19세,10573,5476,5097
202012,30110,대전광역시,동구,15-19세,10518,5444,5074
202101,30110,대전광역시,동구,15-19세,10438,5406,5032
202102,30110,대전광역시,동구,15-19세,10520,5417,5103
202103,30110,대전광역시,동구,15-19세,10502,5395,5107
202104,30110,대전광역시,동구,15-19세,10443,5380,5063
202105,30110,대전광역시,동구,15-19세,10395,5362,5033
202106,30110,대전광역시,동구,15-19세,10345,5345,5000
202007,30110,대전광역시,동구,20-24세,16028,8274,7754
202008,30110,대전광역시,동구,20-24세,15992,8248,7744
202009,30110,대전광역시,동구,20-24세,15922,8185,7737
202010,30110,대전광역시,동구,20-24세,15889,8165,7724
202011,30110,대전광역시,동구,20-24세,15842,8112,7730
202012,30110,대전광역시,동구,20-24세,15870,8134,7736
202101,30110,대전광역시,동구,20-24세,15849,8148,7701
202102,30110,대전광역시,동구,20-24세,15863,8212,7651
202103,30110,대전광역시,동구,20-24세,15864,8232,7632
202104,30110,대전광역시,동구,20-24세,15802,8178,7624
202105,30110,대전광역시,동구,20-24세,15890,8193,7697
202106,30110,대전광역시,동구,20-24세,15881,8191,7690
202007,30110,대전광역시,동구,25-29세,14346,7875,6471
202008,30110,대전광역시,동구,25-29세,14306,7834,6472
202009,30110,대전광역시,동구,25-29세,14330,7849,6481
202010,30110,대전광역시,동구,25-29세,14314,7819,6495
202011,30110,대전광역시,동구,25-29세,14282,7796,6486
202012,30110,대전광역시,동구,25-29세,14316,7809,6507
202101,30110,대전광역시,동구,25-29세,14339,7816,6523
202102,30110,대전광역시,동구,25-29세,14270,7770,6500
202103,30110,대전광역시,동구,25-29세,14356,7820,6536
202104,30110,대전광역시,동구,25-29세,14378,7842,6536
202105,30110,대전광역시,동구,25-29세,14405,7874,6531
202106,30110,대전광역시,동구,25-29세,14344,7831,6513
202007,30110,대전광역시,동구,30-34세,11611,6410,5201
202008,30110,대전광역시,동구,30-34세,11586,6424,5162
202009,30110,대전광역시,동구,30-34세,11578,6434,5144
202010,30110,대전광역시,동구,30-34세,11509,6404,5105
202011,30110,대전광역시,동구,30-34세,11459,6386,5073
202012,30110,대전광역시,동구,30-34세,11557,6465,5092
202101,30110,대전광역시,동구,30-34세,11700,6552,5148
202102,30110,대전광역시,동구,30-34세,11760,6581,5179
202103,30110,대전광역시,동구,30-34세,11781,6586,5195
202104,30110,대전광역시,동구,30-34세,11804,6607,5197
202105,30110,대전광역시,동구,30-34세,11814,6607,5207
202106,30110,대전광역시,동구,30-34세,11857,6604,5253
202007,30110,대전광역시,동구,35-39세,14754,7766,6988
202008,30110,대전광역시,동구,35-39세,14629,7711,6918
202009,30110,대전광역시,동구,35-39세,14480,7641,6839
202010,30110,대전광역시,동구,35-39세,14341,7557,6784
202011,30110,대전광역시,동구,35-39세,14254,7524,6730
202012,30110,대전광역시,동구,35-39세,14295,7527,6768
202101,30110,대전광역시,동구,35-39세,14305,7515,6790
202102,30110,대전광역시,동구,35-39세,14207,7476,6731
202103,30110,대전광역시,동구,35-39세,14070,7404,6666
202104,30110,대전광역시,동구,35-39세,13986,7362,6624
202105,30110,대전광역시,동구,35-39세,13895,7329,6566
202106,30110,대전광역시,동구,35-39세,13765,7271,6494
202007,30110,대전광역시,동구,40-44세,15786,8182,7604
202008,30110,대전광역시,동구,40-44세,15780,8187,7593
202009,30110,대전광역시,동구,40-44세,15847,8223,7624
202010,30110,대전광역시,동구,40-44세,15833,8208,7625
202011,30110,대전광역시,동구,40-44세,15828,8196,7632
202012,30110,대전광역시,동구,40-44세,15796,8197,7599
202101,30110,대전광역시,동구,40-44세,15830,8215,7615
202102,30110,대전광역시,동구,40-44세,15890,8267,7623
202103,30110,대전광역시,동구,40-44세,15767,8198,7569
202104,30110,대전광역시,동구,40-44세,15776,8209,7567
202105,30110,대전광역시,동구,40-44세,15847,8254,7593
202106,30110,대전광역시,동구,40-44세,15962,8298,7664
202007,30110,대전광역시,동구,45-49세,18487,9829,8658
202008,30110,대전광역시,동구,45-49세,18436,9793,8643
202009,30110,대전광역시,동구,45-49세,18352,9746,8606
202010,30110,대전광역시,동구,45-49세,18273,9726,8547
202011,30110,대전광역시,동구,45-49세,18208,9693,8515
202012,30110,대전광역시,동구,45-49세,18284,9713,8571
202101,30110,대전광역시,동구,45-49세,18313,9744,8569
202102,30110,대전광역시,동구,45-49세,18351,9727,8624
202103,30110,대전광역시,동구,45-49세,18260,9684,8576
202104,30110,대전광역시,동구,45-49세,18218,9639,8579
202105,30110,대전광역시,동구,45-49세,18079,9543,8536
202106,30110,대전광역시,동구,45-49세,18000,9495,8505
202007,30110,대전광역시,동구,50-54세,18391,9511,8880
202008,30110,대전광역시,동구,50-54세,18409,9514,8895
202009,30110,대전광역시,동구,50-54세,18387,9502,8885
202010,30110,대전광역시,동구,50-54세,18441,9537,8904
202011,30110,대전광역시,동구,50-54세,18458,9557,8901
202012,30110,대전광역시,동구,50-54세,18462,9571,8891
202101,30110,대전광역시,동구,50-54세,18644,9646,8998
202102,30110,대전광역시,동구,50-54세,18679,9679,9000
202103,30110,대전광역시,동구,50-54세,18550,9630,8920
202104,30110,대전광역시,동구,50-54세,18585,9649,8936
202105,30110,대전광역시,동구,50-54세,18655,9701,8954
202106,30110,대전광역시,동구,50-54세,18697,9729,8968
202007,30110,대전광역시,동구,55-59세,18694,9482,9212
202008,30110,대전광역시,동구,55-59세,18634,9460,9174
202009,30110,대전광역시,동구,55-59세,18532,9420,9112
202010,30110,대전광역시,동구,55-59세,18366,9331,9035
202011,30110,대전광역시,동구,55-59세,18285,9283,9002
202012,30110,대전광역시,동구,55-59세,18274,9268,9006
202101,30110,대전광역시,동구,55-59세,18152,9203,8949
202102,30110,대전광역시,동구,55-59세,18110,9196,8914
202103,30110,대전광역시,동구,55-59세,17963,9139,8824
202104,30110,대전광역시,동구,55-59세,17819,9082,8737
202105,30110,대전광역시,동구,55-59세,17688,9021,8667
202106,30110,대전광역시,동구,55-59세,17529,8950,8579
202007,30110,대전광역시,동구,60-64세,18361,8970,9391
202008,30110,대전광역시,동구,60-64세,18431,8986,9445
202009,30110,대전광역시,동구,60-64세,18487,9007,9480
202010,30110,대전광역시,동구,60-64세,18568,9058,9510
202011,30110,대전광역시,동구,60-64세,18630,9088,9542
202012,30110,대전광역시,동구,60-64세,18723,9148,9575
202101,30110,대전광역시,동구,60-64세,18875,9235,9640
202102,30110,대전광역시,동구,60-64세,18970,9272,9698
202103,30110,대전광역시,동구,60-64세,18998,9297,9701
202104,30110,대전광역시,동구,60-64세,19142,9371,9771
202105,30110,대전광역시,동구,60-64세,19207,9401,9806
202106,30110,대전광역시,동구,60-64세,19376,9476,9900
202007,30110,대전광역시,동구,65-69세,13433,6442,6991
202008,30110,대전광역시,동구,65-69세,13493,6460,7033
202009,30110,대전광역시,동구,65-69세,13561,6504,7057
202010,30110,대전광역시,동구,65-69세,13614,6536,7078
202011,30110,대전광역시,동구,65-69세,13699,6570,7129
202012,30110,대전광역시,동구,65-69세,13841,6638,7203
202101,30110,대전광역시,동구,65-69세,14000,6711,7289
202102,30110,대전광역시,동구,65-69세,14109,6779,7330
202103,30110,대전광역시,동구,65-69세,14185,6798,7387
202104,30110,대전광역시,동구,65-69세,14281,6825,7456
202105,30110,대전광역시,동구,65-69세,14399,6887,7512
202106,30110,대전광역시,동구,65-69세,14414,6891,7523
202007,30110,대전광역시,동구,70-74세,10321,4766,5555
202008,30110,대전광역시,동구,70-74세,10345,4768,5577
202009,30110,대전광역시,동구,70-74세,10411,4786,5625
202010,30110,대전광역시,동구,70-74세,10478,4800,5678
202011,30110,대전광역시,동구,70-74세,10512,4813,5699
202012,30110,대전광역시,동구,70-74세,10601,4846,5755
202101,30110,대전광역시,동구,70-74세,10662,4874,5788
202102,30110,대전광역시,동구,70-74세,10714,4884,5830
202103,30110,대전광역시,동구,70-74세,10673,4875,5798
202104,30110,대전광역시,동구,70-74세,10689,4885,5804
202105,30110,대전광역시,동구,70-74세,10685,4878,5807
202106,30110,대전광역시,동구,70-74세,10702,4903,5799
202007,30110,대전광역시,동구,75-79세,8651,3734,4917
202008,30110,대전광역시,동구,75-79세,8683,3767,4916
202009,30110,대전광역시,동구,75-79세,8647,3764,4883
202010,30110,대전광역시,동구,75-79세,8605,3766,4839
202011,30110,대전광역시,동구,75-79세,8568,3746,4822
202012,30110,대전광역시,동구,75-79세,8549,3750,4799
202101,30110,대전광역시,동구,75-79세,8523,3738,4785
202102,30110,대전광역시,동구,75-79세,8462,3723,4739
202103,30110,대전광역시,동구,75-79세,8429,3687,4742
202104,30110,대전광역시,동구,75-79세,8383,3666,4717
202105,30110,대전광역시,동구,75-79세,8357,3669,4688
202106,30110,대전광역시,동구,75-79세,8333,3651,4682
202007,30110,대전광역시,동구,80-84세,5575,2088,3487
202008,30110,대전광역시,동구,80-84세,5570,2089,3481
202009,30110,대전광역시,동구,80-84세,5578,2090,3488
202010,30110,대전광역시,동구,80-84세,5617,2106,3511
202011,30110,대전광역시,동구,80-84세,5620,2104,3516
202012,30110,대전광역시,동구,80-84세,5622,2106,3516
202101,30110,대전광역시,동구,80-84세,5648,2124,3524
202102,30110,대전광역시,동구,80-84세,5697,2149,3548
202103,30110,대전광역시,동구,80-84세,5699,2158,3541
202104,30110,대전광역시,동구,80-84세,5738,2167,3571
202105,30110,대전광역시,동구,80-84세,5780,2181,3599
202106,30110,대전광역시,동구,80-84세,5842,2210,3632
202007,30110,대전광역시,동구,85-89세,2584,848,1736
202008,30110,대전광역시,동구,85-89세,2609,855,1754
202009,30110,대전광역시,동구,85-89세,2640,864,1776
202010,30110,대전광역시,동구,85-89세,2655,873,1782
202011,30110,대전광역시,동구,85-89세,2663,871,1792
202012,30110,대전광역시,동구,85-89세,2693,882,1811
202101,30110,대전광역시,동구,85-89세,2744,894,1850
202102,30110,대전광역시,동구,85-89세,2788,905,1883
202103,30110,대전광역시,동구,85-89세,2804,906,1898
202104,30110,대전광역시,동구,85-89세,2802,905,1897
202105,30110,대전광역시,동구,85-89세,2818,907,1911
202106,30110,대전광역시,동구,85-89세,2835,907,1928
202007,30110,대전광역시,동구,90-94세,905,218,687
202008,30110,대전광역시,동구,90-94세,916,220,696
202009,30110,대전광역시,동구,90-94세,908,219,689
202010,30110,대전광역시,동구,90-94세,906,222,684
202011,30110,대전광역시,동구,90-94세,912,229,683
202012,30110,대전광역시,동구,90-94세,920,231,689
202101,30110,대전광역시,동구,90-94세,922,237,685
202102,30110,대전광역시,동구,90-94세,939,240,699
202103,30110,대전광역시,동구,90-94세,934,235,699
202104,30110,대전광역시,동구,90-94세,933,238,695
202105,30110,대전광역시,동구,90-94세,940,239,701
202106,30110,대전광역시,동구,90-94세,934,234,700
202007,30110,대전광역시,동구,95-99세,205,55,150
202008,30110,대전광역시,동구,95-99세,200,52,148
202009,30110,대전광역시,동구,95-99세,213,54,159
202010,30110,대전광역시,동구,95-99세,212,52,160
202011,30110,대전광역시,동구,95-99세,210,51,159
202012,30110,대전광역시,동구,95-99세,209,53,156
202101,30110,대전광역시,동구,95-99세,215,53,162
202102,30110,대전광역시,동구,95-99세,215,54,161
202103,30110,대전광역시,동구,95-99세,183,39,144
202104,30110,대전광역시,동구,95-99세,187,39,148
202105,30110,대전광역시,동구,95-99세,190,40,150
202106,30110,대전광역시,동구,95-99세,194,41,153
202007,30110,대전광역시,동구,100+,97,29,68
202008,30110,대전광역시,동구,100+,99,29,70
202009,30110,대전광역시,동구,100+,96,29,67
202010,30110,대전광역시,동구,100+,96,29,67
202011,30110,대전광역시,동구,100+,95,28,67
202012,30110,대전광역시,동구,100+,98,28,70
202101,30110,대전광역시,동구,100+,97,28,69
202102,30110,대전광역시,동구,100+,98,27,71
202103,30110,대전광역시,동구,100+,39,10,29
202104,30110,대전광역시,동구,100+,39,10,29
202105,30110,대전광역시,동구,100+,39,10,29
202106,30110,대전광역시,동구,100+,38,10,28
202007,30140,대전광역시,중구,0-4세,6435,3260,3175
202008,30140,대전광역시,중구,0-4세,6386,3226,3160
202009,30140,대전광역시,중구,0-4세,6282,3178,3104
202010,30140,대전광역시,중구,0-4세,6210,3144,3066
202011,30140,대전광역시,중구,0-4세,6136,3115,3021
202012,30140,대전광역시,중구,0-4세,6031,3066,2965
202101,30140,대전광역시,중구,0-4세,5947,3042,2905
202102,30140,대전광역시,중구,0-4세,5855,2980,2875
202103,30140,대전광역시,중구,0-4세,5773,2932,2841
202104,30140,대전광역시,중구,0-4세,5723,2899,2824
202105,30140,대전광역시,중구,0-4세,5679,2868,2811
202106,30140,대전광역시,중구,0-4세,5654,2871,2783
202007,30140,대전광역시,중구,5-9세,9425,4859,4566
202008,30140,대전광역시,중구,5-9세,9397,4856,4541
202009,30140,대전광역시,중구,5-9세,9333,4805,4528
202010,30140,대전광역시,중구,5-9세,9273,4764,4509
202011,30140,대전광역시,중구,5-9세,9220,4741,4479
202012,30140,대전광역시,중구,5-9세,9143,4697,4446
202101,30140,대전광역시,중구,5-9세,9086,4664,4422
202102,30140,대전광역시,중구,5-9세,8984,4624,4360
202103,30140,대전광역시,중구,5-9세,8949,4618,4331
202104,30140,대전광역시,중구,5-9세,8925,4599,4326
202105,30140,대전광역시,중구,5-9세,8892,4596,4296
202106,30140,대전광역시,중구,5-9세,8849,4560,4289
202007,30140,대전광역시,중구,10-14세,10275,5224,5051
202008,30140,대전광역시,중구,10-14세,10233,5216,5017
202009,30140,대전광역시,중구,10-14세,10231,5232,4999
202010,30140,대전광역시,중구,10-14세,10211,5213,4998
202011,30140,대전광역시,중구,10-14세,10243,5215,5028
202012,30140,대전광역시,중구,10-14세,10236,5218,5018
202101,30140,대전광역시,중구,10-14세,10201,5194,5007
202102,30140,대전광역시,중구,10-14세,10183,5200,4983
202103,30140,대전광역시,중구,10-14세,10207,5206,5001
202104,30140,대전광역시,중구,10-14세,10178,5199,4979
202105,30140,대전광역시,중구,10-14세,10185,5212,4973
202106,30140,대전광역시,중구,10-14세,10181,5212,4969
202007,30140,대전광역시,중구,15-19세,12204,6341,5863
202008,30140,대전광역시,중구,15-19세,12149,6288,5861
202009,30140,대전광역시,중구,15-19세,12081,6260,5821
202010,30140,대전광역시,중구,15-19세,11965,6214,5751
202011,30140,대전광역시,중구,15-19세,11898,6194,5704
202012,30140,대전광역시,중구,15-19세,11751,6114,5637
202101,30140,대전광역시,중구,15-19세,11675,6071,5604
202102,30140,대전광역시,중구,15-19세,11585,6033,5552
202103,30140,대전광역시,중구,15-19세,11488,5995,5493
202104,30140,대전광역시,중구,15-19세,11400,5934,5466
202105,30140,대전광역시,중구,15-19세,11321,5884,5437
202106,30140,대전광역시,중구,15-19세,11268,5845,5423
202007,30140,대전광역시,중구,20-24세,15578,8012,7566
202008,30140,대전광역시,중구,20-24세,15547,7986,7561
202009,30140,대전광역시,중구,20-24세,15534,7966,7568
202010,30140,대전광역시,중구,20-24세,15477,7927,7550
202011,30140,대전광역시,중구,20-24세,15421,7883,7538
202012,30140,대전광역시,중구,20-24세,15329,7845,7484
202101,30140,대전광역시,중구,20-24세,15246,7808,7438
202102,30140,대전광역시,중구,20-24세,15215,7788,7427
202103,30140,대전광역시,중구,20-24세,15113,7744,7369
202104,30140,대전광역시,중구,20-24세,15054,7710,7344
202105,30140,대전광역시,중구,20-24세,14994,7669,7325
202106,30140,대전광역시,중구,20-24세,14941,7651,7290
202007,30140,대전광역시,중구,25-29세,15712,8071,7641
202008,30140,대전광역시,중구,25-29세,15688,8064,7624
202009,30140,대전광역시,중구,25-29세,15623,8027,7596
202010,30140,대전광역시,중구,25-29세,15629,8019,7610
202011,30140,대전광역시,중구,25-29세,15681,8063,7618
202012,30140,대전광역시,중구,25-29세,15611,8003,7608
202101,30140,대전광역시,중구,25-29세,15582,7968,7614
202102,30140,대전광역시,중구,25-29세,15591,7955,7636
202103,30140,대전광역시,중구,25-29세,15539,7919,7620
202104,30140,대전광역시,중구,25-29세,15536,7894,7642
202105,30140,대전광역시,중구,25-29세,15549,7914,7635
202106,30140,대전광역시,중구,25-29세,15588,7919,7669
202007,30140,대전광역시,중구,30-34세,12252,6428,5824
202008,30140,대전광역시,중구,30-34세,12279,6445,5834
202009,30140,대전광역시,중구,30-34세,12266,6419,5847
202010,30140,대전광역시,중구,30-34세,12234,6406,5828
202011,30140,대전광역시,중구,30-34세,12148,6359,5789
202012,30140,대전광역시,중구,30-34세,12045,6335,5710
202101,30140,대전광역시,중구,30-34세,12063,6342,5721
202102,30140,대전광역시,중구,30-34세,12064,6331,5733
202103,30140,대전광역시,중구,30-34세,12059,6330,5729
202104,30140,대전광역시,중구,30-34세,12054,6332,5722
202105,30140,대전광역시,중구,30-34세,12092,6336,5756
202106,30140,대전광역시,중구,30-34세,12144,6363,5781
202007,30140,대전광역시,중구,35-39세,14668,7440,7228
202008,30140,대전광역시,중구,35-39세,14539,7373,7166
202009,30140,대전광역시,중구,35-39세,14428,7311,7117
202010,30140,대전광역시,중구,35-39세,14242,7196,7046
202011,30140,대전광역시,중구,35-39세,14142,7156,6986
202012,30140,대전광역시,중구,35-39세,14046,7095,6951
202101,30140,대전광역시,중구,35-39세,13921,7029,6892
202102,30140,대전광역시,중구,35-39세,13770,6944,6826
202103,30140,대전광역시,중구,35-39세,13645,6881,6764
202104,30140,대전광역시,중구,35-39세,13554,6846,6708
202105,30140,대전광역시,중구,35-39세,13463,6830,6633
202106,30140,대전광역시,중구,35-39세,13337,6766,6571
202007,30140,대전광역시,중구,40-44세,17131,8628,8503
202008,30140,대전광역시,중구,40-44세,17119,8614,8505
202009,30140,대전광역시,중구,40-44세,17163,8655,8508
202010,30140,대전광역시,중구,40-44세,17183,8687,8496
202011,30140,대전광역시,중구,40-44세,17131,8649,8482
202012,30140,대전광역시,중구,40-44세,16989,8593,8396
202101,30140,대전광역시,중구,40-44세,16898,8541,8357
202102,30140,대전광역시,중구,40-44세,16778,8492,8286
202103,30140,대전광역시,중구,40-44세,16675,8441,8234
202104,30140,대전광역시,중구,40-44세,16611,8402,8209
202105,30140,대전광역시,중구,40-44세,16657,8397,8260
202106,30140,대전광역시,중구,40-44세,16728,8436,8292
202007,30140,대전광역시,중구,45-49세,20413,10421,9992
202008,30140,대전광역시,중구,45-49세,20337,10385,9952
202009,30140,대전광역시,중구,45-49세,20217,10311,9906
202010,30140,대전광역시,중구,45-49세,20049,10207,9842
202011,30140,대전광역시,중구,45-49세,19974,10185,9789
202012,30140,대전광역시,중구,45-49세,19916,10136,9780
202101,30140,대전광역시,중구,45-49세,19832,10113,9719
202102,30140,대전광역시,중구,45-49세,19800,10080,9720
202103,30140,대전광역시,중구,45-49세,19634,10019,9615
202104,30140,대전광역시,중구,45-49세,19562,9975,9587
202105,30140,대전광역시,중구,45-49세,19406,9881,9525
202106,30140,대전광역시,중구,45-49세,19260,9802,9458
202007,30140,대전광역시,중구,50-54세,20423,10357,10066
202008,30140,대전광역시,중구,50-54세,20457,10393,10064
202009,30140,대전광역시,중구,50-54세,20455,10413,10042
202010,30140,대전광역시,중구,50-54세,20530,10465,10065
202011,30140,대전광역시,중구,50-54세,20567,10457,10110
202012,30140,대전광역시,중구,50-54세,20471,10412,10059
202101,30140,대전광역시,중구,50-54세,20560,10458,10102
202102,30140,대전광역시,중구,50-54세,20494,10421,10073
202103,30140,대전광역시,중구,50-54세,20357,10342,10015
202104,30140,대전광역시,중구,50-54세,20374,10339,10035
202105,30140,대전광역시,중구,50-54세,20446,10384,10062
202106,30140,대전광역시,중구,50-54세,20517,10428,10089
202007,30140,대전광역시,중구,55-59세,19727,9885,9842
202008,30140,대전광역시,중구,55-59세,19611,9823,9788
202009,30140,대전광역시,중구,55-59세,19560,9799,9761
202010,30140,대전광역시,중구,55-59세,19395,9735,9660
202011,30140,대전광역시,중구,55-59세,19344,9722,9622
202012,30140,대전광역시,중구,55-59세,19223,9634,9589
202101,30140,대전광역시,중구,55-59세,18997,9544,9453
202102,30140,대전광역시,중구,55-59세,18967,9527,9440
202103,30140,대전광역시,중구,55-59세,18832,9460,9372
202104,30140,대전광역시,중구,55-59세,18735,9417,9318
202105,30140,대전광역시,중구,55-59세,18651,9393,9258
202106,30140,대전광역시,중구,55-59세,18426,9274,9152
202007,30140,대전광역시,중구,60-64세,18842,9102,9740
202008,30140,대전광역시,중구,60-64세,18856,9115,9741
202009,30140,대전광역시,중구,60-64세,18901,9134,9767
202010,30140,대전광역시,중구,60-64세,18975,9176,9799
202011,30140,대전광역시,중구,60-64세,19001,9196,9805
202012,30140,대전광역시,중구,60-64세,19058,9248,9810
202101,30140,대전광역시,중구,60-64세,19204,9322,9882
202102,30140,대전광역시,중구,60-64세,19248,9354,9894
202103,30140,대전광역시,중구,60-64세,19259,9360,9899
202104,30140,대전광역시,중구,60-64세,19274,9358,9916
202105,30140,대전광역시,중구,60-64세,19360,9408,9952
202106,30140,대전광역시,중구,60-64세,19448,9454,9994
202007,30140,대전광역시,중구,65-69세,14173,6597,7576
202008,30140,대전광역시,중구,65-69세,14244,6647,7597
202009,30140,대전광역시,중구,65-69세,14335,6699,7636
202010,30140,대전광역시,중구,65-69세,14380,6707,7673
202011,30140,대전광역시,중구,65-69세,14453,6728,7725
202012,30140,대전광역시,중구,65-69세,14545,6763,7782
202101,30140,대전광역시,중구,65-69세,14655,6776,7879
202102,30140,대전광역시,중구,65-69세,14727,6818,7909
202103,30140,대전광역시,중구,65-69세,14832,6895,7937
202104,30140,대전광역시,중구,65-69세,14947,6963,7984
202105,30140,대전광역시,중구,65-69세,15025,7003,8022
202106,30140,대전광역시,중구,65-69세,15099,7034,8065
202007,30140,대전광역시,중구,70-74세,11439,5277,6162
202008,30140,대전광역시,중구,70-74세,11446,5266,6180
202009,30140,대전광역시,중구,70-74세,11495,5279,6216
202010,30140,대전광역시,중구,70-74세,11574,5312,6262
202011,30140,대전광역시,중구,70-74세,11601,5338,6263
202012,30140,대전광역시,중구,70-74세,11644,5363,6281
202101,30140,대전광역시,중구,70-74세,11716,5423,6293
202102,30140,대전광역시,중구,70-74세,11775,5438,6337
202103,30140,대전광역시,중구,70-74세,11677,5389,6288
202104,30140,대전광역시,중구,70-74세,11695,5381,6314
202105,30140,대전광역시,중구,70-74세,11686,5363,6323
202106,30140,대전광역시,중구,70-74세,11688,5364,6324
202007,30140,대전광역시,중구,75-79세,9064,3946,5118
202008,30140,대전광역시,중구,75-79세,9087,3957,5130
202009,30140,대전광역시,중구,75-79세,9054,3940,5114
202010,30140,대전광역시,중구,75-79세,9007,3915,5092
202011,30140,대전광역시,중구,75-79세,9009,3929,5080
202012,30140,대전광역시,중구,75-79세,8944,3906,5038
202101,30140,대전광역시,중구,75-79세,8923,3899,5024
202102,30140,대전광역시,중구,75-79세,8881,3882,4999
202103,30140,대전광역시,중구,75-79세,8920,3903,5017
202104,30140,대전광역시,중구,75-79세,8877,3872,5005
202105,30140,대전광역시,중구,75-79세,8869,3859,5010
202106,30140,대전광역시,중구,75-79세,8873,3859,5014
202007,30140,대전광역시,중구,80-84세,6099,2445,3654
202008,30140,대전광역시,중구,80-84세,6111,2447,3664
202009,30140,대전광역시,중구,80-84세,6113,2444,3669
202010,30140,대전광역시,중구,80-84세,6117,2436,3681
202011,30140,대전광역시,중구,80-84세,6121,2422,3699
202012,30140,대전광역시,중구,80-84세,6146,2437,3709
202101,30140,대전광역시,중구,80-84세,6179,2453,3726
202102,30140,대전광역시,중구,80-84세,6199,2470,3729
202103,30140,대전광역시,중구,80-84세,6173,2456,3717
202104,30140,대전광역시,중구,80-84세,6200,2473,3727
202105,30140,대전광역시,중구,80-84세,6243,2503,3740
202106,30140,대전광역시,중구,80-84세,6283,2529,3754
202007,30140,대전광역시,중구,85-89세,2945,971,1974
202008,30140,대전광역시,중구,85-89세,2967,987,1980
202009,30140,대전광역시,중구,85-89세,3004,1009,1995
202010,30140,대전광역시,중구,85-89세,3011,1013,1998
202011,30140,대전광역시,중구,85-89세,3049,1037,2012
202012,30140,대전광역시,중구,85-89세,3068,1038,2030
202101,30140,대전광역시,중구,85-89세,3097,1046,2051
202102,30140,대전광역시,중구,85-89세,3144,1068,2076
202103,30140,대전광역시,중구,85-89세,3139,1070,2069
202104,30140,대전광역시,중구,85-89세,3168,1083,2085
202105,30140,대전광역시,중구,85-89세,3193,1091,2102
202106,30140,대전광역시,중구,85-89세,3207,1098,2109
202007,30140,대전광역시,중구,90-94세,1021,257,764
202008,30140,대전광역시,중구,90-94세,1008,253,755
202009,30140,대전광역시,중구,90-94세,1017,251,766
202010,30140,대전광역시,중구,90-94세,1030,259,771
202011,30140,대전광역시,중구,90-94세,1028,261,767
202012,30140,대전광역시,중구,90-94세,1026,260,766
202101,30140,대전광역시,중구,90-94세,1047,269,778
202102,30140,대전광역시,중구,90-94세,1056,269,787
202103,30140,대전광역시,중구,90-94세,1048,260,788
202104,30140,대전광역시,중구,90-94세,1062,262,800
202105,30140,대전광역시,중구,90-94세,1070,261,809
202106,30140,대전광역시,중구,90-94세,1067,264,803
202007,30140,대전광역시,중구,95-99세,240,51,189
202008,30140,대전광역시,중구,95-99세,248,52,196
202009,30140,대전광역시,중구,95-99세,248,51,197
202010,30140,대전광역시,중구,95-99세,249,49,200
202011,30140,대전광역시,중구,95-99세,241,48,193
202012,30140,대전광역시,중구,95-99세,243,49,194
202101,30140,대전광역시,중구,95-99세,249,49,200
202102,30140,대전광역시,중구,95-99세,251,49,202
202103,30140,대전광역시,중구,95-99세,236,45,191
202104,30140,대전광역시,중구,95-99세,236,45,191
202105,30140,대전광역시,중구,95-99세,238,45,193
202106,30140,대전광역시,중구,95-99세,234,46,188
202007,30140,대전광역시,중구,100+,83,20,63
202008,30140,대전광역시,중구,100+,83,20,63
202009,30140,대전광역시,중구,100+,85,22,63
202010,30140,대전광역시,중구,100+,84,21,63
202011,30140,대전광역시,중구,100+,84,20,64
202012,30140,대전광역시,중구,100+,85,21,64
202101,30140,대전광역시,중구,100+,86,21,65
202102,30140,대전광역시,중구,100+,87,21,66
202103,30140,대전광역시,중구,100+,46,8,38
202104,30140,대전광역시,중구,100+,48,8,40
202105,30140,대전광역시,중구,100+,48,8,40
202106,30140,대전광역시,중구,100+,49,8,41
202007,30170,대전광역시,서구,0-4세,16653,8616,8037
202008,30170,대전광역시,서구,0-4세,16510,8544,7966
202009,30170,대전광역시,서구,0-4세,16413,8487,7926
202010,30170,대전광역시,서구,0-4세,16159,8364,7795
202011,30170,대전광역시,서구,0-4세,15929,8224,7705
202012,30170,대전광역시,서구,0-4세,15788,8141,7647
202101,30170,대전광역시,서구,0-4세,15591,8044,7547
202102,30170,대전광역시,서구,0-4세,15474,7979,7495
202103,30170,대전광역시,서구,0-4세,15292,7882,7410
202104,30170,대전광역시,서구,0-4세,15156,7816,7340
202105,30170,대전광역시,서구,0-4세,15028,7740,7288
202106,30170,대전광역시,서구,0-4세,14877,7666,7211
202007,30170,대전광역시,서구,5-9세,22756,11659,11097
202008,30170,대전광역시,서구,5-9세,22740,11658,11082
202009,30170,대전광역시,서구,5-9세,22607,11607,11000
202010,30170,대전광역시,서구,5-9세,22527,11591,10936
202011,30170,대전광역시,서구,5-9세,22389,11538,10851
202012,30170,대전광역시,서구,5-9세,22304,11520,10784
202101,30170,대전광역시,서구,5-9세,22183,11457,10726
202102,30170,대전광역시,서구,5-9세,22154,11425,10729
202103,30170,대전광역시,서구,5-9세,22044,11388,10656
202104,30170,대전광역시,서구,5-9세,21993,11359,10634
202105,30170,대전광역시,서구,5-9세,21923,11339,10584
202106,30170,대전광역시,서구,5-9세,21866,11316,10550
202007,30170,대전광역시,서구,10-14세,23624,12136,11488
202008,30170,대전광역시,서구,10-14세,23629,12121,11508
202009,30170,대전광역시,서구,10-14세,23637,12139,11498
202010,30170,대전광역시,서구,10-14세,23685,12144,11541
202011,30170,대전광역시,서구,10-14세,23701,12160,11541
202012,30170,대전광역시,서구,10-14세,23679,12148,11531
202101,30170,대전광역시,서구,10-14세,23693,12151,11542
202102,30170,대전광역시,서구,10-14세,23678,12159,11519
202103,30170,대전광역시,서구,10-14세,23668,12155,11513
202104,30170,대전광역시,서구,10-14세,23696,12169,11527
202105,30170,대전광역시,서구,10-14세,23736,12177,11559
202106,30170,대전광역시,서구,10-14세,23762,12174,11588
202007,30170,대전광역시,서구,15-19세,27043,14035,13008
202008,30170,대전광역시,서구,15-19세,26794,13942,12852
202009,30170,대전광역시,서구,15-19세,26628,13849,12779
202010,30170,대전광역시,서구,15-19세,26386,13740,12646
202011,30170,대전광역시,서구,15-19세,26189,13618,12571
202012,30170,대전광역시,서구,15-19세,26014,13506,12508
202101,30170,대전광역시,서구,15-19세,25777,13372,12405
202102,30170,대전광역시,서구,15-19세,25595,13265,12330
202103,30170,대전광역시,서구,15-19세,25358,13122,12236
202104,30170,대전광역시,서구,15-19세,25203,13034,12169
202105,30170,대전광역시,서구,15-19세,25074,12990,12084
202106,30170,대전광역시,서구,15-19세,24999,12945,12054
202007,30170,대전광역시,서구,20-24세,35902,18126,17776
202008,30170,대전광역시,서구,20-24세,35874,18042,17832
202009,30170,대전광역시,서구,20-24세,35810,17988,17822
202010,30170,대전광역시,서구,20-24세,35697,17919,17778
202011,30170,대전광역시,서구,20-24세,35542,17845,17697
202012,30170,대전광역시,서구,20-24세,35325,17737,17588
202101,30170,대전광역시,서구,20-24세,35196,17700,17496
202102,30170,대전광역시,서구,20-24세,35035,17608,17427
202103,30170,대전광역시,서구,20-24세,34853,17524,17329
202104,30170,대전광역시,서구,20-24세,34705,17434,17271
202105,30170,대전광역시,서구,20-24세,34652,17403,17249
202106,30170,대전광역시,서구,20-24세,34518,17334,17184
202007,30170,대전광역시,서구,25-29세,38233,19677,18556
202008,30170,대전광역시,서구,25-29세,38385,19767,18618
202009,30170,대전광역시,서구,25-29세,38537,19864,18673
202010,30170,대전광역시,서구,25-29세,38539,19862,18677
202011,30170,대전광역시,서구,25-29세,38651,19929,18722
202012,30170,대전광역시,서구,25-29세,38765,20003,18762
202101,30170,대전광역시,서구,25-29세,38783,20002,18781
202102,30170,대전광역시,서구,25-29세,38742,19971,18771
202103,30170,대전광역시,서구,25-29세,38789,20007,18782
202104,30170,대전광역시,서구,25-29세,39001,20160,18841
202105,30170,대전광역시,서구,25-29세,38955,20108,18847
202106,30170,대전광역시,서구,25-29세,38987,20137,18850
202007,30170,대전광역시,서구,30-34세,31613,16431,15182
202008,30170,대전광역시,서구,30-34세,31638,16458,15180
202009,30170,대전광역시,서구,30-34세,31644,16460,15184
202010,30170,대전광역시,서구,30-34세,31488,16378,15110
202011,30170,대전광역시,서구,30-34세,31387,16323,15064
202012,30170,대전광역시,서구,30-34세,31272,16288,14984
202101,30170,대전광역시,서구,30-34세,31285,16288,14997
202102,30170,대전광역시,서구,30-34세,31253,16252,15001
202103,30170,대전광역시,서구,30-34세,31294,16261,15033
202104,30170,대전광역시,서구,30-34세,31383,16316,15067
202105,30170,대전광역시,서구,30-34세,31447,16337,15110
202106,30170,대전광역시,서구,30-34세,31513,16354,15159
202007,30170,대전광역시,서구,35-39세,35784,17899,17885
202008,30170,대전광역시,서구,35-39세,35625,17841,17784
202009,30170,대전광역시,서구,35-39세,35341,17736,17605
202010,30170,대전광역시,서구,35-39세,35122,17630,17492
202011,30170,대전광역시,서구,35-39세,34884,17518,17366
202012,30170,대전광역시,서구,35-39세,34627,17395,17232
202101,30170,대전광역시,서구,35-39세,34448,17333,17115
202102,30170,대전광역시,서구,35-39세,34364,17296,17068
202103,30170,대전광역시,서구,35-39세,34112,17194,16918
202104,30170,대전광역시,서구,35-39세,34012,17119,16893
202105,30170,대전광역시,서구,35-39세,33853,17048,16805
202106,30170,대전광역시,서구,35-39세,33627,16949,16678
202007,30170,대전광역시,서구,40-44세,36590,17718,18872
202008,30170,대전광역시,서구,40-44세,36657,17742,18915
202009,30170,대전광역시,서구,40-44세,36774,17770,19004
202010,30170,대전광역시,서구,40-44세,36802,17798,19004
202011,30170,대전광역시,서구,40-44세,36827,17805,19022
202012,30170,대전광역시,서구,40-44세,36681,17761,18920
202101,30170,대전광역시,서구,40-44세,36576,17709,18867
202102,30170,대전광역시,서구,40-44세,36633,17779,18854
202103,30170,대전광역시,서구,40-44세,36418,17714,18704
202104,30170,대전광역시,서구,40-44세,36354,17727,18627
202105,30170,대전광역시,서구,40-44세,36438,17758,18680
202106,30170,대전광역시,서구,40-44세,36547,17809,18738
202007,30170,대전광역시,서구,45-49세,42956,20740,22216
202008,30170,대전광역시,서구,45-49세,42802,20679,22123
202009,30170,대전광역시,서구,45-49세,42524,20521,22003
202010,30170,대전광역시,서구,45-49세,42229,20394,21835
202011,30170,대전광역시,서구,45-49세,41955,20311,21644
202012,30170,대전광역시,서구,45-49세,41844,20218,21626
202101,30170,대전광역시,서구,45-49세,41667,20127,21540
202102,30170,대전광역시,서구,45-49세,41505,20067,21438
202103,30170,대전광역시,서구,45-49세,41214,19878,21336
202104,30170,대전광역시,서구,45-49세,41114,19768,21346
202105,30170,대전광역시,서구,45-49세,40779,19595,21184
202106,30170,대전광역시,서구,45-49세,40507,19474,21033
202007,30170,대전광역시,서구,50-54세,40787,19786,21001
202008,30170,대전광역시,서구,50-54세,40856,19808,21048
202009,30170,대전광역시,서구,50-54세,40961,19882,21079
202010,30170,대전광역시,서구,50-54세,41139,19937,21202
202011,30170,대전광역시,서구,50-54세,41186,19924,21262
202012,30170,대전광역시,서구,50-54세,41070,19885,21185
202101,30170,대전광역시,서구,50-54세,41251,19934,21317
202102,30170,대전광역시,서구,50-54세,41291,19909,21382
202103,30170,대전광역시,서구,50-54세,41210,19907,21303
202104,30170,대전광역시,서구,50-54세,41347,19982,21365
202105,30170,대전광역시,서구,50-54세,41669,20172,21497
202106,30170,대전광역시,서구,50-54세,41774,20215,21559
202007,30170,대전광역시,서구,55-59세,37300,18084,19216
202008,30170,대전광역시,서구,55-59세,37233,18077,19156
202009,30170,대전광역시,서구,55-59세,37151,18015,19136
202010,30170,대전광역시,서구,55-59세,36928,17925,19003
202011,30170,대전광역시,서구,55-59세,36770,17818,18952
202012,30170,대전광역시,서구,55-59세,36661,17751,18910
202101,30170,대전광역시,서구,55-59세,36312,17642,18670
202102,30170,대전광역시,서구,55-59세,36137,17553,18584
202103,30170,대전광역시,서구,55-59세,35870,17409,18461
202104,30170,대전광역시,서구,55-59세,35677,17335,18342
202105,30170,대전광역시,서구,55-59세,35340,17154,18186
202106,30170,대전광역시,서구,55-59세,34992,17004,17988
202007,30170,대전광역시,서구,60-64세,32184,15564,16620
202008,30170,대전광역시,서구,60-64세,32343,15620,16723
202009,30170,대전광역시,서구,60-64세,32411,15659,16752
202010,30170,대전광역시,서구,60-64세,32578,15727,16851
202011,30170,대전광역시,서구,60-64세,32754,15808,16946
202012,30170,대전광역시,서구,60-64세,32823,15783,17040
202101,30170,대전광역시,서구,60-64세,33138,15906,17232
202102,30170,대전광역시,서구,60-64세,33344,15982,17362
202103,30170,대전광역시,서구,60-64세,33547,16081,17466
202104,30170,대전광역시,서구,60-64세,33721,16122,17599
202105,30170,대전광역시,서구,60-64세,33990,16248,17742
202106,30170,대전광역시,서구,60-64세,34245,16365,17880
202007,30170,대전광역시,서구,65-69세,21225,10220,11005
202008,30170,대전광역시,서구,65-69세,21380,10294,11086
202009,30170,대전광역시,서구,65-69세,21562,10404,11158
202010,30170,대전광역시,서구,65-69세,21632,10415,11217
202011,30170,대전광역시,서구,65-69세,21712,10447,11265
202012,30170,대전광역시,서구,65-69세,21932,10563,11369
202101,30170,대전광역시,서구,65-69세,22138,10665,11473
202102,30170,대전광역시,서구,65-69세,22309,10748,11561
202103,30170,대전광역시,서구,65-69세,22583,10885,11698
202104,30170,대전광역시,서구,65-69세,22750,10962,11788
202105,30170,대전광역시,서구,65-69세,22904,11058,11846
202106,30170,대전광역시,서구,65-69세,23086,11147,11939
202007,30170,대전광역시,서구,70-74세,14609,6938,7671
202008,30170,대전광역시,서구,70-74세,14689,6970,7719
202009,30170,대전광역시,서구,70-74세,14795,7019,7776
202010,30170,대전광역시,서구,70-74세,14948,7092,7856
202011,30170,대전광역시,서구,70-74세,15064,7157,7907
202012,30170,대전광역시,서구,70-74세,15150,7200,7950
202101,30170,대전광역시,서구,70-74세,15250,7238,8012
202102,30170,대전광역시,서구,70-74세,15332,7273,8059
202103,30170,대전광역시,서구,70-74세,15305,7235,8070
202104,30170,대전광역시,서구,70-74세,15373,7265,8108
202105,30170,대전광역시,서구,70-74세,15412,7270,8142
202106,30170,대전광역시,서구,70-74세,15396,7255,8141
202007,30170,대전광역시,서구,75-79세,11046,4847,6199
202008,30170,대전광역시,서구,75-79세,11052,4844,6208
202009,30170,대전광역시,서구,75-79세,10997,4806,6191
202010,30170,대전광역시,서구,75-79세,10939,4779,6160
202011,30170,대전광역시,서구,75-79세,10915,4771,6144
202012,30170,대전광역시,서구,75-79세,10877,4762,6115
202101,30170,대전광역시,서구,75-79세,10907,4783,6124
202102,30170,대전광역시,서구,75-79세,10844,4755,6089
202103,30170,대전광역시,서구,75-79세,10837,4751,6086
202104,30170,대전광역시,서구,75-79세,10803,4744,6059
202105,30170,대전광역시,서구,75-79세,10798,4750,6048
202106,30170,대전광역시,서구,75-79세,10797,4740,6057
202007,30170,대전광역시,서구,80-84세,7298,2779,4519
202008,30170,대전광역시,서구,80-84세,7290,2793,4497
202009,30170,대전광역시,서구,80-84세,7340,2830,4510
202010,30170,대전광역시,서구,80-84세,7337,2825,4512
202011,30170,대전광역시,서구,80-84세,7326,2830,4496
202012,30170,대전광역시,서구,80-84세,7332,2834,4498
202101,30170,대전광역시,서구,80-84세,7343,2845,4498
202102,30170,대전광역시,서구,80-84세,7428,2883,4545
202103,30170,대전광역시,서구,80-84세,7448,2899,4549
202104,30170,대전광역시,서구,80-84세,7467,2912,4555
202105,30170,대전광역시,서구,80-84세,7487,2934,4553
202106,30170,대전광역시,서구,80-84세,7530,2950,4580
202007,30170,대전광역시,서구,85-89세,3847,1167,2680
202008,30170,대전광역시,서구,85-89세,3871,1170,2701
202009,30170,대전광역시,서구,85-89세,3878,1170,2708
202010,30170,대전광역시,서구,85-89세,3903,1196,2707
202011,30170,대전광역시,서구,85-89세,3923,1197,2726
202012,30170,대전광역시,서구,85-89세,3972,1213,2759
202101,30170,대전광역시,서구,85-89세,3999,1227,2772
202102,30170,대전광역시,서구,85-89세,4028,1240,2788
202103,30170,대전광역시,서구,85-89세,4081,1268,2813
202104,30170,대전광역시,서구,85-89세,4105,1271,2834
202105,30170,대전광역시,서구,85-89세,4140,1274,2866
202106,30170,대전광역시,서구,85-89세,4150,1274,2876
202007,30170,대전광역시,서구,90-94세,1365,325,1040
202008,30170,대전광역시,서구,90-94세,1348,325,1023
202009,30170,대전광역시,서구,90-94세,1362,331,1031
202010,30170,대전광역시,서구,90-94세,1368,329,1039
202011,30170,대전광역시,서구,90-94세,1363,332,1031
202012,30170,대전광역시,서구,90-94세,1360,329,1031
202101,30170,대전광역시,서구,90-94세,1378,330,1048
202102,30170,대전광역시,서구,90-94세,1378,336,1042
202103,30170,대전광역시,서구,90-94세,1378,335,1043
202104,30170,대전광역시,서구,90-94세,1374,334,1040
202105,30170,대전광역시,서구,90-94세,1394,335,1059
202106,30170,대전광역시,서구,90-94세,1384,332,1052
202007,30170,대전광역시,서구,95-99세,304,49,255
202008,30170,대전광역시,서구,95-99세,317,49,268
202009,30170,대전광역시,서구,95-99세,317,50,267
202010,30170,대전광역시,서구,95-99세,311,51,260
202011,30170,대전광역시,서구,95-99세,315,56,259
202012,30170,대전광역시,서구,95-99세,312,57,255
202101,30170,대전광역시,서구,95-99세,318,60,258
202102,30170,대전광역시,서구,95-99세,326,60,266
202103,30170,대전광역시,서구,95-99세,323,62,261
202104,30170,대전광역시,서구,95-99세,329,62,267
202105,30170,대전광역시,서구,95-99세,327,63,264
202106,30170,대전광역시,서구,95-99세,319,62,257
202007,30170,대전광역시,서구,100+,90,18,72
202008,30170,대전광역시,서구,100+,91,19,72
202009,30170,대전광역시,서구,100+,91,18,73
202010,30170,대전광역시,서구,100+,89,17,72
202011,30170,대전광역시,서구,100+,90,17,73
202012,30170,대전광역시,서구,100+,92,18,74
202101,30170,대전광역시,서구,100+,93,19,74
202102,30170,대전광역시,서구,100+,95,18,77
202103,30170,대전광역시,서구,100+,61,11,50
202104,30170,대전광역시,서구,100+,59,11,48
202105,30170,대전광역시,서구,100+,60,11,49
202106,30170,대전광역시,서구,100+,58,11,47
202007,30200,대전광역시,유성구,0-4세,15819,8180,7639
202008,30200,대전광역시,유성구,0-4세,15679,8099,7580
202009,30200,대전광역시,유성구,0-4세,15541,8012,7529
202010,30200,대전광역시,유성구,0-4세,15342,7926,7416
202011,30200,대전광역시,유성구,0-4세,15171,7834,7337
202012,30200,대전광역시,유성구,0-4세,15018,7772,7246
202101,30200,대전광역시,유성구,0-4세,14848,7678,7170
202102,30200,대전광역시,유성구,0-4세,14654,7550,7104
202103,30200,대전광역시,유성구,0-4세,14544,7511,7033
202104,30200,대전광역시,유성구,0-4세,14477,7467,7010
202105,30200,대전광역시,유성구,0-4세,14381,7390,6991
202106,30200,대전광역시,유성구,0-4세,14309,7361,6948
202007,30200,대전광역시,유성구,5-9세,20122,10341,9781
202008,30200,대전광역시,유성구,5-9세,20149,10352,9797
202009,30200,대전광역시,유성구,5-9세,20118,10330,9788
202010,30200,대전광역시,유성구,5-9세,20079,10296,9783
202011,30200,대전광역시,유성구,5-9세,19961,10232,9729
202012,30200,대전광역시,유성구,5-9세,19928,10208,9720
202101,30200,대전광역시,유성구,5-9세,19849,10178,9671
202102,30200,대전광역시,유성구,5-9세,19781,10138,9643
202103,30200,대전광역시,유성구,5-9세,19717,10111,9606
202104,30200,대전광역시,유성구,5-9세,19648,10101,9547
202105,30200,대전광역시,유성구,5-9세,19587,10095,9492
202106,30200,대전광역시,유성구,5-9세,19560,10080,9480
202007,30200,대전광역시,유성구,10-14세,18986,9763,9223
202008,30200,대전광역시,유성구,10-14세,19040,9774,9266
202009,30200,대전광역시,유성구,10-14세,19103,9801,9302
202010,30200,대전광역시,유성구,10-14세,19089,9787,9302
202011,30200,대전광역시,유성구,10-14세,19130,9811,9319
202012,30200,대전광역시,유성구,10-14세,19079,9778,9301
202101,30200,대전광역시,유성구,10-14세,19145,9807,9338
202102,30200,대전광역시,유성구,10-14세,19121,9805,9316
202103,30200,대전광역시,유성구,10-14세,19142,9777,9365
202104,30200,대전광역시,유성구,10-14세,19150,9781,9369
202105,30200,대전광역시,유성구,10-14세,19148,9784,9364
202106,30200,대전광역시,유성구,10-14세,19142,9786,9356
202007,30200,대전광역시,유성구,15-19세,19581,10245,9336
202008,30200,대전광역시,유성구,15-19세,19425,10180,9245
202009,30200,대전광역시,유성구,15-19세,19342,10116,9226
202010,30200,대전광역시,유성구,15-19세,19249,10059,9190
202011,30200,대전광역시,유성구,15-19세,19173,10020,9153
202012,30200,대전광역시,유성구,15-19세,19076,9974,9102
202101,30200,대전광역시,유성구,15-19세,18984,9917,9067
202102,30200,대전광역시,유성구,15-19세,18880,9835,9045
202103,30200,대전광역시,유성구,15-19세,18789,9821,8968
202104,30200,대전광역시,유성구,15-19세,18725,9780,8945
202105,30200,대전광역시,유성구,15-19세,18665,9733,8932
202106,30200,대전광역시,유성구,15-19세,18582,9673,8909
202007,30200,대전광역시,유성구,20-24세,25064,13001,12063
202008,30200,대전광역시,유성구,20-24세,25071,13026,12045
202009,30200,대전광역시,유성구,20-24세,25090,13029,12061
202010,30200,대전광역시,유성구,20-24세,24972,12984,11988
202011,30200,대전광역시,유성구,20-24세,24840,12908,11932
202012,30200,대전광역시,유성구,20-24세,24727,12854,11873
202101,30200,대전광역시,유성구,20-24세,24771,12865,11906
202102,30200,대전광역시,유성구,20-24세,24791,12896,11895
202103,30200,대전광역시,유성구,20-24세,24770,12847,11923
202104,30200,대전광역시,유성구,20-24세,24714,12783,11931
202105,30200,대전광역시,유성구,20-24세,24650,12730,11920
202106,30200,대전광역시,유성구,20-24세,24577,12690,11887
202007,30200,대전광역시,유성구,25-29세,27701,15268,12433
202008,30200,대전광역시,유성구,25-29세,27794,15311,12483
202009,30200,대전광역시,유성구,25-29세,27813,15346,12467
202010,30200,대전광역시,유성구,25-29세,27908,15398,12510
202011,30200,대전광역시,유성구,25-29세,28021,15428,12593
202012,30200,대전광역시,유성구,25-29세,28017,15460,12557
202101,30200,대전광역시,유성구,25-29세,27902,15425,12477
202102,30200,대전광역시,유성구,25-29세,27728,15304,12424
202103,30200,대전광역시,유성구,25-29세,27818,15367,12451
202104,30200,대전광역시,유성구,25-29세,27792,15366,12426
202105,30200,대전광역시,유성구,25-29세,27868,15452,12416
202106,30200,대전광역시,유성구,25-29세,27827,15423,12404
202007,30200,대전광역시,유성구,30-34세,26857,14399,12458
202008,30200,대전광역시,유성구,30-34세,26849,14409,12440
202009,30200,대전광역시,유성구,30-34세,26865,14419,12446
202010,30200,대전광역시,유성구,30-34세,26784,14372,12412
202011,30200,대전광역시,유성구,30-34세,26683,14342,12341
202012,30200,대전광역시,유성구,30-34세,26512,14245,12267
202101,30200,대전광역시,유성구,30-34세,26618,14340,12278
202102,30200,대전광역시,유성구,30-34세,26487,14266,12221
202103,30200,대전광역시,유성구,30-34세,26489,14293,12196
202104,30200,대전광역시,유성구,30-34세,26507,14284,12223
202105,30200,대전광역시,유성구,30-34세,26550,14318,12232
202106,30200,대전광역시,유성구,30-34세,26533,14296,12237
202007,30200,대전광역시,유성구,35-39세,30152,15177,14975
202008,30200,대전광역시,유성구,35-39세,30062,15155,14907
202009,30200,대전광역시,유성구,35-39세,29993,15108,14885
202010,30200,대전광역시,유성구,35-39세,29848,15053,14795
202011,30200,대전광역시,유성구,35-39세,29692,14976,14716
202012,30200,대전광역시,유성구,35-39세,29557,14911,14646
202101,30200,대전광역시,유성구,35-39세,29373,14805,14568
202102,30200,대전광역시,유성구,35-39세,29175,14736,14439
202103,30200,대전광역시,유성구,35-39세,28984,14638,14346
202104,30200,대전광역시,유성구,35-39세,28884,14632,14252
202105,30200,대전광역시,유성구,35-39세,28733,14576,14157
202106,30200,대전광역시,유성구,35-39세,28614,14540,14074
202007,30200,대전광역시,유성구,40-44세,29344,14446,14898
202008,30200,대전광역시,유성구,40-44세,29464,14486,14978
202009,30200,대전광역시,유성구,40-44세,29522,14494,15028
202010,30200,대전광역시,유성구,40-44세,29598,14535,15063
202011,30200,대전광역시,유성구,40-44세,29568,14509,15059
202012,30200,대전광역시,유성구,40-44세,29397,14434,14963
202101,30200,대전광역시,유성구,40-44세,29380,14441,14939
202102,30200,대전광역시,유성구,40-44세,29458,14463,14995
202103,30200,대전광역시,유성구,40-44세,29387,14413,14974
202104,30200,대전광역시,유성구,40-44세,29426,14420,15006
202105,30200,대전광역시,유성구,40-44세,29538,14464,15074
202106,30200,대전광역시,유성구,40-44세,29675,14503,15172
202007,30200,대전광역시,유성구,45-49세,31501,15537,15964
202008,30200,대전광역시,유성구,45-49세,31402,15464,15938
202009,30200,대전광역시,유성구,45-49세,31300,15426,15874
202010,30200,대전광역시,유성구,45-49세,31165,15383,15782
202011,30200,대전광역시,유성구,45-49세,31063,15319,15744
202012,30200,대전광역시,유성구,45-49세,31048,15303,15745
202101,30200,대전광역시,유성구,45-49세,31023,15292,15731
202102,30200,대전광역시,유성구,45-49세,30909,15236,15673
202103,30200,대전광역시,유성구,45-49세,30825,15242,15583
202104,30200,대전광역시,유성구,45-49세,30757,15183,15574
202105,30200,대전광역시,유성구,45-49세,30503,15064,15439
202106,30200,대전광역시,유성구,45-49세,30370,15008,15362
202007,30200,대전광역시,유성구,50-54세,28794,14345,14449
202008,30200,대전광역시,유성구,50-54세,28940,14450,14490
202009,30200,대전광역시,유성구,50-54세,29025,14509,14516
202010,30200,대전광역시,유성구,50-54세,29053,14488,14565
202011,30200,대전광역시,유성구,50-54세,29091,14543,14548
202012,30200,대전광역시,유성구,50-54세,29032,14528,14504
202101,30200,대전광역시,유성구,50-54세,29127,14554,14573
202102,30200,대전광역시,유성구,50-54세,29263,14593,14670
202103,30200,대전광역시,유성구,50-54세,29321,14595,14726
202104,30200,대전광역시,유성구,50-54세,29357,14636,14721
202105,30200,대전광역시,유성구,50-54세,29541,14703,14838
202106,30200,대전광역시,유성구,50-54세,29698,14786,14912
202007,30200,대전광역시,유성구,55-59세,25292,12557,12735
202008,30200,대전광역시,유성구,55-59세,25236,12545,12691
202009,30200,대전광역시,유성구,55-59세,25146,12515,12631
202010,30200,대전광역시,유성구,55-59세,25122,12516,12606
202011,30200,대전광역시,유성구,55-59세,25078,12476,12602
202012,30200,대전광역시,유성구,55-59세,25042,12468,12574
202101,30200,대전광역시,유성구,55-59세,24808,12336,12472
202102,30200,대전광역시,유성구,55-59세,24716,12298,12418
202103,30200,대전광역시,유성구,55-59세,24629,12252,12377
202104,30200,대전광역시,유성구,55-59세,24621,12280,12341
202105,30200,대전광역시,유성구,55-59세,24577,12285,12292
202106,30200,대전광역시,유성구,55-59세,24345,12152,12193
202007,30200,대전광역시,유성구,60-64세,20289,10114,10175
202008,30200,대전광역시,유성구,60-64세,20428,10144,10284
202009,30200,대전광역시,유성구,60-64세,20592,10224,10368
202010,30200,대전광역시,유성구,60-64세,20700,10277,10423
202011,30200,대전광역시,유성구,60-64세,20843,10359,10484
202012,30200,대전광역시,유성구,60-64세,20960,10406,10554
202101,30200,대전광역시,유성구,60-64세,21189,10524,10665
202102,30200,대전광역시,유성구,60-64세,21346,10607,10739
202103,30200,대전광역시,유성구,60-64세,21505,10684,10821
202104,30200,대전광역시,유성구,60-64세,21570,10702,10868
202105,30200,대전광역시,유성구,60-64세,21702,10761,10941
202106,30200,대전광역시,유성구,60-64세,21908,10877,11031
202007,30200,대전광역시,유성구,65-69세,12166,6076,6090
202008,30200,대전광역시,유성구,65-69세,12260,6147,6113
202009,30200,대전광역시,유성구,65-69세,12353,6184,6169
202010,30200,대전광역시,유성구,65-69세,12444,6226,6218
202011,30200,대전광역시,유성구,65-69세,12566,6288,6278
202012,30200,대전광역시,유성구,65-69세,12651,6317,6334
202101,30200,대전광역시,유성구,65-69세,12786,6378,6408
202102,30200,대전광역시,유성구,65-69세,12937,6458,6479
202103,30200,대전광역시,유성구,65-69세,13112,6541,6571
202104,30200,대전광역시,유성구,65-69세,13233,6602,6631
202105,30200,대전광역시,유성구,65-69세,13362,6649,6713
202106,30200,대전광역시,유성구,65-69세,13477,6684,6793
202007,30200,대전광역시,유성구,70-74세,7542,3690,3852
202008,30200,대전광역시,유성구,70-74세,7566,3697,3869
202009,30200,대전광역시,유성구,70-74세,7619,3732,3887
202010,30200,대전광역시,유성구,70-74세,7677,3760,3917
202011,30200,대전광역시,유성구,70-74세,7709,3762,3947
202012,30200,대전광역시,유성구,70-74세,7798,3802,3996
202101,30200,대전광역시,유성구,70-74세,7868,3856,4012
202102,30200,대전광역시,유성구,70-74세,7933,3883,4050
202103,30200,대전광역시,유성구,70-74세,7954,3900,4054
202104,30200,대전광역시,유성구,70-74세,7994,3916,4078
202105,30200,대전광역시,유성구,70-74세,8016,3938,4078
202106,30200,대전광역시,유성구,70-74세,8012,3938,4074
202007,30200,대전광역시,유성구,75-79세,5752,2438,3314
202008,30200,대전광역시,유성구,75-79세,5781,2460,3321
202009,30200,대전광역시,유성구,75-79세,5735,2440,3295
202010,30200,대전광역시,유성구,75-79세,5737,2450,3287
202011,30200,대전광역시,유성구,75-79세,5698,2424,3274
202012,30200,대전광역시,유성구,75-79세,5655,2413,3242
202101,30200,대전광역시,유성구,75-79세,5614,2397,3217
202102,30200,대전광역시,유성구,75-79세,5588,2394,3194
202103,30200,대전광역시,유성구,75-79세,5550,2385,3165
202104,30200,대전광역시,유성구,75-79세,5529,2375,3154
202105,30200,대전광역시,유성구,75-79세,5550,2391,3159
202106,30200,대전광역시,유성구,75-79세,5599,2416,3183
202007,30200,대전광역시,유성구,80-84세,4005,1418,2587
202008,30200,대전광역시,유성구,80-84세,4030,1431,2599
202009,30200,대전광역시,유성구,80-84세,4036,1448,2588
202010,30200,대전광역시,유성구,80-84세,4038,1447,2591
202011,30200,대전광역시,유성구,80-84세,4052,1464,2588
202012,30200,대전광역시,유성구,80-84세,4074,1470,2604
202101,30200,대전광역시,유성구,80-84세,4061,1477,2584
202102,30200,대전광역시,유성구,80-84세,4047,1474,2573
202103,30200,대전광역시,유성구,80-84세,4024,1481,2543
202104,30200,대전광역시,유성구,80-84세,4017,1494,2523
202105,30200,대전광역시,유성구,80-84세,4036,1495,2541
202106,30200,대전광역시,유성구,80-84세,4057,1503,2554
202007,30200,대전광역시,유성구,85-89세,2248,620,1628
202008,30200,대전광역시,유성구,85-89세,2250,614,1636
202009,30200,대전광역시,유성구,85-89세,2279,618,1661
202010,30200,대전광역시,유성구,85-89세,2295,626,1669
202011,30200,대전광역시,유성구,85-89세,2313,634,1679
202012,30200,대전광역시,유성구,85-89세,2337,639,1698
202101,30200,대전광역시,유성구,85-89세,2369,643,1726
202102,30200,대전광역시,유성구,85-89세,2389,656,1733
202103,30200,대전광역시,유성구,85-89세,2437,658,1779
202104,30200,대전광역시,유성구,85-89세,2487,669,1818
202105,30200,대전광역시,유성구,85-89세,2515,682,1833
202106,30200,대전광역시,유성구,85-89세,2518,686,1832
202007,30200,대전광역시,유성구,90-94세,863,196,667
202008,30200,대전광역시,유성구,90-94세,881,200,681
202009,30200,대전광역시,유성구,90-94세,884,197,687
202010,30200,대전광역시,유성구,90-94세,883,196,687
202011,30200,대전광역시,유성구,90-94세,890,201,689
202012,30200,대전광역시,유성구,90-94세,890,204,686
202101,30200,대전광역시,유성구,90-94세,912,208,704
202102,30200,대전광역시,유성구,90-94세,918,205,713
202103,30200,대전광역시,유성구,90-94세,922,204,718
202104,30200,대전광역시,유성구,90-94세,928,203,725
202105,30200,대전광역시,유성구,90-94세,922,197,725
202106,30200,대전광역시,유성구,90-94세,922,199,723
202007,30200,대전광역시,유성구,95-99세,182,43,139
202008,30200,대전광역시,유성구,95-99세,186,44,142
202009,30200,대전광역시,유성구,95-99세,192,43,149
202010,30200,대전광역시,유성구,95-99세,192,42,150
202011,30200,대전광역시,유성구,95-99세,192,42,150
202012,30200,대전광역시,유성구,95-99세,192,42,150
202101,30200,대전광역시,유성구,95-99세,189,40,149
202102,30200,대전광역시,유성구,95-99세,195,41,154
202103,30200,대전광역시,유성구,95-99세,185,39,146
202104,30200,대전광역시,유성구,95-99세,175,37,138
202105,30200,대전광역시,유성구,95-99세,175,39,136
202106,30200,대전광역시,유성구,95-99세,174,40,134
202007,30200,대전광역시,유성구,100+,56,13,43
202008,30200,대전광역시,유성구,100+,57,13,44
202009,30200,대전광역시,유성구,100+,56,12,44
202010,30200,대전광역시,유성구,100+,56,12,44
202011,30200,대전광역시,유성구,100+,56,12,44
202012,30200,대전광역시,유성구,100+,57,12,45
202101,30200,대전광역시,유성구,100+,59,14,45
202102,30200,대전광역시,유성구,100+,58,14,44
202103,30200,대전광역시,유성구,100+,32,6,26
202104,30200,대전광역시,유성구,100+,26,4,22
202105,30200,대전광역시,유성구,100+,27,4,23
202106,30200,대전광역시,유성구,100+,28,3,25
202007,30230,대전광역시,대덕구,0-4세,4616,2250,2366
202008,30230,대전광역시,대덕구,0-4세,4552,2216,2336
202009,30230,대전광역시,대덕구,0-4세,4594,2232,2362
202010,30230,대전광역시,대덕구,0-4세,4630,2259,2371
202011,30230,대전광역시,대덕구,0-4세,4635,2259,2376
202012,30230,대전광역시,대덕구,0-4세,4620,2251,2369
202101,30230,대전광역시,대덕구,0-4세,4588,2240,2348
202102,30230,대전광역시,대덕구,0-4세,4553,2231,2322
202103,30230,대전광역시,대덕구,0-4세,4486,2208,2278
202104,30230,대전광역시,대덕구,0-4세,4465,2209,2256
202105,30230,대전광역시,대덕구,0-4세,4444,2200,2244
202106,30230,대전광역시,대덕구,0-4세,4414,2193,2221
202007,30230,대전광역시,대덕구,5-9세,6645,3450,3195
202008,30230,대전광역시,대덕구,5-9세,6632,3415,3217
202009,30230,대전광역시,대덕구,5-9세,6653,3417,3236
202010,30230,대전광역시,대덕구,5-9세,6698,3439,3259
202011,30230,대전광역시,대덕구,5-9세,6671,3429,3242
202012,30230,대전광역시,대덕구,5-9세,6687,3442,3245
202101,30230,대전광역시,대덕구,5-9세,6629,3409,3220
202102,30230,대전광역시,대덕구,5-9세,6573,3380,3193
202103,30230,대전광역시,대덕구,5-9세,6549,3356,3193
202104,30230,대전광역시,대덕구,5-9세,6501,3329,3172
202105,30230,대전광역시,대덕구,5-9세,6441,3297,3144
202106,30230,대전광역시,대덕구,5-9세,6411,3274,3137
202007,30230,대전광역시,대덕구,10-14세,7517,3923,3594
202008,30230,대전광역시,대덕구,10-14세,7501,3930,3571
202009,30230,대전광역시,대덕구,10-14세,7524,3951,3573
202010,30230,대전광역시,대덕구,10-14세,7544,3960,3584
202011,30230,대전광역시,대덕구,10-14세,7556,3959,3597
202012,30230,대전광역시,대덕구,10-14세,7543,3961,3582
202101,30230,대전광역시,대덕구,10-14세,7527,3951,3576
202102,30230,대전광역시,대덕구,10-14세,7510,3936,3574
202103,30230,대전광역시,대덕구,10-14세,7479,3925,3554
202104,30230,대전광역시,대덕구,10-14세,7471,3914,3557
202105,30230,대전광역시,대덕구,10-14세,7458,3907,3551
202106,30230,대전광역시,대덕구,10-14세,7435,3882,3553
202007,30230,대전광역시,대덕구,15-19세,9504,4935,4569
202008,30230,대전광역시,대덕구,15-19세,9423,4893,4530
202009,30230,대전광역시,대덕구,15-19세,9366,4869,4497
202010,30230,대전광역시,대덕구,15-19세,9321,4847,4474
202011,30230,대전광역시,대덕구,15-19세,9242,4805,4437
202012,30230,대전광역시,대덕구,15-19세,9157,4753,4404
202101,30230,대전광역시,대덕구,15-19세,9067,4710,4357
202102,30230,대전광역시,대덕구,15-19세,8987,4672,4315
202103,30230,대전광역시,대덕구,15-19세,8908,4641,4267
202104,30230,대전광역시,대덕구,15-19세,8830,4611,4219
202105,30230,대전광역시,대덕구,15-19세,8765,4567,4198
202106,30230,대전광역시,대덕구,15-19세,8734,4563,4171
202007,30230,대전광역시,대덕구,20-24세,12719,6933,5786
202008,30230,대전광역시,대덕구,20-24세,12631,6885,5746
202009,30230,대전광역시,대덕구,20-24세,12603,6869,5734
202010,30230,대전광역시,대덕구,20-24세,12571,6845,5726
202011,30230,대전광역시,대덕구,20-24세,12607,6873,5734
202012,30230,대전광역시,대덕구,20-24세,12550,6839,5711
202101,30230,대전광역시,대덕구,20-24세,12523,6808,5715
202102,30230,대전광역시,대덕구,20-24세,12451,6775,5676
202103,30230,대전광역시,대덕구,20-24세,12410,6762,5648
202104,30230,대전광역시,대덕구,20-24세,12366,6733,5633
202105,30230,대전광역시,대덕구,20-24세,12352,6736,5616
202106,30230,대전광역시,대덕구,20-24세,12314,6704,5610
202007,30230,대전광역시,대덕구,25-29세,11578,6578,5000
202008,30230,대전광역시,대덕구,25-29세,11631,6590,5041
202009,30230,대전광역시,대덕구,25-29세,11694,6630,5064
202010,30230,대전광역시,대덕구,25-29세,11834,6702,5132
202011,30230,대전광역시,대덕구,25-29세,11912,6729,5183
202012,30230,대전광역시,대덕구,25-29세,11978,6737,5241
202101,30230,대전광역시,대덕구,25-29세,11987,6743,5244
202102,30230,대전광역시,대덕구,25-29세,11937,6726,5211
202103,30230,대전광역시,대덕구,25-29세,11986,6775,5211
202104,30230,대전광역시,대덕구,25-29세,12013,6801,5212
202105,30230,대전광역시,대덕구,25-29세,11998,6766,5232
202106,30230,대전광역시,대덕구,25-29세,11999,6779,5220
202007,30230,대전광역시,대덕구,30-34세,9102,5093,4009
202008,30230,대전광역시,대덕구,30-34세,9092,5093,3999
202009,30230,대전광역시,대덕구,30-34세,9231,5154,4077
202010,30230,대전광역시,대덕구,30-34세,9398,5236,4162
202011,30230,대전광역시,대덕구,30-34세,9463,5302,4161
202012,30230,대전광역시,대덕구,30-34세,9526,5352,4174
202101,30230,대전광역시,대덕구,30-34세,9520,5332,4188
202102,30230,대전광역시,대덕구,30-34세,9551,5330,4221
202103,30230,대전광역시,대덕구,30-34세,9525,5332,4193
202104,30230,대전광역시,대덕구,30-34세,9543,5328,4215
202105,30230,대전광역시,대덕구,30-34세,9598,5376,4222
202106,30230,대전광역시,대덕구,30-34세,9611,5406,4205
202007,30230,대전광역시,대덕구,35-39세,10457,5557,4900
202008,30230,대전광역시,대덕구,35-39세,10388,5514,4874
202009,30230,대전광역시,대덕구,35-39세,10468,5588,4880
202010,30230,대전광역시,대덕구,35-39세,10565,5644,4921
202011,30230,대전광역시,대덕구,35-39세,10631,5677,4954
202012,30230,대전광역시,대덕구,35-39세,10651,5680,4971
202101,30230,대전광역시,대덕구,35-39세,10597,5653,4944
202102,30230,대전광역시,대덕구,35-39세,10451,5578,4873
202103,30230,대전광역시,대덕구,35-39세,10379,5548,4831
202104,30230,대전광역시,대덕구,35-39세,10328,5521,4807
202105,30230,대전광역시,대덕구,35-39세,10268,5502,4766
202106,30230,대전광역시,대덕구,35-39세,10187,5452,4735
202007,30230,대전광역시,대덕구,40-44세,11983,6131,5852
202008,30230,대전광역시,대덕구,40-44세,11912,6101,5811
202009,30230,대전광역시,대덕구,40-44세,11967,6121,5846
202010,30230,대전광역시,대덕구,40-44세,11988,6149,5839
202011,30230,대전광역시,대덕구,40-44세,12003,6160,5843
202012,30230,대전광역시,대덕구,40-44세,11944,6118,5826
202101,30230,대전광역시,대덕구,40-44세,11911,6096,5815
202102,30230,대전광역시,대덕구,40-44세,11939,6152,5787
202103,30230,대전광역시,대덕구,40-44세,11854,6107,5747
202104,30230,대전광역시,대덕구,40-44세,11806,6099,5707
202105,30230,대전광역시,대덕구,40-44세,11809,6114,5695
202106,30230,대전광역시,대덕구,40-44세,11864,6151,5713
202007,30230,대전광역시,대덕구,45-49세,15634,7915,7719
202008,30230,대전광역시,대덕구,45-49세,15532,7848,7684
202009,30230,대전광역시,대덕구,45-49세,15432,7795,7637
202010,30230,대전광역시,대덕구,45-49세,15398,7782,7616
202011,30230,대전광역시,대덕구,45-49세,15317,7758,7559
202012,30230,대전광역시,대덕구,45-49세,15317,7765,7552
202101,30230,대전광역시,대덕구,45-49세,15249,7745,7504
202102,30230,대전광역시,대덕구,45-49세,15191,7714,7477
202103,30230,대전광역시,대덕구,45-49세,15028,7629,7399
202104,30230,대전광역시,대덕구,45-49세,14994,7616,7378
202105,30230,대전광역시,대덕구,45-49세,14820,7521,7299
202106,30230,대전광역시,대덕구,45-49세,14724,7469,7255
202007,30230,대전광역시,대덕구,50-54세,17084,8755,8329
202008,30230,대전광역시,대덕구,50-54세,17140,8791,8349
202009,30230,대전광역시,대덕구,50-54세,17240,8829,8411
202010,30230,대전광역시,대덕구,50-54세,17355,8855,8500
202011,30230,대전광역시,대덕구,50-54세,17462,8899,8563
202012,30230,대전광역시,대덕구,50-54세,17398,8869,8529
202101,30230,대전광역시,대덕구,50-54세,17454,8887,8567
202102,30230,대전광역시,대덕구,50-54세,17461,8881,8580
202103,30230,대전광역시,대덕구,50-54세,17471,8899,8572
202104,30230,대전광역시,대덕구,50-54세,17441,8866,8575
202105,30230,대전광역시,대덕구,50-54세,17550,8925,8625
202106,30230,대전광역시,대덕구,50-54세,17578,8950,8628
202007,30230,대전광역시,대덕구,55-59세,16305,8253,8052
202008,30230,대전광역시,대덕구,55-59세,16239,8219,8020
202009,30230,대전광역시,대덕구,55-59세,16278,8249,8029
202010,30230,대전광역시,대덕구,55-59세,16312,8263,8049
202011,30230,대전광역시,대덕구,55-59세,16292,8250,8042
202012,30230,대전광역시,대덕구,55-59세,16288,8252,8036
202101,30230,대전광역시,대덕구,55-59세,16163,8186,7977
202102,30230,대전광역시,대덕구,55-59세,16090,8159,7931
202103,30230,대전광역시,대덕구,55-59세,15981,8101,7880
202104,30230,대전광역시,대덕구,55-59세,15888,8054,7834
202105,30230,대전광역시,대덕구,55-59세,15792,7997,7795
202106,30230,대전광역시,대덕구,55-59세,15673,7937,7736
202007,30230,대전광역시,대덕구,60-64세,14301,7183,7118
202008,30230,대전광역시,대덕구,60-64세,14373,7222,7151
202009,30230,대전광역시,대덕구,60-64세,14483,7275,7208
202010,30230,대전광역시,대덕구,60-64세,14664,7368,7296
202011,30230,대전광역시,대덕구,60-64세,14786,7433,7353
202012,30230,대전광역시,대덕구,60-64세,14856,7457,7399
202101,30230,대전광역시,대덕구,60-64세,14950,7492,7458
202102,30230,대전광역시,대덕구,60-64세,15075,7561,7514
202103,30230,대전광역시,대덕구,60-64세,15205,7617,7588
202104,30230,대전광역시,대덕구,60-64세,15297,7658,7639
202105,30230,대전광역시,대덕구,60-64세,15385,7723,7662
202106,30230,대전광역시,대덕구,60-64세,15518,7795,7723
202007,30230,대전광역시,대덕구,65-69세,9254,4497,4757
202008,30230,대전광역시,대덕구,65-69세,9360,4536,4824
202009,30230,대전광역시,대덕구,65-69세,9489,4605,4884
202010,30230,대전광역시,대덕구,65-69세,9580,4641,4939
202011,30230,대전광역시,대덕구,65-69세,9673,4698,4975
202012,30230,대전광역시,대덕구,65-69세,9764,4737,5027
202101,30230,대전광역시,대덕구,65-69세,9869,4801,5068
202102,30230,대전광역시,대덕구,65-69세,9979,4846,5133
202103,30230,대전광역시,대덕구,65-69세,10117,4904,5213
202104,30230,대전광역시,대덕구,65-69세,10207,4938,5269
202105,30230,대전광역시,대덕구,65-69세,10260,4945,5315
202106,30230,대전광역시,대덕구,65-69세,10276,4957,5319
202007,30230,대전광역시,대덕구,70-74세,6569,3082,3487
202008,30230,대전광역시,대덕구,70-74세,6591,3093,3498
202009,30230,대전광역시,대덕구,70-74세,6624,3111,3513
202010,30230,대전광역시,대덕구,70-74세,6688,3151,3537
202011,30230,대전광역시,대덕구,70-74세,6726,3167,3559
202012,30230,대전광역시,대덕구,70-74세,6768,3199,3569
202101,30230,대전광역시,대덕구,70-74세,6816,3228,3588
202102,30230,대전광역시,대덕구,70-74세,6856,3239,3617
202103,30230,대전광역시,대덕구,70-74세,6845,3246,3599
202104,30230,대전광역시,대덕구,70-74세,6878,3266,3612
202105,30230,대전광역시,대덕구,70-74세,6945,3301,3644
202106,30230,대전광역시,대덕구,70-74세,6942,3290,3652
202007,30230,대전광역시,대덕구,75-79세,5366,2260,3106
202008,30230,대전광역시,대덕구,75-79세,5359,2275,3084
202009,30230,대전광역시,대덕구,75-79세,5360,2278,3082
202010,30230,대전광역시,대덕구,75-79세,5342,2276,3066
202011,30230,대전광역시,대덕구,75-79세,5340,2278,3062
202012,30230,대전광역시,대덕구,75-79세,5334,2268,3066
202101,30230,대전광역시,대덕구,75-79세,5297,2258,3039
202102,30230,대전광역시,대덕구,75-79세,5251,2237,3014
202103,30230,대전광역시,대덕구,75-79세,5224,2244,2980
202104,30230,대전광역시,대덕구,75-79세,5206,2236,2970
202105,30230,대전광역시,대덕구,75-79세,5185,2235,2950
202106,30230,대전광역시,대덕구,75-79세,5225,2254,2971
202007,30230,대전광역시,대덕구,80-84세,3487,1327,2160
202008,30230,대전광역시,대덕구,80-84세,3480,1312,2168
202009,30230,대전광역시,대덕구,80-84세,3484,1308,2176
202010,30230,대전광역시,대덕구,80-84세,3507,1312,2195
202011,30230,대전광역시,대덕구,80-84세,3503,1317,2186
202012,30230,대전광역시,대덕구,80-84세,3502,1326,2176
202101,30230,대전광역시,대덕구,80-84세,3538,1332,2206
202102,30230,대전광역시,대덕구,80-84세,3581,1360,2221
202103,30230,대전광역시,대덕구,80-84세,3566,1338,2228
202104,30230,대전광역시,대덕구,80-84세,3584,1361,2223
202105,30230,대전광역시,대덕구,80-84세,3611,1368,2243
202106,30230,대전광역시,대덕구,80-84세,3637,1375,2262
202007,30230,대전광역시,대덕구,85-89세,1672,502,1170
202008,30230,대전광역시,대덕구,85-89세,1694,521,1173
202009,30230,대전광역시,대덕구,85-89세,1718,526,1192
202010,30230,대전광역시,대덕구,85-89세,1729,528,1201
202011,30230,대전광역시,대덕구,85-89세,1740,532,1208
202012,30230,대전광역시,대덕구,85-89세,1773,540,1233
202101,30230,대전광역시,대덕구,85-89세,1772,535,1237
202102,30230,대전광역시,대덕구,85-89세,1800,547,1253
202103,30230,대전광역시,대덕구,85-89세,1822,564,1258
202104,30230,대전광역시,대덕구,85-89세,1854,572,1282
202105,30230,대전광역시,대덕구,85-89세,1873,580,1293
202106,30230,대전광역시,대덕구,85-89세,1876,577,1299
202007,30230,대전광역시,대덕구,90-94세,547,115,432
202008,30230,대전광역시,대덕구,90-94세,556,117,439
202009,30230,대전광역시,대덕구,90-94세,564,124,440
202010,30230,대전광역시,대덕구,90-94세,571,127,444
202011,30230,대전광역시,대덕구,90-94세,580,127,453
202012,30230,대전광역시,대덕구,90-94세,577,127,450
202101,30230,대전광역시,대덕구,90-94세,590,132,458
202102,30230,대전광역시,대덕구,90-94세,596,134,462
202103,30230,대전광역시,대덕구,90-94세,599,127,472
202104,30230,대전광역시,대덕구,90-94세,602,123,479
202105,30230,대전광역시,대덕구,90-94세,599,124,475
202106,30230,대전광역시,대덕구,90-94세,600,127,473
202007,30230,대전광역시,대덕구,95-99세,116,17,99
202008,30230,대전광역시,대덕구,95-99세,116,17,99
202009,30230,대전광역시,대덕구,95-99세,114,15,99
202010,30230,대전광역시,대덕구,95-99세,112,15,97
202011,30230,대전광역시,대덕구,95-99세,115,15,100
202012,30230,대전광역시,대덕구,95-99세,112,15,97
202101,30230,대전광역시,대덕구,95-99세,112,16,96
202102,30230,대전광역시,대덕구,95-99세,114,16,98
202103,30230,대전광역시,대덕구,95-99세,112,17,95
202104,30230,대전광역시,대덕구,95-99세,106,16,90
202105,30230,대전광역시,대덕구,95-99세,108,18,90
202106,30230,대전광역시,대덕구,95-99세,113,18,95
202007,30230,대전광역시,대덕구,100+,35,8,27
202008,30230,대전광역시,대덕구,100+,35,8,27
202009,30230,대전광역시,대덕구,100+,36,8,28
202010,30230,대전광역시,대덕구,100+,37,9,28
202011,30230,대전광역시,대덕구,100+,39,10,29
202012,30230,대전광역시,대덕구,100+,39,10,29
202101,30230,대전광역시,대덕구,100+,40,9,31
202102,30230,대전광역시,대덕구,100+,42,9,33
202103,30230,대전광역시,대덕구,100+,26,3,23
202104,30230,대전광역시,대덕구,100+,29,3,26
202105,30230,대전광역시,대덕구,100+,28,2,26
202106,30230,대전광역시,대덕구,100+,29,2,27
202007,31110,울산광역시,중구,0-4세,7023,3636,3387
202008,31110,울산광역시,중구,0-4세,6932,3583,3349
202009,31110,울산광역시,중구,0-4세,6881,3547,3334
202010,31110,울산광역시,중구,0-4세,6830,3522,3308
202011,31110,울산광역시,중구,0-4세,6749,3474,3275
202012,31110,울산광역시,중구,0-4세,6690,3449,3241
202101,31110,울산광역시,중구,0-4세,6606,3405,3201
202102,31110,울산광역시,중구,0-4세,6491,3349,3142
202103,31110,울산광역시,중구,0-4세,6398,3286,3112
202104,31110,울산광역시,중구,0-4세,6330,3260,3070
202105,31110,울산광역시,중구,0-4세,6274,3220,3054
202106,31110,울산광역시,중구,0-4세,6231,3193,3038
202007,31110,울산광역시,중구,5-9세,10156,5253,4903
202008,31110,울산광역시,중구,5-9세,10131,5255,4876
202009,31110,울산광역시,중구,5-9세,10087,5230,4857
202010,31110,울산광역시,중구,5-9세,10013,5184,4829
202011,31110,울산광역시,중구,5-9세,9956,5146,4810
202012,31110,울산광역시,중구,5-9세,9948,5130,4818
202101,31110,울산광역시,중구,5-9세,9869,5097,4772
202102,31110,울산광역시,중구,5-9세,9846,5087,4759
202103,31110,울산광역시,중구,5-9세,9784,5057,4727
202104,31110,울산광역시,중구,5-9세,9773,5047,4726
202105,31110,울산광역시,중구,5-9세,9739,5030,4709
202106,31110,울산광역시,중구,5-9세,9702,5014,4688
202007,31110,울산광역시,중구,10-14세,9793,5203,4590
202008,31110,울산광역시,중구,10-14세,9788,5181,4607
202009,31110,울산광역시,중구,10-14세,9802,5182,4620
202010,31110,울산광역시,중구,10-14세,9813,5192,4621
202011,31110,울산광역시,중구,10-14세,9861,5225,4636
202012,31110,울산광역시,중구,10-14세,9838,5211,4627
202101,31110,울산광역시,중구,10-14세,9901,5234,4667
202102,31110,울산광역시,중구,10-14세,9879,5229,4650
202103,31110,울산광역시,중구,10-14세,9920,5247,4673
202104,31110,울산광역시,중구,10-14세,9947,5263,4684
202105,31110,울산광역시,중구,10-14세,9942,5262,4680
202106,31110,울산광역시,중구,10-14세,9964,5268,4696
202007,31110,울산광역시,중구,15-19세,10613,5722,4891
202008,31110,울산광역시,중구,15-19세,10538,5683,4855
202009,31110,울산광역시,중구,15-19세,10488,5654,4834
202010,31110,울산광역시,중구,15-19세,10411,5615,4796
202011,31110,울산광역시,중구,15-19세,10334,5564,4770
202012,31110,울산광역시,중구,15-19세,10280,5527,4753
202101,31110,울산광역시,중구,15-19세,10196,5497,4699
202102,31110,울산광역시,중구,15-19세,10067,5421,4646
202103,31110,울산광역시,중구,15-19세,9886,5324,4562
202104,31110,울산광역시,중구,15-19세,9835,5312,4523
202105,31110,울산광역시,중구,15-19세,9782,5266,4516
202106,31110,울산광역시,중구,15-19세,9736,5240,4496
202007,31110,울산광역시,중구,20-24세,13565,7543,6022
202008,31110,울산광역시,중구,20-24세,13477,7510,5967
202009,31110,울산광역시,중구,20-24세,13362,7451,5911
202010,31110,울산광역시,중구,20-24세,13316,7446,5870
202011,31110,울산광역시,중구,20-24세,13178,7367,5811
202012,31110,울산광역시,중구,20-24세,13001,7268,5733
202101,31110,울산광역시,중구,20-24세,12859,7170,5689
202102,31110,울산광역시,중구,20-24세,12716,7076,5640
202103,31110,울산광역시,중구,20-24세,12574,6991,5583
202104,31110,울산광역시,중구,20-24세,12506,6938,5568
202105,31110,울산광역시,중구,20-24세,12474,6922,5552
202106,31110,울산광역시,중구,20-24세,12451,6917,5534
202007,31110,울산광역시,중구,25-29세,13898,7733,6165
202008,31110,울산광역시,중구,25-29세,13918,7739,6179
202009,31110,울산광역시,중구,25-29세,13875,7718,6157
202010,31110,울산광역시,중구,25-29세,13867,7702,6165
202011,31110,울산광역시,중구,25-29세,13867,7711,6156
202012,31110,울산광역시,중구,25-29세,13815,7677,6138
202101,31110,울산광역시,중구,25-29세,13811,7676,6135
202102,31110,울산광역시,중구,25-29세,13660,7593,6067
202103,31110,울산광역시,중구,25-29세,13563,7581,5982
202104,31110,울산광역시,중구,25-29세,13492,7529,5963
202105,31110,울산광역시,중구,25-29세,13510,7560,5950
202106,31110,울산광역시,중구,25-29세,13518,7568,5950
202007,31110,울산광역시,중구,30-34세,11951,6436,5515
202008,31110,울산광역시,중구,30-34세,11930,6416,5514
202009,31110,울산광역시,중구,30-34세,11879,6394,5485
202010,31110,울산광역시,중구,30-34세,11862,6389,5473
202011,31110,울산광역시,중구,30-34세,11775,6340,5435
202012,31110,울산광역시,중구,30-34세,11717,6307,5410
202101,31110,울산광역시,중구,30-34세,11659,6266,5393
202102,31110,울산광역시,중구,30-34세,11653,6282,5371
202103,31110,울산광역시,중구,30-34세,11672,6278,5394
202104,31110,울산광역시,중구,30-34세,11674,6279,5395
202105,31110,울산광역시,중구,30-34세,11653,6261,5392
202106,31110,울산광역시,중구,30-34세,11686,6295,5391
202007,31110,울산광역시,중구,35-39세,15263,7910,7353
202008,31110,울산광역시,중구,35-39세,15072,7794,7278
202009,31110,울산광역시,중구,35-39세,14962,7720,7242
202010,31110,울산광역시,중구,35-39세,14805,7621,7184
202011,31110,울산광역시,중구,35-39세,14720,7552,7168
202012,31110,울산광역시,중구,35-39세,14654,7516,7138
202101,31110,울산광역시,중구,35-39세,14563,7487,7076
202102,31110,울산광역시,중구,35-39세,14404,7407,6997
202103,31110,울산광역시,중구,35-39세,14250,7320,6930
202104,31110,울산광역시,중구,35-39세,14190,7288,6902
202105,31110,울산광역시,중구,35-39세,14095,7259,6836
202106,31110,울산광역시,중구,35-39세,14045,7244,6801
202007,31110,울산광역시,중구,40-44세,16091,8257,7834
202008,31110,울산광역시,중구,40-44세,16117,8293,7824
202009,31110,울산광역시,중구,40-44세,16114,8299,7815
202010,31110,울산광역시,중구,40-44세,16227,8390,7837
202011,31110,울산광역시,중구,40-44세,16250,8408,7842
202012,31110,울산광역시,중구,40-44세,16186,8422,7764
202101,31110,울산광역시,중구,40-44세,16196,8446,7750
202102,31110,울산광역시,중구,40-44세,16202,8448,7754
202103,31110,울산광역시,중구,40-44세,16087,8400,7687
202104,31110,울산광역시,중구,40-44세,16070,8380,7690
202105,31110,울산광역시,중구,40-44세,16112,8393,7719
202106,31110,울산광역시,중구,40-44세,16212,8421,7791
202007,31110,울산광역시,중구,45-49세,18729,9398,9331
202008,31110,울산광역시,중구,45-49세,18621,9338,9283
202009,31110,울산광역시,중구,45-49세,18508,9296,9212
202010,31110,울산광역시,중구,45-49세,18338,9197,9141
202011,31110,울산광역시,중구,45-49세,18154,9104,9050
202012,31110,울산광역시,중구,45-49세,18072,9063,9009
202101,31110,울산광역시,중구,45-49세,17952,8984,8968
202102,31110,울산광역시,중구,45-49세,17888,8958,8930
202103,31110,울산광역시,중구,45-49세,17747,8896,8851
202104,31110,울산광역시,중구,45-49세,17677,8869,8808
202105,31110,울산광역시,중구,45-49세,17515,8813,8702
202106,31110,울산광역시,중구,45-49세,17420,8761,8659
202007,31110,울산광역시,중구,50-54세,20750,10194,10556
202008,31110,울산광역시,중구,50-54세,20712,10168,10544
202009,31110,울산광역시,중구,50-54세,20676,10139,10537
202010,31110,울산광역시,중구,50-54세,20665,10135,10530
202011,31110,울산광역시,중구,50-54세,20694,10147,10547
202012,31110,울산광역시,중구,50-54세,20628,10110,10518
202101,31110,울산광역시,중구,50-54세,20634,10109,10525
202102,31110,울산광역시,중구,50-54세,20523,10055,10468
202103,31110,울산광역시,중구,50-54세,20301,9944,10357
202104,31110,울산광역시,중구,50-54세,20230,9894,10336
202105,31110,울산광역시,중구,50-54세,20301,9902,10399
202106,31110,울산광역시,중구,50-54세,20325,9914,10411
202007,31110,울산광역시,중구,55-59세,21065,10657,10408
202008,31110,울산광역시,중구,55-59세,21066,10657,10409
202009,31110,울산광역시,중구,55-59세,21017,10652,10365
202010,31110,울산광역시,중구,55-59세,20952,10632,10320
202011,31110,울산광역시,중구,55-59세,20857,10568,10289
202012,31110,울산광역시,중구,55-59세,20775,10506,10269
202101,31110,울산광역시,중구,55-59세,20618,10437,10181
202102,31110,울산광역시,중구,55-59세,20582,10421,10161
202103,31110,울산광역시,중구,55-59세,20464,10377,10087
202104,31110,울산광역시,중구,55-59세,20359,10311,10048
202105,31110,울산광역시,중구,55-59세,20270,10283,9987
202106,31110,울산광역시,중구,55-59세,20135,10212,9923
202007,31110,울산광역시,중구,60-64세,18399,9045,9354
202008,31110,울산광역시,중구,60-64세,18425,9060,9365
202009,31110,울산광역시,중구,60-64세,18487,9071,9416
202010,31110,울산광역시,중구,60-64세,18626,9122,9504
202011,31110,울산광역시,중구,60-64세,18694,9187,9507
202012,31110,울산광역시,중구,60-64세,18760,9214,9546
202101,31110,울산광역시,중구,60-64세,18914,9284,9630
202102,31110,울산광역시,중구,60-64세,19023,9326,9697
202103,31110,울산광역시,중구,60-64세,19058,9342,9716
202104,31110,울산광역시,중구,60-64세,19133,9401,9732
202105,31110,울산광역시,중구,60-64세,19266,9465,9801
202106,31110,울산광역시,중구,60-64세,19386,9566,9820
202007,31110,울산광역시,중구,65-69세,12614,6112,6502
202008,31110,울산광역시,중구,65-69세,12740,6156,6584
202009,31110,울산광역시,중구,65-69세,12840,6211,6629
202010,31110,울산광역시,중구,65-69세,12890,6237,6653
202011,31110,울산광역시,중구,65-69세,12985,6263,6722
202012,31110,울산광역시,중구,65-69세,13096,6297,6799
202101,31110,울산광역시,중구,65-69세,13183,6362,6821
202102,31110,울산광역시,중구,65-69세,13262,6407,6855
202103,31110,울산광역시,중구,65-69세,13343,6443,6900
202104,31110,울산광역시,중구,65-69세,13396,6461,6935
202105,31110,울산광역시,중구,65-69세,13453,6471,6982
202106,31110,울산광역시,중구,65-69세,13508,6478,7030
202007,31110,울산광역시,중구,70-74세,8122,3875,4247
202008,31110,울산광역시,중구,70-74세,8135,3888,4247
202009,31110,울산광역시,중구,70-74세,8219,3915,4304
202010,31110,울산광역시,중구,70-74세,8313,3962,4351
202011,31110,울산광역시,중구,70-74세,8385,3996,4389
202012,31110,울산광역시,중구,70-74세,8479,4046,4433
202101,31110,울산광역시,중구,70-74세,8562,4066,4496
202102,31110,울산광역시,중구,70-74세,8626,4097,4529
202103,31110,울산광역시,중구,70-74세,8650,4100,4550
202104,31110,울산광역시,중구,70-74세,8686,4119,4567
202105,31110,울산광역시,중구,70-74세,8731,4138,4593
202106,31110,울산광역시,중구,70-74세,8793,4176,4617
202007,31110,울산광역시,중구,75-79세,5897,2547,3350
202008,31110,울산광역시,중구,75-79세,5917,2553,3364
202009,31110,울산광역시,중구,75-79세,5891,2557,3334
202010,31110,울산광역시,중구,75-79세,5843,2544,3299
202011,31110,울산광역시,중구,75-79세,5817,2535,3282
202012,31110,울산광역시,중구,75-79세,5803,2530,3273
202101,31110,울산광역시,중구,75-79세,5781,2531,3250
202102,31110,울산광역시,중구,75-79세,5770,2528,3242
202103,31110,울산광역시,중구,75-79세,5750,2530,3220
202104,31110,울산광역시,중구,75-79세,5737,2526,3211
202105,31110,울산광역시,중구,75-79세,5743,2535,3208
202106,31110,울산광역시,중구,75-79세,5726,2535,3191
202007,31110,울산광역시,중구,80-84세,3521,1307,2214
202008,31110,울산광역시,중구,80-84세,3533,1309,2224
202009,31110,울산광역시,중구,80-84세,3547,1310,2237
202010,31110,울산광역시,중구,80-84세,3555,1315,2240
202011,31110,울산광역시,중구,80-84세,3566,1329,2237
202012,31110,울산광역시,중구,80-84세,3573,1346,2227
202101,31110,울산광역시,중구,80-84세,3583,1350,2233
202102,31110,울산광역시,중구,80-84세,3602,1359,2243
202103,31110,울산광역시,중구,80-84세,3572,1356,2216
202104,31110,울산광역시,중구,80-84세,3596,1377,2219
202105,31110,울산광역시,중구,80-84세,3611,1378,2233
202106,31110,울산광역시,중구,80-84세,3631,1379,2252
202007,31110,울산광역시,중구,85-89세,1518,441,1077
202008,31110,울산광역시,중구,85-89세,1538,445,1093
202009,31110,울산광역시,중구,85-89세,1556,452,1104
202010,31110,울산광역시,중구,85-89세,1571,459,1112
202011,31110,울산광역시,중구,85-89세,1579,467,1112
202012,31110,울산광역시,중구,85-89세,1590,459,1131
202101,31110,울산광역시,중구,85-89세,1618,476,1142
202102,31110,울산광역시,중구,85-89세,1629,478,1151
202103,31110,울산광역시,중구,85-89세,1624,475,1149
202104,31110,울산광역시,중구,85-89세,1636,477,1159
202105,31110,울산광역시,중구,85-89세,1665,491,1174
202106,31110,울산광역시,중구,85-89세,1675,498,1177
202007,31110,울산광역시,중구,90-94세,501,88,413
202008,31110,울산광역시,중구,90-94세,495,86,409
202009,31110,울산광역시,중구,90-94세,502,91,411
202010,31110,울산광역시,중구,90-94세,502,92,410
202011,31110,울산광역시,중구,90-94세,500,92,408
202012,31110,울산광역시,중구,90-94세,514,99,415
202101,31110,울산광역시,중구,90-94세,513,96,417
202102,31110,울산광역시,중구,90-94세,528,99,429
202103,31110,울산광역시,중구,90-94세,521,87,434
202104,31110,울산광역시,중구,90-94세,525,85,440
202105,31110,울산광역시,중구,90-94세,527,82,445
202106,31110,울산광역시,중구,90-94세,526,82,444
202007,31110,울산광역시,중구,95-99세,110,12,98
202008,31110,울산광역시,중구,95-99세,110,12,98
202009,31110,울산광역시,중구,95-99세,113,12,101
202010,31110,울산광역시,중구,95-99세,115,12,103
202011,31110,울산광역시,중구,95-99세,118,13,105
202012,31110,울산광역시,중구,95-99세,116,11,105
202101,31110,울산광역시,중구,95-99세,114,11,103
202102,31110,울산광역시,중구,95-99세,112,11,101
202103,31110,울산광역시,중구,95-99세,93,9,84
202104,31110,울산광역시,중구,95-99세,94,10,84
202105,31110,울산광역시,중구,95-99세,97,13,84
202106,31110,울산광역시,중구,95-99세,95,13,82
202007,31110,울산광역시,중구,100+,56,11,45
202008,31110,울산광역시,중구,100+,54,11,43
202009,31110,울산광역시,중구,100+,56,12,44
202010,31110,울산광역시,중구,100+,57,12,45
202011,31110,울산광역시,중구,100+,57,12,45
202012,31110,울산광역시,중구,100+,60,13,47
202101,31110,울산광역시,중구,100+,59,13,46
202102,31110,울산광역시,중구,100+,60,13,47
202103,31110,울산광역시,중구,100+,19,2,17
202104,31110,울산광역시,중구,100+,15,2,13
202105,31110,울산광역시,중구,100+,15,2,13
202106,31110,울산광역시,중구,100+,14,2,12
202007,31140,울산광역시,남구,0-4세,10454,5332,5122
202008,31140,울산광역시,남구,0-4세,10389,5308,5081
202009,31140,울산광역시,남구,0-4세,10276,5250,5026
202010,31140,울산광역시,남구,0-4세,10137,5201,4936
202011,31140,울산광역시,남구,0-4세,10059,5155,4904
202012,31140,울산광역시,남구,0-4세,9967,5119,4848
202101,31140,울산광역시,남구,0-4세,9863,5053,4810
202102,31140,울산광역시,남구,0-4세,9783,5009,4774
202103,31140,울산광역시,남구,0-4세,9680,4934,4746
202104,31140,울산광역시,남구,0-4세,9576,4870,4706
202105,31140,울산광역시,남구,0-4세,9463,4808,4655
202106,31140,울산광역시,남구,0-4세,9360,4751,4609
202007,31140,울산광역시,남구,5-9세,14055,7282,6773
202008,31140,울산광역시,남구,5-9세,14005,7238,6767
202009,31140,울산광역시,남구,5-9세,13979,7225,6754
202010,31140,울산광역시,남구,5-9세,13975,7210,6765
202011,31140,울산광역시,남구,5-9세,13949,7206,6743
202012,31140,울산광역시,남구,5-9세,13910,7176,6734
202101,31140,울산광역시,남구,5-9세,13826,7134,6692
202102,31140,울산광역시,남구,5-9세,13812,7128,6684
202103,31140,울산광역시,남구,5-9세,13769,7126,6643
202104,31140,울산광역시,남구,5-9세,13752,7124,6628
202105,31140,울산광역시,남구,5-9세,13745,7111,6634
202106,31140,울산광역시,남구,5-9세,13730,7115,6615
202007,31140,울산광역시,남구,10-14세,14261,7404,6857
202008,31140,울산광역시,남구,10-14세,14283,7411,6872
202009,31140,울산광역시,남구,10-14세,14283,7416,6867
202010,31140,울산광역시,남구,10-14세,14317,7457,6860
202011,31140,울산광역시,남구,10-14세,14320,7454,6866
202012,31140,울산광역시,남구,10-14세,14334,7457,6877
202101,31140,울산광역시,남구,10-14세,14384,7502,6882
202102,31140,울산광역시,남구,10-14세,14365,7497,6868
202103,31140,울산광역시,남구,10-14세,14375,7511,6864
202104,31140,울산광역시,남구,10-14세,14408,7547,6861
202105,31140,울산광역시,남구,10-14세,14400,7545,6855
202106,31140,울산광역시,남구,10-14세,14391,7535,6856
202007,31140,울산광역시,남구,15-19세,16905,9040,7865
202008,31140,울산광역시,남구,15-19세,16751,8974,7777
202009,31140,울산광역시,남구,15-19세,16598,8909,7689
202010,31140,울산광역시,남구,15-19세,16486,8823,7663
202011,31140,울산광역시,남구,15-19세,16332,8757,7575
202012,31140,울산광역시,남구,15-19세,16226,8713,7513
202101,31140,울산광역시,남구,15-19세,16100,8653,7447
202102,31140,울산광역시,남구,15-19세,15851,8520,7331
202103,31140,울산광역시,남구,15-19세,15599,8393,7206
202104,31140,울산광역시,남구,15-19세,15427,8258,7169
202105,31140,울산광역시,남구,15-19세,15347,8213,7134
202106,31140,울산광역시,남구,15-19세,15259,8164,7095
202007,31140,울산광역시,남구,20-24세,22733,12552,10181
202008,31140,울산광역시,남구,20-24세,22562,12433,10129
202009,31140,울산광역시,남구,20-24세,22458,12384,10074
202010,31140,울산광역시,남구,20-24세,22385,12323,10062
202011,31140,울산광역시,남구,20-24세,22276,12251,10025
202012,31140,울산광역시,남구,20-24세,22101,12178,9923
202101,31140,울산광역시,남구,20-24세,21976,12098,9878
202102,31140,울산광역시,남구,20-24세,21849,12032,9817
202103,31140,울산광역시,남구,20-24세,21632,11934,9698
202104,31140,울산광역시,남구,20-24세,21520,11887,9633
202105,31140,울산광역시,남구,20-24세,21399,11827,9572
202106,31140,울산광역시,남구,20-24세,21273,11764,9509
202007,31140,울산광역시,남구,25-29세,23584,13319,10265
202008,31140,울산광역시,남구,25-29세,23573,13314,10259
202009,31140,울산광역시,남구,25-29세,23629,13339,10290
202010,31140,울산광역시,남구,25-29세,23634,13328,10306
202011,31140,울산광역시,남구,25-29세,23712,13369,10343
202012,31140,울산광역시,남구,25-29세,23646,13323,10323
202101,31140,울산광역시,남구,25-29세,23661,13333,10328
202102,31140,울산광역시,남구,25-29세,23572,13248,10324
202103,31140,울산광역시,남구,25-29세,23512,13174,10338
202104,31140,울산광역시,남구,25-29세,23507,13189,10318
202105,31140,울산광역시,남구,25-29세,23453,13157,10296
202106,31140,울산광역시,남구,25-29세,23394,13134,10260
202007,31140,울산광역시,남구,30-34세,20185,11025,9160
202008,31140,울산광역시,남구,30-34세,20137,10977,9160
202009,31140,울산광역시,남구,30-34세,20116,10966,9150
202010,31140,울산광역시,남구,30-34세,20049,10932,9117
202011,31140,울산광역시,남구,30-34세,20016,10934,9082
202012,31140,울산광역시,남구,30-34세,19970,10938,9032
202101,31140,울산광역시,남구,30-34세,20060,11027,9033
202102,31140,울산광역시,남구,30-34세,20112,11066,9046
202103,31140,울산광역시,남구,30-34세,20175,11124,9051
202104,31140,울산광역시,남구,30-34세,20220,11184,9036
202105,31140,울산광역시,남구,30-34세,20249,11212,9037
202106,31140,울산광역시,남구,30-34세,20295,11224,9071
202007,31140,울산광역시,남구,35-39세,22872,11832,11040
202008,31140,울산광역시,남구,35-39세,22797,11790,11007
202009,31140,울산광역시,남구,35-39세,22614,11714,10900
202010,31140,울산광역시,남구,35-39세,22461,11652,10809
202011,31140,울산광역시,남구,35-39세,22340,11595,10745
202012,31140,울산광역시,남구,35-39세,22210,11529,10681
202101,31140,울산광역시,남구,35-39세,22047,11403,10644
202102,31140,울산광역시,남구,35-39세,21906,11375,10531
202103,31140,울산광역시,남구,35-39세,21689,11263,10426
202104,31140,울산광역시,남구,35-39세,21573,11190,10383
202105,31140,울산광역시,남구,35-39세,21414,11095,10319
202106,31140,울산광역시,남구,35-39세,21246,11014,10232
202007,31140,울산광역시,남구,40-44세,23358,11725,11633
202008,31140,울산광역시,남구,40-44세,23337,11714,11623
202009,31140,울산광역시,남구,40-44세,23445,11765,11680
202010,31140,울산광역시,남구,40-44세,23468,11768,11700
202011,31140,울산광역시,남구,40-44세,23511,11802,11709
202012,31140,울산광역시,남구,40-44세,23474,11796,11678
202101,31140,울산광역시,남구,40-44세,23471,11824,11647
202102,31140,울산광역시,남구,40-44세,23468,11845,11623
202103,31140,울산광역시,남구,40-44세,23347,11776,11571
202104,31140,울산광역시,남구,40-44세,23395,11841,11554
202105,31140,울산광역시,남구,40-44세,23432,11854,11578
202106,31140,울산광역시,남구,40-44세,23536,11936,11600
202007,31140,울산광역시,남구,45-49세,29003,13801,15202
202008,31140,울산광역시,남구,45-49세,28844,13734,15110
202009,31140,울산광역시,남구,45-49세,28625,13621,15004
202010,31140,울산광역시,남구,45-49세,28425,13521,14904
202011,31140,울산광역시,남구,45-49세,28274,13437,14837
202012,31140,울산광역시,남구,45-49세,28179,13377,14802
202101,31140,울산광역시,남구,45-49세,28009,13328,14681
202102,31140,울산광역시,남구,45-49세,27841,13224,14617
202103,31140,울산광역시,남구,45-49세,27604,13159,14445
202104,31140,울산광역시,남구,45-49세,27495,13085,14410
202105,31140,울산광역시,남구,45-49세,27202,12979,14223
202106,31140,울산광역시,남구,45-49세,26934,12844,14090
202007,31140,울산광역시,남구,50-54세,32297,16017,16280
202008,31140,울산광역시,남구,50-54세,32241,15989,16252
202009,31140,울산광역시,남구,50-54세,32211,15940,16271
202010,31140,울산광역시,남구,50-54세,32213,15922,16291
202011,31140,울산광역시,남구,50-54세,32139,15876,16263
202012,31140,울산광역시,남구,50-54세,31950,15802,16148
202101,31140,울산광역시,남구,50-54세,32016,15791,16225
202102,31140,울산광역시,남구,50-54세,31936,15732,16204
202103,31140,울산광역시,남구,50-54세,31717,15605,16112
202104,31140,울산광역시,남구,50-54세,31659,15546,16113
202105,31140,울산광역시,남구,50-54세,31696,15532,16164
202106,31140,울산광역시,남구,50-54세,31730,15540,16190
202007,31140,울산광역시,남구,55-59세,30052,15407,14645
202008,31140,울산광역시,남구,55-59세,29972,15358,14614
202009,31140,울산광역시,남구,55-59세,29898,15334,14564
202010,31140,울산광역시,남구,55-59세,29910,15348,14562
202011,31140,울산광역시,남구,55-59세,29849,15312,14537
202012,31140,울산광역시,남구,55-59세,29868,15275,14593
202101,31140,울산광역시,남구,55-59세,29699,15205,14494
202102,31140,울산광역시,남구,55-59세,29604,15190,14414
202103,31140,울산광역시,남구,55-59세,29578,15195,14383
202104,31140,울산광역시,남구,55-59세,29519,15187,14332
202105,31140,울산광역시,남구,55-59세,29430,15140,14290
202106,31140,울산광역시,남구,55-59세,29283,15022,14261
202007,31140,울산광역시,남구,60-64세,24538,12205,12333
202008,31140,울산광역시,남구,60-64세,24649,12250,12399
202009,31140,울산광역시,남구,60-64세,24766,12310,12456
202010,31140,울산광역시,남구,60-64세,24875,12373,12502
202011,31140,울산광역시,남구,60-64세,25006,12439,12567
202012,31140,울산광역시,남구,60-64세,25056,12472,12584
202101,31140,울산광역시,남구,60-64세,25256,12593,12663
202102,31140,울산광역시,남구,60-64세,25437,12652,12785
202103,31140,울산광역시,남구,60-64세,25582,12749,12833
202104,31140,울산광역시,남구,60-64세,25651,12757,12894
202105,31140,울산광역시,남구,60-64세,25791,12819,12972
202106,31140,울산광역시,남구,60-64세,25980,12954,13026
202007,31140,울산광역시,남구,65-69세,15790,7843,7947
202008,31140,울산광역시,남구,65-69세,15947,7907,8040
202009,31140,울산광역시,남구,65-69세,16076,7977,8099
202010,31140,울산광역시,남구,65-69세,16136,8020,8116
202011,31140,울산광역시,남구,65-69세,16216,8048,8168
202012,31140,울산광역시,남구,65-69세,16346,8107,8239
202101,31140,울산광역시,남구,65-69세,16483,8160,8323
202102,31140,울산광역시,남구,65-69세,16579,8204,8375
202103,31140,울산광역시,남구,65-69세,16720,8263,8457
202104,31140,울산광역시,남구,65-69세,16801,8319,8482
202105,31140,울산광역시,남구,65-69세,16913,8394,8519
202106,31140,울산광역시,남구,65-69세,16978,8430,8548
202007,31140,울산광역시,남구,70-74세,9742,4808,4934
202008,31140,울산광역시,남구,70-74세,9778,4841,4937
202009,31140,울산광역시,남구,70-74세,9833,4872,4961
202010,31140,울산광역시,남구,70-74세,9972,4914,5058
202011,31140,울산광역시,남구,70-74세,10031,4951,5080
202012,31140,울산광역시,남구,70-74세,10156,5014,5142
202101,31140,울산광역시,남구,70-74세,10237,5059,5178
202102,31140,울산광역시,남구,70-74세,10336,5112,5224
202103,31140,울산광역시,남구,70-74세,10343,5112,5231
202104,31140,울산광역시,남구,70-74세,10434,5151,5283
202105,31140,울산광역시,남구,70-74세,10477,5163,5314
202106,31140,울산광역시,남구,70-74세,10515,5174,5341
202007,31140,울산광역시,남구,75-79세,6458,2914,3544
202008,31140,울산광역시,남구,75-79세,6478,2922,3556
202009,31140,울산광역시,남구,75-79세,6441,2901,3540
202010,31140,울산광역시,남구,75-79세,6395,2890,3505
202011,31140,울산광역시,남구,75-79세,6365,2870,3495
202012,31140,울산광역시,남구,75-79세,6315,2842,3473
202101,31140,울산광역시,남구,75-79세,6315,2853,3462
202102,31140,울산광역시,남구,75-79세,6297,2838,3459
202103,31140,울산광역시,남구,75-79세,6298,2846,3452
202104,31140,울산광역시,남구,75-79세,6275,2841,3434
202105,31140,울산광역시,남구,75-79세,6290,2847,3443
202106,31140,울산광역시,남구,75-79세,6305,2854,3451
202007,31140,울산광역시,남구,80-84세,3762,1377,2385
202008,31140,울산광역시,남구,80-84세,3760,1387,2373
202009,31140,울산광역시,남구,80-84세,3775,1392,2383
202010,31140,울산광역시,남구,80-84세,3815,1411,2404
202011,31140,울산광역시,남구,80-84세,3823,1422,2401
202012,31140,울산광역시,남구,80-84세,3839,1434,2405
202101,31140,울산광역시,남구,80-84세,3839,1441,2398
202102,31140,울산광역시,남구,80-84세,3876,1465,2411
202103,31140,울산광역시,남구,80-84세,3891,1471,2420
202104,31140,울산광역시,남구,80-84세,3889,1473,2416
202105,31140,울산광역시,남구,80-84세,3910,1483,2427
202106,31140,울산광역시,남구,80-84세,3938,1500,2438
202007,31140,울산광역시,남구,85-89세,1742,488,1254
202008,31140,울산광역시,남구,85-89세,1750,486,1264
202009,31140,울산광역시,남구,85-89세,1764,498,1266
202010,31140,울산광역시,남구,85-89세,1777,507,1270
202011,31140,울산광역시,남구,85-89세,1787,505,1282
202012,31140,울산광역시,남구,85-89세,1805,513,1292
202101,31140,울산광역시,남구,85-89세,1819,529,1290
202102,31140,울산광역시,남구,85-89세,1845,537,1308
202103,31140,울산광역시,남구,85-89세,1862,540,1322
202104,31140,울산광역시,남구,85-89세,1874,545,1329
202105,31140,울산광역시,남구,85-89세,1879,541,1338
202106,31140,울산광역시,남구,85-89세,1880,544,1336
202007,31140,울산광역시,남구,90-94세,547,95,452
202008,31140,울산광역시,남구,90-94세,547,100,447
202009,31140,울산광역시,남구,90-94세,550,99,451
202010,31140,울산광역시,남구,90-94세,550,99,451
202011,31140,울산광역시,남구,90-94세,553,101,452
202012,31140,울산광역시,남구,90-94세,553,105,448
202101,31140,울산광역시,남구,90-94세,558,106,452
202102,31140,울산광역시,남구,90-94세,562,108,454
202103,31140,울산광역시,남구,90-94세,546,99,447
202104,31140,울산광역시,남구,90-94세,551,102,449
202105,31140,울산광역시,남구,90-94세,547,101,446
202106,31140,울산광역시,남구,90-94세,540,95,445
202007,31140,울산광역시,남구,95-99세,114,17,97
202008,31140,울산광역시,남구,95-99세,121,18,103
202009,31140,울산광역시,남구,95-99세,124,19,105
202010,31140,울산광역시,남구,95-99세,121,20,101
202011,31140,울산광역시,남구,95-99세,124,21,103
202012,31140,울산광역시,남구,95-99세,125,20,105
202101,31140,울산광역시,남구,95-99세,127,20,107
202102,31140,울산광역시,남구,95-99세,123,19,104
202103,31140,울산광역시,남구,95-99세,120,17,103
202104,31140,울산광역시,남구,95-99세,126,17,109
202105,31140,울산광역시,남구,95-99세,127,19,108
202106,31140,울산광역시,남구,95-99세,130,19,111
202007,31140,울산광역시,남구,100+,34,10,24
202008,31140,울산광역시,남구,100+,34,9,25
202009,31140,울산광역시,남구,100+,33,8,25
202010,31140,울산광역시,남구,100+,33,8,25
202011,31140,울산광역시,남구,100+,34,8,26
202012,31140,울산광역시,남구,100+,34,8,26
202101,31140,울산광역시,남구,100+,34,8,26
202102,31140,울산광역시,남구,100+,35,8,27
202103,31140,울산광역시,남구,100+,20,1,19
202104,31140,울산광역시,남구,100+,20,1,19
202105,31140,울산광역시,남구,100+,20,1,19
202106,31140,울산광역시,남구,100+,19,1,18
202007,31170,울산광역시,동구,0-4세,6458,3297,3161
202008,31170,울산광역시,동구,0-4세,6403,3262,3141
202009,31170,울산광역시,동구,0-4세,6312,3204,3108
202010,31170,울산광역시,동구,0-4세,6251,3173,3078
202011,31170,울산광역시,동구,0-4세,6169,3137,3032
202012,31170,울산광역시,동구,0-4세,6078,3089,2989
202101,31170,울산광역시,동구,0-4세,5999,3046,2953
202102,31170,울산광역시,동구,0-4세,5902,3002,2900
202103,31170,울산광역시,동구,0-4세,5821,2957,2864
202104,31170,울산광역시,동구,0-4세,5718,2899,2819
202105,31170,울산광역시,동구,0-4세,5615,2852,2763
202106,31170,울산광역시,동구,0-4세,5567,2826,2741
202007,31170,울산광역시,동구,5-9세,8988,4631,4357
202008,31170,울산광역시,동구,5-9세,8943,4597,4346
202009,31170,울산광역시,동구,5-9세,8920,4595,4325
202010,31170,울산광역시,동구,5-9세,8880,4563,4317
202011,31170,울산광역시,동구,5-9세,8843,4547,4296
202012,31170,울산광역시,동구,5-9세,8811,4529,4282
202101,31170,울산광역시,동구,5-9세,8762,4507,4255
202102,31170,울산광역시,동구,5-9세,8701,4482,4219
202103,31170,울산광역시,동구,5-9세,8687,4473,4214
202104,31170,울산광역시,동구,5-9세,8667,4453,4214
202105,31170,울산광역시,동구,5-9세,8663,4436,4227
202106,31170,울산광역시,동구,5-9세,8633,4405,4228
202007,31170,울산광역시,동구,10-14세,8073,4265,3808
202008,31170,울산광역시,동구,10-14세,8095,4280,3815
202009,31170,울산광역시,동구,10-14세,8118,4271,3847
202010,31170,울산광역시,동구,10-14세,8190,4323,3867
202011,31170,울산광역시,동구,10-14세,8223,4328,3895
202012,31170,울산광역시,동구,10-14세,8243,4341,3902
202101,31170,울산광역시,동구,10-14세,8299,4371,3928
202102,31170,울산광역시,동구,10-14세,8287,4372,3915
202103,31170,울산광역시,동구,10-14세,8278,4375,3903
202104,31170,울산광역시,동구,10-14세,8306,4395,3911
202105,31170,울산광역시,동구,10-14세,8315,4395,3920
202106,31170,울산광역시,동구,10-14세,8337,4419,3918
202007,31170,울산광역시,동구,15-19세,7523,3963,3560
202008,31170,울산광역시,동구,15-19세,7483,3953,3530
202009,31170,울산광역시,동구,15-19세,7436,3939,3497
202010,31170,울산광역시,동구,15-19세,7386,3899,3487
202011,31170,울산광역시,동구,15-19세,7371,3899,3472
202012,31170,울산광역시,동구,15-19세,7368,3899,3469
202101,31170,울산광역시,동구,15-19세,7323,3879,3444
202102,31170,울산광역시,동구,15-19세,7310,3871,3439
202103,31170,울산광역시,동구,15-19세,7285,3857,3428
202104,31170,울산광역시,동구,15-19세,7274,3842,3432
202105,31170,울산광역시,동구,15-19세,7264,3855,3409
202106,31170,울산광역시,동구,15-19세,7258,3853,3405
202007,31170,울산광역시,동구,20-24세,8832,4884,3948
202008,31170,울산광역시,동구,20-24세,8782,4854,3928
202009,31170,울산광역시,동구,20-24세,8749,4817,3932
202010,31170,울산광역시,동구,20-24세,8724,4817,3907
202011,31170,울산광역시,동구,20-24세,8676,4799,3877
202012,31170,울산광역시,동구,20-24세,8579,4760,3819
202101,31170,울산광역시,동구,20-24세,8560,4737,3823
202102,31170,울산광역시,동구,20-24세,8516,4705,3811
202103,31170,울산광역시,동구,20-24세,8439,4635,3804
202104,31170,울산광역시,동구,20-24세,8404,4623,3781
202105,31170,울산광역시,동구,20-24세,8380,4587,3793
202106,31170,울산광역시,동구,20-24세,8338,4556,3782
202007,31170,울산광역시,동구,25-29세,9202,5283,3919
202008,31170,울산광역시,동구,25-29세,9181,5278,3903
202009,31170,울산광역시,동구,25-29세,9166,5274,3892
202010,31170,울산광역시,동구,25-29세,9169,5264,3905
202011,31170,울산광역시,동구,25-29세,9147,5248,3899
202012,31170,울산광역시,동구,25-29세,9146,5252,3894
202101,31170,울산광역시,동구,25-29세,9112,5214,3898
202102,31170,울산광역시,동구,25-29세,9060,5177,3883
202103,31170,울산광역시,동구,25-29세,9085,5208,3877
202104,31170,울산광역시,동구,25-29세,9068,5204,3864
202105,31170,울산광역시,동구,25-29세,9038,5186,3852
202106,31170,울산광역시,동구,25-29세,9002,5176,3826
202007,31170,울산광역시,동구,30-34세,9855,5568,4287
202008,31170,울산광역시,동구,30-34세,9804,5548,4256
202009,31170,울산광역시,동구,30-34세,9747,5514,4233
202010,31170,울산광역시,동구,30-34세,9660,5466,4194
202011,31170,울산광역시,동구,30-34세,9572,5400,4172
202012,31170,울산광역시,동구,30-34세,9461,5339,4122
202101,31170,울산광역시,동구,30-34세,9374,5273,4101
202102,31170,울산광역시,동구,30-34세,9300,5232,4068
202103,31170,울산광역시,동구,30-34세,9228,5195,4033
202104,31170,울산광역시,동구,30-34세,9189,5185,4004
202105,31170,울산광역시,동구,30-34세,9169,5180,3989
202106,31170,울산광역시,동구,30-34세,9132,5153,3979
202007,31170,울산광역시,동구,35-39세,13997,7607,6390
202008,31170,울산광역시,동구,35-39세,13882,7537,6345
202009,31170,울산광역시,동구,35-39세,13794,7481,6313
202010,31170,울산광역시,동구,35-39세,13718,7425,6293
202011,31170,울산광역시,동구,35-39세,13614,7367,6247
202012,31170,울산광역시,동구,35-39세,13581,7349,6232
202101,31170,울산광역시,동구,35-39세,13482,7276,6206
202102,31170,울산광역시,동구,35-39세,13309,7190,6119
202103,31170,울산광역시,동구,35-39세,13198,7155,6043
202104,31170,울산광역시,동구,35-39세,13082,7061,6021
202105,31170,울산광역시,동구,35-39세,12990,7009,5981
202106,31170,울산광역시,동구,35-39세,12909,6951,5958
202007,31170,울산광역시,동구,40-44세,13323,7220,6103
202008,31170,울산광역시,동구,40-44세,13387,7265,6122
202009,31170,울산광역시,동구,40-44세,13426,7288,6138
202010,31170,울산광역시,동구,40-44세,13493,7336,6157
202011,31170,울산광역시,동구,40-44세,13587,7396,6191
202012,31170,울산광역시,동구,40-44세,13542,7379,6163
202101,31170,울산광역시,동구,40-44세,13565,7402,6163
202102,31170,울산광역시,동구,40-44세,13659,7447,6212
202103,31170,울산광역시,동구,40-44세,13646,7434,6212
202104,31170,울산광역시,동구,40-44세,13650,7453,6197
202105,31170,울산광역시,동구,40-44세,13677,7451,6226
202106,31170,울산광역시,동구,40-44세,13735,7479,6256
202007,31170,울산광역시,동구,45-49세,12506,6769,5737
202008,31170,울산광역시,동구,45-49세,12504,6770,5734
202009,31170,울산광역시,동구,45-49세,12487,6756,5731
202010,31170,울산광역시,동구,45-49세,12489,6780,5709
202011,31170,울산광역시,동구,45-49세,12434,6746,5688
202012,31170,울산광역시,동구,45-49세,12448,6757,5691
202101,31170,울산광역시,동구,45-49세,12477,6770,5707
202102,31170,울산광역시,동구,45-49세,12436,6758,5678
202103,31170,울산광역시,동구,45-49세,12406,6745,5661
202104,31170,울산광역시,동구,45-49세,12417,6754,5663
202105,31170,울산광역시,동구,45-49세,12332,6702,5630
202106,31170,울산광역시,동구,45-49세,12291,6686,5605
202007,31170,울산광역시,동구,50-54세,12533,6329,6204
202008,31170,울산광역시,동구,50-54세,12521,6351,6170
202009,31170,울산광역시,동구,50-54세,12492,6349,6143
202010,31170,울산광역시,동구,50-54세,12482,6333,6149
202011,31170,울산광역시,동구,50-54세,12514,6353,6161
202012,31170,울산광역시,동구,50-54세,12450,6312,6138
202101,31170,울산광역시,동구,50-54세,12468,6329,6139
202102,31170,울산광역시,동구,50-54세,12430,6322,6108
202103,31170,울산광역시,동구,50-54세,12347,6272,6075
202104,31170,울산광역시,동구,50-54세,12326,6245,6081
202105,31170,울산광역시,동구,50-54세,12355,6260,6095
202106,31170,울산광역시,동구,50-54세,12368,6273,6095
202007,31170,울산광역시,동구,55-59세,13699,6627,7072
202008,31170,울산광역시,동구,55-59세,13598,6567,7031
202009,31170,울산광역시,동구,55-59세,13509,6526,6983
202010,31170,울산광역시,동구,55-59세,13417,6502,6915
202011,31170,울산광역시,동구,55-59세,13287,6435,6852
202012,31170,울산광역시,동구,55-59세,13252,6434,6818
202101,31170,울산광역시,동구,55-59세,13099,6364,6735
202102,31170,울산광역시,동구,55-59세,13003,6341,6662
202103,31170,울산광역시,동구,55-59세,12973,6344,6629
202104,31170,울산광역시,동구,55-59세,12868,6316,6552
202105,31170,울산광역시,동구,55-59세,12771,6312,6459
202106,31170,울산광역시,동구,55-59세,12666,6270,6396
202007,31170,울산광역시,동구,60-64세,13499,6802,6697
202008,31170,울산광역시,동구,60-64세,13598,6847,6751
202009,31170,울산광역시,동구,60-64세,13695,6876,6819
202010,31170,울산광역시,동구,60-64세,13767,6899,6868
202011,31170,울산광역시,동구,60-64세,13854,6936,6918
202012,31170,울산광역시,동구,60-64세,13892,6950,6942
202101,31170,울산광역시,동구,60-64세,13965,6973,6992
202102,31170,울산광역시,동구,60-64세,14046,6986,7060
202103,31170,울산광역시,동구,60-64세,14040,6973,7067
202104,31170,울산광역시,동구,60-64세,14121,6977,7144
202105,31170,울산광역시,동구,60-64세,14177,6975,7202
202106,31170,울산광역시,동구,60-64세,14248,7005,7243
202007,31170,울산광역시,동구,65-69세,8448,4367,4081
202008,31170,울산광역시,동구,65-69세,8533,4408,4125
202009,31170,울산광역시,동구,65-69세,8603,4448,4155
202010,31170,울산광역시,동구,65-69세,8702,4480,4222
202011,31170,울산광역시,동구,65-69세,8758,4504,4254
202012,31170,울산광역시,동구,65-69세,8817,4521,4296
202101,31170,울산광역시,동구,65-69세,8894,4546,4348
202102,31170,울산광역시,동구,65-69세,8957,4563,4394
202103,31170,울산광역시,동구,65-69세,9023,4595,4428
202104,31170,울산광역시,동구,65-69세,9071,4617,4454
202105,31170,울산광역시,동구,65-69세,9128,4647,4481
202106,31170,울산광역시,동구,65-69세,9202,4679,4523
202007,31170,울산광역시,동구,70-74세,5057,2676,2381
202008,31170,울산광역시,동구,70-74세,5093,2698,2395
202009,31170,울산광역시,동구,70-74세,5147,2724,2423
202010,31170,울산광역시,동구,70-74세,5192,2754,2438
202011,31170,울산광역시,동구,70-74세,5244,2778,2466
202012,31170,울산광역시,동구,70-74세,5304,2810,2494
202101,31170,울산광역시,동구,70-74세,5372,2856,2516
202102,31170,울산광역시,동구,70-74세,5419,2896,2523
202103,31170,울산광역시,동구,70-74세,5421,2881,2540
202104,31170,울산광역시,동구,70-74세,5450,2890,2560
202105,31170,울산광역시,동구,70-74세,5480,2901,2579
202106,31170,울산광역시,동구,70-74세,5482,2901,2581
202007,31170,울산광역시,동구,75-79세,2969,1404,1565
202008,31170,울산광역시,동구,75-79세,2979,1410,1569
202009,31170,울산광역시,동구,75-79세,2965,1403,1562
202010,31170,울산광역시,동구,75-79세,2960,1401,1559
202011,31170,울산광역시,동구,75-79세,2954,1394,1560
202012,31170,울산광역시,동구,75-79세,2973,1410,1563
202101,31170,울산광역시,동구,75-79세,2970,1409,1561
202102,31170,울산광역시,동구,75-79세,2975,1415,1560
202103,31170,울산광역시,동구,75-79세,2992,1417,1575
202104,31170,울산광역시,동구,75-79세,2981,1424,1557
202105,31170,울산광역시,동구,75-79세,3010,1439,1571
202106,31170,울산광역시,동구,75-79세,3022,1446,1576
202007,31170,울산광역시,동구,80-84세,1632,589,1043
202008,31170,울산광역시,동구,80-84세,1634,591,1043
202009,31170,울산광역시,동구,80-84세,1654,599,1055
202010,31170,울산광역시,동구,80-84세,1653,595,1058
202011,31170,울산광역시,동구,80-84세,1665,604,1061
202012,31170,울산광역시,동구,80-84세,1661,613,1048
202101,31170,울산광역시,동구,80-84세,1682,627,1055
202102,31170,울산광역시,동구,80-84세,1700,637,1063
202103,31170,울산광역시,동구,80-84세,1698,639,1059
202104,31170,울산광역시,동구,80-84세,1722,648,1074
202105,31170,울산광역시,동구,80-84세,1722,655,1067
202106,31170,울산광역시,동구,80-84세,1737,662,1075
202007,31170,울산광역시,동구,85-89세,777,175,602
202008,31170,울산광역시,동구,85-89세,786,181,605
202009,31170,울산광역시,동구,85-89세,792,185,607
202010,31170,울산광역시,동구,85-89세,798,196,602
202011,31170,울산광역시,동구,85-89세,800,199,601
202012,31170,울산광역시,동구,85-89세,806,199,607
202101,31170,울산광역시,동구,85-89세,806,200,606
202102,31170,울산광역시,동구,85-89세,815,201,614
202103,31170,울산광역시,동구,85-89세,822,206,616
202104,31170,울산광역시,동구,85-89세,832,208,624
202105,31170,울산광역시,동구,85-89세,832,207,625
202106,31170,울산광역시,동구,85-89세,830,209,621
202007,31170,울산광역시,동구,90-94세,281,37,244
202008,31170,울산광역시,동구,90-94세,278,38,240
202009,31170,울산광역시,동구,90-94세,276,40,236
202010,31170,울산광역시,동구,90-94세,276,40,236
202011,31170,울산광역시,동구,90-94세,284,42,242
202012,31170,울산광역시,동구,90-94세,283,42,241
202101,31170,울산광역시,동구,90-94세,274,41,233
202102,31170,울산광역시,동구,90-94세,271,41,230
202103,31170,울산광역시,동구,90-94세,272,40,232
202104,31170,울산광역시,동구,90-94세,275,41,234
202105,31170,울산광역시,동구,90-94세,278,42,236
202106,31170,울산광역시,동구,90-94세,285,43,242
202007,31170,울산광역시,동구,95-99세,79,9,70
202008,31170,울산광역시,동구,95-99세,80,10,70
202009,31170,울산광역시,동구,95-99세,82,9,73
202010,31170,울산광역시,동구,95-99세,86,10,76
202011,31170,울산광역시,동구,95-99세,89,9,80
202012,31170,울산광역시,동구,95-99세,84,9,75
202101,31170,울산광역시,동구,95-99세,85,9,76
202102,31170,울산광역시,동구,95-99세,85,9,76
202103,31170,울산광역시,동구,95-99세,82,9,73
202104,31170,울산광역시,동구,95-99세,80,9,71
202105,31170,울산광역시,동구,95-99세,79,9,70
202106,31170,울산광역시,동구,95-99세,78,9,69
202007,31170,울산광역시,동구,100+,26,5,21
202008,31170,울산광역시,동구,100+,25,4,21
202009,31170,울산광역시,동구,100+,26,5,21
202010,31170,울산광역시,동구,100+,26,5,21
202011,31170,울산광역시,동구,100+,26,5,21
202012,31170,울산광역시,동구,100+,27,5,22
202101,31170,울산광역시,동구,100+,28,5,23
202102,31170,울산광역시,동구,100+,28,5,23
202103,31170,울산광역시,동구,100+,10,2,8
202104,31170,울산광역시,동구,100+,10,2,8
202105,31170,울산광역시,동구,100+,9,2,7
202106,31170,울산광역시,동구,100+,9,2,7
202007,31200,울산광역시,북구,0-4세,11586,5939,5647
202008,31200,울산광역시,북구,0-4세,11521,5898,5623
202009,31200,울산광역시,북구,0-4세,11440,5859,5581
202010,31200,울산광역시,북구,0-4세,11295,5781,5514
202011,31200,울산광역시,북구,0-4세,11186,5729,5457
202012,31200,울산광역시,북구,0-4세,11133,5691,5442
202101,31200,울산광역시,북구,0-4세,11007,5629,5378
202102,31200,울산광역시,북구,0-4세,10879,5569,5310
202103,31200,울산광역시,북구,0-4세,10781,5531,5250
202104,31200,울산광역시,북구,0-4세,10629,5458,5171
202105,31200,울산광역시,북구,0-4세,10518,5395,5123
202106,31200,울산광역시,북구,0-4세,10436,5345,5091
202007,31200,울산광역시,북구,5-9세,14218,7319,6899
202008,31200,울산광역시,북구,5-9세,14198,7311,6887
202009,31200,울산광역시,북구,5-9세,14168,7277,6891
202010,31200,울산광역시,북구,5-9세,14149,7267,6882
202011,31200,울산광역시,북구,5-9세,14127,7269,6858
202012,31200,울산광역시,북구,5-9세,14163,7298,6865
202101,31200,울산광역시,북구,5-9세,14136,7278,6858
202102,31200,울산광역시,북구,5-9세,14097,7247,6850
202103,31200,울산광역시,북구,5-9세,14099,7253,6846
202104,31200,울산광역시,북구,5-9세,14111,7249,6862
202105,31200,울산광역시,북구,5-9세,14098,7258,6840
202106,31200,울산광역시,북구,5-9세,14080,7263,6817
202007,31200,울산광역시,북구,10-14세,12396,6351,6045
202008,31200,울산광역시,북구,10-14세,12464,6391,6073
202009,31200,울산광역시,북구,10-14세,12538,6437,6101
202010,31200,울산광역시,북구,10-14세,12594,6460,6134
202011,31200,울산광역시,북구,10-14세,12660,6474,6186
202012,31200,울산광역시,북구,10-14세,12668,6466,6202
202101,31200,울산광역시,북구,10-14세,12719,6491,6228
202102,31200,울산광역시,북구,10-14세,12712,6513,6199
202103,31200,울산광역시,북구,10-14세,12752,6529,6223
202104,31200,울산광역시,북구,10-14세,12834,6578,6256
202105,31200,울산광역시,북구,10-14세,12898,6612,6286
202106,31200,울산광역시,북구,10-14세,12938,6628,6310
202007,31200,울산광역시,북구,15-19세,11205,5976,5229
202008,31200,울산광역시,북구,15-19세,11114,5929,5185
202009,31200,울산광역시,북구,15-19세,11090,5913,5177
202010,31200,울산광역시,북구,15-19세,11047,5892,5155
202011,31200,울산광역시,북구,15-19세,11007,5878,5129
202012,31200,울산광역시,북구,15-19세,10991,5867,5124
202101,31200,울산광역시,북구,15-19세,10924,5814,5110
202102,31200,울산광역시,북구,15-19세,10833,5757,5076
202103,31200,울산광역시,북구,15-19세,10721,5691,5030
202104,31200,울산광역시,북구,15-19세,10688,5661,5027
202105,31200,울산광역시,북구,15-19세,10635,5609,5026
202106,31200,울산광역시,북구,15-19세,10626,5592,5034
202007,31200,울산광역시,북구,20-24세,13739,7823,5916
202008,31200,울산광역시,북구,20-24세,13662,7781,5881
202009,31200,울산광역시,북구,20-24세,13603,7741,5862
202010,31200,울산광역시,북구,20-24세,13629,7749,5880
202011,31200,울산광역시,북구,20-24세,13590,7738,5852
202012,31200,울산광역시,북구,20-24세,13459,7674,5785
202101,31200,울산광역시,북구,20-24세,13418,7658,5760
202102,31200,울산광역시,북구,20-24세,13241,7568,5673
202103,31200,울산광역시,북구,20-24세,13102,7490,5612
202104,31200,울산광역시,북구,20-24세,13032,7462,5570
202105,31200,울산광역시,북구,20-24세,12982,7482,5500
202106,31200,울산광역시,북구,20-24세,12892,7421,5471
202007,31200,울산광역시,북구,25-29세,14329,7991,6338
202008,31200,울산광역시,북구,25-29세,14302,7969,6333
202009,31200,울산광역시,북구,25-29세,14359,8011,6348
202010,31200,울산광역시,북구,25-29세,14330,8015,6315
202011,31200,울산광역시,북구,25-29세,14295,7987,6308
202012,31200,울산광역시,북구,25-29세,14310,8003,6307
202101,31200,울산광역시,북구,25-29세,14266,8029,6237
202102,31200,울산광역시,북구,25-29세,14196,8025,6171
202103,31200,울산광역시,북구,25-29세,14222,8057,6165
202104,31200,울산광역시,북구,25-29세,14199,8077,6122
202105,31200,울산광역시,북구,25-29세,14177,8072,6105
202106,31200,울산광역시,북구,25-29세,14095,8041,6054
202007,31200,울산광역시,북구,30-34세,14991,8015,6976
202008,31200,울산광역시,북구,30-34세,14981,8012,6969
202009,31200,울산광역시,북구,30-34세,14968,8017,6951
202010,31200,울산광역시,북구,30-34세,14927,8000,6927
202011,31200,울산광역시,북구,30-34세,14860,7966,6894
202012,31200,울산광역시,북구,30-34세,14854,7981,6873
202101,31200,울산광역시,북구,30-34세,14863,7987,6876
202102,31200,울산광역시,북구,30-34세,14793,7943,6850
202103,31200,울산광역시,북구,30-34세,14791,7951,6840
202104,31200,울산광역시,북구,30-34세,14775,7923,6852
202105,31200,울산광역시,북구,30-34세,14762,7908,6854
202106,31200,울산광역시,북구,30-34세,14758,7905,6853
202007,31200,울산광역시,북구,35-39세,19900,10073,9827
202008,31200,울산광역시,북구,35-39세,19815,10028,9787
202009,31200,울산광역시,북구,35-39세,19711,9995,9716
202010,31200,울산광역시,북구,35-39세,19584,9933,9651
202011,31200,울산광역시,북구,35-39세,19456,9896,9560
202012,31200,울산광역시,북구,35-39세,19410,9862,9548
202101,31200,울산광역시,북구,35-39세,19281,9782,9499
202102,31200,울산광역시,북구,35-39세,19148,9701,9447
202103,31200,울산광역시,북구,35-39세,19010,9643,9367
202104,31200,울산광역시,북구,35-39세,18884,9578,9306
202105,31200,울산광역시,북구,35-39세,18764,9509,9255
202106,31200,울산광역시,북구,35-39세,18623,9435,9188
202007,31200,울산광역시,북구,40-44세,19676,10350,9326
202008,31200,울산광역시,북구,40-44세,19750,10385,9365
202009,31200,울산광역시,북구,40-44세,19856,10409,9447
202010,31200,울산광역시,북구,40-44세,19951,10440,9511
202011,31200,울산광역시,북구,40-44세,20058,10478,9580
202012,31200,울산광역시,북구,40-44세,20118,10503,9615
202101,31200,울산광역시,북구,40-44세,20182,10537,9645
202102,31200,울산광역시,북구,40-44세,20241,10587,9654
202103,31200,울산광역시,북구,40-44세,20236,10554,9682
202104,31200,울산광역시,북구,40-44세,20259,10572,9687
202105,31200,울산광역시,북구,40-44세,20299,10585,9714
202106,31200,울산광역시,북구,40-44세,20417,10640,9777
202007,31200,울산광역시,북구,45-49세,18777,9309,9468
202008,31200,울산광역시,북구,45-49세,18699,9265,9434
202009,31200,울산광역시,북구,45-49세,18639,9271,9368
202010,31200,울산광역시,북구,45-49세,18574,9249,9325
202011,31200,울산광역시,북구,45-49세,18501,9239,9262
202012,31200,울산광역시,북구,45-49세,18472,9245,9227
202101,31200,울산광역시,북구,45-49세,18512,9284,9228
202102,31200,울산광역시,북구,45-49세,18474,9285,9189
202103,31200,울산광역시,북구,45-49세,18457,9294,9163
202104,31200,울산광역시,북구,45-49세,18473,9319,9154
202105,31200,울산광역시,북구,45-49세,18371,9269,9102
202106,31200,울산광역시,북구,45-49세,18268,9215,9053
202007,31200,울산광역시,북구,50-54세,20359,10113,10246
202008,31200,울산광역시,북구,50-54세,20397,10127,10270
202009,31200,울산광역시,북구,50-54세,20331,10060,10271
202010,31200,울산광역시,북구,50-54세,20350,10048,10302
202011,31200,울산광역시,북구,50-54세,20385,10071,10314
202012,31200,울산광역시,북구,50-54세,20314,9993,10321
202101,31200,울산광역시,북구,50-54세,20329,9983,10346
202102,31200,울산광역시,북구,50-54세,20314,9954,10360
202103,31200,울산광역시,북구,50-54세,20089,9799,10290
202104,31200,울산광역시,북구,50-54세,20048,9780,10268
202105,31200,울산광역시,북구,50-54세,20029,9785,10244
202106,31200,울산광역시,북구,50-54세,20053,9804,10249
202007,31200,울산광역시,북구,55-59세,18158,9905,8253
202008,31200,울산광역시,북구,55-59세,18198,9908,8290
202009,31200,울산광역시,북구,55-59세,18301,9960,8341
202010,31200,울산광역시,북구,55-59세,18369,9973,8396
202011,31200,울산광역시,북구,55-59세,18345,9943,8402
202012,31200,울산광역시,북구,55-59세,18394,9999,8395
202101,31200,울산광역시,북구,55-59세,18401,9982,8419
202102,31200,울산광역시,북구,55-59세,18431,9965,8466
202103,31200,울산광역시,북구,55-59세,18532,10023,8509
202104,31200,울산광역시,북구,55-59세,18533,10007,8526
202105,31200,울산광역시,북구,55-59세,18514,9974,8540
202106,31200,울산광역시,북구,55-59세,18428,9926,8502
202007,31200,울산광역시,북구,60-64세,12062,6364,5698
202008,31200,울산광역시,북구,60-64세,12149,6423,5726
202009,31200,울산광역시,북구,60-64세,12254,6494,5760
202010,31200,울산광역시,북구,60-64세,12393,6596,5797
202011,31200,울산광역시,북구,60-64세,12540,6671,5869
202012,31200,울산광역시,북구,60-64세,12703,6749,5954
202101,31200,울산광역시,북구,60-64세,12933,6880,6053
202102,31200,울산광역시,북구,60-64세,13115,6993,6122
202103,31200,울산광역시,북구,60-64세,13246,7065,6181
202104,31200,울산광역시,북구,60-64세,13366,7133,6233
202105,31200,울산광역시,북구,60-64세,13544,7228,6316
202106,31200,울산광역시,북구,60-64세,13697,7312,6385
202007,31200,울산광역시,북구,65-69세,6750,3462,3288
202008,31200,울산광역시,북구,65-69세,6830,3515,3315
202009,31200,울산광역시,북구,65-69세,6912,3548,3364
202010,31200,울산광역시,북구,65-69세,6986,3588,3398
202011,31200,울산광역시,북구,65-69세,7026,3607,3419
202012,31200,울산광역시,북구,65-69세,7147,3664,3483
202101,31200,울산광역시,북구,65-69세,7248,3720,3528
202102,31200,울산광역시,북구,65-69세,7302,3747,3555
202103,31200,울산광역시,북구,65-69세,7416,3800,3616
202104,31200,울산광역시,북구,65-69세,7493,3842,3651
202105,31200,울산광역시,북구,65-69세,7542,3865,3677
202106,31200,울산광역시,북구,65-69세,7593,3890,3703
202007,31200,울산광역시,북구,70-74세,4224,2021,2203
202008,31200,울산광역시,북구,70-74세,4256,2034,2222
202009,31200,울산광역시,북구,70-74세,4303,2062,2241
202010,31200,울산광역시,북구,70-74세,4328,2077,2251
202011,31200,울산광역시,북구,70-74세,4387,2103,2284
202012,31200,울산광역시,북구,70-74세,4417,2127,2290
202101,31200,울산광역시,북구,70-74세,4497,2165,2332
202102,31200,울산광역시,북구,70-74세,4528,2190,2338
202103,31200,울산광역시,북구,70-74세,4554,2204,2350
202104,31200,울산광역시,북구,70-74세,4586,2215,2371
202105,31200,울산광역시,북구,70-74세,4638,2247,2391
202106,31200,울산광역시,북구,70-74세,4662,2263,2399
202007,31200,울산광역시,북구,75-79세,2994,1307,1687
202008,31200,울산광역시,북구,75-79세,2998,1313,1685
202009,31200,울산광역시,북구,75-79세,2998,1318,1680
202010,31200,울산광역시,북구,75-79세,3000,1319,1681
202011,31200,울산광역시,북구,75-79세,3000,1324,1676
202012,31200,울산광역시,북구,75-79세,2980,1315,1665
202101,31200,울산광역시,북구,75-79세,2965,1317,1648
202102,31200,울산광역시,북구,75-79세,2948,1304,1644
202103,31200,울산광역시,북구,75-79세,2957,1305,1652
202104,31200,울산광역시,북구,75-79세,2956,1311,1645
202105,31200,울산광역시,북구,75-79세,2973,1315,1658
202106,31200,울산광역시,북구,75-79세,2969,1315,1654
202007,31200,울산광역시,북구,80-84세,1957,617,1340
202008,31200,울산광역시,북구,80-84세,1962,621,1341
202009,31200,울산광역시,북구,80-84세,1959,624,1335
202010,31200,울산광역시,북구,80-84세,1960,630,1330
202011,31200,울산광역시,북구,80-84세,1964,631,1333
202012,31200,울산광역시,북구,80-84세,1980,634,1346
202101,31200,울산광역시,북구,80-84세,1983,637,1346
202102,31200,울산광역시,북구,80-84세,1998,651,1347
202103,31200,울산광역시,북구,80-84세,2008,657,1351
202104,31200,울산광역시,북구,80-84세,2019,665,1354
202105,31200,울산광역시,북구,80-84세,2030,678,1352
202106,31200,울산광역시,북구,80-84세,2050,688,1362
202007,31200,울산광역시,북구,85-89세,991,246,745
202008,31200,울산광역시,북구,85-89세,1009,253,756
202009,31200,울산광역시,북구,85-89세,1012,248,764
202010,31200,울산광역시,북구,85-89세,1014,249,765
202011,31200,울산광역시,북구,85-89세,1034,252,782
202012,31200,울산광역시,북구,85-89세,1042,251,791
202101,31200,울산광역시,북구,85-89세,1049,258,791
202102,31200,울산광역시,북구,85-89세,1060,255,805
202103,31200,울산광역시,북구,85-89세,1059,260,799
202104,31200,울산광역시,북구,85-89세,1064,264,800
202105,31200,울산광역시,북구,85-89세,1058,256,802
202106,31200,울산광역시,북구,85-89세,1068,253,815
202007,31200,울산광역시,북구,90-94세,357,54,303
202008,31200,울산광역시,북구,90-94세,351,52,299
202009,31200,울산광역시,북구,90-94세,351,53,298
202010,31200,울산광역시,북구,90-94세,357,53,304
202011,31200,울산광역시,북구,90-94세,347,50,297
202012,31200,울산광역시,북구,90-94세,342,50,292
202101,31200,울산광역시,북구,90-94세,345,50,295
202102,31200,울산광역시,북구,90-94세,348,52,296
202103,31200,울산광역시,북구,90-94세,347,53,294
202104,31200,울산광역시,북구,90-94세,357,55,302
202105,31200,울산광역시,북구,90-94세,365,59,306
202106,31200,울산광역시,북구,90-94세,369,60,309
202007,31200,울산광역시,북구,95-99세,88,15,73
202008,31200,울산광역시,북구,95-99세,89,14,75
202009,31200,울산광역시,북구,95-99세,89,14,75
202010,31200,울산광역시,북구,95-99세,91,14,77
202011,31200,울산광역시,북구,95-99세,93,15,78
202012,31200,울산광역시,북구,95-99세,97,16,81
202101,31200,울산광역시,북구,95-99세,96,13,83
202102,31200,울산광역시,북구,95-99세,94,12,82
202103,31200,울산광역시,북구,95-99세,85,9,76
202104,31200,울산광역시,북구,95-99세,86,9,77
202105,31200,울산광역시,북구,95-99세,88,9,79
202106,31200,울산광역시,북구,95-99세,91,9,82
202007,31200,울산광역시,북구,100+,20,3,17
202008,31200,울산광역시,북구,100+,20,4,16
202009,31200,울산광역시,북구,100+,21,4,17
202010,31200,울산광역시,북구,100+,21,4,17
202011,31200,울산광역시,북구,100+,21,4,17
202012,31200,울산광역시,북구,100+,20,4,16
202101,31200,울산광역시,북구,100+,21,5,16
202102,31200,울산광역시,북구,100+,22,6,16
202103,31200,울산광역시,북구,100+,17,4,13
202104,31200,울산광역시,북구,100+,18,4,14
202105,31200,울산광역시,북구,100+,18,4,14
202106,31200,울산광역시,북구,100+,18,4,14
202007,31710,울산광역시,울주군,0-4세,7836,4023,3813
202008,31710,울산광역시,울주군,0-4세,7751,3991,3760
202009,31710,울산광역시,울주군,0-4세,7687,3941,3746
202010,31710,울산광역시,울주군,0-4세,7614,3908,3706
202011,31710,울산광역시,울주군,0-4세,7546,3867,3679
202012,31710,울산광역시,울주군,0-4세,7467,3842,3625
202101,31710,울산광역시,울주군,0-4세,7388,3800,3588
202102,31710,울산광역시,울주군,0-4세,7323,3785,3538
202103,31710,울산광역시,울주군,0-4세,7228,3744,3484
202104,31710,울산광역시,울주군,0-4세,7184,3704,3480
202105,31710,울산광역시,울주군,0-4세,7109,3677,3432
202106,31710,울산광역시,울주군,0-4세,7049,3645,3404
202007,31710,울산광역시,울주군,5-9세,10542,5371,5171
202008,31710,울산광역시,울주군,5-9세,10545,5379,5166
202009,31710,울산광역시,울주군,5-9세,10483,5353,5130
202010,31710,울산광역시,울주군,5-9세,10416,5320,5096
202011,31710,울산광역시,울주군,5-9세,10359,5304,5055
202012,31710,울산광역시,울주군,5-9세,10339,5296,5043
202101,31710,울산광역시,울주군,5-9세,10292,5277,5015
202102,31710,울산광역시,울주군,5-9세,10235,5237,4998
202103,31710,울산광역시,울주군,5-9세,10175,5215,4960
202104,31710,울산광역시,울주군,5-9세,10115,5179,4936
202105,31710,울산광역시,울주군,5-9세,10103,5179,4924
202106,31710,울산광역시,울주군,5-9세,10077,5176,4901
202007,31710,울산광역시,울주군,10-14세,10843,5613,5230
202008,31710,울산광역시,울주군,10-14세,10819,5594,5225
202009,31710,울산광역시,울주군,10-14세,10826,5609,5217
202010,31710,울산광역시,울주군,10-14세,10856,5617,5239
202011,31710,울산광역시,울주군,10-14세,10892,5634,5258
202012,31710,울산광역시,울주군,10-14세,10894,5611,5283
202101,31710,울산광역시,울주군,10-14세,10882,5606,5276
202102,31710,울산광역시,울주군,10-14세,10840,5566,5274
202103,31710,울산광역시,울주군,10-14세,10854,5555,5299
202104,31710,울산광역시,울주군,10-14세,10858,5582,5276
202105,31710,울산광역시,울주군,10-14세,10870,5599,5271
202106,31710,울산광역시,울주군,10-14세,10858,5580,5278
202007,31710,울산광역시,울주군,15-19세,11924,6291,5633
202008,31710,울산광역시,울주군,15-19세,11850,6227,5623
202009,31710,울산광역시,울주군,15-19세,11784,6171,5613
202010,31710,울산광역시,울주군,15-19세,11689,6100,5589
202011,31710,울산광역시,울주군,15-19세,11596,6068,5528
202012,31710,울산광역시,울주군,15-19세,11578,6082,5496
202101,31710,울산광역시,울주군,15-19세,11511,6037,5474
202102,31710,울산광역시,울주군,15-19세,11446,6016,5430
202103,31710,울산광역시,울주군,15-19세,11368,5985,5383
202104,31710,울산광역시,울주군,15-19세,11317,5951,5366
202105,31710,울산광역시,울주군,15-19세,11275,5918,5357
202106,31710,울산광역시,울주군,15-19세,11256,5896,5360
202007,31710,울산광역시,울주군,20-24세,13684,7687,5997
202008,31710,울산광역시,울주군,20-24세,13694,7705,5989
202009,31710,울산광역시,울주군,20-24세,13685,7705,5980
202010,31710,울산광역시,울주군,20-24세,13694,7733,5961
202011,31710,울산광역시,울주군,20-24세,13675,7707,5968
202012,31710,울산광역시,울주군,20-24세,13608,7692,5916
202101,31710,울산광역시,울주군,20-24세,13619,7691,5928
202102,31710,울산광역시,울주군,20-24세,13562,7652,5910
202103,31710,울산광역시,울주군,20-24세,13421,7600,5821
202104,31710,울산광역시,울주군,20-24세,13414,7598,5816
202105,31710,울산광역시,울주군,20-24세,13373,7558,5815
202106,31710,울산광역시,울주군,20-24세,13384,7574,5810
202007,31710,울산광역시,울주군,25-29세,12840,7341,5499
202008,31710,울산광역시,울주군,25-29세,12829,7354,5475
202009,31710,울산광역시,울주군,25-29세,12872,7372,5500
202010,31710,울산광역시,울주군,25-29세,12870,7347,5523
202011,31710,울산광역시,울주군,25-29세,12841,7327,5514
202012,31710,울산광역시,울주군,25-29세,12904,7373,5531
202101,31710,울산광역시,울주군,25-29세,12918,7390,5528
202102,31710,울산광역시,울주군,25-29세,12851,7369,5482
202103,31710,울산광역시,울주군,25-29세,12863,7379,5484
202104,31710,울산광역시,울주군,25-29세,12870,7380,5490
202105,31710,울산광역시,울주군,25-29세,12821,7378,5443
202106,31710,울산광역시,울주군,25-29세,12820,7414,5406
202007,31710,울산광역시,울주군,30-34세,11554,6237,5317
202008,31710,울산광역시,울주군,30-34세,11550,6246,5304
202009,31710,울산광역시,울주군,30-34세,11493,6205,5288
202010,31710,울산광역시,울주군,30-34세,11479,6223,5256
202011,31710,울산광역시,울주군,30-34세,11405,6184,5221
202012,31710,울산광역시,울주군,30-34세,11396,6189,5207
202101,31710,울산광역시,울주군,30-34세,11390,6184,5206
202102,31710,울산광역시,울주군,30-34세,11364,6172,5192
202103,31710,울산광역시,울주군,30-34세,11335,6151,5184
202104,31710,울산광역시,울주군,30-34세,11331,6152,5179
202105,31710,울산광역시,울주군,30-34세,11358,6170,5188
202106,31710,울산광역시,울주군,30-34세,11338,6128,5210
202007,31710,울산광역시,울주군,35-39세,14904,7763,7141
202008,31710,울산광역시,울주군,35-39세,14789,7716,7073
202009,31710,울산광역시,울주군,35-39세,14716,7711,7005
202010,31710,울산광역시,울주군,35-39세,14615,7657,6958
202011,31710,울산광역시,울주군,35-39세,14565,7638,6927
202012,31710,울산광역시,울주군,35-39세,14452,7555,6897
202101,31710,울산광역시,울주군,35-39세,14344,7505,6839
202102,31710,울산광역시,울주군,35-39세,14182,7441,6741
202103,31710,울산광역시,울주군,35-39세,14082,7407,6675
202104,31710,울산광역시,울주군,35-39세,14031,7388,6643
202105,31710,울산광역시,울주군,35-39세,13942,7332,6610
202106,31710,울산광역시,울주군,35-39세,13848,7306,6542
202007,31710,울산광역시,울주군,40-44세,16794,8693,8101
202008,31710,울산광역시,울주군,40-44세,16853,8718,8135
202009,31710,울산광역시,울주군,40-44세,16864,8703,8161
202010,31710,울산광역시,울주군,40-44세,16893,8727,8166
202011,31710,울산광역시,울주군,40-44세,16937,8748,8189
202012,31710,울산광역시,울주군,40-44세,16863,8749,8114
202101,31710,울산광역시,울주군,40-44세,16828,8725,8103
202102,31710,울산광역시,울주군,40-44세,16808,8717,8091
202103,31710,울산광역시,울주군,40-44세,16709,8674,8035
202104,31710,울산광역시,울주군,40-44세,16664,8663,8001
202105,31710,울산광역시,울주군,40-44세,16679,8682,7997
202106,31710,울산광역시,울주군,40-44세,16727,8704,8023
202007,31710,울산광역시,울주군,45-49세,20870,10600,10270
202008,31710,울산광역시,울주군,45-49세,20819,10560,10259
202009,31710,울산광역시,울주군,45-49세,20702,10518,10184
202010,31710,울산광역시,울주군,45-49세,20581,10444,10137
202011,31710,울산광역시,울주군,45-49세,20477,10384,10093
202012,31710,울산광역시,울주군,45-49세,20454,10353,10101
202101,31710,울산광역시,울주군,45-49세,20365,10274,10091
202102,31710,울산광역시,울주군,45-49세,20238,10219,10019
202103,31710,울산광역시,울주군,45-49세,20118,10146,9972
202104,31710,울산광역시,울주군,45-49세,20042,10092,9950
202105,31710,울산광역시,울주군,45-49세,19905,10021,9884
202106,31710,울산광역시,울주군,45-49세,19799,9984,9815
202007,31710,울산광역시,울주군,50-54세,21627,11379,10248
202008,31710,울산광역시,울주군,50-54세,21638,11362,10276
202009,31710,울산광역시,울주군,50-54세,21685,11375,10310
202010,31710,울산광역시,울주군,50-54세,21671,11340,10331
202011,31710,울산광역시,울주군,50-54세,21674,11351,10323
202012,31710,울산광역시,울주군,50-54세,21609,11290,10319
202101,31710,울산광역시,울주군,50-54세,21721,11370,10351
202102,31710,울산광역시,울주군,50-54세,21750,11366,10384
202103,31710,울산광역시,울주군,50-54세,21683,11323,10360
202104,31710,울산광역시,울주군,50-54세,21694,11327,10367
202105,31710,울산광역시,울주군,50-54세,21798,11368,10430
202106,31710,울산광역시,울주군,50-54세,21870,11399,10471
202007,31710,울산광역시,울주군,55-59세,20024,10668,9356
202008,31710,울산광역시,울주군,55-59세,20082,10736,9346
202009,31710,울산광역시,울주군,55-59세,20078,10743,9335
202010,31710,울산광역시,울주군,55-59세,20103,10788,9315
202011,31710,울산광역시,울주군,55-59세,20146,10787,9359
202012,31710,울산광역시,울주군,55-59세,20281,10889,9392
202101,31710,울산광역시,울주군,55-59세,20223,10861,9362
202102,31710,울산광역시,울주군,55-59세,20211,10856,9355
202103,31710,울산광역시,울주군,55-59세,20124,10806,9318
202104,31710,울산광역시,울주군,55-59세,20105,10789,9316
202105,31710,울산광역시,울주군,55-59세,20048,10757,9291
202106,31710,울산광역시,울주군,55-59세,19994,10711,9283
202007,31710,울산광역시,울주군,60-64세,17171,9003,8168
202008,31710,울산광역시,울주군,60-64세,17271,9037,8234
202009,31710,울산광역시,울주군,60-64세,17385,9114,8271
202010,31710,울산광역시,울주군,60-64세,17481,9156,8325
202011,31710,울산광역시,울주군,60-64세,17611,9227,8384
202012,31710,울산광역시,울주군,60-64세,17710,9285,8425
202101,31710,울산광역시,울주군,60-64세,17927,9394,8533
202102,31710,울산광역시,울주군,60-64세,18040,9438,8602
202103,31710,울산광역시,울주군,60-64세,18175,9516,8659
202104,31710,울산광역시,울주군,60-64세,18274,9578,8696
202105,31710,울산광역시,울주군,60-64세,18412,9655,8757
202106,31710,울산광역시,울주군,60-64세,18521,9715,8806
202007,31710,울산광역시,울주군,65-69세,11368,5776,5592
202008,31710,울산광역시,울주군,65-69세,11458,5821,5637
202009,31710,울산광역시,울주군,65-69세,11564,5868,5696
202010,31710,울산광역시,울주군,65-69세,11656,5902,5754
202011,31710,울산광역시,울주군,65-69세,11734,5958,5776
202012,31710,울산광역시,울주군,65-69세,11820,5991,5829
202101,31710,울산광역시,울주군,65-69세,11951,6069,5882
202102,31710,울산광역시,울주군,65-69세,12079,6138,5941
202103,31710,울산광역시,울주군,65-69세,12173,6205,5968
202104,31710,울산광역시,울주군,65-69세,12296,6260,6036
202105,31710,울산광역시,울주군,65-69세,12393,6318,6075
202106,31710,울산광역시,울주군,65-69세,12486,6357,6129
202007,31710,울산광역시,울주군,70-74세,7532,3790,3742
202008,31710,울산광역시,울주군,70-74세,7568,3814,3754
202009,31710,울산광역시,울주군,70-74세,7635,3845,3790
202010,31710,울산광역시,울주군,70-74세,7726,3903,3823
202011,31710,울산광역시,울주군,70-74세,7848,3959,3889
202012,31710,울산광역시,울주군,70-74세,7942,4021,3921
202101,31710,울산광역시,울주군,70-74세,8014,4045,3969
202102,31710,울산광역시,울주군,70-74세,8049,4069,3980
202103,31710,울산광역시,울주군,70-74세,8083,4081,4002
202104,31710,울산광역시,울주군,70-74세,8153,4114,4039
202105,31710,울산광역시,울주군,70-74세,8175,4124,4051
202106,31710,울산광역시,울주군,70-74세,8212,4145,4067
202007,31710,울산광역시,울주군,75-79세,5942,2503,3439
202008,31710,울산광역시,울주군,75-79세,5932,2498,3434
202009,31710,울산광역시,울주군,75-79세,5903,2474,3429
202010,31710,울산광역시,울주군,75-79세,5880,2471,3409
202011,31710,울산광역시,울주군,75-79세,5843,2466,3377
202012,31710,울산광역시,울주군,75-79세,5799,2460,3339
202101,31710,울산광역시,울주군,75-79세,5762,2456,3306
202102,31710,울산광역시,울주군,75-79세,5744,2445,3299
202103,31710,울산광역시,울주군,75-79세,5744,2449,3295
202104,31710,울산광역시,울주군,75-79세,5745,2461,3284
202105,31710,울산광역시,울주군,75-79세,5744,2455,3289
202106,31710,울산광역시,울주군,75-79세,5725,2452,3273
202007,31710,울산광역시,울주군,80-84세,4048,1397,2651
202008,31710,울산광역시,울주군,80-84세,4084,1419,2665
202009,31710,울산광역시,울주군,80-84세,4087,1439,2648
202010,31710,울산광역시,울주군,80-84세,4104,1449,2655
202011,31710,울산광역시,울주군,80-84세,4109,1450,2659
202012,31710,울산광역시,울주군,80-84세,4111,1444,2667
202101,31710,울산광역시,울주군,80-84세,4149,1465,2684
202102,31710,울산광역시,울주군,80-84세,4167,1468,2699
202103,31710,울산광역시,울주군,80-84세,4176,1465,2711
202104,31710,울산광역시,울주군,80-84세,4173,1473,2700
202105,31710,울산광역시,울주군,80-84세,4221,1509,2712
202106,31710,울산광역시,울주군,80-84세,4261,1526,2735
202007,31710,울산광역시,울주군,85-89세,2207,590,1617
202008,31710,울산광역시,울주군,85-89세,2211,585,1626
202009,31710,울산광역시,울주군,85-89세,2253,592,1661
202010,31710,울산광역시,울주군,85-89세,2267,591,1676
202011,31710,울산광역시,울주군,85-89세,2275,600,1675
202012,31710,울산광역시,울주군,85-89세,2305,610,1695
202101,31710,울산광역시,울주군,85-89세,2329,606,1723
202102,31710,울산광역시,울주군,85-89세,2333,609,1724
202103,31710,울산광역시,울주군,85-89세,2348,616,1732
202104,31710,울산광역시,울주군,85-89세,2378,628,1750
202105,31710,울산광역시,울주군,85-89세,2372,625,1747
202106,31710,울산광역시,울주군,85-89세,2363,623,1740
202007,31710,울산광역시,울주군,90-94세,793,146,647
202008,31710,울산광역시,울주군,90-94세,794,151,643
202009,31710,울산광역시,울주군,90-94세,793,147,646
202010,31710,울산광역시,울주군,90-94세,795,150,645
202011,31710,울산광역시,울주군,90-94세,793,151,642
202012,31710,울산광역시,울주군,90-94세,792,155,637
202101,31710,울산광역시,울주군,90-94세,798,164,634
202102,31710,울산광역시,울주군,90-94세,814,164,650
202103,31710,울산광역시,울주군,90-94세,826,159,667
202104,31710,울산광역시,울주군,90-94세,816,157,659
202105,31710,울산광역시,울주군,90-94세,824,157,667
202106,31710,울산광역시,울주군,90-94세,816,161,655
202007,31710,울산광역시,울주군,95-99세,171,24,147
202008,31710,울산광역시,울주군,95-99세,181,25,156
202009,31710,울산광역시,울주군,95-99세,184,27,157
202010,31710,울산광역시,울주군,95-99세,184,27,157
202011,31710,울산광역시,울주군,95-99세,180,26,154
202012,31710,울산광역시,울주군,95-99세,180,26,154
202101,31710,울산광역시,울주군,95-99세,183,28,155
202102,31710,울산광역시,울주군,95-99세,187,29,158
202103,31710,울산광역시,울주군,95-99세,178,25,153
202104,31710,울산광역시,울주군,95-99세,186,25,161
202105,31710,울산광역시,울주군,95-99세,184,24,160
202106,31710,울산광역시,울주군,95-99세,188,24,164
202007,31710,울산광역시,울주군,100+,33,5,28
202008,31710,울산광역시,울주군,100+,34,5,29
202009,31710,울산광역시,울주군,100+,34,5,29
202010,31710,울산광역시,울주군,100+,34,5,29
202011,31710,울산광역시,울주군,100+,34,5,29
202012,31710,울산광역시,울주군,100+,34,5,29
202101,31710,울산광역시,울주군,100+,34,5,29
202102,31710,울산광역시,울주군,100+,35,5,30
202103,31710,울산광역시,울주군,100+,22,2,20
202104,31710,울산광역시,울주군,100+,23,2,21
202105,31710,울산광역시,울주군,100+,23,2,21
202106,31710,울산광역시,울주군,100+,22,2,20
202007,36110,세종특별자치시,X,0-4세,21103,10738,10365
202008,36110,세종특별자치시,X,0-4세,21005,10696,10309
202009,36110,세종특별자치시,X,0-4세,20813,10598,10215
202010,36110,세종특별자치시,X,0-4세,20846,10616,10230
202011,36110,세종특별자치시,X,0-4세,20920,10659,10261
202012,36110,세종특별자치시,X,0-4세,20901,10638,10263
202101,36110,세종특별자치시,X,0-4세,20756,10573,10183
202102,36110,세종특별자치시,X,0-4세,20738,10566,10172
202103,36110,세종특별자치시,X,0-4세,20674,10517,10157
202104,36110,세종특별자치시,X,0-4세,20567,10431,10136
202105,36110,세종특별자치시,X,0-4세,20431,10381,10050
202106,36110,세종특별자치시,X,0-4세,20301,10304,9997
202007,36110,세종특별자치시,X,5-9세,25963,13396,12567
202008,36110,세종특별자치시,X,5-9세,25982,13380,12602
202009,36110,세종특별자치시,X,5-9세,25983,13376,12607
202010,36110,세종특별자치시,X,5-9세,26196,13479,12717
202011,36110,세종특별자치시,X,5-9세,26302,13534,12768
202012,36110,세종특별자치시,X,5-9세,26382,13550,12832
202101,36110,세종특별자치시,X,5-9세,26470,13613,12857
202102,36110,세종특별자치시,X,5-9세,26551,13654,12897
202103,36110,세종특별자치시,X,5-9세,26626,13674,12952
202104,36110,세종특별자치시,X,5-9세,26672,13707,12965
202105,36110,세종특별자치시,X,5-9세,26643,13674,12969
202106,36110,세종특별자치시,X,5-9세,26676,13718,12958
202007,36110,세종특별자치시,X,10-14세,23363,11719,11644
202008,36110,세종특별자치시,X,10-14세,23478,11788,11690
202009,36110,세종특별자치시,X,10-14세,23608,11860,11748
202010,36110,세종특별자치시,X,10-14세,23881,12022,11859
202011,36110,세종특별자치시,X,10-14세,24091,12117,11974
202012,36110,세종특별자치시,X,10-14세,24319,12249,12070
202101,36110,세종특별자치시,X,10-14세,24559,12365,12194
202102,36110,세종특별자치시,X,10-14세,24744,12493,12251
202103,36110,세종특별자치시,X,10-14세,24871,12575,12296
202104,36110,세종특별자치시,X,10-14세,24972,12631,12341
202105,36110,세종특별자치시,X,10-14세,25083,12680,12403
202106,36110,세종특별자치시,X,10-14세,25203,12727,12476
202007,36110,세종특별자치시,X,15-19세,17865,8948,8917
202008,36110,세종특별자치시,X,15-19세,17938,8989,8949
202009,36110,세종특별자치시,X,15-19세,17942,8977,8965
202010,36110,세종특별자치시,X,15-19세,18087,9018,9069
202011,36110,세종특별자치시,X,15-19세,18215,9090,9125
202012,36110,세종특별자치시,X,15-19세,18358,9170,9188
202101,36110,세종특별자치시,X,15-19세,18538,9266,9272
202102,36110,세종특별자치시,X,15-19세,18588,9285,9303
202103,36110,세종특별자치시,X,15-19세,18651,9304,9347
202104,36110,세종특별자치시,X,15-19세,18738,9360,9378
202105,36110,세종특별자치시,X,15-19세,18763,9349,9414
202106,36110,세종특별자치시,X,15-19세,18869,9422,9447
202007,36110,세종특별자치시,X,20-24세,16561,8663,7898
202008,36110,세종특별자치시,X,20-24세,16525,8627,7898
202009,36110,세종특별자치시,X,20-24세,16608,8668,7940
202010,36110,세종특별자치시,X,20-24세,16788,8798,7990
202011,36110,세종특별자치시,X,20-24세,16882,8826,8056
202012,36110,세종특별자치시,X,20-24세,17056,8931,8125
202101,36110,세종특별자치시,X,20-24세,17158,9008,8150
202102,36110,세종특별자치시,X,20-24세,17256,9054,8202
202103,36110,세종특별자치시,X,20-24세,17247,9086,8161
202104,36110,세종특별자치시,X,20-24세,17249,9064,8185
202105,36110,세종특별자치시,X,20-24세,17302,9120,8182
202106,36110,세종특별자치시,X,20-24세,17289,9108,8181
202007,36110,세종특별자치시,X,25-29세,19615,9647,9968
202008,36110,세종특별자치시,X,25-29세,19716,9735,9981
202009,36110,세종특별자치시,X,25-29세,19739,9777,9962
202010,36110,세종특별자치시,X,25-29세,19954,9860,10094
202011,36110,세종특별자치시,X,25-29세,20112,9979,10133
202012,36110,세종특별자치시,X,25-29세,20397,10119,10278
202101,36110,세종특별자치시,X,25-29세,20577,10192,10385
202102,36110,세종특별자치시,X,25-29세,20503,10185,10318
202103,36110,세종특별자치시,X,25-29세,20619,10254,10365
202104,36110,세종특별자치시,X,25-29세,20761,10344,10417
202105,36110,세종특별자치시,X,25-29세,20792,10387,10405
202106,36110,세종특별자치시,X,25-29세,20916,10459,10457
202007,36110,세종특별자치시,X,30-34세,25503,12450,13053
202008,36110,세종특별자치시,X,30-34세,25524,12454,13070
202009,36110,세종특별자치시,X,30-34세,25565,12441,13124
202010,36110,세종특별자치시,X,30-34세,25761,12560,13201
202011,36110,세종특별자치시,X,30-34세,25880,12636,13244
202012,36110,세종특별자치시,X,30-34세,26014,12727,13287
202101,36110,세종특별자치시,X,30-34세,26087,12780,13307
202102,36110,세종특별자치시,X,30-34세,26146,12774,13372
202103,36110,세종특별자치시,X,30-34세,26195,12793,13402
202104,36110,세종특별자치시,X,30-34세,26240,12805,13435
202105,36110,세종특별자치시,X,30-34세,26262,12814,13448
202106,36110,세종특별자치시,X,30-34세,26314,12836,13478
202007,36110,세종특별자치시,X,35-39세,35303,17160,18143
202008,36110,세종특별자치시,X,35-39세,35271,17179,18092
202009,36110,세종특별자치시,X,35-39세,35138,17150,17988
202010,36110,세종특별자치시,X,35-39세,35233,17184,18049
202011,36110,세종특별자치시,X,35-39세,35360,17232,18128
202012,36110,세종특별자치시,X,35-39세,35478,17277,18201
202101,36110,세종특별자치시,X,35-39세,35441,17263,18178
202102,36110,세종특별자치시,X,35-39세,35411,17289,18122
202103,36110,세종특별자치시,X,35-39세,35320,17267,18053
202104,36110,세종특별자치시,X,35-39세,35250,17221,18029
202105,36110,세종특별자치시,X,35-39세,35056,17116,17940
202106,36110,세종특별자치시,X,35-39세,34880,17047,17833
202007,36110,세종특별자치시,X,40-44세,35005,17405,17600
202008,36110,세종특별자치시,X,40-44세,35134,17420,17714
202009,36110,세종특별자치시,X,40-44세,35364,17531,17833
202010,36110,세종특별자치시,X,40-44세,35826,17774,18052
202011,36110,세종특별자치시,X,40-44세,36229,18000,18229
202012,36110,세종특별자치시,X,40-44세,36398,18085,18313
202101,36110,세종특별자치시,X,40-44세,36642,18194,18448
202102,36110,세종특별자치시,X,40-44세,36964,18355,18609
202103,36110,세종특별자치시,X,40-44세,36974,18344,18630
202104,36110,세종특별자치시,X,40-44세,37076,18377,18699
202105,36110,세종특별자치시,X,40-44세,37325,18516,18809
202106,36110,세종특별자치시,X,40-44세,37650,18686,18964
202007,36110,세종특별자치시,X,45-49세,31683,16724,14959
202008,36110,세종특별자치시,X,45-49세,31816,16817,14999
202009,36110,세종특별자치시,X,45-49세,31774,16782,14992
202010,36110,세종특별자치시,X,45-49세,31935,16866,15069
202011,36110,세종특별자치시,X,45-49세,32089,16925,15164
202012,36110,세종특별자치시,X,45-49세,32433,17103,15330
202101,36110,세종특별자치시,X,45-49세,32729,17199,15530
202102,36110,세종특별자치시,X,45-49세,33018,17283,15735
202103,36110,세종특별자치시,X,45-49세,33101,17341,15760
202104,36110,세종특별자치시,X,45-49세,33169,17390,15779
202105,36110,세종특별자치시,X,45-49세,32994,17252,15742
202106,36110,세종특별자치시,X,45-49세,32996,17237,15759
202007,36110,세종특별자치시,X,50-54세,23501,12311,11190
202008,36110,세종특별자치시,X,50-54세,23711,12449,11262
202009,36110,세종특별자치시,X,50-54세,23967,12587,11380
202010,36110,세종특별자치시,X,50-54세,24349,12763,11586
202011,36110,세종특별자치시,X,50-54세,24671,12914,11757
202012,36110,세종특별자치시,X,50-54세,24767,12966,11801
202101,36110,세종특별자치시,X,50-54세,25115,13171,11944
202102,36110,세종특별자치시,X,50-54세,25396,13350,12046
202103,36110,세종특별자치시,X,50-54세,25584,13454,12130
202104,36110,세종특별자치시,X,50-54세,25766,13561,12205
202105,36110,세종특별자치시,X,50-54세,26113,13757,12356
202106,36110,세종특별자치시,X,50-54세,26318,13877,12441
202007,36110,세종특별자치시,X,55-59세,20069,10328,9741
202008,36110,세종특별자치시,X,55-59세,20103,10334,9769
202009,36110,세종특별자치시,X,55-59세,20138,10356,9782
202010,36110,세종특별자치시,X,55-59세,20247,10448,9799
202011,36110,세종특별자치시,X,55-59세,20299,10470,9829
202012,36110,세종특별자치시,X,55-59세,20438,10528,9910
202101,36110,세종특별자치시,X,55-59세,20351,10522,9829
202102,36110,세종특별자치시,X,55-59세,20364,10522,9842
202103,36110,세종특별자치시,X,55-59세,20369,10530,9839
202104,36110,세종특별자치시,X,55-59세,20374,10512,9862
202105,36110,세종특별자치시,X,55-59세,20356,10503,9853
202106,36110,세종특별자치시,X,55-59세,20265,10466,9799
202007,36110,세종특별자치시,X,60-64세,17168,8574,8594
202008,36110,세종특별자치시,X,60-64세,17296,8637,8659
202009,36110,세종특별자치시,X,60-64세,17420,8719,8701
202010,36110,세종특별자치시,X,60-64세,17600,8792,8808
202011,36110,세종특별자치시,X,60-64세,17799,8887,8912
202012,36110,세종특별자치시,X,60-64세,18009,9001,9008
202101,36110,세종특별자치시,X,60-64세,18223,9098,9125
202102,36110,세종특별자치시,X,60-64세,18372,9146,9226
202103,36110,세종특별자치시,X,60-64세,18558,9237,9321
202104,36110,세종특별자치시,X,60-64세,18721,9330,9391
202105,36110,세종특별자치시,X,60-64세,18878,9409,9469
202106,36110,세종특별자치시,X,60-64세,19124,9536,9588
202007,36110,세종특별자치시,X,65-69세,11439,5612,5827
202008,36110,세종특별자치시,X,65-69세,11540,5656,5884
202009,36110,세종특별자치시,X,65-69세,11654,5705,5949
202010,36110,세종특별자치시,X,65-69세,11809,5779,6030
202011,36110,세종특별자치시,X,65-69세,11986,5851,6135
202012,36110,세종특별자치시,X,65-69세,12130,5934,6196
202101,36110,세종특별자치시,X,65-69세,12330,6042,6288
202102,36110,세종특별자치시,X,65-69세,12536,6167,6369
202103,36110,세종특별자치시,X,65-69세,12712,6241,6471
202104,36110,세종특별자치시,X,65-69세,12848,6307,6541
202105,36110,세종특별자치시,X,65-69세,12955,6359,6596
202106,36110,세종특별자치시,X,65-69세,13041,6407,6634
202007,36110,세종특별자치시,X,70-74세,7842,3778,4064
202008,36110,세종특별자치시,X,70-74세,7909,3810,4099
202009,36110,세종특별자치시,X,70-74세,7973,3840,4133
202010,36110,세종특별자치시,X,70-74세,8087,3891,4196
202011,36110,세종특별자치시,X,70-74세,8156,3927,4229
202012,36110,세종특별자치시,X,70-74세,8276,3989,4287
202101,36110,세종특별자치시,X,70-74세,8365,4033,4332
202102,36110,세종특별자치시,X,70-74세,8423,4062,4361
202103,36110,세종특별자치시,X,70-74세,8414,4069,4345
202104,36110,세종특별자치시,X,70-74세,8430,4072,4358
202105,36110,세종특별자치시,X,70-74세,8479,4093,4386
202106,36110,세종특별자치시,X,70-74세,8504,4097,4407
202007,36110,세종특별자치시,X,75-79세,6119,2610,3509
202008,36110,세종특별자치시,X,75-79세,6111,2608,3503
202009,36110,세종특별자치시,X,75-79세,6114,2618,3496
202010,36110,세종특별자치시,X,75-79세,6132,2622,3510
202011,36110,세종특별자치시,X,75-79세,6130,2621,3509
202012,36110,세종특별자치시,X,75-79세,6116,2613,3503
202101,36110,세종특별자치시,X,75-79세,6103,2626,3477
202102,36110,세종특별자치시,X,75-79세,6046,2613,3433
202103,36110,세종특별자치시,X,75-79세,6037,2619,3418
202104,36110,세종특별자치시,X,75-79세,5992,2609,3383
202105,36110,세종특별자치시,X,75-79세,5978,2600,3378
202106,36110,세종특별자치시,X,75-79세,6002,2627,3375
202007,36110,세종특별자치시,X,80-84세,4369,1610,2759
202008,36110,세종특별자치시,X,80-84세,4378,1603,2775
202009,36110,세종특별자치시,X,80-84세,4368,1607,2761
202010,36110,세종특별자치시,X,80-84세,4412,1638,2774
202011,36110,세종특별자치시,X,80-84세,4432,1642,2790
202012,36110,세종특별자치시,X,80-84세,4429,1644,2785
202101,36110,세종특별자치시,X,80-84세,4466,1658,2808
202102,36110,세종특별자치시,X,80-84세,4500,1668,2832
202103,36110,세종특별자치시,X,80-84세,4508,1675,2833
202104,36110,세종특별자치시,X,80-84세,4517,1667,2850
202105,36110,세종특별자치시,X,80-84세,4540,1692,2848
202106,36110,세종특별자치시,X,80-84세,4557,1694,2863
202007,36110,세종특별자치시,X,85-89세,2546,721,1825
202008,36110,세종특별자치시,X,85-89세,2585,738,1847
202009,36110,세종특별자치시,X,85-89세,2619,753,1866
202010,36110,세종특별자치시,X,85-89세,2633,757,1876
202011,36110,세종특별자치시,X,85-89세,2648,756,1892
202012,36110,세종특별자치시,X,85-89세,2680,771,1909
202101,36110,세종특별자치시,X,85-89세,2698,778,1920
202102,36110,세종특별자치시,X,85-89세,2727,784,1943
202103,36110,세종특별자치시,X,85-89세,2737,780,1957
202104,36110,세종특별자치시,X,85-89세,2767,802,1965
202105,36110,세종특별자치시,X,85-89세,2781,806,1975
202106,36110,세종특별자치시,X,85-89세,2774,808,1966
202007,36110,세종특별자치시,X,90-94세,953,213,740
202008,36110,세종특별자치시,X,90-94세,958,211,747
202009,36110,세종특별자치시,X,90-94세,972,214,758
202010,36110,세종특별자치시,X,90-94세,975,218,757
202011,36110,세종특별자치시,X,90-94세,977,220,757
202012,36110,세종특별자치시,X,90-94세,994,222,772
202101,36110,세종특별자치시,X,90-94세,1009,225,784
202102,36110,세종특별자치시,X,90-94세,1030,226,804
202103,36110,세종특별자치시,X,90-94세,1031,229,802
202104,36110,세종특별자치시,X,90-94세,1049,228,821
202105,36110,세종특별자치시,X,90-94세,1067,225,842
202106,36110,세종특별자치시,X,90-94세,1081,225,856
202007,36110,세종특별자치시,X,95-99세,192,42,150
202008,36110,세종특별자치시,X,95-99세,196,41,155
202009,36110,세종특별자치시,X,95-99세,200,42,158
202010,36110,세종특별자치시,X,95-99세,202,39,163
202011,36110,세종특별자치시,X,95-99세,200,39,161
202012,36110,세종특별자치시,X,95-99세,206,41,165
202101,36110,세종특별자치시,X,95-99세,204,40,164
202102,36110,세종특별자치시,X,95-99세,206,41,165
202103,36110,세종특별자치시,X,95-99세,197,34,163
202104,36110,세종특별자치시,X,95-99세,202,37,165
202105,36110,세종특별자치시,X,95-99세,201,37,164
202106,36110,세종특별자치시,X,95-99세,197,38,159
202007,36110,세종특별자치시,X,100+,55,11,44
202008,36110,세종특별자치시,X,100+,56,11,45
202009,36110,세종특별자치시,X,100+,55,12,43
202010,36110,세종특별자치시,X,100+,54,11,43
202011,36110,세종특별자치시,X,100+,52,11,41
202012,36110,세종특별자치시,X,100+,50,10,40
202101,36110,세종특별자치시,X,100+,50,10,40
202102,36110,세종특별자치시,X,100+,50,11,39
202103,36110,세종특별자치시,X,100+,37,7,30
202104,36110,세종특별자치시,X,100+,36,7,29
202105,36110,세종특별자치시,X,100+,37,8,29
202106,36110,세종특별자치시,X,100+,38,9,29
202007,41111,경기도,수원시 장안구,0-4세,7533,3823,3710
202008,41111,경기도,수원시 장안구,0-4세,7429,3764,3665
202009,41111,경기도,수원시 장안구,0-4세,7338,3728,3610
202010,41111,경기도,수원시 장안구,0-4세,7267,3692,3575
202011,41111,경기도,수원시 장안구,0-4세,7188,3647,3541
202012,41111,경기도,수원시 장안구,0-4세,7115,3613,3502
202101,41111,경기도,수원시 장안구,0-4세,7014,3560,3454
202102,41111,경기도,수원시 장안구,0-4세,6918,3503,3415
202103,41111,경기도,수원시 장안구,0-4세,6793,3452,3341
202104,41111,경기도,수원시 장안구,0-4세,6715,3398,3317
202105,41111,경기도,수원시 장안구,0-4세,6660,3375,3285
202106,41111,경기도,수원시 장안구,0-4세,6587,3337,3250
202007,41111,경기도,수원시 장안구,5-9세,11501,6028,5473
202008,41111,경기도,수원시 장안구,5-9세,11458,6004,5454
202009,41111,경기도,수원시 장안구,5-9세,11397,5940,5457
202010,41111,경기도,수원시 장안구,5-9세,11336,5903,5433
202011,41111,경기도,수원시 장안구,5-9세,11285,5886,5399
202012,41111,경기도,수원시 장안구,5-9세,11226,5858,5368
202101,41111,경기도,수원시 장안구,5-9세,11118,5797,5321
202102,41111,경기도,수원시 장안구,5-9세,11016,5741,5275
202103,41111,경기도,수원시 장안구,5-9세,10943,5695,5248
202104,41111,경기도,수원시 장안구,5-9세,10894,5673,5221
202105,41111,경기도,수원시 장안구,5-9세,10815,5606,5209
202106,41111,경기도,수원시 장안구,5-9세,10751,5559,5192
202007,41111,경기도,수원시 장안구,10-14세,13401,6900,6501
202008,41111,경기도,수원시 장안구,10-14세,13369,6874,6495
202009,41111,경기도,수원시 장안구,10-14세,13367,6881,6486
202010,41111,경기도,수원시 장안구,10-14세,13323,6868,6455
202011,41111,경기도,수원시 장안구,10-14세,13348,6894,6454
202012,41111,경기도,수원시 장안구,10-14세,13372,6919,6453
202101,41111,경기도,수원시 장안구,10-14세,13380,6928,6452
202102,41111,경기도,수원시 장안구,10-14세,13360,6912,6448
202103,41111,경기도,수원시 장안구,10-14세,13283,6881,6402
202104,41111,경기도,수원시 장안구,10-14세,13230,6845,6385
202105,41111,경기도,수원시 장안구,10-14세,13194,6831,6363
202106,41111,경기도,수원시 장안구,10-14세,13137,6815,6322
202007,41111,경기도,수원시 장안구,15-19세,15785,8316,7469
202008,41111,경기도,수원시 장안구,15-19세,15665,8266,7399
202009,41111,경기도,수원시 장안구,15-19세,15736,8318,7418
202010,41111,경기도,수원시 장안구,15-19세,15629,8262,7367
202011,41111,경기도,수원시 장안구,15-19세,15456,8147,7309
202012,41111,경기도,수원시 장안구,15-19세,15279,8022,7257
202101,41111,경기도,수원시 장안구,15-19세,15162,7950,7212
202102,41111,경기도,수원시 장안구,15-19세,15006,7877,7129
202103,41111,경기도,수원시 장안구,15-19세,15200,8064,7136
202104,41111,경기도,수원시 장안구,15-19세,15075,8008,7067
202105,41111,경기도,수원시 장안구,15-19세,14940,7925,7015
202106,41111,경기도,수원시 장안구,15-19세,14800,7818,6982
202007,41111,경기도,수원시 장안구,20-24세,22531,12127,10404
202008,41111,경기도,수원시 장안구,20-24세,22480,12118,10362
202009,41111,경기도,수원시 장안구,20-24세,22524,12178,10346
202010,41111,경기도,수원시 장안구,20-24세,22444,12141,10303
202011,41111,경기도,수원시 장안구,20-24세,22397,12106,10291
202012,41111,경기도,수원시 장안구,20-24세,22218,12003,10215
202101,41111,경기도,수원시 장안구,20-24세,22086,11937,10149
202102,41111,경기도,수원시 장안구,20-24세,22092,11961,10131
202103,41111,경기도,수원시 장안구,20-24세,22169,12054,10115
202104,41111,경기도,수원시 장안구,20-24세,21994,11937,10057
202105,41111,경기도,수원시 장안구,20-24세,21873,11865,10008
202106,41111,경기도,수원시 장안구,20-24세,21780,11784,9996
202007,41111,경기도,수원시 장안구,25-29세,21621,12000,9621
202008,41111,경기도,수원시 장안구,25-29세,21590,11958,9632
202009,41111,경기도,수원시 장안구,25-29세,21595,11983,9612
202010,41111,경기도,수원시 장안구,25-29세,21672,12056,9616
202011,41111,경기도,수원시 장안구,25-29세,21728,12067,9661
202012,41111,경기도,수원시 장안구,25-29세,21781,12076,9705
202101,41111,경기도,수원시 장안구,25-29세,21776,12062,9714
202102,41111,경기도,수원시 장안구,25-29세,21690,11991,9699
202103,41111,경기도,수원시 장안구,25-29세,21768,12019,9749
202104,41111,경기도,수원시 장안구,25-29세,21735,12031,9704
202105,41111,경기도,수원시 장안구,25-29세,21751,12033,9718
202106,41111,경기도,수원시 장안구,25-29세,21730,12031,9699
202007,41111,경기도,수원시 장안구,30-34세,15481,8336,7145
202008,41111,경기도,수원시 장안구,30-34세,15448,8324,7124
202009,41111,경기도,수원시 장안구,30-34세,15412,8306,7106
202010,41111,경기도,수원시 장안구,30-34세,15338,8256,7082
202011,41111,경기도,수원시 장안구,30-34세,15281,8239,7042
202012,41111,경기도,수원시 장안구,30-34세,15301,8256,7045
202101,41111,경기도,수원시 장안구,30-34세,15392,8299,7093
202102,41111,경기도,수원시 장안구,30-34세,15430,8316,7114
202103,41111,경기도,수원시 장안구,30-34세,15389,8298,7091
202104,41111,경기도,수원시 장안구,30-34세,15473,8362,7111
202105,41111,경기도,수원시 장안구,30-34세,15560,8413,7147
202106,41111,경기도,수원시 장안구,30-34세,15635,8456,7179
202007,41111,경기도,수원시 장안구,35-39세,17835,8998,8837
202008,41111,경기도,수원시 장안구,35-39세,17736,8948,8788
202009,41111,경기도,수원시 장안구,35-39세,17618,8917,8701
202010,41111,경기도,수원시 장안구,35-39세,17509,8845,8664
202011,41111,경기도,수원시 장안구,35-39세,17459,8814,8645
202012,41111,경기도,수원시 장안구,35-39세,17366,8787,8579
202101,41111,경기도,수원시 장안구,35-39세,17198,8711,8487
202102,41111,경기도,수원시 장안구,35-39세,17020,8640,8380
202103,41111,경기도,수원시 장안구,35-39세,16813,8558,8255
202104,41111,경기도,수원시 장안구,35-39세,16676,8488,8188
202105,41111,경기도,수원시 장안구,35-39세,16531,8449,8082
202106,41111,경기도,수원시 장안구,35-39세,16367,8377,7990
202007,41111,경기도,수원시 장안구,40-44세,20702,10284,10418
202008,41111,경기도,수원시 장안구,40-44세,20618,10215,10403
202009,41111,경기도,수원시 장안구,40-44세,20577,10185,10392
202010,41111,경기도,수원시 장안구,40-44세,20503,10149,10354
202011,41111,경기도,수원시 장안구,40-44세,20441,10126,10315
202012,41111,경기도,수원시 장안구,40-44세,20313,10058,10255
202101,41111,경기도,수원시 장안구,40-44세,20233,10008,10225
202102,41111,경기도,수원시 장안구,40-44세,20189,10005,10184
202103,41111,경기도,수원시 장안구,40-44세,20021,9934,10087
202104,41111,경기도,수원시 장안구,40-44세,20015,9931,10084
202105,41111,경기도,수원시 장안구,40-44세,20036,9926,10110
202106,41111,경기도,수원시 장안구,40-44세,20128,9940,10188
202007,41111,경기도,수원시 장안구,45-49세,25589,12668,12921
202008,41111,경기도,수원시 장안구,45-49세,25472,12608,12864
202009,41111,경기도,수원시 장안구,45-49세,25290,12493,12797
202010,41111,경기도,수원시 장안구,45-49세,25114,12406,12708
202011,41111,경기도,수원시 장안구,45-49세,25026,12371,12655
202012,41111,경기도,수원시 장안구,45-49세,25000,12374,12626
202101,41111,경기도,수원시 장안구,45-49세,24908,12299,12609
202102,41111,경기도,수원시 장안구,45-49세,24797,12257,12540
202103,41111,경기도,수원시 장안구,45-49세,24555,12141,12414
202104,41111,경기도,수원시 장안구,45-49세,24338,12065,12273
202105,41111,경기도,수원시 장안구,45-49세,24138,11971,12167
202106,41111,경기도,수원시 장안구,45-49세,23949,11856,12093
202007,41111,경기도,수원시 장안구,50-54세,26120,12843,13277
202008,41111,경기도,수원시 장안구,50-54세,26119,12849,13270
202009,41111,경기도,수원시 장안구,50-54세,26169,12893,13276
202010,41111,경기도,수원시 장안구,50-54세,26227,12931,13296
202011,41111,경기도,수원시 장안구,50-54세,26226,12919,13307
202012,41111,경기도,수원시 장안구,50-54세,26128,12876,13252
202101,41111,경기도,수원시 장안구,50-54세,26219,12949,13270
202102,41111,경기도,수원시 장안구,50-54세,26135,12865,13270
202103,41111,경기도,수원시 장안구,50-54세,25926,12759,13167
202104,41111,경기도,수원시 장안구,50-54세,25928,12749,13179
202105,41111,경기도,수원시 장안구,50-54세,26008,12781,13227
202106,41111,경기도,수원시 장안구,50-54세,26069,12826,13243
202007,41111,경기도,수원시 장안구,55-59세,23241,11816,11425
202008,41111,경기도,수원시 장안구,55-59세,23210,11812,11398
202009,41111,경기도,수원시 장안구,55-59세,23243,11833,11410
202010,41111,경기도,수원시 장안구,55-59세,23180,11791,11389
202011,41111,경기도,수원시 장안구,55-59세,23108,11777,11331
202012,41111,경기도,수원시 장안구,55-59세,23138,11778,11360
202101,41111,경기도,수원시 장안구,55-59세,23038,11746,11292
202102,41111,경기도,수원시 장안구,55-59세,23048,11762,11286
202103,41111,경기도,수원시 장안구,55-59세,22860,11659,11201
202104,41111,경기도,수원시 장안구,55-59세,22719,11573,11146
202105,41111,경기도,수원시 장안구,55-59세,22622,11536,11086
202106,41111,경기도,수원시 장안구,55-59세,22473,11433,11040
202007,41111,경기도,수원시 장안구,60-64세,18278,9173,9105
202008,41111,경기도,수원시 장안구,60-64세,18389,9248,9141
202009,41111,경기도,수원시 장안구,60-64세,18454,9301,9153
202010,41111,경기도,수원시 장안구,60-64세,18577,9366,9211
202011,41111,경기도,수원시 장안구,60-64세,18700,9406,9294
202012,41111,경기도,수원시 장안구,60-64세,18767,9428,9339
202101,41111,경기도,수원시 장안구,60-64세,18936,9487,9449
202102,41111,경기도,수원시 장안구,60-64세,19087,9559,9528
202103,41111,경기도,수원시 장안구,60-64세,19186,9620,9566
202104,41111,경기도,수원시 장안구,60-64세,19308,9692,9616
202105,41111,경기도,수원시 장안구,60-64세,19491,9773,9718
202106,41111,경기도,수원시 장안구,60-64세,19699,9883,9816
202007,41111,경기도,수원시 장안구,65-69세,11585,5521,6064
202008,41111,경기도,수원시 장안구,65-69세,11638,5548,6090
202009,41111,경기도,수원시 장안구,65-69세,11745,5599,6146
202010,41111,경기도,수원시 장안구,65-69세,11817,5655,6162
202011,41111,경기도,수원시 장안구,65-69세,11898,5708,6190
202012,41111,경기도,수원시 장안구,65-69세,11972,5746,6226
202101,41111,경기도,수원시 장안구,65-69세,12097,5811,6286
202102,41111,경기도,수원시 장안구,65-69세,12207,5868,6339
202103,41111,경기도,수원시 장안구,65-69세,12329,5914,6415
202104,41111,경기도,수원시 장안구,65-69세,12395,5934,6461
202105,41111,경기도,수원시 장안구,65-69세,12492,5970,6522
202106,41111,경기도,수원시 장안구,65-69세,12581,6034,6547
202007,41111,경기도,수원시 장안구,70-74세,8593,3942,4651
202008,41111,경기도,수원시 장안구,70-74세,8624,3949,4675
202009,41111,경기도,수원시 장안구,70-74세,8662,3972,4690
202010,41111,경기도,수원시 장안구,70-74세,8728,3995,4733
202011,41111,경기도,수원시 장안구,70-74세,8789,4026,4763
202012,41111,경기도,수원시 장안구,70-74세,8827,4039,4788
202101,41111,경기도,수원시 장안구,70-74세,8865,4052,4813
202102,41111,경기도,수원시 장안구,70-74세,8878,4065,4813
202103,41111,경기도,수원시 장안구,70-74세,8804,4033,4771
202104,41111,경기도,수원시 장안구,70-74세,8802,4032,4770
202105,41111,경기도,수원시 장안구,70-74세,8796,4032,4764
202106,41111,경기도,수원시 장안구,70-74세,8771,4016,4755
202007,41111,경기도,수원시 장안구,75-79세,7042,2976,4066
202008,41111,경기도,수원시 장안구,75-79세,7061,2982,4079
202009,41111,경기도,수원시 장안구,75-79세,7046,2968,4078
202010,41111,경기도,수원시 장안구,75-79세,7035,2950,4085
202011,41111,경기도,수원시 장안구,75-79세,6990,2928,4062
202012,41111,경기도,수원시 장안구,75-79세,6976,2934,4042
202101,41111,경기도,수원시 장안구,75-79세,6946,2926,4020
202102,41111,경기도,수원시 장안구,75-79세,6931,2924,4007
202103,41111,경기도,수원시 장안구,75-79세,6913,2905,4008
202104,41111,경기도,수원시 장안구,75-79세,6896,2899,3997
202105,41111,경기도,수원시 장안구,75-79세,6892,2893,3999
202106,41111,경기도,수원시 장안구,75-79세,6890,2905,3985
202007,41111,경기도,수원시 장안구,80-84세,4854,1868,2986
202008,41111,경기도,수원시 장안구,80-84세,4863,1866,2997
202009,41111,경기도,수원시 장안구,80-84세,4891,1872,3019
202010,41111,경기도,수원시 장안구,80-84세,4891,1879,3012
202011,41111,경기도,수원시 장안구,80-84세,4904,1880,3024
202012,41111,경기도,수원시 장안구,80-84세,4918,1894,3024
202101,41111,경기도,수원시 장안구,80-84세,4955,1920,3035
202102,41111,경기도,수원시 장안구,80-84세,4983,1933,3050
202103,41111,경기도,수원시 장안구,80-84세,4946,1933,3013
202104,41111,경기도,수원시 장안구,80-84세,4957,1946,3011
202105,41111,경기도,수원시 장안구,80-84세,4996,1970,3026
202106,41111,경기도,수원시 장안구,80-84세,5004,1968,3036
202007,41111,경기도,수원시 장안구,85-89세,2501,779,1722
202008,41111,경기도,수원시 장안구,85-89세,2518,786,1732
202009,41111,경기도,수원시 장안구,85-89세,2528,793,1735
202010,41111,경기도,수원시 장안구,85-89세,2557,799,1758
202011,41111,경기도,수원시 장안구,85-89세,2574,803,1771
202012,41111,경기도,수원시 장안구,85-89세,2608,810,1798
202101,41111,경기도,수원시 장안구,85-89세,2628,815,1813
202102,41111,경기도,수원시 장안구,85-89세,2663,825,1838
202103,41111,경기도,수원시 장안구,85-89세,2703,834,1869
202104,41111,경기도,수원시 장안구,85-89세,2704,834,1870
202105,41111,경기도,수원시 장안구,85-89세,2700,829,1871
202106,41111,경기도,수원시 장안구,85-89세,2715,831,1884
202007,41111,경기도,수원시 장안구,90-94세,955,224,731
202008,41111,경기도,수원시 장안구,90-94세,967,226,741
202009,41111,경기도,수원시 장안구,90-94세,984,235,749
202010,41111,경기도,수원시 장안구,90-94세,996,243,753
202011,41111,경기도,수원시 장안구,90-94세,1022,256,766
202012,41111,경기도,수원시 장안구,90-94세,1028,256,772
202101,41111,경기도,수원시 장안구,90-94세,1038,261,777
202102,41111,경기도,수원시 장안구,90-94세,1033,260,773
202103,41111,경기도,수원시 장안구,90-94세,1022,258,764
202104,41111,경기도,수원시 장안구,90-94세,1017,252,765
202105,41111,경기도,수원시 장안구,90-94세,1021,252,769
202106,41111,경기도,수원시 장안구,90-94세,1018,254,764
202007,41111,경기도,수원시 장안구,95-99세,244,62,182
202008,41111,경기도,수원시 장안구,95-99세,244,61,183
202009,41111,경기도,수원시 장안구,95-99세,248,59,189
202010,41111,경기도,수원시 장안구,95-99세,248,57,191
202011,41111,경기도,수원시 장안구,95-99세,240,58,182
202012,41111,경기도,수원시 장안구,95-99세,239,59,180
202101,41111,경기도,수원시 장안구,95-99세,245,60,185
202102,41111,경기도,수원시 장안구,95-99세,249,62,187
202103,41111,경기도,수원시 장안구,95-99세,233,55,178
202104,41111,경기도,수원시 장안구,95-99세,238,55,183
202105,41111,경기도,수원시 장안구,95-99세,230,53,177
202106,41111,경기도,수원시 장안구,95-99세,227,51,176
202007,41111,경기도,수원시 장안구,100+,87,21,66
202008,41111,경기도,수원시 장안구,100+,86,21,65
202009,41111,경기도,수원시 장안구,100+,87,21,66
202010,41111,경기도,수원시 장안구,100+,89,21,68
202011,41111,경기도,수원시 장안구,100+,88,21,67
202012,41111,경기도,수원시 장안구,100+,89,21,68
202101,41111,경기도,수원시 장안구,100+,90,21,69
202102,41111,경기도,수원시 장안구,100+,91,22,69
202103,41111,경기도,수원시 장안구,100+,62,13,49
202104,41111,경기도,수원시 장안구,100+,61,14,47
202105,41111,경기도,수원시 장안구,100+,61,15,46
202106,41111,경기도,수원시 장안구,100+,62,15,47
202007,41113,경기도,수원시 권선구,0-4세,15121,7825,7296
202008,41113,경기도,수원시 권선구,0-4세,14950,7728,7222
202009,41113,경기도,수원시 권선구,0-4세,14810,7662,7148
202010,41113,경기도,수원시 권선구,0-4세,14611,7579,7032
202011,41113,경기도,수원시 권선구,0-4세,14512,7549,6963
202012,41113,경기도,수원시 권선구,0-4세,14355,7451,6904
202101,41113,경기도,수원시 권선구,0-4세,14152,7345,6807
202102,41113,경기도,수원시 권선구,0-4세,13959,7234,6725
202103,41113,경기도,수원시 권선구,0-4세,13710,7106,6604
202104,41113,경기도,수원시 권선구,0-4세,13497,6977,6520
202105,41113,경기도,수원시 권선구,0-4세,13371,6917,6454
202106,41113,경기도,수원시 권선구,0-4세,13267,6855,6412
202007,41113,경기도,수원시 권선구,5-9세,18463,9413,9050
202008,41113,경기도,수원시 권선구,5-9세,18455,9424,9031
202009,41113,경기도,수원시 권선구,5-9세,18367,9396,8971
202010,41113,경기도,수원시 권선구,5-9세,18316,9380,8936
202011,41113,경기도,수원시 권선구,5-9세,18209,9347,8862
202012,41113,경기도,수원시 권선구,5-9세,18157,9311,8846
202101,41113,경기도,수원시 권선구,5-9세,18151,9304,8847
202102,41113,경기도,수원시 권선구,5-9세,18093,9277,8816
202103,41113,경기도,수원시 권선구,5-9세,17971,9216,8755
202104,41113,경기도,수원시 권선구,5-9세,17895,9194,8701
202105,41113,경기도,수원시 권선구,5-9세,17853,9191,8662
202106,41113,경기도,수원시 권선구,5-9세,17817,9180,8637
202007,41113,경기도,수원시 권선구,10-14세,16235,8391,7844
202008,41113,경기도,수원시 권선구,10-14세,16253,8406,7847
202009,41113,경기도,수원시 권선구,10-14세,16292,8439,7853
202010,41113,경기도,수원시 권선구,10-14세,16360,8453,7907
202011,41113,경기도,수원시 권선구,10-14세,16467,8496,7971
202012,41113,경기도,수원시 권선구,10-14세,16481,8500,7981
202101,41113,경기도,수원시 권선구,10-14세,16518,8519,7999
202102,41113,경기도,수원시 권선구,10-14세,16438,8474,7964
202103,41113,경기도,수원시 권선구,10-14세,16416,8478,7938
202104,41113,경기도,수원시 권선구,10-14세,16433,8479,7954
202105,41113,경기도,수원시 권선구,10-14세,16453,8472,7981
202106,41113,경기도,수원시 권선구,10-14세,16475,8468,8007
202007,41113,경기도,수원시 권선구,15-19세,17643,9229,8414
202008,41113,경기도,수원시 권선구,15-19세,17553,9181,8372
202009,41113,경기도,수원시 권선구,15-19세,17412,9118,8294
202010,41113,경기도,수원시 권선구,15-19세,17246,9050,8196
202011,41113,경기도,수원시 권선구,15-19세,17087,8933,8154
202012,41113,경기도,수원시 권선구,15-19세,16998,8907,8091
202101,41113,경기도,수원시 권선구,15-19세,16896,8869,8027
202102,41113,경기도,수원시 권선구,15-19세,16822,8816,8006
202103,41113,경기도,수원시 권선구,15-19세,16724,8746,7978
202104,41113,경기도,수원시 권선구,15-19세,16595,8678,7917
202105,41113,경기도,수원시 권선구,15-19세,16473,8619,7854
202106,41113,경기도,수원시 권선구,15-19세,16395,8587,7808
202007,41113,경기도,수원시 권선구,20-24세,25046,12893,12153
202008,41113,경기도,수원시 권선구,20-24세,24899,12845,12054
202009,41113,경기도,수원시 권선구,20-24세,24747,12761,11986
202010,41113,경기도,수원시 권선구,20-24세,24683,12714,11969
202011,41113,경기도,수원시 권선구,20-24세,24591,12694,11897
202012,41113,경기도,수원시 권선구,20-24세,24430,12594,11836
202101,41113,경기도,수원시 권선구,20-24세,24300,12524,11776
202102,41113,경기도,수원시 권선구,20-24세,24205,12465,11740
202103,41113,경기도,수원시 권선구,20-24세,24050,12365,11685
202104,41113,경기도,수원시 권선구,20-24세,23943,12305,11638
202105,41113,경기도,수원시 권선구,20-24세,23870,12262,11608
202106,41113,경기도,수원시 권선구,20-24세,23767,12207,11560
202007,41113,경기도,수원시 권선구,25-29세,29906,15755,14151
202008,41113,경기도,수원시 권선구,25-29세,29941,15738,14203
202009,41113,경기도,수원시 권선구,25-29세,29928,15721,14207
202010,41113,경기도,수원시 권선구,25-29세,29938,15744,14194
202011,41113,경기도,수원시 권선구,25-29세,29958,15739,14219
202012,41113,경기도,수원시 권선구,25-29세,30073,15844,14229
202101,41113,경기도,수원시 권선구,25-29세,30118,15895,14223
202102,41113,경기도,수원시 권선구,25-29세,30007,15877,14130
202103,41113,경기도,수원시 권선구,25-29세,29976,15915,14061
202104,41113,경기도,수원시 권선구,25-29세,29931,15888,14043
202105,41113,경기도,수원시 권선구,25-29세,29845,15830,14015
202106,41113,경기도,수원시 권선구,25-29세,29827,15853,13974
202007,41113,경기도,수원시 권선구,30-34세,27109,14213,12896
202008,41113,경기도,수원시 권선구,30-34세,27027,14144,12883
202009,41113,경기도,수원시 권선구,30-34세,26968,14121,12847
202010,41113,경기도,수원시 권선구,30-34세,26869,14045,12824
202011,41113,경기도,수원시 권선구,30-34세,26796,14026,12770
202012,41113,경기도,수원시 권선구,30-34세,26707,13982,12725
202101,41113,경기도,수원시 권선구,30-34세,26742,14005,12737
202102,41113,경기도,수원시 권선구,30-34세,26713,13966,12747
202103,41113,경기도,수원시 권선구,30-34세,26664,13997,12667
202104,41113,경기도,수원시 권선구,30-34세,26595,13990,12605
202105,41113,경기도,수원시 권선구,30-34세,26754,14069,12685
202106,41113,경기도,수원시 권선구,30-34세,26838,14109,12729
202007,41113,경기도,수원시 권선구,35-39세,32366,16861,15505
202008,41113,경기도,수원시 권선구,35-39세,32193,16784,15409
202009,41113,경기도,수원시 권선구,35-39세,31966,16649,15317
202010,41113,경기도,수원시 권선구,35-39세,31781,16565,15216
202011,41113,경기도,수원시 권선구,35-39세,31651,16481,15170
202012,41113,경기도,수원시 권선구,35-39세,31456,16381,15075
202101,41113,경기도,수원시 권선구,35-39세,31261,16275,14986
202102,41113,경기도,수원시 권선구,35-39세,30939,16120,14819
202103,41113,경기도,수원시 권선구,35-39세,30616,15960,14656
202104,41113,경기도,수원시 권선구,35-39세,30400,15851,14549
202105,41113,경기도,수원시 권선구,35-39세,30207,15770,14437
202106,41113,경기도,수원시 권선구,35-39세,30021,15670,14351
202007,41113,경기도,수원시 권선구,40-44세,30250,15828,14422
202008,41113,경기도,수원시 권선구,40-44세,30389,15896,14493
202009,41113,경기도,수원시 권선구,40-44세,30516,15982,14534
202010,41113,경기도,수원시 권선구,40-44세,30564,16022,14542
202011,41113,경기도,수원시 권선구,40-44세,30639,16085,14554
202012,41113,경기도,수원시 권선구,40-44세,30593,16034,14559
202101,41113,경기도,수원시 권선구,40-44세,30696,16090,14606
202102,41113,경기도,수원시 권선구,40-44세,30834,16174,14660
202103,41113,경기도,수원시 권선구,40-44세,30643,16066,14577
202104,41113,경기도,수원시 권선구,40-44세,30585,16019,14566
202105,41113,경기도,수원시 권선구,40-44세,30630,16030,14600
202106,41113,경기도,수원시 권선구,40-44세,30733,16072,14661
202007,41113,경기도,수원시 권선구,45-49세,31545,16089,15456
202008,41113,경기도,수원시 권선구,45-49세,31445,16035,15410
202009,41113,경기도,수원시 권선구,45-49세,31280,15970,15310
202010,41113,경기도,수원시 권선구,45-49세,31144,15912,15232
202011,41113,경기도,수원시 권선구,45-49세,31073,15866,15207
202012,41113,경기도,수원시 권선구,45-49세,31092,15881,15211
202101,41113,경기도,수원시 권선구,45-49세,31006,15832,15174
202102,41113,경기도,수원시 권선구,45-49세,30818,15750,15068
202103,41113,경기도,수원시 권선구,45-49세,30549,15635,14914
202104,41113,경기도,수원시 권선구,45-49세,30523,15616,14907
202105,41113,경기도,수원시 권선구,45-49세,30280,15479,14801
202106,41113,경기도,수원시 권선구,45-49세,30168,15404,14764
202007,41113,경기도,수원시 권선구,50-54세,31949,15452,16497
202008,41113,경기도,수원시 권선구,50-54세,31907,15445,16462
202009,41113,경기도,수원시 권선구,50-54세,31922,15426,16496
202010,41113,경기도,수원시 권선구,50-54세,31921,15437,16484
202011,41113,경기도,수원시 권선구,50-54세,31932,15450,16482
202012,41113,경기도,수원시 권선구,50-54세,31755,15352,16403
202101,41113,경기도,수원시 권선구,50-54세,31933,15445,16488
202102,41113,경기도,수원시 권선구,50-54세,32008,15489,16519
202103,41113,경기도,수원시 권선구,50-54세,31923,15462,16461
202104,41113,경기도,수원시 권선구,50-54세,31873,15461,16412
202105,41113,경기도,수원시 권선구,50-54세,31932,15512,16420
202106,41113,경기도,수원시 권선구,50-54세,31935,15532,16403
202007,41113,경기도,수원시 권선구,55-59세,30541,15335,15206
202008,41113,경기도,수원시 권선구,55-59세,30548,15329,15219
202009,41113,경기도,수원시 권선구,55-59세,30450,15309,15141
202010,41113,경기도,수원시 권선구,55-59세,30449,15301,15148
202011,41113,경기도,수원시 권선구,55-59세,30389,15261,15128
202012,41113,경기도,수원시 권선구,55-59세,30336,15219,15117
202101,41113,경기도,수원시 권선구,55-59세,30081,15098,14983
202102,41113,경기도,수원시 권선구,55-59세,30077,15075,15002
202103,41113,경기도,수원시 권선구,55-59세,29937,15006,14931
202104,41113,경기도,수원시 권선구,55-59세,29783,14951,14832
202105,41113,경기도,수원시 권선구,55-59세,29636,14865,14771
202106,41113,경기도,수원시 권선구,55-59세,29427,14727,14700
202007,41113,경기도,수원시 권선구,60-64세,23899,11945,11954
202008,41113,경기도,수원시 권선구,60-64세,24097,12062,12035
202009,41113,경기도,수원시 권선구,60-64세,24265,12142,12123
202010,41113,경기도,수원시 권선구,60-64세,24401,12200,12201
202011,41113,경기도,수원시 권선구,60-64세,24609,12286,12323
202012,41113,경기도,수원시 권선구,60-64세,24805,12380,12425
202101,41113,경기도,수원시 권선구,60-64세,25110,12552,12558
202102,41113,경기도,수원시 권선구,60-64세,25258,12628,12630
202103,41113,경기도,수원시 권선구,60-64세,25374,12669,12705
202104,41113,경기도,수원시 권선구,60-64세,25583,12771,12812
202105,41113,경기도,수원시 권선구,60-64세,25813,12897,12916
202106,41113,경기도,수원시 권선구,60-64세,26130,13098,13032
202007,41113,경기도,수원시 권선구,65-69세,14606,7098,7508
202008,41113,경기도,수원시 권선구,65-69세,14750,7157,7593
202009,41113,경기도,수원시 권선구,65-69세,14873,7207,7666
202010,41113,경기도,수원시 권선구,65-69세,14968,7250,7718
202011,41113,경기도,수원시 권선구,65-69세,15066,7312,7754
202012,41113,경기도,수원시 권선구,65-69세,15171,7354,7817
202101,41113,경기도,수원시 권선구,65-69세,15357,7444,7913
202102,41113,경기도,수원시 권선구,65-69세,15560,7557,8003
202103,41113,경기도,수원시 권선구,65-69세,15720,7649,8071
202104,41113,경기도,수원시 권선구,65-69세,15841,7685,8156
202105,41113,경기도,수원시 권선구,65-69세,15949,7734,8215
202106,41113,경기도,수원시 권선구,65-69세,16034,7771,8263
202007,41113,경기도,수원시 권선구,70-74세,9981,4707,5274
202008,41113,경기도,수원시 권선구,70-74세,9974,4717,5257
202009,41113,경기도,수원시 권선구,70-74세,10005,4728,5277
202010,41113,경기도,수원시 권선구,70-74세,10088,4762,5326
202011,41113,경기도,수원시 권선구,70-74세,10173,4801,5372
202012,41113,경기도,수원시 권선구,70-74세,10223,4817,5406
202101,41113,경기도,수원시 권선구,70-74세,10275,4854,5421
202102,41113,경기도,수원시 권선구,70-74세,10275,4859,5416
202103,41113,경기도,수원시 권선구,70-74세,10245,4852,5393
202104,41113,경기도,수원시 권선구,70-74세,10265,4849,5416
202105,41113,경기도,수원시 권선구,70-74세,10252,4840,5412
202106,41113,경기도,수원시 권선구,70-74세,10266,4843,5423
202007,41113,경기도,수원시 권선구,75-79세,7314,3174,4140
202008,41113,경기도,수원시 권선구,75-79세,7343,3188,4155
202009,41113,경기도,수원시 권선구,75-79세,7320,3180,4140
202010,41113,경기도,수원시 권선구,75-79세,7295,3175,4120
202011,41113,경기도,수원시 권선구,75-79세,7280,3176,4104
202012,41113,경기도,수원시 권선구,75-79세,7253,3169,4084
202101,41113,경기도,수원시 권선구,75-79세,7257,3166,4091
202102,41113,경기도,수원시 권선구,75-79세,7234,3153,4081
202103,41113,경기도,수원시 권선구,75-79세,7188,3134,4054
202104,41113,경기도,수원시 권선구,75-79세,7170,3141,4029
202105,41113,경기도,수원시 권선구,75-79세,7163,3150,4013
202106,41113,경기도,수원시 권선구,75-79세,7140,3150,3990
202007,41113,경기도,수원시 권선구,80-84세,4901,1784,3117
202008,41113,경기도,수원시 권선구,80-84세,4917,1794,3123
202009,41113,경기도,수원시 권선구,80-84세,4895,1798,3097
202010,41113,경기도,수원시 권선구,80-84세,4933,1810,3123
202011,41113,경기도,수원시 권선구,80-84세,4949,1819,3130
202012,41113,경기도,수원시 권선구,80-84세,4953,1833,3120
202101,41113,경기도,수원시 권선구,80-84세,5007,1861,3146
202102,41113,경기도,수원시 권선구,80-84세,5038,1867,3171
202103,41113,경기도,수원시 권선구,80-84세,5041,1864,3177
202104,41113,경기도,수원시 권선구,80-84세,5041,1860,3181
202105,41113,경기도,수원시 권선구,80-84세,5067,1867,3200
202106,41113,경기도,수원시 권선구,80-84세,5122,1871,3251
202007,41113,경기도,수원시 권선구,85-89세,2451,733,1718
202008,41113,경기도,수원시 권선구,85-89세,2468,747,1721
202009,41113,경기도,수원시 권선구,85-89세,2491,749,1742
202010,41113,경기도,수원시 권선구,85-89세,2500,748,1752
202011,41113,경기도,수원시 권선구,85-89세,2519,753,1766
202012,41113,경기도,수원시 권선구,85-89세,2549,755,1794
202101,41113,경기도,수원시 권선구,85-89세,2558,764,1794
202102,41113,경기도,수원시 권선구,85-89세,2599,782,1817
202103,41113,경기도,수원시 권선구,85-89세,2609,778,1831
202104,41113,경기도,수원시 권선구,85-89세,2619,788,1831
202105,41113,경기도,수원시 권선구,85-89세,2631,800,1831
202106,41113,경기도,수원시 권선구,85-89세,2632,808,1824
202007,41113,경기도,수원시 권선구,90-94세,924,208,716
202008,41113,경기도,수원시 권선구,90-94세,921,209,712
202009,41113,경기도,수원시 권선구,90-94세,935,217,718
202010,41113,경기도,수원시 권선구,90-94세,930,216,714
202011,41113,경기도,수원시 권선구,90-94세,924,213,711
202012,41113,경기도,수원시 권선구,90-94세,935,216,719
202101,41113,경기도,수원시 권선구,90-94세,938,208,730
202102,41113,경기도,수원시 권선구,90-94세,946,212,734
202103,41113,경기도,수원시 권선구,90-94세,919,206,713
202104,41113,경기도,수원시 권선구,90-94세,926,206,720
202105,41113,경기도,수원시 권선구,90-94세,925,203,722
202106,41113,경기도,수원시 권선구,90-94세,931,205,726
202007,41113,경기도,수원시 권선구,95-99세,206,41,165
202008,41113,경기도,수원시 권선구,95-99세,217,44,173
202009,41113,경기도,수원시 권선구,95-99세,222,44,178
202010,41113,경기도,수원시 권선구,95-99세,223,45,178
202011,41113,경기도,수원시 권선구,95-99세,231,45,186
202012,41113,경기도,수원시 권선구,95-99세,228,42,186
202101,41113,경기도,수원시 권선구,95-99세,234,47,187
202102,41113,경기도,수원시 권선구,95-99세,237,46,191
202103,41113,경기도,수원시 권선구,95-99세,227,45,182
202104,41113,경기도,수원시 권선구,95-99세,228,46,182
202105,41113,경기도,수원시 권선구,95-99세,228,46,182
202106,41113,경기도,수원시 권선구,95-99세,227,46,181
202007,41113,경기도,수원시 권선구,100+,92,26,66
202008,41113,경기도,수원시 권선구,100+,90,26,64
202009,41113,경기도,수원시 권선구,100+,91,27,64
202010,41113,경기도,수원시 권선구,100+,94,27,67
202011,41113,경기도,수원시 권선구,100+,95,27,68
202012,41113,경기도,수원시 권선구,100+,95,28,67
202101,41113,경기도,수원시 권선구,100+,96,28,68
202102,41113,경기도,수원시 권선구,100+,97,29,68
202103,41113,경기도,수원시 권선구,100+,51,13,38
202104,41113,경기도,수원시 권선구,100+,52,13,39
202105,41113,경기도,수원시 권선구,100+,52,13,39
202106,41113,경기도,수원시 권선구,100+,56,13,43
202007,41115,경기도,수원시 팔달구,0-4세,4324,2159,2165
202008,41115,경기도,수원시 팔달구,0-4세,4257,2140,2117
202009,41115,경기도,수원시 팔달구,0-4세,4223,2125,2098
202010,41115,경기도,수원시 팔달구,0-4세,4176,2101,2075
202011,41115,경기도,수원시 팔달구,0-4세,4115,2062,2053
202012,41115,경기도,수원시 팔달구,0-4세,4119,2051,2068
202101,41115,경기도,수원시 팔달구,0-4세,4095,2056,2039
202102,41115,경기도,수원시 팔달구,0-4세,4240,2142,2098
202103,41115,경기도,수원시 팔달구,0-4세,4614,2338,2276
202104,41115,경기도,수원시 팔달구,0-4세,4703,2383,2320
202105,41115,경기도,수원시 팔달구,0-4세,4678,2372,2306
202106,41115,경기도,수원시 팔달구,0-4세,4677,2363,2314
202007,41115,경기도,수원시 팔달구,5-9세,5526,2844,2682
202008,41115,경기도,수원시 팔달구,5-9세,5505,2827,2678
202009,41115,경기도,수원시 팔달구,5-9세,5472,2800,2672
202010,41115,경기도,수원시 팔달구,5-9세,5424,2787,2637
202011,41115,경기도,수원시 팔달구,5-9세,5382,2767,2615
202012,41115,경기도,수원시 팔달구,5-9세,5364,2756,2608
202101,41115,경기도,수원시 팔달구,5-9세,5285,2705,2580
202102,41115,경기도,수원시 팔달구,5-9세,5427,2789,2638
202103,41115,경기도,수원시 팔달구,5-9세,5633,2888,2745
202104,41115,경기도,수원시 팔달구,5-9세,5658,2878,2780
202105,41115,경기도,수원시 팔달구,5-9세,5674,2880,2794
202106,41115,경기도,수원시 팔달구,5-9세,5696,2889,2807
202007,41115,경기도,수원시 팔달구,10-14세,6204,3216,2988
202008,41115,경기도,수원시 팔달구,10-14세,6185,3219,2966
202009,41115,경기도,수원시 팔달구,10-14세,6170,3210,2960
202010,41115,경기도,수원시 팔달구,10-14세,6169,3211,2958
202011,41115,경기도,수원시 팔달구,10-14세,6173,3210,2963
202012,41115,경기도,수원시 팔달구,10-14세,6155,3195,2960
202101,41115,경기도,수원시 팔달구,10-14세,6161,3198,2963
202102,41115,경기도,수원시 팔달구,10-14세,6290,3268,3022
202103,41115,경기도,수원시 팔달구,10-14세,6347,3287,3060
202104,41115,경기도,수원시 팔달구,10-14세,6374,3315,3059
202105,41115,경기도,수원시 팔달구,10-14세,6386,3332,3054
202106,41115,경기도,수원시 팔달구,10-14세,6400,3341,3059
202007,41115,경기도,수원시 팔달구,15-19세,8037,4077,3960
202008,41115,경기도,수원시 팔달구,15-19세,7947,4021,3926
202009,41115,경기도,수원시 팔달구,15-19세,7878,3983,3895
202010,41115,경기도,수원시 팔달구,15-19세,7805,3931,3874
202011,41115,경기도,수원시 팔달구,15-19세,7752,3911,3841
202012,41115,경기도,수원시 팔달구,15-19세,7685,3895,3790
202101,41115,경기도,수원시 팔달구,15-19세,7616,3853,3763
202102,41115,경기도,수원시 팔달구,15-19세,7669,3895,3774
202103,41115,경기도,수원시 팔달구,15-19세,7797,3943,3854
202104,41115,경기도,수원시 팔달구,15-19세,7829,3935,3894
202105,41115,경기도,수원시 팔달구,15-19세,7747,3886,3861
202106,41115,경기도,수원시 팔달구,15-19세,7715,3871,3844
202007,41115,경기도,수원시 팔달구,20-24세,12632,6326,6306
202008,41115,경기도,수원시 팔달구,20-24세,12616,6307,6309
202009,41115,경기도,수원시 팔달구,20-24세,12544,6302,6242
202010,41115,경기도,수원시 팔달구,20-24세,12511,6264,6247
202011,41115,경기도,수원시 팔달구,20-24세,12516,6250,6266
202012,41115,경기도,수원시 팔달구,20-24세,12530,6244,6286
202101,41115,경기도,수원시 팔달구,20-24세,12522,6226,6296
202102,41115,경기도,수원시 팔달구,20-24세,12680,6281,6399
202103,41115,경기도,수원시 팔달구,20-24세,12884,6393,6491
202104,41115,경기도,수원시 팔달구,20-24세,12921,6403,6518
202105,41115,경기도,수원시 팔달구,20-24세,12961,6413,6548
202106,41115,경기도,수원시 팔달구,20-24세,12925,6379,6546
202007,41115,경기도,수원시 팔달구,25-29세,16057,8612,7445
202008,41115,경기도,수원시 팔달구,25-29세,16142,8652,7490
202009,41115,경기도,수원시 팔달구,25-29세,16210,8669,7541
202010,41115,경기도,수원시 팔달구,25-29세,16209,8688,7521
202011,41115,경기도,수원시 팔달구,25-29세,16321,8770,7551
202012,41115,경기도,수원시 팔달구,25-29세,16450,8846,7604
202101,41115,경기도,수원시 팔달구,25-29세,16530,8871,7659
202102,41115,경기도,수원시 팔달구,25-29세,16719,8961,7758
202103,41115,경기도,수원시 팔달구,25-29세,17067,9116,7951
202104,41115,경기도,수원시 팔달구,25-29세,17297,9211,8086
202105,41115,경기도,수원시 팔달구,25-29세,17433,9269,8164
202106,41115,경기도,수원시 팔달구,25-29세,17540,9326,8214
202007,41115,경기도,수원시 팔달구,30-34세,12451,6841,5610
202008,41115,경기도,수원시 팔달구,30-34세,12444,6830,5614
202009,41115,경기도,수원시 팔달구,30-34세,12454,6837,5617
202010,41115,경기도,수원시 팔달구,30-34세,12474,6852,5622
202011,41115,경기도,수원시 팔달구,30-34세,12516,6900,5616
202012,41115,경기도,수원시 팔달구,30-34세,12589,6943,5646
202101,41115,경기도,수원시 팔달구,30-34세,12684,7017,5667
202102,41115,경기도,수원시 팔달구,30-34세,12917,7147,5770
202103,41115,경기도,수원시 팔달구,30-34세,13421,7385,6036
202104,41115,경기도,수원시 팔달구,30-34세,13691,7536,6155
202105,41115,경기도,수원시 팔달구,30-34세,13786,7558,6228
202106,41115,경기도,수원시 팔달구,30-34세,13895,7588,6307
202007,41115,경기도,수원시 팔달구,35-39세,12346,6554,5792
202008,41115,경기도,수원시 팔달구,35-39세,12267,6527,5740
202009,41115,경기도,수원시 팔달구,35-39세,12205,6474,5731
202010,41115,경기도,수원시 팔달구,35-39세,12182,6452,5730
202011,41115,경기도,수원시 팔달구,35-39세,12129,6429,5700
202012,41115,경기도,수원시 팔달구,35-39세,12110,6434,5676
202101,41115,경기도,수원시 팔달구,35-39세,12074,6434,5640
202102,41115,경기도,수원시 팔달구,35-39세,12294,6548,5746
202103,41115,경기도,수원시 팔달구,35-39세,12797,6842,5955
202104,41115,경기도,수원시 팔달구,35-39세,12900,6901,5999
202105,41115,경기도,수원시 팔달구,35-39세,12929,6939,5990
202106,41115,경기도,수원시 팔달구,35-39세,12878,6945,5933
202007,41115,경기도,수원시 팔달구,40-44세,12626,6518,6108
202008,41115,경기도,수원시 팔달구,40-44세,12596,6513,6083
202009,41115,경기도,수원시 팔달구,40-44세,12557,6488,6069
202010,41115,경기도,수원시 팔달구,40-44세,12538,6498,6040
202011,41115,경기도,수원시 팔달구,40-44세,12480,6483,5997
202012,41115,경기도,수원시 팔달구,40-44세,12474,6490,5984
202101,41115,경기도,수원시 팔달구,40-44세,12458,6497,5961
202102,41115,경기도,수원시 팔달구,40-44세,12723,6649,6074
202103,41115,경기도,수원시 팔달구,40-44세,12997,6805,6192
202104,41115,경기도,수원시 팔달구,40-44세,13124,6883,6241
202105,41115,경기도,수원시 팔달구,40-44세,13158,6881,6277
202106,41115,경기도,수원시 팔달구,40-44세,13238,6932,6306
202007,41115,경기도,수원시 팔달구,45-49세,15067,7763,7304
202008,41115,경기도,수원시 팔달구,45-49세,14973,7724,7249
202009,41115,경기도,수원시 팔달구,45-49세,14901,7668,7233
202010,41115,경기도,수원시 팔달구,45-49세,14838,7632,7206
202011,41115,경기도,수원시 팔달구,45-49세,14845,7648,7197
202012,41115,경기도,수원시 팔달구,45-49세,14851,7654,7197
202101,41115,경기도,수원시 팔달구,45-49세,14803,7635,7168
202102,41115,경기도,수원시 팔달구,45-49세,14913,7694,7219
202103,41115,경기도,수원시 팔달구,45-49세,14980,7694,7286
202104,41115,경기도,수원시 팔달구,45-49세,15012,7698,7314
202105,41115,경기도,수원시 팔달구,45-49세,14930,7673,7257
202106,41115,경기도,수원시 팔달구,45-49세,14853,7627,7226
202007,41115,경기도,수원시 팔달구,50-54세,15486,7914,7572
202008,41115,경기도,수원시 팔달구,50-54세,15541,7923,7618
202009,41115,경기도,수원시 팔달구,50-54세,15577,7933,7644
202010,41115,경기도,수원시 팔달구,50-54세,15566,7911,7655
202011,41115,경기도,수원시 팔달구,50-54세,15577,7907,7670
202012,41115,경기도,수원시 팔달구,50-54세,15554,7891,7663
202101,41115,경기도,수원시 팔달구,50-54세,15633,7927,7706
202102,41115,경기도,수원시 팔달구,50-54세,15759,7997,7762
202103,41115,경기도,수원시 팔달구,50-54세,15948,8102,7846
202104,41115,경기도,수원시 팔달구,50-54세,16098,8155,7943
202105,41115,경기도,수원시 팔달구,50-54세,16196,8209,7987
202106,41115,경기도,수원시 팔달구,50-54세,16232,8215,8017
202007,41115,경기도,수원시 팔달구,55-59세,15234,7746,7488
202008,41115,경기도,수원시 팔달구,55-59세,15157,7694,7463
202009,41115,경기도,수원시 팔달구,55-59세,15104,7672,7432
202010,41115,경기도,수원시 팔달구,55-59세,15061,7668,7393
202011,41115,경기도,수원시 팔달구,55-59세,15004,7635,7369
202012,41115,경기도,수원시 팔달구,55-59세,14991,7604,7387
202101,41115,경기도,수원시 팔달구,55-59세,14892,7548,7344
202102,41115,경기도,수원시 팔달구,55-59세,14911,7555,7356
202103,41115,경기도,수원시 팔달구,55-59세,15055,7642,7413
202104,41115,경기도,수원시 팔달구,55-59세,15107,7699,7408
202105,41115,경기도,수원시 팔달구,55-59세,15048,7661,7387
202106,41115,경기도,수원시 팔달구,55-59세,14971,7639,7332
202007,41115,경기도,수원시 팔달구,60-64세,12858,6364,6494
202008,41115,경기도,수원시 팔달구,60-64세,12934,6421,6513
202009,41115,경기도,수원시 팔달구,60-64세,13012,6475,6537
202010,41115,경기도,수원시 팔달구,60-64세,13069,6497,6572
202011,41115,경기도,수원시 팔달구,60-64세,13166,6555,6611
202012,41115,경기도,수원시 팔달구,60-64세,13221,6594,6627
202101,41115,경기도,수원시 팔달구,60-64세,13372,6684,6688
202102,41115,경기도,수원시 팔달구,60-64세,13563,6793,6770
202103,41115,경기도,수원시 팔달구,60-64세,13819,6949,6870
202104,41115,경기도,수원시 팔달구,60-64세,14022,7033,6989
202105,41115,경기도,수원시 팔달구,60-64세,14140,7103,7037
202106,41115,경기도,수원시 팔달구,60-64세,14249,7149,7100
202007,41115,경기도,수원시 팔달구,65-69세,8979,4230,4749
202008,41115,경기도,수원시 팔달구,65-69세,9027,4245,4782
202009,41115,경기도,수원시 팔달구,65-69세,9066,4259,4807
202010,41115,경기도,수원시 팔달구,65-69세,9113,4289,4824
202011,41115,경기도,수원시 팔달구,65-69세,9167,4318,4849
202012,41115,경기도,수원시 팔달구,65-69세,9229,4343,4886
202101,41115,경기도,수원시 팔달구,65-69세,9295,4379,4916
202102,41115,경기도,수원시 팔달구,65-69세,9376,4400,4976
202103,41115,경기도,수원시 팔달구,65-69세,9589,4495,5094
202104,41115,경기도,수원시 팔달구,65-69세,9699,4558,5141
202105,41115,경기도,수원시 팔달구,65-69세,9772,4596,5176
202106,41115,경기도,수원시 팔달구,65-69세,9840,4623,5217
202007,41115,경기도,수원시 팔달구,70-74세,6617,3009,3608
202008,41115,경기도,수원시 팔달구,70-74세,6613,3009,3604
202009,41115,경기도,수원시 팔달구,70-74세,6643,3023,3620
202010,41115,경기도,수원시 팔달구,70-74세,6680,3040,3640
202011,41115,경기도,수원시 팔달구,70-74세,6688,3045,3643
202012,41115,경기도,수원시 팔달구,70-74세,6706,3049,3657
202101,41115,경기도,수원시 팔달구,70-74세,6763,3059,3704
202102,41115,경기도,수원시 팔달구,70-74세,6821,3082,3739
202103,41115,경기도,수원시 팔달구,70-74세,6802,3102,3700
202104,41115,경기도,수원시 팔달구,70-74세,6872,3141,3731
202105,41115,경기도,수원시 팔달구,70-74세,6875,3142,3733
202106,41115,경기도,수원시 팔달구,70-74세,6859,3132,3727
202007,41115,경기도,수원시 팔달구,75-79세,5225,2246,2979
202008,41115,경기도,수원시 팔달구,75-79세,5251,2260,2991
202009,41115,경기도,수원시 팔달구,75-79세,5227,2242,2985
202010,41115,경기도,수원시 팔달구,75-79세,5208,2232,2976
202011,41115,경기도,수원시 팔달구,75-79세,5187,2219,2968
202012,41115,경기도,수원시 팔달구,75-79세,5195,2229,2966
202101,41115,경기도,수원시 팔달구,75-79세,5156,2222,2934
202102,41115,경기도,수원시 팔달구,75-79세,5162,2230,2932
202103,41115,경기도,수원시 팔달구,75-79세,5173,2240,2933
202104,41115,경기도,수원시 팔달구,75-79세,5192,2257,2935
202105,41115,경기도,수원시 팔달구,75-79세,5194,2260,2934
202106,41115,경기도,수원시 팔달구,75-79세,5194,2270,2924
202007,41115,경기도,수원시 팔달구,80-84세,3272,1224,2048
202008,41115,경기도,수원시 팔달구,80-84세,3278,1222,2056
202009,41115,경기도,수원시 팔달구,80-84세,3290,1243,2047
202010,41115,경기도,수원시 팔달구,80-84세,3307,1248,2059
202011,41115,경기도,수원시 팔달구,80-84세,3323,1257,2066
202012,41115,경기도,수원시 팔달구,80-84세,3323,1256,2067
202101,41115,경기도,수원시 팔달구,80-84세,3352,1269,2083
202102,41115,경기도,수원시 팔달구,80-84세,3400,1304,2096
202103,41115,경기도,수원시 팔달구,80-84세,3420,1302,2118
202104,41115,경기도,수원시 팔달구,80-84세,3456,1318,2138
202105,41115,경기도,수원시 팔달구,80-84세,3493,1332,2161
202106,41115,경기도,수원시 팔달구,80-84세,3524,1347,2177
202007,41115,경기도,수원시 팔달구,85-89세,1499,483,1016
202008,41115,경기도,수원시 팔달구,85-89세,1521,492,1029
202009,41115,경기도,수원시 팔달구,85-89세,1537,497,1040
202010,41115,경기도,수원시 팔달구,85-89세,1537,491,1046
202011,41115,경기도,수원시 팔달구,85-89세,1546,497,1049
202012,41115,경기도,수원시 팔달구,85-89세,1570,504,1066
202101,41115,경기도,수원시 팔달구,85-89세,1590,517,1073
202102,41115,경기도,수원시 팔달구,85-89세,1613,519,1094
202103,41115,경기도,수원시 팔달구,85-89세,1642,533,1109
202104,41115,경기도,수원시 팔달구,85-89세,1671,538,1133
202105,41115,경기도,수원시 팔달구,85-89세,1696,544,1152
202106,41115,경기도,수원시 팔달구,85-89세,1691,540,1151
202007,41115,경기도,수원시 팔달구,90-94세,554,129,425
202008,41115,경기도,수원시 팔달구,90-94세,553,129,424
202009,41115,경기도,수원시 팔달구,90-94세,545,125,420
202010,41115,경기도,수원시 팔달구,90-94세,551,131,420
202011,41115,경기도,수원시 팔달구,90-94세,560,137,423
202012,41115,경기도,수원시 팔달구,90-94세,551,135,416
202101,41115,경기도,수원시 팔달구,90-94세,555,136,419
202102,41115,경기도,수원시 팔달구,90-94세,563,137,426
202103,41115,경기도,수원시 팔달구,90-94세,573,142,431
202104,41115,경기도,수원시 팔달구,90-94세,567,142,425
202105,41115,경기도,수원시 팔달구,90-94세,564,139,425
202106,41115,경기도,수원시 팔달구,90-94세,563,139,424
202007,41115,경기도,수원시 팔달구,95-99세,164,46,118
202008,41115,경기도,수원시 팔달구,95-99세,166,46,120
202009,41115,경기도,수원시 팔달구,95-99세,173,45,128
202010,41115,경기도,수원시 팔달구,95-99세,171,43,128
202011,41115,경기도,수원시 팔달구,95-99세,168,41,127
202012,41115,경기도,수원시 팔달구,95-99세,169,41,128
202101,41115,경기도,수원시 팔달구,95-99세,163,41,122
202102,41115,경기도,수원시 팔달구,95-99세,166,43,123
202103,41115,경기도,수원시 팔달구,95-99세,140,30,110
202104,41115,경기도,수원시 팔달구,95-99세,139,28,111
202105,41115,경기도,수원시 팔달구,95-99세,138,28,110
202106,41115,경기도,수원시 팔달구,95-99세,136,28,108
202007,41115,경기도,수원시 팔달구,100+,89,23,66
202008,41115,경기도,수원시 팔달구,100+,90,24,66
202009,41115,경기도,수원시 팔달구,100+,91,24,67
202010,41115,경기도,수원시 팔달구,100+,94,25,69
202011,41115,경기도,수원시 팔달구,100+,94,26,68
202012,41115,경기도,수원시 팔달구,100+,94,26,68
202101,41115,경기도,수원시 팔달구,100+,99,26,73
202102,41115,경기도,수원시 팔달구,100+,101,27,74
202103,41115,경기도,수원시 팔달구,100+,45,12,33
202104,41115,경기도,수원시 팔달구,100+,45,12,33
202105,41115,경기도,수원시 팔달구,100+,46,11,35
202106,41115,경기도,수원시 팔달구,100+,47,11,36
202007,41117,경기도,수원시 영통구,0-4세,16362,8508,7854
202008,41117,경기도,수원시 영통구,0-4세,16151,8396,7755
202009,41117,경기도,수원시 영통구,0-4세,15987,8310,7677
202010,41117,경기도,수원시 영통구,0-4세,15813,8215,7598
202011,41117,경기도,수원시 영통구,0-4세,15698,8150,7548
202012,41117,경기도,수원시 영통구,0-4세,15529,8079,7450
202101,41117,경기도,수원시 영통구,0-4세,15362,8001,7361
202102,41117,경기도,수원시 영통구,0-4세,15124,7887,7237
202103,41117,경기도,수원시 영통구,0-4세,14883,7758,7125
202104,41117,경기도,수원시 영통구,0-4세,14757,7699,7058
202105,41117,경기도,수원시 영통구,0-4세,14591,7579,7012
202106,41117,경기도,수원시 영통구,0-4세,14443,7505,6938
202007,41117,경기도,수원시 영통구,5-9세,21609,11178,10431
202008,41117,경기도,수원시 영통구,5-9세,21577,11159,10418
202009,41117,경기도,수원시 영통구,5-9세,21497,11113,10384
202010,41117,경기도,수원시 영통구,5-9세,21385,11041,10344
202011,41117,경기도,수원시 영통구,5-9세,21295,10984,10311
202012,41117,경기도,수원시 영통구,5-9세,21249,10976,10273
202101,41117,경기도,수원시 영통구,5-9세,21154,10941,10213
202102,41117,경기도,수원시 영통구,5-9세,20972,10828,10144
202103,41117,경기도,수원시 영통구,5-9세,20798,10749,10049
202104,41117,경기도,수원시 영통구,5-9세,20686,10703,9983
202105,41117,경기도,수원시 영통구,5-9세,20627,10695,9932
202106,41117,경기도,수원시 영통구,5-9세,20562,10653,9909
202007,41117,경기도,수원시 영통구,10-14세,21209,10948,10261
202008,41117,경기도,수원시 영통구,10-14세,21211,10977,10234
202009,41117,경기도,수원시 영통구,10-14세,21228,10988,10240
202010,41117,경기도,수원시 영통구,10-14세,21285,11027,10258
202011,41117,경기도,수원시 영통구,10-14세,21310,11051,10259
202012,41117,경기도,수원시 영통구,10-14세,21365,11041,10324
202101,41117,경기도,수원시 영통구,10-14세,21413,11055,10358
202102,41117,경기도,수원시 영통구,10-14세,21374,11055,10319
202103,41117,경기도,수원시 영통구,10-14세,21368,11034,10334
202104,41117,경기도,수원시 영통구,10-14세,21359,11038,10321
202105,41117,경기도,수원시 영통구,10-14세,21314,11013,10301
202106,41117,경기도,수원시 영통구,10-14세,21357,11028,10329
202007,41117,경기도,수원시 영통구,15-19세,21647,11080,10567
202008,41117,경기도,수원시 영통구,15-19세,21535,10973,10562
202009,41117,경기도,수원시 영통구,15-19세,21406,10914,10492
202010,41117,경기도,수원시 영통구,15-19세,21252,10827,10425
202011,41117,경기도,수원시 영통구,15-19세,21136,10776,10360
202012,41117,경기도,수원시 영통구,15-19세,20994,10760,10234
202101,41117,경기도,수원시 영통구,15-19세,20858,10667,10191
202102,41117,경기도,수원시 영통구,15-19세,20781,10603,10178
202103,41117,경기도,수원시 영통구,15-19세,20653,10555,10098
202104,41117,경기도,수원시 영통구,15-19세,20535,10462,10073
202105,41117,경기도,수원시 영통구,15-19세,20477,10456,10021
202106,41117,경기도,수원시 영통구,15-19세,20377,10395,9982
202007,41117,경기도,수원시 영통구,20-24세,26603,13660,12943
202008,41117,경기도,수원시 영통구,20-24세,26607,13715,12892
202009,41117,경기도,수원시 영통구,20-24세,26562,13673,12889
202010,41117,경기도,수원시 영통구,20-24세,26560,13628,12932
202011,41117,경기도,수원시 영통구,20-24세,26535,13600,12935
202012,41117,경기도,수원시 영통구,20-24세,26467,13523,12944
202101,41117,경기도,수원시 영통구,20-24세,26461,13502,12959
202102,41117,경기도,수원시 영통구,20-24세,26532,13537,12995
202103,41117,경기도,수원시 영통구,20-24세,26468,13523,12945
202104,41117,경기도,수원시 영통구,20-24세,26386,13477,12909
202105,41117,경기도,수원시 영통구,20-24세,26324,13422,12902
202106,41117,경기도,수원시 영통구,20-24세,26227,13374,12853
202007,41117,경기도,수원시 영통구,25-29세,32687,17158,15529
202008,41117,경기도,수원시 영통구,25-29세,32616,17121,15495
202009,41117,경기도,수원시 영통구,25-29세,32563,17095,15468
202010,41117,경기도,수원시 영통구,25-29세,32551,17120,15431
202011,41117,경기도,수원시 영통구,25-29세,32643,17132,15511
202012,41117,경기도,수원시 영통구,25-29세,32656,17182,15474
202101,41117,경기도,수원시 영통구,25-29세,32589,17161,15428
202102,41117,경기도,수원시 영통구,25-29세,32335,17048,15287
202103,41117,경기도,수원시 영통구,25-29세,32375,17019,15356
202104,41117,경기도,수원시 영통구,25-29세,32309,17002,15307
202105,41117,경기도,수원시 영통구,25-29세,32257,16951,15306
202106,41117,경기도,수원시 영통구,25-29세,32189,16912,15277
202007,41117,경기도,수원시 영통구,30-34세,30423,15743,14680
202008,41117,경기도,수원시 영통구,30-34세,30399,15737,14662
202009,41117,경기도,수원시 영통구,30-34세,30441,15745,14696
202010,41117,경기도,수원시 영통구,30-34세,30263,15645,14618
202011,41117,경기도,수원시 영통구,30-34세,30205,15612,14593
202012,41117,경기도,수원시 영통구,30-34세,30161,15630,14531
202101,41117,경기도,수원시 영통구,30-34세,30098,15591,14507
202102,41117,경기도,수원시 영통구,30-34세,29987,15540,14447
202103,41117,경기도,수원시 영통구,30-34세,29872,15496,14376
202104,41117,경기도,수원시 영통구,30-34세,29911,15503,14408
202105,41117,경기도,수원시 영통구,30-34세,29967,15572,14395
202106,41117,경기도,수원시 영통구,30-34세,30020,15626,14394
202007,41117,경기도,수원시 영통구,35-39세,33708,16716,16992
202008,41117,경기도,수원시 영통구,35-39세,33540,16631,16909
202009,41117,경기도,수원시 영통구,35-39세,33286,16503,16783
202010,41117,경기도,수원시 영통구,35-39세,33191,16478,16713
202011,41117,경기도,수원시 영통구,35-39세,32984,16368,16616
202012,41117,경기도,수원시 영통구,35-39세,32897,16298,16599
202101,41117,경기도,수원시 영통구,35-39세,32733,16232,16501
202102,41117,경기도,수원시 영통구,35-39세,32503,16129,16374
202103,41117,경기도,수원시 영통구,35-39세,32098,15901,16197
202104,41117,경기도,수원시 영통구,35-39세,31860,15826,16034
202105,41117,경기도,수원시 영통구,35-39세,31685,15766,15919
202106,41117,경기도,수원시 영통구,35-39세,31570,15713,15857
202007,41117,경기도,수원시 영통구,40-44세,33958,16745,17213
202008,41117,경기도,수원시 영통구,40-44세,34032,16786,17246
202009,41117,경기도,수원시 영통구,40-44세,34090,16795,17295
202010,41117,경기도,수원시 영통구,40-44세,34217,16828,17389
202011,41117,경기도,수원시 영통구,40-44세,34222,16820,17402
202012,41117,경기도,수원시 영통구,40-44세,34165,16858,17307
202101,41117,경기도,수원시 영통구,40-44세,34153,16828,17325
202102,41117,경기도,수원시 영통구,40-44세,34104,16841,17263
202103,41117,경기도,수원시 영통구,40-44세,33932,16742,17190
202104,41117,경기도,수원시 영통구,40-44세,33875,16684,17191
202105,41117,경기도,수원시 영통구,40-44세,33915,16682,17233
202106,41117,경기도,수원시 영통구,40-44세,33985,16693,17292
202007,41117,경기도,수원시 영통구,45-49세,34791,17148,17643
202008,41117,경기도,수원시 영통구,45-49세,34667,17089,17578
202009,41117,경기도,수원시 영통구,45-49세,34546,17030,17516
202010,41117,경기도,수원시 영통구,45-49세,34394,16924,17470
202011,41117,경기도,수원시 영통구,45-49세,34405,16955,17450
202012,41117,경기도,수원시 영통구,45-49세,34349,16893,17456
202101,41117,경기도,수원시 영통구,45-49세,34256,16840,17416
202102,41117,경기도,수원시 영통구,45-49세,34140,16763,17377
202103,41117,경기도,수원시 영통구,45-49세,33973,16693,17280
202104,41117,경기도,수원시 영통구,45-49세,33972,16686,17286
202105,41117,경기도,수원시 영통구,45-49세,33788,16598,17190
202106,41117,경기도,수원시 영통구,45-49세,33590,16501,17089
202007,41117,경기도,수원시 영통구,50-54세,29861,14776,15085
202008,41117,경기도,수원시 영통구,50-54세,29912,14794,15118
202009,41117,경기도,수원시 영통구,50-54세,30034,14853,15181
202010,41117,경기도,수원시 영통구,50-54세,30229,14976,15253
202011,41117,경기도,수원시 영통구,50-54세,30272,14980,15292
202012,41117,경기도,수원시 영통구,50-54세,30238,14965,15273
202101,41117,경기도,수원시 영통구,50-54세,30466,15064,15402
202102,41117,경기도,수원시 영통구,50-54세,30659,15162,15497
202103,41117,경기도,수원시 영통구,50-54세,30576,15106,15470
202104,41117,경기도,수원시 영통구,50-54세,30656,15154,15502
202105,41117,경기도,수원시 영통구,50-54세,30791,15248,15543
202106,41117,경기도,수원시 영통구,50-54세,30942,15337,15605
202007,41117,경기도,수원시 영통구,55-59세,24105,12328,11777
202008,41117,경기도,수원시 영통구,55-59세,24115,12311,11804
202009,41117,경기도,수원시 영통구,55-59세,24079,12285,11794
202010,41117,경기도,수원시 영통구,55-59세,24121,12298,11823
202011,41117,경기도,수원시 영통구,55-59세,24225,12324,11901
202012,41117,경기도,수원시 영통구,55-59세,24356,12363,11993
202101,41117,경기도,수원시 영통구,55-59세,24247,12329,11918
202102,41117,경기도,수원시 영통구,55-59세,24258,12324,11934
202103,41117,경기도,수원시 영통구,55-59세,24271,12338,11933
202104,41117,경기도,수원시 영통구,55-59세,24184,12286,11898
202105,41117,경기도,수원시 영통구,55-59세,24132,12227,11905
202106,41117,경기도,수원시 영통구,55-59세,23962,12141,11821
202007,41117,경기도,수원시 영통구,60-64세,16711,8572,8139
202008,41117,경기도,수원시 영통구,60-64세,16871,8668,8203
202009,41117,경기도,수원시 영통구,60-64세,17027,8743,8284
202010,41117,경기도,수원시 영통구,60-64세,17117,8786,8331
202011,41117,경기도,수원시 영통구,60-64세,17282,8905,8377
202012,41117,경기도,수원시 영통구,60-64세,17381,8978,8403
202101,41117,경기도,수원시 영통구,60-64세,17638,9099,8539
202102,41117,경기도,수원시 영통구,60-64세,17820,9177,8643
202103,41117,경기도,수원시 영통구,60-64세,17967,9211,8756
202104,41117,경기도,수원시 영통구,60-64세,18097,9255,8842
202105,41117,경기도,수원시 영통구,60-64세,18281,9339,8942
202106,41117,경기도,수원시 영통구,60-64세,18455,9418,9037
202007,41117,경기도,수원시 영통구,65-69세,9278,4434,4844
202008,41117,경기도,수원시 영통구,65-69세,9372,4474,4898
202009,41117,경기도,수원시 영통구,65-69세,9496,4549,4947
202010,41117,경기도,수원시 영통구,65-69세,9589,4599,4990
202011,41117,경기도,수원시 영통구,65-69세,9667,4624,5043
202012,41117,경기도,수원시 영통구,65-69세,9750,4647,5103
202101,41117,경기도,수원시 영통구,65-69세,9860,4707,5153
202102,41117,경기도,수원시 영통구,65-69세,9982,4775,5207
202103,41117,경기도,수원시 영통구,65-69세,10114,4848,5266
202104,41117,경기도,수원시 영통구,65-69세,10172,4889,5283
202105,41117,경기도,수원시 영통구,65-69세,10266,4940,5326
202106,41117,경기도,수원시 영통구,65-69세,10330,4982,5348
202007,41117,경기도,수원시 영통구,70-74세,6424,2960,3464
202008,41117,경기도,수원시 영통구,70-74세,6449,2977,3472
202009,41117,경기도,수원시 영통구,70-74세,6470,2993,3477
202010,41117,경기도,수원시 영통구,70-74세,6497,3018,3479
202011,41117,경기도,수원시 영통구,70-74세,6563,3057,3506
202012,41117,경기도,수원시 영통구,70-74세,6592,3069,3523
202101,41117,경기도,수원시 영통구,70-74세,6614,3082,3532
202102,41117,경기도,수원시 영통구,70-74세,6639,3105,3534
202103,41117,경기도,수원시 영통구,70-74세,6632,3108,3524
202104,41117,경기도,수원시 영통구,70-74세,6625,3112,3513
202105,41117,경기도,수원시 영통구,70-74세,6624,3107,3517
202106,41117,경기도,수원시 영통구,70-74세,6624,3101,3523
202007,41117,경기도,수원시 영통구,75-79세,4829,1942,2887
202008,41117,경기도,수원시 영통구,75-79세,4836,1939,2897
202009,41117,경기도,수원시 영통구,75-79세,4835,1935,2900
202010,41117,경기도,수원시 영통구,75-79세,4835,1934,2901
202011,41117,경기도,수원시 영통구,75-79세,4828,1932,2896
202012,41117,경기도,수원시 영통구,75-79세,4803,1934,2869
202101,41117,경기도,수원시 영통구,75-79세,4814,1936,2878
202102,41117,경기도,수원시 영통구,75-79세,4801,1942,2859
202103,41117,경기도,수원시 영통구,75-79세,4768,1931,2837
202104,41117,경기도,수원시 영통구,75-79세,4771,1928,2843
202105,41117,경기도,수원시 영통구,75-79세,4787,1936,2851
202106,41117,경기도,수원시 영통구,75-79세,4763,1933,2830
202007,41117,경기도,수원시 영통구,80-84세,3210,1131,2079
202008,41117,경기도,수원시 영통구,80-84세,3222,1136,2086
202009,41117,경기도,수원시 영통구,80-84세,3225,1141,2084
202010,41117,경기도,수원시 영통구,80-84세,3249,1156,2093
202011,41117,경기도,수원시 영통구,80-84세,3251,1162,2089
202012,41117,경기도,수원시 영통구,80-84세,3253,1159,2094
202101,41117,경기도,수원시 영통구,80-84세,3263,1172,2091
202102,41117,경기도,수원시 영통구,80-84세,3308,1185,2123
202103,41117,경기도,수원시 영통구,80-84세,3340,1210,2130
202104,41117,경기도,수원시 영통구,80-84세,3345,1220,2125
202105,41117,경기도,수원시 영통구,80-84세,3349,1235,2114
202106,41117,경기도,수원시 영통구,80-84세,3392,1247,2145
202007,41117,경기도,수원시 영통구,85-89세,1730,492,1238
202008,41117,경기도,수원시 영통구,85-89세,1743,494,1249
202009,41117,경기도,수원시 영통구,85-89세,1759,496,1263
202010,41117,경기도,수원시 영통구,85-89세,1750,495,1255
202011,41117,경기도,수원시 영통구,85-89세,1763,503,1260
202012,41117,경기도,수원시 영통구,85-89세,1779,510,1269
202101,41117,경기도,수원시 영통구,85-89세,1781,512,1269
202102,41117,경기도,수원시 영통구,85-89세,1781,517,1264
202103,41117,경기도,수원시 영통구,85-89세,1799,515,1284
202104,41117,경기도,수원시 영통구,85-89세,1816,528,1288
202105,41117,경기도,수원시 영통구,85-89세,1817,530,1287
202106,41117,경기도,수원시 영통구,85-89세,1829,530,1299
202007,41117,경기도,수원시 영통구,90-94세,643,135,508
202008,41117,경기도,수원시 영통구,90-94세,646,138,508
202009,41117,경기도,수원시 영통구,90-94세,662,138,524
202010,41117,경기도,수원시 영통구,90-94세,673,142,531
202011,41117,경기도,수원시 영통구,90-94세,671,137,534
202012,41117,경기도,수원시 영통구,90-94세,662,138,524
202101,41117,경기도,수원시 영통구,90-94세,675,140,535
202102,41117,경기도,수원시 영통구,90-94세,684,140,544
202103,41117,경기도,수원시 영통구,90-94세,686,138,548
202104,41117,경기도,수원시 영통구,90-94세,686,138,548
202105,41117,경기도,수원시 영통구,90-94세,691,138,553
202106,41117,경기도,수원시 영통구,90-94세,691,136,555
202007,41117,경기도,수원시 영통구,95-99세,143,27,116
202008,41117,경기도,수원시 영통구,95-99세,150,26,124
202009,41117,경기도,수원시 영통구,95-99세,149,26,123
202010,41117,경기도,수원시 영통구,95-99세,151,26,125
202011,41117,경기도,수원시 영통구,95-99세,153,26,127
202012,41117,경기도,수원시 영통구,95-99세,158,27,131
202101,41117,경기도,수원시 영통구,95-99세,159,26,133
202102,41117,경기도,수원시 영통구,95-99세,160,28,132
202103,41117,경기도,수원시 영통구,95-99세,158,26,132
202104,41117,경기도,수원시 영통구,95-99세,164,28,136
202105,41117,경기도,수원시 영통구,95-99세,164,26,138
202106,41117,경기도,수원시 영통구,95-99세,158,25,133
202007,41117,경기도,수원시 영통구,100+,39,9,30
202008,41117,경기도,수원시 영통구,100+,39,9,30
202009,41117,경기도,수원시 영통구,100+,39,9,30
202010,41117,경기도,수원시 영통구,100+,39,9,30
202011,41117,경기도,수원시 영통구,100+,38,9,29
202012,41117,경기도,수원시 영통구,100+,38,9,29
202101,41117,경기도,수원시 영통구,100+,39,9,30
202102,41117,경기도,수원시 영통구,100+,42,9,33
202103,41117,경기도,수원시 영통구,100+,39,8,31
202104,41117,경기도,수원시 영통구,100+,41,8,33
202105,41117,경기도,수원시 영통구,100+,40,7,33
202106,41117,경기도,수원시 영통구,100+,40,7,33
202007,41131,경기도,성남시 수정구,0-4세,7109,3602,3507
202008,41131,경기도,성남시 수정구,0-4세,7373,3730,3643
202009,41131,경기도,성남시 수정구,0-4세,7483,3791,3692
202010,41131,경기도,성남시 수정구,0-4세,7474,3772,3702
202011,41131,경기도,성남시 수정구,0-4세,7390,3741,3649
202012,41131,경기도,성남시 수정구,0-4세,7363,3719,3644
202101,41131,경기도,성남시 수정구,0-4세,7281,3672,3609
202102,41131,경기도,성남시 수정구,0-4세,7210,3650,3560
202103,41131,경기도,성남시 수정구,0-4세,7116,3601,3515
202104,41131,경기도,성남시 수정구,0-4세,7075,3590,3485
202105,41131,경기도,성남시 수정구,0-4세,7064,3591,3473
202106,41131,경기도,성남시 수정구,0-4세,7004,3556,3448
202007,41131,경기도,성남시 수정구,5-9세,8360,4244,4116
202008,41131,경기도,성남시 수정구,5-9세,8514,4327,4187
202009,41131,경기도,성남시 수정구,5-9세,8594,4341,4253
202010,41131,경기도,성남시 수정구,5-9세,8602,4336,4266
202011,41131,경기도,성남시 수정구,5-9세,8523,4296,4227
202012,41131,경기도,성남시 수정구,5-9세,8506,4286,4220
202101,41131,경기도,성남시 수정구,5-9세,8442,4257,4185
202102,41131,경기도,성남시 수정구,5-9세,8358,4226,4132
202103,41131,경기도,성남시 수정구,5-9세,8311,4205,4106
202104,41131,경기도,성남시 수정구,5-9세,8283,4184,4099
202105,41131,경기도,성남시 수정구,5-9세,8246,4160,4086
202106,41131,경기도,성남시 수정구,5-9세,8207,4150,4057
202007,41131,경기도,성남시 수정구,10-14세,8009,4094,3915
202008,41131,경기도,성남시 수정구,10-14세,8106,4135,3971
202009,41131,경기도,성남시 수정구,10-14세,8182,4169,4013
202010,41131,경기도,성남시 수정구,10-14세,8222,4180,4042
202011,41131,경기도,성남시 수정구,10-14세,8244,4204,4040
202012,41131,경기도,성남시 수정구,10-14세,8245,4201,4044
202101,41131,경기도,성남시 수정구,10-14세,8241,4190,4051
202102,41131,경기도,성남시 수정구,10-14세,8215,4170,4045
202103,41131,경기도,성남시 수정구,10-14세,8193,4164,4029
202104,41131,경기도,성남시 수정구,10-14세,8190,4161,4029
202105,41131,경기도,성남시 수정구,10-14세,8212,4179,4033
202106,41131,경기도,성남시 수정구,10-14세,8207,4157,4050
202007,41131,경기도,성남시 수정구,15-19세,9473,4907,4566
202008,41131,경기도,성남시 수정구,15-19세,9549,4911,4638
202009,41131,경기도,성남시 수정구,15-19세,9550,4899,4651
202010,41131,경기도,성남시 수정구,15-19세,9508,4873,4635
202011,41131,경기도,성남시 수정구,15-19세,9444,4825,4619
202012,41131,경기도,성남시 수정구,15-19세,9320,4785,4535
202101,41131,경기도,성남시 수정구,15-19세,9265,4769,4496
202102,41131,경기도,성남시 수정구,15-19세,9187,4733,4454
202103,41131,경기도,성남시 수정구,15-19세,9092,4685,4407
202104,41131,경기도,성남시 수정구,15-19세,8990,4626,4364
202105,41131,경기도,성남시 수정구,15-19세,8922,4584,4338
202106,41131,경기도,성남시 수정구,15-19세,8879,4567,4312
202007,41131,경기도,성남시 수정구,20-24세,15292,7788,7504
202008,41131,경기도,성남시 수정구,20-24세,15551,7944,7607
202009,41131,경기도,성남시 수정구,20-24세,15712,8037,7675
202010,41131,경기도,성남시 수정구,20-24세,15673,8008,7665
202011,41131,경기도,성남시 수정구,20-24세,15608,7978,7630
202012,41131,경기도,성남시 수정구,20-24세,15593,7979,7614
202101,41131,경기도,성남시 수정구,20-24세,15509,7919,7590
202102,41131,경기도,성남시 수정구,20-24세,15468,7863,7605
202103,41131,경기도,성남시 수정구,20-24세,15398,7801,7597
202104,41131,경기도,성남시 수정구,20-24세,15289,7739,7550
202105,41131,경기도,성남시 수정구,20-24세,15215,7694,7521
202106,41131,경기도,성남시 수정구,20-24세,15119,7645,7474
202007,41131,경기도,성남시 수정구,25-29세,18841,10170,8671
202008,41131,경기도,성남시 수정구,25-29세,19197,10336,8861
202009,41131,경기도,성남시 수정구,25-29세,19507,10488,9019
202010,41131,경기도,성남시 수정구,25-29세,19557,10519,9038
202011,41131,경기도,성남시 수정구,25-29세,19632,10574,9058
202012,41131,경기도,성남시 수정구,25-29세,19642,10578,9064
202101,41131,경기도,성남시 수정구,25-29세,19655,10620,9035
202102,41131,경기도,성남시 수정구,25-29세,19631,10614,9017
202103,41131,경기도,성남시 수정구,25-29세,19577,10583,8994
202104,41131,경기도,성남시 수정구,25-29세,19553,10589,8964
202105,41131,경기도,성남시 수정구,25-29세,19452,10531,8921
202106,41131,경기도,성남시 수정구,25-29세,19409,10524,8885
202007,41131,경기도,성남시 수정구,30-34세,16430,8896,7534
202008,41131,경기도,성남시 수정구,30-34세,16860,9111,7749
202009,41131,경기도,성남시 수정구,30-34세,17105,9227,7878
202010,41131,경기도,성남시 수정구,30-34세,17152,9247,7905
202011,41131,경기도,성남시 수정구,30-34세,17130,9222,7908
202012,41131,경기도,성남시 수정구,30-34세,17092,9185,7907
202101,41131,경기도,성남시 수정구,30-34세,17200,9231,7969
202102,41131,경기도,성남시 수정구,30-34세,17205,9237,7968
202103,41131,경기도,성남시 수정구,30-34세,17144,9207,7937
202104,41131,경기도,성남시 수정구,30-34세,17222,9256,7966
202105,41131,경기도,성남시 수정구,30-34세,17224,9245,7979
202106,41131,경기도,성남시 수정구,30-34세,17212,9256,7956
202007,41131,경기도,성남시 수정구,35-39세,18306,9709,8597
202008,41131,경기도,성남시 수정구,35-39세,18749,9946,8803
202009,41131,경기도,성남시 수정구,35-39세,18954,10062,8892
202010,41131,경기도,성남시 수정구,35-39세,18993,10098,8895
202011,41131,경기도,성남시 수정구,35-39세,18920,10051,8869
202012,41131,경기도,성남시 수정구,35-39세,18879,10023,8856
202101,41131,경기도,성남시 수정구,35-39세,18707,9932,8775
202102,41131,경기도,성남시 수정구,35-39세,18595,9895,8700
202103,41131,경기도,성남시 수정구,35-39세,18319,9745,8574
202104,41131,경기도,성남시 수정구,35-39세,18169,9657,8512
202105,41131,경기도,성남시 수정구,35-39세,18086,9596,8490
202106,41131,경기도,성남시 수정구,35-39세,17946,9526,8420
202007,41131,경기도,성남시 수정구,40-44세,17371,9220,8151
202008,41131,경기도,성남시 수정구,40-44세,17699,9410,8289
202009,41131,경기도,성남시 수정구,40-44세,18017,9573,8444
202010,41131,경기도,성남시 수정구,40-44세,18103,9600,8503
202011,41131,경기도,성남시 수정구,40-44세,18124,9603,8521
202012,41131,경기도,성남시 수정구,40-44세,18140,9625,8515
202101,41131,경기도,성남시 수정구,40-44세,18176,9650,8526
202102,41131,경기도,성남시 수정구,40-44세,18184,9673,8511
202103,41131,경기도,성남시 수정구,40-44세,18001,9583,8418
202104,41131,경기도,성남시 수정구,40-44세,17925,9528,8397
202105,41131,경기도,성남시 수정구,40-44세,17925,9516,8409
202106,41131,경기도,성남시 수정구,40-44세,17910,9510,8400
202007,41131,경기도,성남시 수정구,45-49세,19501,10296,9205
202008,41131,경기도,성남시 수정구,45-49세,19702,10366,9336
202009,41131,경기도,성남시 수정구,45-49세,19748,10384,9364
202010,41131,경기도,성남시 수정구,45-49세,19702,10350,9352
202011,41131,경기도,성남시 수정구,45-49세,19612,10306,9306
202012,41131,경기도,성남시 수정구,45-49세,19511,10249,9262
202101,41131,경기도,성남시 수정구,45-49세,19429,10201,9228
202102,41131,경기도,성남시 수정구,45-49세,19297,10152,9145
202103,41131,경기도,성남시 수정구,45-49세,19098,10061,9037
202104,41131,경기도,성남시 수정구,45-49세,19033,10028,9005
202105,41131,경기도,성남시 수정구,45-49세,18841,9918,8923
202106,41131,경기도,성남시 수정구,45-49세,18654,9799,8855
202007,41131,경기도,성남시 수정구,50-54세,20094,10244,9850
202008,41131,경기도,성남시 수정구,50-54세,20384,10405,9979
202009,41131,경기도,성남시 수정구,50-54세,20641,10521,10120
202010,41131,경기도,성남시 수정구,50-54세,20687,10564,10123
202011,41131,경기도,성남시 수정구,50-54세,20649,10533,10116
202012,41131,경기도,성남시 수정구,50-54세,20557,10487,10070
202101,41131,경기도,성남시 수정구,50-54세,20608,10514,10094
202102,41131,경기도,성남시 수정구,50-54세,20634,10485,10149
202103,41131,경기도,성남시 수정구,50-54세,20366,10361,10005
202104,41131,경기도,성남시 수정구,50-54세,20292,10323,9969
202105,41131,경기도,성남시 수정구,50-54세,20327,10364,9963
202106,41131,경기도,성남시 수정구,50-54세,20347,10364,9983
202007,41131,경기도,성남시 수정구,55-59세,20358,10315,10043
202008,41131,경기도,성남시 수정구,55-59세,20580,10409,10171
202009,41131,경기도,성남시 수정구,55-59세,20780,10502,10278
202010,41131,경기도,성남시 수정구,55-59세,20779,10499,10280
202011,41131,경기도,성남시 수정구,55-59세,20721,10488,10233
202012,41131,경기도,성남시 수정구,55-59세,20690,10460,10230
202101,41131,경기도,성남시 수정구,55-59세,20576,10428,10148
202102,41131,경기도,성남시 수정구,55-59세,20458,10428,10030
202103,41131,경기도,성남시 수정구,55-59세,20270,10339,9931
202104,41131,경기도,성남시 수정구,55-59세,20175,10285,9890
202105,41131,경기도,성남시 수정구,55-59세,20007,10202,9805
202106,41131,경기도,성남시 수정구,55-59세,19780,10111,9669
202007,41131,경기도,성남시 수정구,60-64세,18846,9236,9610
202008,41131,경기도,성남시 수정구,60-64세,19222,9417,9805
202009,41131,경기도,성남시 수정구,60-64세,19483,9535,9948
202010,41131,경기도,성남시 수정구,60-64세,19656,9627,10029
202011,41131,경기도,성남시 수정구,60-64세,19746,9682,10064
202012,41131,경기도,성남시 수정구,60-64세,19723,9677,10046
202101,41131,경기도,성남시 수정구,60-64세,19890,9754,10136
202102,41131,경기도,성남시 수정구,60-64세,19962,9764,10198
202103,41131,경기도,성남시 수정구,60-64세,19853,9712,10141
202104,41131,경기도,성남시 수정구,60-64세,19896,9735,10161
202105,41131,경기도,성남시 수정구,60-64세,19973,9805,10168
202106,41131,경기도,성남시 수정구,60-64세,19997,9812,10185
202007,41131,경기도,성남시 수정구,65-69세,13039,6223,6816
202008,41131,경기도,성남시 수정구,65-69세,13304,6348,6956
202009,41131,경기도,성남시 수정구,65-69세,13534,6443,7091
202010,41131,경기도,성남시 수정구,65-69세,13702,6534,7168
202011,41131,경기도,성남시 수정구,65-69세,13736,6537,7199
202012,41131,경기도,성남시 수정구,65-69세,13759,6572,7187
202101,41131,경기도,성남시 수정구,65-69세,13821,6611,7210
202102,41131,경기도,성남시 수정구,65-69세,13950,6661,7289
202103,41131,경기도,성남시 수정구,65-69세,13908,6663,7245
202104,41131,경기도,성남시 수정구,65-69세,14007,6703,7304
202105,41131,경기도,성남시 수정구,65-69세,14076,6738,7338
202106,41131,경기도,성남시 수정구,65-69세,14079,6734,7345
202007,41131,경기도,성남시 수정구,70-74세,9605,4426,5179
202008,41131,경기도,성남시 수정구,70-74세,9745,4506,5239
202009,41131,경기도,성남시 수정구,70-74세,9913,4592,5321
202010,41131,경기도,성남시 수정구,70-74세,9983,4619,5364
202011,41131,경기도,성남시 수정구,70-74세,10029,4653,5376
202012,41131,경기도,성남시 수정구,70-74세,10047,4669,5378
202101,41131,경기도,성남시 수정구,70-74세,10084,4687,5397
202102,41131,경기도,성남시 수정구,70-74세,10138,4715,5423
202103,41131,경기도,성남시 수정구,70-74세,10004,4675,5329
202104,41131,경기도,성남시 수정구,70-74세,9964,4651,5313
202105,41131,경기도,성남시 수정구,70-74세,9922,4615,5307
202106,41131,경기도,성남시 수정구,70-74세,9879,4587,5292
202007,41131,경기도,성남시 수정구,75-79세,7130,3103,4027
202008,41131,경기도,성남시 수정구,75-79세,7172,3122,4050
202009,41131,경기도,성남시 수정구,75-79세,7192,3145,4047
202010,41131,경기도,성남시 수정구,75-79세,7204,3160,4044
202011,41131,경기도,성남시 수정구,75-79세,7172,3143,4029
202012,41131,경기도,성남시 수정구,75-79세,7122,3124,3998
202101,41131,경기도,성남시 수정구,75-79세,7129,3119,4010
202102,41131,경기도,성남시 수정구,75-79세,7110,3101,4009
202103,41131,경기도,성남시 수정구,75-79세,7028,3065,3963
202104,41131,경기도,성남시 수정구,75-79세,6971,3054,3917
202105,41131,경기도,성남시 수정구,75-79세,6933,3024,3909
202106,41131,경기도,성남시 수정구,75-79세,6926,3025,3901
202007,41131,경기도,성남시 수정구,80-84세,4207,1619,2588
202008,41131,경기도,성남시 수정구,80-84세,4264,1652,2612
202009,41131,경기도,성남시 수정구,80-84세,4305,1681,2624
202010,41131,경기도,성남시 수정구,80-84세,4338,1698,2640
202011,41131,경기도,성남시 수정구,80-84세,4349,1701,2648
202012,41131,경기도,성남시 수정구,80-84세,4334,1692,2642
202101,41131,경기도,성남시 수정구,80-84세,4349,1705,2644
202102,41131,경기도,성남시 수정구,80-84세,4378,1727,2651
202103,41131,경기도,성남시 수정구,80-84세,4308,1691,2617
202104,41131,경기도,성남시 수정구,80-84세,4325,1710,2615
202105,41131,경기도,성남시 수정구,80-84세,4330,1711,2619
202106,41131,경기도,성남시 수정구,80-84세,4339,1716,2623
202007,41131,경기도,성남시 수정구,85-89세,1895,557,1338
202008,41131,경기도,성남시 수정구,85-89세,1925,569,1356
202009,41131,경기도,성남시 수정구,85-89세,1945,578,1367
202010,41131,경기도,성남시 수정구,85-89세,1953,582,1371
202011,41131,경기도,성남시 수정구,85-89세,1964,584,1380
202012,41131,경기도,성남시 수정구,85-89세,2002,596,1406
202101,41131,경기도,성남시 수정구,85-89세,2023,610,1413
202102,41131,경기도,성남시 수정구,85-89세,2042,613,1429
202103,41131,경기도,성남시 수정구,85-89세,2017,593,1424
202104,41131,경기도,성남시 수정구,85-89세,2029,595,1434
202105,41131,경기도,성남시 수정구,85-89세,2035,605,1430
202106,41131,경기도,성남시 수정구,85-89세,2042,603,1439
202007,41131,경기도,성남시 수정구,90-94세,713,176,537
202008,41131,경기도,성남시 수정구,90-94세,729,176,553
202009,41131,경기도,성남시 수정구,90-94세,735,176,559
202010,41131,경기도,성남시 수정구,90-94세,732,178,554
202011,41131,경기도,성남시 수정구,90-94세,739,183,556
202012,41131,경기도,성남시 수정구,90-94세,749,186,563
202101,41131,경기도,성남시 수정구,90-94세,755,184,571
202102,41131,경기도,성남시 수정구,90-94세,764,184,580
202103,41131,경기도,성남시 수정구,90-94세,734,174,560
202104,41131,경기도,성남시 수정구,90-94세,725,167,558
202105,41131,경기도,성남시 수정구,90-94세,715,168,547
202106,41131,경기도,성남시 수정구,90-94세,715,171,544
202007,41131,경기도,성남시 수정구,95-99세,210,46,164
202008,41131,경기도,성남시 수정구,95-99세,214,48,166
202009,41131,경기도,성남시 수정구,95-99세,218,47,171
202010,41131,경기도,성남시 수정구,95-99세,223,48,175
202011,41131,경기도,성남시 수정구,95-99세,215,48,167
202012,41131,경기도,성남시 수정구,95-99세,215,48,167
202101,41131,경기도,성남시 수정구,95-99세,209,49,160
202102,41131,경기도,성남시 수정구,95-99세,211,48,163
202103,41131,경기도,성남시 수정구,95-99세,172,33,139
202104,41131,경기도,성남시 수정구,95-99세,164,27,137
202105,41131,경기도,성남시 수정구,95-99세,165,28,137
202106,41131,경기도,성남시 수정구,95-99세,163,27,136
202007,41131,경기도,성남시 수정구,100+,204,62,142
202008,41131,경기도,성남시 수정구,100+,204,62,142
202009,41131,경기도,성남시 수정구,100+,205,63,142
202010,41131,경기도,성남시 수정구,100+,208,63,145
202011,41131,경기도,성남시 수정구,100+,210,64,146
202012,41131,경기도,성남시 수정구,100+,212,63,149
202101,41131,경기도,성남시 수정구,100+,219,65,154
202102,41131,경기도,성남시 수정구,100+,220,66,154
202103,41131,경기도,성남시 수정구,100+,75,24,51
202104,41131,경기도,성남시 수정구,100+,59,17,42
202105,41131,경기도,성남시 수정구,100+,59,18,41
202106,41131,경기도,성남시 수정구,100+,59,17,42
202007,41133,경기도,성남시 중원구,0-4세,6172,3154,3018
202008,41133,경기도,성남시 중원구,0-4세,6068,3100,2968
202009,41133,경기도,성남시 중원구,0-4세,6038,3078,2960
202010,41133,경기도,성남시 중원구,0-4세,6006,3055,2951
202011,41133,경기도,성남시 중원구,0-4세,5987,3052,2935
202012,41133,경기도,성남시 중원구,0-4세,5942,3030,2912
202101,41133,경기도,성남시 중원구,0-4세,5866,2981,2885
202102,41133,경기도,성남시 중원구,0-4세,5844,2968,2876
202103,41133,경기도,성남시 중원구,0-4세,5853,2986,2867
202104,41133,경기도,성남시 중원구,0-4세,5845,2987,2858
202105,41133,경기도,성남시 중원구,0-4세,5822,2973,2849
202106,41133,경기도,성남시 중원구,0-4세,5768,2929,2839
202007,41133,경기도,성남시 중원구,5-9세,7577,3941,3636
202008,41133,경기도,성남시 중원구,5-9세,7489,3880,3609
202009,41133,경기도,성남시 중원구,5-9세,7410,3837,3573
202010,41133,경기도,성남시 중원구,5-9세,7384,3839,3545
202011,41133,경기도,성남시 중원구,5-9세,7354,3820,3534
202012,41133,경기도,성남시 중원구,5-9세,7318,3785,3533
202101,41133,경기도,성남시 중원구,5-9세,7310,3776,3534
202102,41133,경기도,성남시 중원구,5-9세,7263,3750,3513
202103,41133,경기도,성남시 중원구,5-9세,7249,3731,3518
202104,41133,경기도,성남시 중원구,5-9세,7237,3722,3515
202105,41133,경기도,성남시 중원구,5-9세,7196,3693,3503
202106,41133,경기도,성남시 중원구,5-9세,7158,3682,3476
202007,41133,경기도,성남시 중원구,10-14세,7702,3946,3756
202008,41133,경기도,성남시 중원구,10-14세,7633,3923,3710
202009,41133,경기도,성남시 중원구,10-14세,7679,3959,3720
202010,41133,경기도,성남시 중원구,10-14세,7690,3954,3736
202011,41133,경기도,성남시 중원구,10-14세,7689,3962,3727
202012,41133,경기도,성남시 중원구,10-14세,7716,3989,3727
202101,41133,경기도,성남시 중원구,10-14세,7719,3996,3723
202102,41133,경기도,성남시 중원구,10-14세,7703,3987,3716
202103,41133,경기도,성남시 중원구,10-14세,7711,3974,3737
202104,41133,경기도,성남시 중원구,10-14세,7730,3987,3743
202105,41133,경기도,성남시 중원구,10-14세,7720,3975,3745
202106,41133,경기도,성남시 중원구,10-14세,7676,3953,3723
202007,41133,경기도,성남시 중원구,15-19세,9356,4853,4503
202008,41133,경기도,성남시 중원구,15-19세,9248,4791,4457
202009,41133,경기도,성남시 중원구,15-19세,9128,4751,4377
202010,41133,경기도,성남시 중원구,15-19세,9004,4693,4311
202011,41133,경기도,성남시 중원구,15-19세,8933,4648,4285
202012,41133,경기도,성남시 중원구,15-19세,8871,4596,4275
202101,41133,경기도,성남시 중원구,15-19세,8775,4537,4238
202102,41133,경기도,성남시 중원구,15-19세,8724,4512,4212
202103,41133,경기도,성남시 중원구,15-19세,8679,4486,4193
202104,41133,경기도,성남시 중원구,15-19세,8594,4433,4161
202105,41133,경기도,성남시 중원구,15-19세,8547,4416,4131
202106,41133,경기도,성남시 중원구,15-19세,8490,4381,4109
202007,41133,경기도,성남시 중원구,20-24세,13857,6977,6880
202008,41133,경기도,성남시 중원구,20-24세,13730,6896,6834
202009,41133,경기도,성남시 중원구,20-24세,13592,6826,6766
202010,41133,경기도,성남시 중원구,20-24세,13477,6779,6698
202011,41133,경기도,성남시 중원구,20-24세,13428,6734,6694
202012,41133,경기도,성남시 중원구,20-24세,13357,6698,6659
202101,41133,경기도,성남시 중원구,20-24세,13350,6677,6673
202102,41133,경기도,성남시 중원구,20-24세,13315,6678,6637
202103,41133,경기도,성남시 중원구,20-24세,13222,6647,6575
202104,41133,경기도,성남시 중원구,20-24세,13163,6622,6541
202105,41133,경기도,성남시 중원구,20-24세,13090,6570,6520
202106,41133,경기도,성남시 중원구,20-24세,13012,6544,6468
202007,41133,경기도,성남시 중원구,25-29세,17584,9394,8190
202008,41133,경기도,성남시 중원구,25-29세,17509,9383,8126
202009,41133,경기도,성남시 중원구,25-29세,17587,9387,8200
202010,41133,경기도,성남시 중원구,25-29세,17649,9390,8259
202011,41133,경기도,성남시 중원구,25-29세,17737,9429,8308
202012,41133,경기도,성남시 중원구,25-29세,17895,9498,8397
202101,41133,경기도,성남시 중원구,25-29세,17850,9460,8390
202102,41133,경기도,성남시 중원구,25-29세,17811,9412,8399
202103,41133,경기도,성남시 중원구,25-29세,17818,9412,8406
202104,41133,경기도,성남시 중원구,25-29세,17814,9429,8385
202105,41133,경기도,성남시 중원구,25-29세,17752,9400,8352
202106,41133,경기도,성남시 중원구,25-29세,17669,9349,8320
202007,41133,경기도,성남시 중원구,30-34세,15014,8111,6903
202008,41133,경기도,성남시 중원구,30-34세,15008,8111,6897
202009,41133,경기도,성남시 중원구,30-34세,15032,8107,6925
202010,41133,경기도,성남시 중원구,30-34세,15052,8135,6917
202011,41133,경기도,성남시 중원구,30-34세,15076,8147,6929
202012,41133,경기도,성남시 중원구,30-34세,15136,8196,6940
202101,41133,경기도,성남시 중원구,30-34세,15219,8252,6967
202102,41133,경기도,성남시 중원구,30-34세,15274,8296,6978
202103,41133,경기도,성남시 중원구,30-34세,15423,8361,7062
202104,41133,경기도,성남시 중원구,30-34세,15479,8375,7104
202105,41133,경기도,성남시 중원구,30-34세,15563,8431,7132
202106,41133,경기도,성남시 중원구,30-34세,15648,8484,7164
202007,41133,경기도,성남시 중원구,35-39세,16336,8668,7668
202008,41133,경기도,성남시 중원구,35-39세,16181,8589,7592
202009,41133,경기도,성남시 중원구,35-39세,16111,8544,7567
202010,41133,경기도,성남시 중원구,35-39세,15999,8499,7500
202011,41133,경기도,성남시 중원구,35-39세,16002,8524,7478
202012,41133,경기도,성남시 중원구,35-39세,15987,8537,7450
202101,41133,경기도,성남시 중원구,35-39세,15909,8492,7417
202102,41133,경기도,성남시 중원구,35-39세,15842,8446,7396
202103,41133,경기도,성남시 중원구,35-39세,15782,8424,7358
202104,41133,경기도,성남시 중원구,35-39세,15726,8402,7324
202105,41133,경기도,성남시 중원구,35-39세,15641,8365,7276
202106,41133,경기도,성남시 중원구,35-39세,15506,8316,7190
202007,41133,경기도,성남시 중원구,40-44세,15634,8281,7353
202008,41133,경기도,성남시 중원구,40-44세,15571,8259,7312
202009,41133,경기도,성남시 중원구,40-44세,15513,8214,7299
202010,41133,경기도,성남시 중원구,40-44세,15543,8222,7321
202011,41133,경기도,성남시 중원구,40-44세,15532,8207,7325
202012,41133,경기도,성남시 중원구,40-44세,15485,8160,7325
202101,41133,경기도,성남시 중원구,40-44세,15518,8191,7327
202102,41133,경기도,성남시 중원구,40-44세,15508,8194,7314
202103,41133,경기도,성남시 중원구,40-44세,15459,8186,7273
202104,41133,경기도,성남시 중원구,40-44세,15489,8202,7287
202105,41133,경기도,성남시 중원구,40-44세,15527,8235,7292
202106,41133,경기도,성남시 중원구,40-44세,15593,8264,7329
202007,41133,경기도,성남시 중원구,45-49세,18112,9524,8588
202008,41133,경기도,성남시 중원구,45-49세,17898,9418,8480
202009,41133,경기도,성남시 중원구,45-49세,17724,9341,8383
202010,41133,경기도,성남시 중원구,45-49세,17600,9250,8350
202011,41133,경기도,성남시 중원구,45-49세,17455,9164,8291
202012,41133,경기도,성남시 중원구,45-49세,17423,9149,8274
202101,41133,경기도,성남시 중원구,45-49세,17357,9099,8258
202102,41133,경기도,성남시 중원구,45-49세,17340,9092,8248
202103,41133,경기도,성남시 중원구,45-49세,17210,9036,8174
202104,41133,경기도,성남시 중원구,45-49세,17172,9009,8163
202105,41133,경기도,성남시 중원구,45-49세,17014,8930,8084
202106,41133,경기도,성남시 중원구,45-49세,16880,8868,8012
202007,41133,경기도,성남시 중원구,50-54세,19259,9769,9490
202008,41133,경기도,성남시 중원구,50-54세,19142,9728,9414
202009,41133,경기도,성남시 중원구,50-54세,19091,9704,9387
202010,41133,경기도,성남시 중원구,50-54세,19032,9688,9344
202011,41133,경기도,성남시 중원구,50-54세,19039,9710,9329
202012,41133,경기도,성남시 중원구,50-54세,18977,9716,9261
202101,41133,경기도,성남시 중원구,50-54세,19042,9758,9284
202102,41133,경기도,성남시 중원구,50-54세,19048,9769,9279
202103,41133,경기도,성남시 중원구,50-54세,18914,9704,9210
202104,41133,경기도,성남시 중원구,50-54세,18907,9708,9199
202105,41133,경기도,성남시 중원구,50-54세,18945,9725,9220
202106,41133,경기도,성남시 중원구,50-54세,18917,9711,9206
202007,41133,경기도,성남시 중원구,55-59세,19768,9834,9934
202008,41133,경기도,성남시 중원구,55-59세,19633,9762,9871
202009,41133,경기도,성남시 중원구,55-59세,19465,9684,9781
202010,41133,경기도,성남시 중원구,55-59세,19348,9618,9730
202011,41133,경기도,성남시 중원구,55-59세,19265,9576,9689
202012,41133,경기도,성남시 중원구,55-59세,19266,9567,9699
202101,41133,경기도,성남시 중원구,55-59세,19129,9510,9619
202102,41133,경기도,성남시 중원구,55-59세,19037,9468,9569
202103,41133,경기도,성남시 중원구,55-59세,18931,9439,9492
202104,41133,경기도,성남시 중원구,55-59세,18850,9432,9418
202105,41133,경기도,성남시 중원구,55-59세,18785,9406,9379
202106,41133,경기도,성남시 중원구,55-59세,18625,9349,9276
202007,41133,경기도,성남시 중원구,60-64세,17998,9089,8909
202008,41133,경기도,성남시 중원구,60-64세,18053,9105,8948
202009,41133,경기도,성남시 중원구,60-64세,18099,9157,8942
202010,41133,경기도,성남시 중원구,60-64세,18192,9216,8976
202011,41133,경기도,성남시 중원구,60-64세,18272,9269,9003
202012,41133,경기도,성남시 중원구,60-64세,18375,9309,9066
202101,41133,경기도,성남시 중원구,60-64세,18500,9343,9157
202102,41133,경기도,성남시 중원구,60-64세,18642,9420,9222
202103,41133,경기도,성남시 중원구,60-64세,18679,9410,9269
202104,41133,경기도,성남시 중원구,60-64세,18788,9462,9326
202105,41133,경기도,성남시 중원구,60-64세,18908,9521,9387
202106,41133,경기도,성남시 중원구,60-64세,19035,9567,9468
202007,41133,경기도,성남시 중원구,65-69세,12057,5858,6199
202008,41133,경기도,성남시 중원구,65-69세,12058,5856,6202
202009,41133,경기도,성남시 중원구,65-69세,12135,5869,6266
202010,41133,경기도,성남시 중원구,65-69세,12180,5870,6310
202011,41133,경기도,성남시 중원구,65-69세,12271,5903,6368
202012,41133,경기도,성남시 중원구,65-69세,12339,5943,6396
202101,41133,경기도,성남시 중원구,65-69세,12441,6029,6412
202102,41133,경기도,성남시 중원구,65-69세,12510,6059,6451
202103,41133,경기도,성남시 중원구,65-69세,12530,6085,6445
202104,41133,경기도,성남시 중원구,65-69세,12608,6127,6481
202105,41133,경기도,성남시 중원구,65-69세,12694,6167,6527
202106,41133,경기도,성남시 중원구,65-69세,12778,6198,6580
202007,41133,경기도,성남시 중원구,70-74세,8684,4114,4570
202008,41133,경기도,성남시 중원구,70-74세,8670,4101,4569
202009,41133,경기도,성남시 중원구,70-74세,8696,4121,4575
202010,41133,경기도,성남시 중원구,70-74세,8769,4154,4615
202011,41133,경기도,성남시 중원구,70-74세,8812,4178,4634
202012,41133,경기도,성남시 중원구,70-74세,8897,4203,4694
202101,41133,경기도,성남시 중원구,70-74세,8972,4223,4749
202102,41133,경기도,성남시 중원구,70-74세,9028,4243,4785
202103,41133,경기도,성남시 중원구,70-74세,8968,4223,4745
202104,41133,경기도,성남시 중원구,70-74세,8989,4231,4758
202105,41133,경기도,성남시 중원구,70-74세,9014,4243,4771
202106,41133,경기도,성남시 중원구,70-74세,8981,4237,4744
202007,41133,경기도,성남시 중원구,75-79세,6422,2814,3608
202008,41133,경기도,성남시 중원구,75-79세,6440,2824,3616
202009,41133,경기도,성남시 중원구,75-79세,6420,2806,3614
202010,41133,경기도,성남시 중원구,75-79세,6415,2813,3602
202011,41133,경기도,성남시 중원구,75-79세,6422,2827,3595
202012,41133,경기도,성남시 중원구,75-79세,6409,2830,3579
202101,41133,경기도,성남시 중원구,75-79세,6394,2835,3559
202102,41133,경기도,성남시 중원구,75-79세,6374,2826,3548
202103,41133,경기도,성남시 중원구,75-79세,6285,2779,3506
202104,41133,경기도,성남시 중원구,75-79세,6259,2763,3496
202105,41133,경기도,성남시 중원구,75-79세,6282,2782,3500
202106,41133,경기도,성남시 중원구,75-79세,6277,2766,3511
202007,41133,경기도,성남시 중원구,80-84세,3838,1471,2367
202008,41133,경기도,성남시 중원구,80-84세,3849,1474,2375
202009,41133,경기도,성남시 중원구,80-84세,3853,1476,2377
202010,41133,경기도,성남시 중원구,80-84세,3864,1481,2383
202011,41133,경기도,성남시 중원구,80-84세,3876,1489,2387
202012,41133,경기도,성남시 중원구,80-84세,3900,1508,2392
202101,41133,경기도,성남시 중원구,80-84세,3924,1511,2413
202102,41133,경기도,성남시 중원구,80-84세,3971,1525,2446
202103,41133,경기도,성남시 중원구,80-84세,3936,1501,2435
202104,41133,경기도,성남시 중원구,80-84세,3953,1510,2443
202105,41133,경기도,성남시 중원구,80-84세,3963,1509,2454
202106,41133,경기도,성남시 중원구,80-84세,3981,1523,2458
202007,41133,경기도,성남시 중원구,85-89세,1718,469,1249
202008,41133,경기도,성남시 중원구,85-89세,1719,478,1241
202009,41133,경기도,성남시 중원구,85-89세,1732,483,1249
202010,41133,경기도,성남시 중원구,85-89세,1742,489,1253
202011,41133,경기도,성남시 중원구,85-89세,1762,498,1264
202012,41133,경기도,성남시 중원구,85-89세,1780,508,1272
202101,41133,경기도,성남시 중원구,85-89세,1800,526,1274
202102,41133,경기도,성남시 중원구,85-89세,1812,532,1280
202103,41133,경기도,성남시 중원구,85-89세,1815,524,1291
202104,41133,경기도,성남시 중원구,85-89세,1823,530,1293
202105,41133,경기도,성남시 중원구,85-89세,1849,552,1297
202106,41133,경기도,성남시 중원구,85-89세,1870,566,1304
202007,41133,경기도,성남시 중원구,90-94세,684,131,553
202008,41133,경기도,성남시 중원구,90-94세,693,131,562
202009,41133,경기도,성남시 중원구,90-94세,689,133,556
202010,41133,경기도,성남시 중원구,90-94세,681,134,547
202011,41133,경기도,성남시 중원구,90-94세,676,128,548
202012,41133,경기도,성남시 중원구,90-94세,670,123,547
202101,41133,경기도,성남시 중원구,90-94세,672,128,544
202102,41133,경기도,성남시 중원구,90-94세,683,133,550
202103,41133,경기도,성남시 중원구,90-94세,652,128,524
202104,41133,경기도,성남시 중원구,90-94세,661,130,531
202105,41133,경기도,성남시 중원구,90-94세,673,130,543
202106,41133,경기도,성남시 중원구,90-94세,672,129,543
202007,41133,경기도,성남시 중원구,95-99세,192,48,144
202008,41133,경기도,성남시 중원구,95-99세,192,48,144
202009,41133,경기도,성남시 중원구,95-99세,200,48,152
202010,41133,경기도,성남시 중원구,95-99세,201,46,155
202011,41133,경기도,성남시 중원구,95-99세,200,46,154
202012,41133,경기도,성남시 중원구,95-99세,201,48,153
202101,41133,경기도,성남시 중원구,95-99세,207,48,159
202102,41133,경기도,성남시 중원구,95-99세,209,48,161
202103,41133,경기도,성남시 중원구,95-99세,161,27,134
202104,41133,경기도,성남시 중원구,95-99세,166,28,138
202105,41133,경기도,성남시 중원구,95-99세,166,30,136
202106,41133,경기도,성남시 중원구,95-99세,170,30,140
202007,41133,경기도,성남시 중원구,100+,182,49,133
202008,41133,경기도,성남시 중원구,100+,185,50,135
202009,41133,경기도,성남시 중원구,100+,185,50,135
202010,41133,경기도,성남시 중원구,100+,185,51,134
202011,41133,경기도,성남시 중원구,100+,187,51,136
202012,41133,경기도,성남시 중원구,100+,187,51,136
202101,41133,경기도,성남시 중원구,100+,188,52,136
202102,41133,경기도,성남시 중원구,100+,190,52,138
202103,41133,경기도,성남시 중원구,100+,59,11,48
202104,41133,경기도,성남시 중원구,100+,61,11,50
202105,41133,경기도,성남시 중원구,100+,61,11,50
202106,41133,경기도,성남시 중원구,100+,61,11,50
202007,41135,경기도,성남시 분당구,0-4세,16407,8375,8032
202008,41135,경기도,성남시 분당구,0-4세,16200,8276,7924
202009,41135,경기도,성남시 분당구,0-4세,15980,8125,7855
202010,41135,경기도,성남시 분당구,0-4세,15822,8015,7807
202011,41135,경기도,성남시 분당구,0-4세,15651,7950,7701
202012,41135,경기도,성남시 분당구,0-4세,15586,7917,7669
202101,41135,경기도,성남시 분당구,0-4세,15427,7833,7594
202102,41135,경기도,성남시 분당구,0-4세,15344,7812,7532
202103,41135,경기도,성남시 분당구,0-4세,15168,7716,7452
202104,41135,경기도,성남시 분당구,0-4세,15057,7655,7402
202105,41135,경기도,성남시 분당구,0-4세,14951,7609,7342
202106,41135,경기도,성남시 분당구,0-4세,15136,7728,7408
202007,41135,경기도,성남시 분당구,5-9세,24444,12609,11835
202008,41135,경기도,성남시 분당구,5-9세,24370,12554,11816
202009,41135,경기도,성남시 분당구,5-9세,24340,12565,11775
202010,41135,경기도,성남시 분당구,5-9세,24225,12548,11677
202011,41135,경기도,성남시 분당구,5-9세,24096,12486,11610
202012,41135,경기도,성남시 분당구,5-9세,24120,12512,11608
202101,41135,경기도,성남시 분당구,5-9세,23975,12422,11553
202102,41135,경기도,성남시 분당구,5-9세,23927,12368,11559
202103,41135,경기도,성남시 분당구,5-9세,23902,12334,11568
202104,41135,경기도,성남시 분당구,5-9세,23769,12259,11510
202105,41135,경기도,성남시 분당구,5-9세,23661,12207,11454
202106,41135,경기도,성남시 분당구,5-9세,23648,12183,11465
202007,41135,경기도,성남시 분당구,10-14세,26266,13471,12795
202008,41135,경기도,성남시 분당구,10-14세,26297,13490,12807
202009,41135,경기도,성남시 분당구,10-14세,26353,13489,12864
202010,41135,경기도,성남시 분당구,10-14세,26417,13509,12908
202011,41135,경기도,성남시 분당구,10-14세,26468,13521,12947
202012,41135,경기도,성남시 분당구,10-14세,26481,13516,12965
202101,41135,경기도,성남시 분당구,10-14세,26580,13589,12991
202102,41135,경기도,성남시 분당구,10-14세,26597,13591,13006
202103,41135,경기도,성남시 분당구,10-14세,26555,13610,12945
202104,41135,경기도,성남시 분당구,10-14세,26553,13612,12941
202105,41135,경기도,성남시 분당구,10-14세,26493,13589,12904
202106,41135,경기도,성남시 분당구,10-14세,26542,13635,12907
202007,41135,경기도,성남시 분당구,15-19세,27983,14296,13687
202008,41135,경기도,성남시 분당구,15-19세,27781,14195,13586
202009,41135,경기도,성남시 분당구,15-19세,27530,14067,13463
202010,41135,경기도,성남시 분당구,15-19세,27423,14017,13406
202011,41135,경기도,성남시 분당구,15-19세,27304,13965,13339
202012,41135,경기도,성남시 분당구,15-19세,27206,13908,13298
202101,41135,경기도,성남시 분당구,15-19세,26997,13804,13193
202102,41135,경기도,성남시 분당구,15-19세,26825,13734,13091
202103,41135,경기도,성남시 분당구,15-19세,26614,13631,12983
202104,41135,경기도,성남시 분당구,15-19세,26453,13537,12916
202105,41135,경기도,성남시 분당구,15-19세,26382,13488,12894
202106,41135,경기도,성남시 분당구,15-19세,26293,13418,12875
202007,41135,경기도,성남시 분당구,20-24세,31091,15732,15359
202008,41135,경기도,성남시 분당구,20-24세,30999,15646,15353
202009,41135,경기도,성남시 분당구,20-24세,30900,15594,15306
202010,41135,경기도,성남시 분당구,20-24세,30740,15529,15211
202011,41135,경기도,성남시 분당구,20-24세,30725,15518,15207
202012,41135,경기도,성남시 분당구,20-24세,30613,15470,15143
202101,41135,경기도,성남시 분당구,20-24세,30650,15479,15171
202102,41135,경기도,성남시 분당구,20-24세,30559,15434,15125
202103,41135,경기도,성남시 분당구,20-24세,30346,15298,15048
202104,41135,경기도,성남시 분당구,20-24세,30266,15262,15004
202105,41135,경기도,성남시 분당구,20-24세,30173,15213,14960
202106,41135,경기도,성남시 분당구,20-24세,30152,15223,14929
202007,41135,경기도,성남시 분당구,25-29세,35501,17741,17760
202008,41135,경기도,성남시 분당구,25-29세,35388,17711,17677
202009,41135,경기도,성남시 분당구,25-29세,35259,17650,17609
202010,41135,경기도,성남시 분당구,25-29세,35288,17653,17635
202011,41135,경기도,성남시 분당구,25-29세,35237,17655,17582
202012,41135,경기도,성남시 분당구,25-29세,35178,17612,17566
202101,41135,경기도,성남시 분당구,25-29세,35044,17582,17462
202102,41135,경기도,성남시 분당구,25-29세,34790,17449,17341
202103,41135,경기도,성남시 분당구,25-29세,34754,17425,17329
202104,41135,경기도,성남시 분당구,25-29세,34604,17371,17233
202105,41135,경기도,성남시 분당구,25-29세,34536,17343,17193
202106,41135,경기도,성남시 분당구,25-29세,34531,17351,17180
202007,41135,경기도,성남시 분당구,30-34세,33827,16409,17418
202008,41135,경기도,성남시 분당구,30-34세,33640,16311,17329
202009,41135,경기도,성남시 분당구,30-34세,33562,16296,17266
202010,41135,경기도,성남시 분당구,30-34세,33397,16215,17182
202011,41135,경기도,성남시 분당구,30-34세,33342,16187,17155
202012,41135,경기도,성남시 분당구,30-34세,33285,16245,17040
202101,41135,경기도,성남시 분당구,30-34세,33226,16202,17024
202102,41135,경기도,성남시 분당구,30-34세,33143,16179,16964
202103,41135,경기도,성남시 분당구,30-34세,33048,16164,16884
202104,41135,경기도,성남시 분당구,30-34세,33031,16150,16881
202105,41135,경기도,성남시 분당구,30-34세,33004,16164,16840
202106,41135,경기도,성남시 분당구,30-34세,33230,16264,16966
202007,41135,경기도,성남시 분당구,35-39세,37476,17875,19601
202008,41135,경기도,성남시 분당구,35-39세,37149,17722,19427
202009,41135,경기도,성남시 분당구,35-39세,36909,17611,19298
202010,41135,경기도,성남시 분당구,35-39세,36804,17563,19241
202011,41135,경기도,성남시 분당구,35-39세,36683,17495,19188
202012,41135,경기도,성남시 분당구,35-39세,36629,17412,19217
202101,41135,경기도,성남시 분당구,35-39세,36501,17342,19159
202102,41135,경기도,성남시 분당구,35-39세,36262,17225,19037
202103,41135,경기도,성남시 분당구,35-39세,36041,17169,18872
202104,41135,경기도,성남시 분당구,35-39세,35794,17093,18701
202105,41135,경기도,성남시 분당구,35-39세,35620,16998,18622
202106,41135,경기도,성남시 분당구,35-39세,35805,17095,18710
202007,41135,경기도,성남시 분당구,40-44세,40403,18628,21775
202008,41135,경기도,성남시 분당구,40-44세,40454,18621,21833
202009,41135,경기도,성남시 분당구,40-44세,40500,18622,21878
202010,41135,경기도,성남시 분당구,40-44세,40623,18691,21932
202011,41135,경기도,성남시 분당구,40-44세,40599,18694,21905
202012,41135,경기도,성남시 분당구,40-44세,40565,18702,21863
202101,41135,경기도,성남시 분당구,40-44세,40615,18738,21877
202102,41135,경기도,성남시 분당구,40-44세,40688,18780,21908
202103,41135,경기도,성남시 분당구,40-44세,40479,18666,21813
202104,41135,경기도,성남시 분당구,40-44세,40455,18665,21790
202105,41135,경기도,성남시 분당구,40-44세,40445,18657,21788
202106,41135,경기도,성남시 분당구,40-44세,40618,18740,21878
202007,41135,경기도,성남시 분당구,45-49세,47341,22305,25036
202008,41135,경기도,성남시 분당구,45-49세,47070,22171,24899
202009,41135,경기도,성남시 분당구,45-49세,46762,21978,24784
202010,41135,경기도,성남시 분당구,45-49세,46407,21841,24566
202011,41135,경기도,성남시 분당구,45-49세,46239,21744,24495
202012,41135,경기도,성남시 분당구,45-49세,46041,21618,24423
202101,41135,경기도,성남시 분당구,45-49세,45816,21527,24289
202102,41135,경기도,성남시 분당구,45-49세,45547,21418,24129
202103,41135,경기도,성남시 분당구,45-49세,45211,21229,23982
202104,41135,경기도,성남시 분당구,45-49세,45011,21082,23929
202105,41135,경기도,성남시 분당구,45-49세,44675,20949,23726
202106,41135,경기도,성남시 분당구,45-49세,44542,20889,23653
202007,41135,경기도,성남시 분당구,50-54세,41308,20402,20906
202008,41135,경기도,성남시 분당구,50-54세,41337,20426,20911
202009,41135,경기도,성남시 분당구,50-54세,41464,20536,20928
202010,41135,경기도,성남시 분당구,50-54세,41602,20584,21018
202011,41135,경기도,성남시 분당구,50-54세,41732,20639,21093
202012,41135,경기도,성남시 분당구,50-54세,41655,20630,21025
202101,41135,경기도,성남시 분당구,50-54세,41964,20740,21224
202102,41135,경기도,성남시 분당구,50-54세,42266,20848,21418
202103,41135,경기도,성남시 분당구,50-54세,42296,20886,21410
202104,41135,경기도,성남시 분당구,50-54세,42380,20948,21432
202105,41135,경기도,성남시 분당구,50-54세,42602,21009,21593
202106,41135,경기도,성남시 분당구,50-54세,42911,21170,21741
202007,41135,경기도,성남시 분당구,55-59세,34921,17109,17812
202008,41135,경기도,성남시 분당구,55-59세,34809,17060,17749
202009,41135,경기도,성남시 분당구,55-59세,34683,16980,17703
202010,41135,경기도,성남시 분당구,55-59세,34619,16928,17691
202011,41135,경기도,성남시 분당구,55-59세,34571,16885,17686
202012,41135,경기도,성남시 분당구,55-59세,34647,16914,17733
202101,41135,경기도,성남시 분당구,55-59세,34507,16891,17616
202102,41135,경기도,성남시 분당구,55-59세,34400,16846,17554
202103,41135,경기도,성남시 분당구,55-59세,34210,16746,17464
202104,41135,경기도,성남시 분당구,55-59세,34118,16694,17424
202105,41135,경기도,성남시 분당구,55-59세,34138,16727,17411
202106,41135,경기도,성남시 분당구,55-59세,33984,16664,17320
202007,41135,경기도,성남시 분당구,60-64세,29425,14521,14904
202008,41135,경기도,성남시 분당구,60-64세,29549,14561,14988
202009,41135,경기도,성남시 분당구,60-64세,29548,14554,14994
202010,41135,경기도,성남시 분당구,60-64세,29605,14569,15036
202011,41135,경기도,성남시 분당구,60-64세,29738,14644,15094
202012,41135,경기도,성남시 분당구,60-64세,29828,14670,15158
202101,41135,경기도,성남시 분당구,60-64세,30024,14763,15261
202102,41135,경기도,성남시 분당구,60-64세,30170,14797,15373
202103,41135,경기도,성남시 분당구,60-64세,30241,14820,15421
202104,41135,경기도,성남시 분당구,60-64세,30372,14884,15488
202105,41135,경기도,성남시 분당구,60-64세,30468,14947,15521
202106,41135,경기도,성남시 분당구,60-64세,30751,15058,15693
202007,41135,경기도,성남시 분당구,65-69세,18848,9132,9716
202008,41135,경기도,성남시 분당구,65-69세,18967,9197,9770
202009,41135,경기도,성남시 분당구,65-69세,19143,9289,9854
202010,41135,경기도,성남시 분당구,65-69세,19315,9365,9950
202011,41135,경기도,성남시 분당구,65-69세,19438,9418,10020
202012,41135,경기도,성남시 분당구,65-69세,19593,9481,10112
202101,41135,경기도,성남시 분당구,65-69세,19756,9539,10217
202102,41135,경기도,성남시 분당구,65-69세,19894,9650,10244
202103,41135,경기도,성남시 분당구,65-69세,20163,9797,10366
202104,41135,경기도,성남시 분당구,65-69세,20360,9876,10484
202105,41135,경기도,성남시 분당구,65-69세,20487,9924,10563
202106,41135,경기도,성남시 분당구,65-69세,20743,10064,10679
202007,41135,경기도,성남시 분당구,70-74세,14323,6512,7811
202008,41135,경기도,성남시 분당구,70-74세,14310,6501,7809
202009,41135,경기도,성남시 분당구,70-74세,14321,6511,7810
202010,41135,경기도,성남시 분당구,70-74세,14353,6539,7814
202011,41135,경기도,성남시 분당구,70-74세,14406,6548,7858
202012,41135,경기도,성남시 분당구,70-74세,14432,6564,7868
202101,41135,경기도,성남시 분당구,70-74세,14531,6632,7899
202102,41135,경기도,성남시 분당구,70-74세,14584,6656,7928
202103,41135,경기도,성남시 분당구,70-74세,14478,6594,7884
202104,41135,경기도,성남시 분당구,70-74세,14450,6596,7854
202105,41135,경기도,성남시 분당구,70-74세,14429,6595,7834
202106,41135,경기도,성남시 분당구,70-74세,14418,6587,7831
202007,41135,경기도,성남시 분당구,75-79세,11204,5029,6175
202008,41135,경기도,성남시 분당구,75-79세,11224,5049,6175
202009,41135,경기도,성남시 분당구,75-79세,11176,5031,6145
202010,41135,경기도,성남시 분당구,75-79세,11153,5017,6136
202011,41135,경기도,성남시 분당구,75-79세,11108,5016,6092
202012,41135,경기도,성남시 분당구,75-79세,11041,5001,6040
202101,41135,경기도,성남시 분당구,75-79세,11025,4971,6054
202102,41135,경기도,성남시 분당구,75-79세,11018,4949,6069
202103,41135,경기도,성남시 분당구,75-79세,11030,4961,6069
202104,41135,경기도,성남시 분당구,75-79세,11008,4944,6064
202105,41135,경기도,성남시 분당구,75-79세,11021,4957,6064
202106,41135,경기도,성남시 분당구,75-79세,11056,4975,6081
202007,41135,경기도,성남시 분당구,80-84세,8125,3290,4835
202008,41135,경기도,성남시 분당구,80-84세,8137,3301,4836
202009,41135,경기도,성남시 분당구,80-84세,8148,3324,4824
202010,41135,경기도,성남시 분당구,80-84세,8142,3323,4819
202011,41135,경기도,성남시 분당구,80-84세,8166,3334,4832
202012,41135,경기도,성남시 분당구,80-84세,8195,3348,4847
202101,41135,경기도,성남시 분당구,80-84세,8243,3378,4865
202102,41135,경기도,성남시 분당구,80-84세,8217,3392,4825
202103,41135,경기도,성남시 분당구,80-84세,8209,3402,4807
202104,41135,경기도,성남시 분당구,80-84세,8266,3431,4835
202105,41135,경기도,성남시 분당구,80-84세,8278,3436,4842
202106,41135,경기도,성남시 분당구,80-84세,8315,3463,4852
202007,41135,경기도,성남시 분당구,85-89세,4566,1542,3024
202008,41135,경기도,성남시 분당구,85-89세,4575,1543,3032
202009,41135,경기도,성남시 분당구,85-89세,4608,1541,3067
202010,41135,경기도,성남시 분당구,85-89세,4648,1563,3085
202011,41135,경기도,성남시 분당구,85-89세,4688,1571,3117
202012,41135,경기도,성남시 분당구,85-89세,4708,1577,3131
202101,41135,경기도,성남시 분당구,85-89세,4748,1593,3155
202102,41135,경기도,성남시 분당구,85-89세,4788,1618,3170
202103,41135,경기도,성남시 분당구,85-89세,4796,1616,3180
202104,41135,경기도,성남시 분당구,85-89세,4791,1623,3168
202105,41135,경기도,성남시 분당구,85-89세,4822,1647,3175
202106,41135,경기도,성남시 분당구,85-89세,4850,1653,3197
202007,41135,경기도,성남시 분당구,90-94세,1852,507,1345
202008,41135,경기도,성남시 분당구,90-94세,1859,509,1350
202009,41135,경기도,성남시 분당구,90-94세,1865,522,1343
202010,41135,경기도,성남시 분당구,90-94세,1878,537,1341
202011,41135,경기도,성남시 분당구,90-94세,1872,538,1334
202012,41135,경기도,성남시 분당구,90-94세,1881,549,1332
202101,41135,경기도,성남시 분당구,90-94세,1885,549,1336
202102,41135,경기도,성남시 분당구,90-94세,1913,555,1358
202103,41135,경기도,성남시 분당구,90-94세,1942,566,1376
202104,41135,경기도,성남시 분당구,90-94세,1962,574,1388
202105,41135,경기도,성남시 분당구,90-94세,1981,583,1398
202106,41135,경기도,성남시 분당구,90-94세,1978,584,1394
202007,41135,경기도,성남시 분당구,95-99세,436,99,337
202008,41135,경기도,성남시 분당구,95-99세,445,99,346
202009,41135,경기도,성남시 분당구,95-99세,456,96,360
202010,41135,경기도,성남시 분당구,95-99세,461,98,363
202011,41135,경기도,성남시 분당구,95-99세,456,94,362
202012,41135,경기도,성남시 분당구,95-99세,452,93,359
202101,41135,경기도,성남시 분당구,95-99세,450,93,357
202102,41135,경기도,성남시 분당구,95-99세,442,89,353
202103,41135,경기도,성남시 분당구,95-99세,429,86,343
202104,41135,경기도,성남시 분당구,95-99세,440,87,353
202105,41135,경기도,성남시 분당구,95-99세,441,87,354
202106,41135,경기도,성남시 분당구,95-99세,435,89,346
202007,41135,경기도,성남시 분당구,100+,96,21,75
202008,41135,경기도,성남시 분당구,100+,96,21,75
202009,41135,경기도,성남시 분당구,100+,94,22,72
202010,41135,경기도,성남시 분당구,100+,94,22,72
202011,41135,경기도,성남시 분당구,100+,95,22,73
202012,41135,경기도,성남시 분당구,100+,96,20,76
202101,41135,경기도,성남시 분당구,100+,100,20,80
202102,41135,경기도,성남시 분당구,100+,100,23,77
202103,41135,경기도,성남시 분당구,100+,76,18,58
202104,41135,경기도,성남시 분당구,100+,77,18,59
202105,41135,경기도,성남시 분당구,100+,78,19,59
202106,41135,경기도,성남시 분당구,100+,76,18,58
202007,41150,경기도,의정부시,0-4세,14872,7728,7144
202008,41150,경기도,의정부시,0-4세,14761,7677,7084
202009,41150,경기도,의정부시,0-4세,14758,7662,7096
202010,41150,경기도,의정부시,0-4세,14702,7635,7067
202011,41150,경기도,의정부시,0-4세,14634,7600,7034
202012,41150,경기도,의정부시,0-4세,14656,7632,7024
202101,41150,경기도,의정부시,0-4세,14549,7578,6971
202102,41150,경기도,의정부시,0-4세,14456,7537,6919
202103,41150,경기도,의정부시,0-4세,14343,7479,6864
202104,41150,경기도,의정부시,0-4세,14223,7430,6793
202105,41150,경기도,의정부시,0-4세,14124,7392,6732
202106,41150,경기도,의정부시,0-4세,14102,7374,6728
202007,41150,경기도,의정부시,5-9세,19683,10113,9570
202008,41150,경기도,의정부시,5-9세,19741,10147,9594
202009,41150,경기도,의정부시,5-9세,19753,10164,9589
202010,41150,경기도,의정부시,5-9세,19770,10166,9604
202011,41150,경기도,의정부시,5-9세,19735,10159,9576
202012,41150,경기도,의정부시,5-9세,19797,10187,9610
202101,41150,경기도,의정부시,5-9세,19767,10152,9615
202102,41150,경기도,의정부시,5-9세,19657,10074,9583
202103,41150,경기도,의정부시,5-9세,19620,10051,9569
202104,41150,경기도,의정부시,5-9세,19584,10030,9554
202105,41150,경기도,의정부시,5-9세,19547,10003,9544
202106,41150,경기도,의정부시,5-9세,19531,9998,9533
202007,41150,경기도,의정부시,10-14세,19794,10226,9568
202008,41150,경기도,의정부시,10-14세,19808,10229,9579
202009,41150,경기도,의정부시,10-14세,19906,10268,9638
202010,41150,경기도,의정부시,10-14세,19928,10304,9624
202011,41150,경기도,의정부시,10-14세,20030,10368,9662
202012,41150,경기도,의정부시,10-14세,20101,10394,9707
202101,41150,경기도,의정부시,10-14세,20207,10455,9752
202102,41150,경기도,의정부시,10-14세,20163,10429,9734
202103,41150,경기도,의정부시,10-14세,20156,10443,9713
202104,41150,경기도,의정부시,10-14세,20123,10443,9680
202105,41150,경기도,의정부시,10-14세,20109,10433,9676
202106,41150,경기도,의정부시,10-14세,20106,10438,9668
202007,41150,경기도,의정부시,15-19세,23022,11823,11199
202008,41150,경기도,의정부시,15-19세,22888,11761,11127
202009,41150,경기도,의정부시,15-19세,22771,11706,11065
202010,41150,경기도,의정부시,15-19세,22665,11637,11028
202011,41150,경기도,의정부시,15-19세,22584,11581,11003
202012,41150,경기도,의정부시,15-19세,22438,11531,10907
202101,41150,경기도,의정부시,15-19세,22238,11428,10810
202102,41150,경기도,의정부시,15-19세,22109,11377,10732
202103,41150,경기도,의정부시,15-19세,21979,11323,10656
202104,41150,경기도,의정부시,15-19세,21855,11230,10625
202105,41150,경기도,의정부시,15-19세,21755,11180,10575
202106,41150,경기도,의정부시,15-19세,21689,11130,10559
202007,41150,경기도,의정부시,20-24세,31117,15772,15345
202008,41150,경기도,의정부시,20-24세,31131,15785,15346
202009,41150,경기도,의정부시,20-24세,31211,15830,15381
202010,41150,경기도,의정부시,20-24세,31177,15801,15376
202011,41150,경기도,의정부시,20-24세,31149,15761,15388
202012,41150,경기도,의정부시,20-24세,31098,15759,15339
202101,41150,경기도,의정부시,20-24세,31187,15776,15411
202102,41150,경기도,의정부시,20-24세,31315,15779,15536
202103,41150,경기도,의정부시,20-24세,31334,15760,15574
202104,41150,경기도,의정부시,20-24세,31261,15724,15537
202105,41150,경기도,의정부시,20-24세,31192,15675,15517
202106,41150,경기도,의정부시,20-24세,31139,15664,15475
202007,41150,경기도,의정부시,25-29세,32312,16546,15766
202008,41150,경기도,의정부시,25-29세,32462,16590,15872
202009,41150,경기도,의정부시,25-29세,32705,16685,16020
202010,41150,경기도,의정부시,25-29세,32983,16861,16122
202011,41150,경기도,의정부시,25-29세,33217,16959,16258
202012,41150,경기도,의정부시,25-29세,33473,17067,16406
202101,41150,경기도,의정부시,25-29세,33513,17087,16426
202102,41150,경기도,의정부시,25-29세,33500,17044,16456
202103,41150,경기도,의정부시,25-29세,33543,17075,16468
202104,41150,경기도,의정부시,25-29세,33549,17065,16484
202105,41150,경기도,의정부시,25-29세,33594,17131,16463
202106,41150,경기도,의정부시,25-29세,33644,17136,16508
202007,41150,경기도,의정부시,30-34세,26786,13604,13182
202008,41150,경기도,의정부시,30-34세,26878,13687,13191
202009,41150,경기도,의정부시,30-34세,26989,13729,13260
202010,41150,경기도,의정부시,30-34세,27048,13734,13314
202011,41150,경기도,의정부시,30-34세,27139,13780,13359
202012,41150,경기도,의정부시,30-34세,27286,13853,13433
202101,41150,경기도,의정부시,30-34세,27349,13908,13441
202102,41150,경기도,의정부시,30-34세,27377,13939,13438
202103,41150,경기도,의정부시,30-34세,27417,13935,13482
202104,41150,경기도,의정부시,30-34세,27493,14005,13488
202105,41150,경기도,의정부시,30-34세,27583,14044,13539
202106,41150,경기도,의정부시,30-34세,27734,14126,13608
202007,41150,경기도,의정부시,35-39세,32818,16787,16031
202008,41150,경기도,의정부시,35-39세,32844,16802,16042
202009,41150,경기도,의정부시,35-39세,32846,16797,16049
202010,41150,경기도,의정부시,35-39세,32807,16763,16044
202011,41150,경기도,의정부시,35-39세,32762,16768,15994
202012,41150,경기도,의정부시,35-39세,32861,16841,16020
202101,41150,경기도,의정부시,35-39세,32736,16784,15952
202102,41150,경기도,의정부시,35-39세,32472,16643,15829
202103,41150,경기도,의정부시,35-39세,32246,16531,15715
202104,41150,경기도,의정부시,35-39세,32125,16453,15672
202105,41150,경기도,의정부시,35-39세,31972,16355,15617
202106,41150,경기도,의정부시,35-39세,32005,16356,15649
202007,41150,경기도,의정부시,40-44세,33517,16997,16520
202008,41150,경기도,의정부시,40-44세,33679,17099,16580
202009,41150,경기도,의정부시,40-44세,33900,17235,16665
202010,41150,경기도,의정부시,40-44세,34101,17328,16773
202011,41150,경기도,의정부시,40-44세,34233,17382,16851
202012,41150,경기도,의정부시,40-44세,34272,17396,16876
202101,41150,경기도,의정부시,40-44세,34454,17488,16966
202102,41150,경기도,의정부시,40-44세,34608,17595,17013
202103,41150,경기도,의정부시,40-44세,34469,17568,16901
202104,41150,경기도,의정부시,40-44세,34529,17592,16937
202105,41150,경기도,의정부시,40-44세,34576,17623,16953
202106,41150,경기도,의정부시,40-44세,34776,17754,17022
202007,41150,경기도,의정부시,45-49세,41014,20320,20694
202008,41150,경기도,의정부시,45-49세,40829,20237,20592
202009,41150,경기도,의정부시,45-49세,40726,20192,20534
202010,41150,경기도,의정부시,45-49세,40563,20090,20473
202011,41150,경기도,의정부시,45-49세,40522,20087,20435
202012,41150,경기도,의정부시,45-49세,40522,20086,20436
202101,41150,경기도,의정부시,45-49세,40365,20032,20333
202102,41150,경기도,의정부시,45-49세,40127,19924,20203
202103,41150,경기도,의정부시,45-49세,39840,19792,20048
202104,41150,경기도,의정부시,45-49세,39635,19656,19979
202105,41150,경기도,의정부시,45-49세,39253,19471,19782
202106,41150,경기도,의정부시,45-49세,39043,19351,19692
202007,41150,경기도,의정부시,50-54세,40794,19903,20891
202008,41150,경기도,의정부시,50-54세,40990,19969,21021
202009,41150,경기도,의정부시,50-54세,41170,20052,21118
202010,41150,경기도,의정부시,50-54세,41404,20203,21201
202011,41150,경기도,의정부시,50-54세,41458,20226,21232
202012,41150,경기도,의정부시,50-54세,41440,20243,21197
202101,41150,경기도,의정부시,50-54세,41739,20385,21354
202102,41150,경기도,의정부시,50-54세,41878,20446,21432
202103,41150,경기도,의정부시,50-54세,41716,20354,21362
202104,41150,경기도,의정부시,50-54세,41772,20430,21342
202105,41150,경기도,의정부시,50-54세,42004,20584,21420
202106,41150,경기도,의정부시,50-54세,42138,20670,21468
202007,41150,경기도,의정부시,55-59세,38690,19216,19474
202008,41150,경기도,의정부시,55-59세,38686,19209,19477
202009,41150,경기도,의정부시,55-59세,38769,19224,19545
202010,41150,경기도,의정부시,55-59세,38764,19214,19550
202011,41150,경기도,의정부시,55-59세,38803,19212,19591
202012,41150,경기도,의정부시,55-59세,38947,19266,19681
202101,41150,경기도,의정부시,55-59세,38783,19183,19600
202102,41150,경기도,의정부시,55-59세,38743,19161,19582
202103,41150,경기도,의정부시,55-59세,38576,19092,19484
202104,41150,경기도,의정부시,55-59세,38504,19047,19457
202105,41150,경기도,의정부시,55-59세,38446,18968,19478
202106,41150,경기도,의정부시,55-59세,38290,18899,19391
202007,41150,경기도,의정부시,60-64세,33112,16310,16802
202008,41150,경기도,의정부시,60-64세,33359,16442,16917
202009,41150,경기도,의정부시,60-64세,33681,16603,17078
202010,41150,경기도,의정부시,60-64세,33991,16720,17271
202011,41150,경기도,의정부시,60-64세,34231,16844,17387
202012,41150,경기도,의정부시,60-64세,34450,16933,17517
202101,41150,경기도,의정부시,60-64세,34765,17072,17693
202102,41150,경기도,의정부시,60-64세,34998,17185,17813
202103,41150,경기도,의정부시,60-64세,34965,17214,17751
202104,41150,경기도,의정부시,60-64세,35226,17331,17895
202105,41150,경기도,의정부시,60-64세,35487,17462,18025
202106,41150,경기도,의정부시,60-64세,35787,17614,18173
202007,41150,경기도,의정부시,65-69세,21745,10162,11583
202008,41150,경기도,의정부시,65-69세,21964,10266,11698
202009,41150,경기도,의정부시,65-69세,22202,10375,11827
202010,41150,경기도,의정부시,65-69세,22382,10480,11902
202011,41150,경기도,의정부시,65-69세,22595,10561,12034
202012,41150,경기도,의정부시,65-69세,22834,10680,12154
202101,41150,경기도,의정부시,65-69세,23078,10816,12262
202102,41150,경기도,의정부시,65-69세,23293,10932,12361
202103,41150,경기도,의정부시,65-69세,23423,11061,12362
202104,41150,경기도,의정부시,65-69세,23552,11106,12446
202105,41150,경기도,의정부시,65-69세,23677,11165,12512
202106,41150,경기도,의정부시,65-69세,23864,11258,12606
202007,41150,경기도,의정부시,70-74세,16852,7566,9286
202008,41150,경기도,의정부시,70-74세,16954,7619,9335
202009,41150,경기도,의정부시,70-74세,17065,7664,9401
202010,41150,경기도,의정부시,70-74세,17183,7713,9470
202011,41150,경기도,의정부시,70-74세,17252,7744,9508
202012,41150,경기도,의정부시,70-74세,17359,7801,9558
202101,41150,경기도,의정부시,70-74세,17490,7863,9627
202102,41150,경기도,의정부시,70-74세,17537,7889,9648
202103,41150,경기도,의정부시,70-74세,17379,7840,9539
202104,41150,경기도,의정부시,70-74세,17404,7863,9541
202105,41150,경기도,의정부시,70-74세,17387,7873,9514
202106,41150,경기도,의정부시,70-74세,17363,7859,9504
202007,41150,경기도,의정부시,75-79세,13955,5951,8004
202008,41150,경기도,의정부시,75-79세,13982,5969,8013
202009,41150,경기도,의정부시,75-79세,13964,5974,7990
202010,41150,경기도,의정부시,75-79세,13973,5969,8004
202011,41150,경기도,의정부시,75-79세,13985,5962,8023
202012,41150,경기도,의정부시,75-79세,13954,5951,8003
202101,41150,경기도,의정부시,75-79세,13943,5960,7983
202102,41150,경기도,의정부시,75-79세,13869,5932,7937
202103,41150,경기도,의정부시,75-79세,13769,5885,7884
202104,41150,경기도,의정부시,75-79세,13761,5874,7887
202105,41150,경기도,의정부시,75-79세,13741,5856,7885
202106,41150,경기도,의정부시,75-79세,13736,5848,7888
202007,41150,경기도,의정부시,80-84세,9303,3593,5710
202008,41150,경기도,의정부시,80-84세,9349,3611,5738
202009,41150,경기도,의정부시,80-84세,9423,3646,5777
202010,41150,경기도,의정부시,80-84세,9502,3691,5811
202011,41150,경기도,의정부시,80-84세,9528,3711,5817
202012,41150,경기도,의정부시,80-84세,9583,3739,5844
202101,41150,경기도,의정부시,80-84세,9635,3766,5869
202102,41150,경기도,의정부시,80-84세,9746,3815,5931
202103,41150,경기도,의정부시,80-84세,9727,3808,5919
202104,41150,경기도,의정부시,80-84세,9772,3833,5939
202105,41150,경기도,의정부시,80-84세,9793,3866,5927
202106,41150,경기도,의정부시,80-84세,9843,3905,5938
202007,41150,경기도,의정부시,85-89세,4271,1388,2883
202008,41150,경기도,의정부시,85-89세,4309,1402,2907
202009,41150,경기도,의정부시,85-89세,4360,1425,2935
202010,41150,경기도,의정부시,85-89세,4390,1438,2952
202011,41150,경기도,의정부시,85-89세,4441,1460,2981
202012,41150,경기도,의정부시,85-89세,4519,1483,3036
202101,41150,경기도,의정부시,85-89세,4558,1495,3063
202102,41150,경기도,의정부시,85-89세,4598,1515,3083
202103,41150,경기도,의정부시,85-89세,4615,1514,3101
202104,41150,경기도,의정부시,85-89세,4679,1537,3142
202105,41150,경기도,의정부시,85-89세,4716,1540,3176
202106,41150,경기도,의정부시,85-89세,4761,1546,3215
202007,41150,경기도,의정부시,90-94세,1458,357,1101
202008,41150,경기도,의정부시,90-94세,1482,366,1116
202009,41150,경기도,의정부시,90-94세,1497,360,1137
202010,41150,경기도,의정부시,90-94세,1504,361,1143
202011,41150,경기도,의정부시,90-94세,1516,368,1148
202012,41150,경기도,의정부시,90-94세,1542,377,1165
202101,41150,경기도,의정부시,90-94세,1561,377,1184
202102,41150,경기도,의정부시,90-94세,1581,381,1200
202103,41150,경기도,의정부시,90-94세,1569,371,1198
202104,41150,경기도,의정부시,90-94세,1578,369,1209
202105,41150,경기도,의정부시,90-94세,1572,366,1206
202106,41150,경기도,의정부시,90-94세,1577,370,1207
202007,41150,경기도,의정부시,95-99세,342,71,271
202008,41150,경기도,의정부시,95-99세,350,72,278
202009,41150,경기도,의정부시,95-99세,360,78,282
202010,41150,경기도,의정부시,95-99세,357,75,282
202011,41150,경기도,의정부시,95-99세,349,74,275
202012,41150,경기도,의정부시,95-99세,345,72,273
202101,41150,경기도,의정부시,95-99세,347,75,272
202102,41150,경기도,의정부시,95-99세,357,77,280
202103,41150,경기도,의정부시,95-99세,330,68,262
202104,41150,경기도,의정부시,95-99세,324,67,257
202105,41150,경기도,의정부시,95-99세,319,68,251
202106,41150,경기도,의정부시,95-99세,319,67,252
202007,41150,경기도,의정부시,100+,214,46,168
202008,41150,경기도,의정부시,100+,214,46,168
202009,41150,경기도,의정부시,100+,217,46,171
202010,41150,경기도,의정부시,100+,224,49,175
202011,41150,경기도,의정부시,100+,227,49,178
202012,41150,경기도,의정부시,100+,233,51,182
202101,41150,경기도,의정부시,100+,235,51,184
202102,41150,경기도,의정부시,100+,235,51,184
202103,41150,경기도,의정부시,100+,127,27,100
202104,41150,경기도,의정부시,100+,128,27,101
202105,41150,경기도,의정부시,100+,76,18,58
202106,41150,경기도,의정부시,100+,76,17,59
202007,41171,경기도,안양시 만안구,0-4세,7568,3821,3747
202008,41171,경기도,안양시 만안구,0-4세,7470,3763,3707
202009,41171,경기도,안양시 만안구,0-4세,7401,3727,3674
202010,41171,경기도,안양시 만안구,0-4세,7358,3699,3659
202011,41171,경기도,안양시 만안구,0-4세,7266,3646,3620
202012,41171,경기도,안양시 만안구,0-4세,7189,3612,3577
202101,41171,경기도,안양시 만안구,0-4세,7104,3579,3525
202102,41171,경기도,안양시 만안구,0-4세,6997,3505,3492
202103,41171,경기도,안양시 만안구,0-4세,7020,3508,3512
202104,41171,경기도,안양시 만안구,0-4세,6977,3489,3488
202105,41171,경기도,안양시 만안구,0-4세,6923,3454,3469
202106,41171,경기도,안양시 만안구,0-4세,6879,3441,3438
202007,41171,경기도,안양시 만안구,5-9세,8551,4385,4166
202008,41171,경기도,안양시 만안구,5-9세,8484,4339,4145
202009,41171,경기도,안양시 만안구,5-9세,8478,4322,4156
202010,41171,경기도,안양시 만안구,5-9세,8440,4313,4127
202011,41171,경기도,안양시 만안구,5-9세,8399,4285,4114
202012,41171,경기도,안양시 만안구,5-9세,8371,4271,4100
202101,41171,경기도,안양시 만안구,5-9세,8304,4219,4085
202102,41171,경기도,안양시 만안구,5-9세,8171,4170,4001
202103,41171,경기도,안양시 만안구,5-9세,8167,4169,3998
202104,41171,경기도,안양시 만안구,5-9세,8187,4196,3991
202105,41171,경기도,안양시 만안구,5-9세,8200,4200,4000
202106,41171,경기도,안양시 만안구,5-9세,8198,4187,4011
202007,41171,경기도,안양시 만안구,10-14세,8552,4480,4072
202008,41171,경기도,안양시 만안구,10-14세,8556,4501,4055
202009,41171,경기도,안양시 만안구,10-14세,8533,4498,4035
202010,41171,경기도,안양시 만안구,10-14세,8574,4505,4069
202011,41171,경기도,안양시 만안구,10-14세,8563,4486,4077
202012,41171,경기도,안양시 만안구,10-14세,8559,4488,4071
202101,41171,경기도,안양시 만안구,10-14세,8575,4490,4085
202102,41171,경기도,안양시 만안구,10-14세,8476,4419,4057
202103,41171,경기도,안양시 만안구,10-14세,8484,4427,4057
202104,41171,경기도,안양시 만안구,10-14세,8471,4425,4046
202105,41171,경기도,안양시 만안구,10-14세,8437,4402,4035
202106,41171,경기도,안양시 만안구,10-14세,8424,4399,4025
202007,41171,경기도,안양시 만안구,15-19세,10780,5569,5211
202008,41171,경기도,안양시 만안구,15-19세,10660,5505,5155
202009,41171,경기도,안양시 만안구,15-19세,10523,5447,5076
202010,41171,경기도,안양시 만안구,15-19세,10452,5410,5042
202011,41171,경기도,안양시 만안구,15-19세,10386,5389,4997
202012,41171,경기도,안양시 만안구,15-19세,10300,5347,4953
202101,41171,경기도,안양시 만안구,15-19세,10200,5301,4899
202102,41171,경기도,안양시 만안구,15-19세,10158,5297,4861
202103,41171,경기도,안양시 만안구,15-19세,10091,5261,4830
202104,41171,경기도,안양시 만안구,15-19세,10030,5229,4801
202105,41171,경기도,안양시 만안구,15-19세,10014,5220,4794
202106,41171,경기도,안양시 만안구,15-19세,10008,5220,4788
202007,41171,경기도,안양시 만안구,20-24세,16282,8442,7840
202008,41171,경기도,안양시 만안구,20-24세,16234,8443,7791
202009,41171,경기도,안양시 만안구,20-24세,16166,8389,7777
202010,41171,경기도,안양시 만안구,20-24세,16090,8364,7726
202011,41171,경기도,안양시 만안구,20-24세,16045,8320,7725
202012,41171,경기도,안양시 만안구,20-24세,15918,8250,7668
202101,41171,경기도,안양시 만안구,20-24세,15801,8179,7622
202102,41171,경기도,안양시 만안구,20-24세,15720,8134,7586
202103,41171,경기도,안양시 만안구,20-24세,15689,8103,7586
202104,41171,경기도,안양시 만안구,20-24세,15728,8113,7615
202105,41171,경기도,안양시 만안구,20-24세,15642,8052,7590
202106,41171,경기도,안양시 만안구,20-24세,15630,8044,7586
202007,41171,경기도,안양시 만안구,25-29세,18617,9848,8769
202008,41171,경기도,안양시 만안구,25-29세,18664,9870,8794
202009,41171,경기도,안양시 만안구,25-29세,18642,9854,8788
202010,41171,경기도,안양시 만안구,25-29세,18602,9812,8790
202011,41171,경기도,안양시 만안구,25-29세,18575,9797,8778
202012,41171,경기도,안양시 만안구,25-29세,18584,9816,8768
202101,41171,경기도,안양시 만안구,25-29세,18557,9794,8763
202102,41171,경기도,안양시 만안구,25-29세,18388,9689,8699
202103,41171,경기도,안양시 만안구,25-29세,18409,9712,8697
202104,41171,경기도,안양시 만안구,25-29세,18474,9762,8712
202105,41171,경기도,안양시 만안구,25-29세,18468,9779,8689
202106,41171,경기도,안양시 만안구,25-29세,18478,9775,8703
202007,41171,경기도,안양시 만안구,30-34세,16329,8493,7836
202008,41171,경기도,안양시 만안구,30-34세,16279,8499,7780
202009,41171,경기도,안양시 만안구,30-34세,16214,8476,7738
202010,41171,경기도,안양시 만안구,30-34세,16178,8452,7726
202011,41171,경기도,안양시 만안구,30-34세,16129,8440,7689
202012,41171,경기도,안양시 만안구,30-34세,16078,8448,7630
202101,41171,경기도,안양시 만안구,30-34세,16015,8423,7592
202102,41171,경기도,안양시 만안구,30-34세,15977,8406,7571
202103,41171,경기도,안양시 만안구,30-34세,16113,8464,7649
202104,41171,경기도,안양시 만안구,30-34세,16228,8531,7697
202105,41171,경기도,안양시 만안구,30-34세,16269,8541,7728
202106,41171,경기도,안양시 만안구,30-34세,16354,8588,7766
202007,41171,경기도,안양시 만안구,35-39세,17233,9153,8080
202008,41171,경기도,안양시 만안구,35-39세,17089,9063,8026
202009,41171,경기도,안양시 만안구,35-39세,17011,9035,7976
202010,41171,경기도,안양시 만안구,35-39세,16978,9030,7948
202011,41171,경기도,안양시 만안구,35-39세,16922,8992,7930
202012,41171,경기도,안양시 만안구,35-39세,16876,8948,7928
202101,41171,경기도,안양시 만안구,35-39세,16831,8956,7875
202102,41171,경기도,안양시 만안구,35-39세,16655,8874,7781
202103,41171,경기도,안양시 만안구,35-39세,16614,8852,7762
202104,41171,경기도,안양시 만안구,35-39세,16602,8840,7762
202105,41171,경기도,안양시 만안구,35-39세,16602,8831,7771
202106,41171,경기도,안양시 만안구,35-39세,16580,8798,7782
202007,41171,경기도,안양시 만안구,40-44세,16459,8515,7944
202008,41171,경기도,안양시 만안구,40-44세,16391,8513,7878
202009,41171,경기도,안양시 만안구,40-44세,16427,8514,7913
202010,41171,경기도,안양시 만안구,40-44세,16477,8529,7948
202011,41171,경기도,안양시 만안구,40-44세,16503,8563,7940
202012,41171,경기도,안양시 만안구,40-44세,16435,8548,7887
202101,41171,경기도,안양시 만안구,40-44세,16397,8522,7875
202102,41171,경기도,안양시 만안구,40-44세,16296,8469,7827
202103,41171,경기도,안양시 만안구,40-44세,16300,8487,7813
202104,41171,경기도,안양시 만안구,40-44세,16332,8514,7818
202105,41171,경기도,안양시 만안구,40-44세,16369,8545,7824
202106,41171,경기도,안양시 만안구,40-44세,16463,8610,7853
202007,41171,경기도,안양시 만안구,45-49세,19330,9738,9592
202008,41171,경기도,안양시 만안구,45-49세,19213,9668,9545
202009,41171,경기도,안양시 만안구,45-49세,19058,9607,9451
202010,41171,경기도,안양시 만안구,45-49세,18952,9560,9392
202011,41171,경기도,안양시 만안구,45-49세,18836,9486,9350
202012,41171,경기도,안양시 만안구,45-49세,18749,9447,9302
202101,41171,경기도,안양시 만안구,45-49세,18635,9400,9235
202102,41171,경기도,안양시 만안구,45-49세,18572,9374,9198
202103,41171,경기도,안양시 만안구,45-49세,18399,9302,9097
202104,41171,경기도,안양시 만안구,45-49세,18359,9268,9091
202105,41171,경기도,안양시 만안구,45-49세,18190,9177,9013
202106,41171,경기도,안양시 만안구,45-49세,18090,9114,8976
202007,41171,경기도,안양시 만안구,50-54세,21501,10423,11078
202008,41171,경기도,안양시 만안구,50-54세,21510,10430,11080
202009,41171,경기도,안양시 만안구,50-54세,21552,10448,11104
202010,41171,경기도,안양시 만안구,50-54세,21524,10437,11087
202011,41171,경기도,안양시 만안구,50-54세,21475,10432,11043
202012,41171,경기도,안양시 만안구,50-54세,21340,10318,11022
202101,41171,경기도,안양시 만안구,50-54세,21442,10372,11070
202102,41171,경기도,안양시 만안구,50-54세,21353,10340,11013
202103,41171,경기도,안양시 만안구,50-54세,21260,10293,10967
202104,41171,경기도,안양시 만안구,50-54세,21294,10288,11006
202105,41171,경기도,안양시 만안구,50-54세,21414,10358,11056
202106,41171,경기도,안양시 만안구,50-54세,21458,10386,11072
202007,41171,경기도,안양시 만안구,55-59세,22532,11224,11308
202008,41171,경기도,안양시 만안구,55-59세,22428,11158,11270
202009,41171,경기도,안양시 만안구,55-59세,22367,11132,11235
202010,41171,경기도,안양시 만안구,55-59세,22251,11059,11192
202011,41171,경기도,안양시 만안구,55-59세,22087,10961,11126
202012,41171,경기도,안양시 만안구,55-59세,22045,10966,11079
202101,41171,경기도,안양시 만안구,55-59세,21872,10888,10984
202102,41171,경기도,안양시 만안구,55-59세,21781,10822,10959
202103,41171,경기도,안양시 만안구,55-59세,21697,10807,10890
202104,41171,경기도,안양시 만안구,55-59세,21615,10785,10830
202105,41171,경기도,안양시 만안구,55-59세,21567,10735,10832
202106,41171,경기도,안양시 만안구,55-59세,21396,10640,10756
202007,41171,경기도,안양시 만안구,60-64세,20338,10016,10322
202008,41171,경기도,안양시 만안구,60-64세,20426,10076,10350
202009,41171,경기도,안양시 만안구,60-64세,20477,10095,10382
202010,41171,경기도,안양시 만안구,60-64세,20577,10133,10444
202011,41171,경기도,안양시 만안구,60-64세,20693,10197,10496
202012,41171,경기도,안양시 만안구,60-64세,20789,10238,10551
202101,41171,경기도,안양시 만안구,60-64세,20923,10288,10635
202102,41171,경기도,안양시 만안구,60-64세,21055,10361,10694
202103,41171,경기도,안양시 만안구,60-64세,21083,10338,10745
202104,41171,경기도,안양시 만안구,60-64세,21208,10389,10819
202105,41171,경기도,안양시 만안구,60-64세,21360,10477,10883
202106,41171,경기도,안양시 만안구,60-64세,21477,10530,10947
202007,41171,경기도,안양시 만안구,65-69세,13219,6543,6676
202008,41171,경기도,안양시 만안구,65-69세,13306,6593,6713
202009,41171,경기도,안양시 만안구,65-69세,13426,6633,6793
202010,41171,경기도,안양시 만안구,65-69세,13492,6681,6811
202011,41171,경기도,안양시 만안구,65-69세,13612,6740,6872
202012,41171,경기도,안양시 만안구,65-69세,13689,6774,6915
202101,41171,경기도,안양시 만안구,65-69세,13829,6829,7000
202102,41171,경기도,안양시 만안구,65-69세,13877,6848,7029
202103,41171,경기도,안양시 만안구,65-69세,14001,6926,7075
202104,41171,경기도,안양시 만안구,65-69세,14095,6976,7119
202105,41171,경기도,안양시 만안구,65-69세,14201,7033,7168
202106,41171,경기도,안양시 만안구,65-69세,14318,7100,7218
202007,41171,경기도,안양시 만안구,70-74세,9249,4495,4754
202008,41171,경기도,안양시 만안구,70-74세,9258,4493,4765
202009,41171,경기도,안양시 만안구,70-74세,9326,4531,4795
202010,41171,경기도,안양시 만안구,70-74세,9401,4576,4825
202011,41171,경기도,안양시 만안구,70-74세,9425,4598,4827
202012,41171,경기도,안양시 만안구,70-74세,9467,4625,4842
202101,41171,경기도,안양시 만안구,70-74세,9524,4661,4863
202102,41171,경기도,안양시 만안구,70-74세,9562,4683,4879
202103,41171,경기도,안양시 만안구,70-74세,9561,4677,4884
202104,41171,경기도,안양시 만안구,70-74세,9574,4687,4887
202105,41171,경기도,안양시 만안구,70-74세,9556,4660,4896
202106,41171,경기도,안양시 만안구,70-74세,9505,4638,4867
202007,41171,경기도,안양시 만안구,75-79세,7052,3081,3971
202008,41171,경기도,안양시 만안구,75-79세,7084,3105,3979
202009,41171,경기도,안양시 만안구,75-79세,7084,3101,3983
202010,41171,경기도,안양시 만안구,75-79세,7072,3093,3979
202011,41171,경기도,안양시 만안구,75-79세,7043,3068,3975
202012,41171,경기도,안양시 만안구,75-79세,6991,3043,3948
202101,41171,경기도,안양시 만안구,75-79세,6986,3045,3941
202102,41171,경기도,안양시 만안구,75-79세,6958,3027,3931
202103,41171,경기도,안양시 만안구,75-79세,6935,3032,3903
202104,41171,경기도,안양시 만안구,75-79세,6956,3049,3907
202105,41171,경기도,안양시 만안구,75-79세,6979,3080,3899
202106,41171,경기도,안양시 만안구,75-79세,6971,3080,3891
202007,41171,경기도,안양시 만안구,80-84세,4601,1749,2852
202008,41171,경기도,안양시 만안구,80-84세,4581,1752,2829
202009,41171,경기도,안양시 만안구,80-84세,4582,1760,2822
202010,41171,경기도,안양시 만안구,80-84세,4584,1756,2828
202011,41171,경기도,안양시 만안구,80-84세,4604,1763,2841
202012,41171,경기도,안양시 만안구,80-84세,4606,1750,2856
202101,41171,경기도,안양시 만안구,80-84세,4618,1758,2860
202102,41171,경기도,안양시 만안구,80-84세,4640,1777,2863
202103,41171,경기도,안양시 만안구,80-84세,4649,1775,2874
202104,41171,경기도,안양시 만안구,80-84세,4644,1776,2868
202105,41171,경기도,안양시 만안구,80-84세,4679,1790,2889
202106,41171,경기도,안양시 만안구,80-84세,4698,1799,2899
202007,41171,경기도,안양시 만안구,85-89세,2261,690,1571
202008,41171,경기도,안양시 만안구,85-89세,2283,684,1599
202009,41171,경기도,안양시 만안구,85-89세,2284,688,1596
202010,41171,경기도,안양시 만안구,85-89세,2303,704,1599
202011,41171,경기도,안양시 만안구,85-89세,2322,710,1612
202012,41171,경기도,안양시 만안구,85-89세,2363,734,1629
202101,41171,경기도,안양시 만안구,85-89세,2377,731,1646
202102,41171,경기도,안양시 만안구,85-89세,2396,734,1662
202103,41171,경기도,안양시 만안구,85-89세,2393,737,1656
202104,41171,경기도,안양시 만안구,85-89세,2429,750,1679
202105,41171,경기도,안양시 만안구,85-89세,2440,752,1688
202106,41171,경기도,안양시 만안구,85-89세,2434,740,1694
202007,41171,경기도,안양시 만안구,90-94세,730,157,573
202008,41171,경기도,안양시 만안구,90-94세,740,159,581
202009,41171,경기도,안양시 만안구,90-94세,756,162,594
202010,41171,경기도,안양시 만안구,90-94세,764,162,602
202011,41171,경기도,안양시 만안구,90-94세,768,165,603
202012,41171,경기도,안양시 만안구,90-94세,769,164,605
202101,41171,경기도,안양시 만안구,90-94세,784,176,608
202102,41171,경기도,안양시 만안구,90-94세,801,183,618
202103,41171,경기도,안양시 만안구,90-94세,777,170,607
202104,41171,경기도,안양시 만안구,90-94세,780,172,608
202105,41171,경기도,안양시 만안구,90-94세,769,166,603
202106,41171,경기도,안양시 만안구,90-94세,782,169,613
202007,41171,경기도,안양시 만안구,95-99세,214,56,158
202008,41171,경기도,안양시 만안구,95-99세,210,52,158
202009,41171,경기도,안양시 만안구,95-99세,215,54,161
202010,41171,경기도,안양시 만안구,95-99세,212,53,159
202011,41171,경기도,안양시 만안구,95-99세,211,50,161
202012,41171,경기도,안양시 만안구,95-99세,209,48,161
202101,41171,경기도,안양시 만안구,95-99세,207,48,159
202102,41171,경기도,안양시 만안구,95-99세,206,48,158
202103,41171,경기도,안양시 만안구,95-99세,187,42,145
202104,41171,경기도,안양시 만안구,95-99세,196,44,152
202105,41171,경기도,안양시 만안구,95-99세,200,48,152
202106,41171,경기도,안양시 만안구,95-99세,205,49,156
202007,41171,경기도,안양시 만안구,100+,80,26,54
202008,41171,경기도,안양시 만안구,100+,80,26,54
202009,41171,경기도,안양시 만안구,100+,82,27,55
202010,41171,경기도,안양시 만안구,100+,83,28,55
202011,41171,경기도,안양시 만안구,100+,83,28,55
202012,41171,경기도,안양시 만안구,100+,86,29,57
202101,41171,경기도,안양시 만안구,100+,89,30,59
202102,41171,경기도,안양시 만안구,100+,92,31,61
202103,41171,경기도,안양시 만안구,100+,50,14,36
202104,41171,경기도,안양시 만안구,100+,52,14,38
202105,41171,경기도,안양시 만안구,100+,52,14,38
202106,41171,경기도,안양시 만안구,100+,43,11,32
202007,41173,경기도,안양시 동안구,0-4세,10421,5309,5112
202008,41173,경기도,안양시 동안구,0-4세,10290,5266,5024
202009,41173,경기도,안양시 동안구,0-4세,10169,5212,4957
202010,41173,경기도,안양시 동안구,0-4세,10043,5156,4887
202011,41173,경기도,안양시 동안구,0-4세,9936,5098,4838
202012,41173,경기도,안양시 동안구,0-4세,9810,5037,4773
202101,41173,경기도,안양시 동안구,0-4세,9741,5001,4740
202102,41173,경기도,안양시 동안구,0-4세,9931,5086,4845
202103,41173,경기도,안양시 동안구,0-4세,9973,5081,4892
202104,41173,경기도,안양시 동안구,0-4세,9984,5087,4897
202105,41173,경기도,안양시 동안구,0-4세,9907,5055,4852
202106,41173,경기도,안양시 동안구,0-4세,9810,5002,4808
202007,41173,경기도,안양시 동안구,5-9세,14275,7275,7000
202008,41173,경기도,안양시 동안구,5-9세,14220,7257,6963
202009,41173,경기도,안양시 동안구,5-9세,14133,7192,6941
202010,41173,경기도,안양시 동안구,5-9세,14036,7138,6898
202011,41173,경기도,안양시 동안구,5-9세,13969,7098,6871
202012,41173,경기도,안양시 동안구,5-9세,13924,7078,6846
202101,41173,경기도,안양시 동안구,5-9세,13831,7030,6801
202102,41173,경기도,안양시 동안구,5-9세,14029,7139,6890
202103,41173,경기도,안양시 동안구,5-9세,14026,7157,6869
202104,41173,경기도,안양시 동안구,5-9세,13956,7136,6820
202105,41173,경기도,안양시 동안구,5-9세,13914,7111,6803
202106,41173,경기도,안양시 동안구,5-9세,13885,7112,6773
202007,41173,경기도,안양시 동안구,10-14세,16134,8340,7794
202008,41173,경기도,안양시 동안구,10-14세,16098,8310,7788
202009,41173,경기도,안양시 동안구,10-14세,16100,8322,7778
202010,41173,경기도,안양시 동안구,10-14세,16108,8340,7768
202011,41173,경기도,안양시 동안구,10-14세,16115,8360,7755
202012,41173,경기도,안양시 동안구,10-14세,16110,8346,7764
202101,41173,경기도,안양시 동안구,10-14세,16164,8390,7774
202102,41173,경기도,안양시 동안구,10-14세,16260,8426,7834
202103,41173,경기도,안양시 동안구,10-14세,16279,8401,7878
202104,41173,경기도,안양시 동안구,10-14세,16263,8403,7860
202105,41173,경기도,안양시 동안구,10-14세,16227,8360,7867
202106,41173,경기도,안양시 동안구,10-14세,16182,8317,7865
202007,41173,경기도,안양시 동안구,15-19세,18172,9350,8822
202008,41173,경기도,안양시 동안구,15-19세,18017,9252,8765
202009,41173,경기도,안양시 동안구,15-19세,17867,9182,8685
202010,41173,경기도,안양시 동안구,15-19세,17691,9101,8590
202011,41173,경기도,안양시 동안구,15-19세,17523,9013,8510
202012,41173,경기도,안양시 동안구,15-19세,17388,8952,8436
202101,41173,경기도,안양시 동안구,15-19세,17339,8956,8383
202102,41173,경기도,안양시 동안구,15-19세,17321,8961,8360
202103,41173,경기도,안양시 동안구,15-19세,17205,8911,8294
202104,41173,경기도,안양시 동안구,15-19세,17096,8832,8264
202105,41173,경기도,안양시 동안구,15-19세,16996,8808,8188
202106,41173,경기도,안양시 동안구,15-19세,16922,8762,8160
202007,41173,경기도,안양시 동안구,20-24세,21450,11157,10293
202008,41173,경기도,안양시 동안구,20-24세,21310,11074,10236
202009,41173,경기도,안양시 동안구,20-24세,21207,11027,10180
202010,41173,경기도,안양시 동안구,20-24세,21103,10974,10129
202011,41173,경기도,안양시 동안구,20-24세,21117,10974,10143
202012,41173,경기도,안양시 동안구,20-24세,21029,10903,10126
202101,41173,경기도,안양시 동안구,20-24세,20961,10833,10128
202102,41173,경기도,안양시 동안구,20-24세,20871,10796,10075
202103,41173,경기도,안양시 동안구,20-24세,20833,10753,10080
202104,41173,경기도,안양시 동안구,20-24세,20769,10718,10051
202105,41173,경기도,안양시 동안구,20-24세,20716,10693,10023
202106,41173,경기도,안양시 동안구,20-24세,20609,10637,9972
202007,41173,경기도,안양시 동안구,25-29세,22626,11689,10937
202008,41173,경기도,안양시 동안구,25-29세,22478,11601,10877
202009,41173,경기도,안양시 동안구,25-29세,22297,11511,10786
202010,41173,경기도,안양시 동안구,25-29세,22217,11454,10763
202011,41173,경기도,안양시 동안구,25-29세,22245,11443,10802
202012,41173,경기도,안양시 동안구,25-29세,22223,11433,10790
202101,41173,경기도,안양시 동안구,25-29세,22097,11324,10773
202102,41173,경기도,안양시 동안구,25-29세,22188,11395,10793
202103,41173,경기도,안양시 동안구,25-29세,22275,11451,10824
202104,41173,경기도,안양시 동안구,25-29세,22200,11407,10793
202105,41173,경기도,안양시 동안구,25-29세,22098,11348,10750
202106,41173,경기도,안양시 동안구,25-29세,22006,11272,10734
202007,41173,경기도,안양시 동안구,30-34세,21414,10898,10516
202008,41173,경기도,안양시 동안구,30-34세,21297,10847,10450
202009,41173,경기도,안양시 동안구,30-34세,21159,10764,10395
202010,41173,경기도,안양시 동안구,30-34세,21027,10676,10351
202011,41173,경기도,안양시 동안구,30-34세,20950,10650,10300
202012,41173,경기도,안양시 동안구,30-34세,20880,10641,10239
202101,41173,경기도,안양시 동안구,30-34세,20995,10703,10292
202102,41173,경기도,안양시 동안구,30-34세,21309,10857,10452
202103,41173,경기도,안양시 동안구,30-34세,21609,11023,10586
202104,41173,경기도,안양시 동안구,30-34세,21699,11054,10645
202105,41173,경기도,안양시 동안구,30-34세,21706,11045,10661
202106,41173,경기도,안양시 동안구,30-34세,21642,11002,10640
202007,41173,경기도,안양시 동안구,35-39세,23242,11557,11685
202008,41173,경기도,안양시 동안구,35-39세,23103,11494,11609
202009,41173,경기도,안양시 동안구,35-39세,22875,11389,11486
202010,41173,경기도,안양시 동안구,35-39세,22712,11282,11430
202011,41173,경기도,안양시 동안구,35-39세,22610,11232,11378
202012,41173,경기도,안양시 동안구,35-39세,22519,11171,11348
202101,41173,경기도,안양시 동안구,35-39세,22514,11175,11339
202102,41173,경기도,안양시 동안구,35-39세,22824,11336,11488
202103,41173,경기도,안양시 동안구,35-39세,22925,11412,11513
202104,41173,경기도,안양시 동안구,35-39세,22861,11381,11480
202105,41173,경기도,안양시 동안구,35-39세,22815,11368,11447
202106,41173,경기도,안양시 동안구,35-39세,22671,11315,11356
202007,41173,경기도,안양시 동안구,40-44세,24097,11348,12749
202008,41173,경기도,안양시 동안구,40-44세,24056,11337,12719
202009,41173,경기도,안양시 동안구,40-44세,23995,11301,12694
202010,41173,경기도,안양시 동안구,40-44세,24009,11317,12692
202011,41173,경기도,안양시 동안구,40-44세,23971,11294,12677
202012,41173,경기도,안양시 동안구,40-44세,23847,11269,12578
202101,41173,경기도,안양시 동안구,40-44세,23832,11285,12547
202102,41173,경기도,안양시 동안구,40-44세,24197,11532,12665
202103,41173,경기도,안양시 동안구,40-44세,24175,11539,12636
202104,41173,경기도,안양시 동안구,40-44세,24162,11563,12599
202105,41173,경기도,안양시 동안구,40-44세,24159,11571,12588
202106,41173,경기도,안양시 동안구,40-44세,24191,11590,12601
202007,41173,경기도,안양시 동안구,45-49세,29704,14176,15528
202008,41173,경기도,안양시 동안구,45-49세,29492,14068,15424
202009,41173,경기도,안양시 동안구,45-49세,29285,13961,15324
202010,41173,경기도,안양시 동안구,45-49세,29048,13847,15201
202011,41173,경기도,안양시 동안구,45-49세,28857,13780,15077
202012,41173,경기도,안양시 동안구,45-49세,28775,13728,15047
202101,41173,경기도,안양시 동안구,45-49세,28633,13639,14994
202102,41173,경기도,안양시 동안구,45-49세,28660,13619,15041
202103,41173,경기도,안양시 동안구,45-49세,28566,13590,14976
202104,41173,경기도,안양시 동안구,45-49세,28495,13553,14942
202105,41173,경기도,안양시 동안구,45-49세,28272,13428,14844
202106,41173,경기도,안양시 동안구,45-49세,28057,13305,14752
202007,41173,경기도,안양시 동안구,50-54세,28413,13745,14668
202008,41173,경기도,안양시 동안구,50-54세,28381,13748,14633
202009,41173,경기도,안양시 동안구,50-54세,28402,13770,14632
202010,41173,경기도,안양시 동안구,50-54세,28403,13751,14652
202011,41173,경기도,안양시 동안구,50-54세,28448,13762,14686
202012,41173,경기도,안양시 동안구,50-54세,28308,13696,14612
202101,41173,경기도,안양시 동안구,50-54세,28511,13778,14733
202102,41173,경기도,안양시 동안구,50-54세,28605,13838,14767
202103,41173,경기도,안양시 동안구,50-54세,28578,13794,14784
202104,41173,경기도,안양시 동안구,50-54세,28573,13776,14797
202105,41173,경기도,안양시 동안구,50-54세,28603,13802,14801
202106,41173,경기도,안양시 동안구,50-54세,28610,13816,14794
202007,41173,경기도,안양시 동안구,55-59세,26261,12631,13630
202008,41173,경기도,안양시 동안구,55-59세,26101,12522,13579
202009,41173,경기도,안양시 동안구,55-59세,25926,12410,13516
202010,41173,경기도,안양시 동안구,55-59세,25858,12366,13492
202011,41173,경기도,안양시 동안구,55-59세,25799,12315,13484
202012,41173,경기도,안양시 동안구,55-59세,25820,12337,13483
202101,41173,경기도,안양시 동안구,55-59세,25629,12261,13368
202102,41173,경기도,안양시 동안구,55-59세,25652,12269,13383
202103,41173,경기도,안양시 동안구,55-59세,25545,12263,13282
202104,41173,경기도,안양시 동안구,55-59세,25401,12205,13196
202105,41173,경기도,안양시 동안구,55-59세,25216,12112,13104
202106,41173,경기도,안양시 동안구,55-59세,24982,12005,12977
202007,41173,경기도,안양시 동안구,60-64세,22172,10905,11267
202008,41173,경기도,안양시 동안구,60-64세,22240,10949,11291
202009,41173,경기도,안양시 동안구,60-64세,22300,10976,11324
202010,41173,경기도,안양시 동안구,60-64세,22381,11003,11378
202011,41173,경기도,안양시 동안구,60-64세,22523,11074,11449
202012,41173,경기도,안양시 동안구,60-64세,22580,11081,11499
202101,41173,경기도,안양시 동안구,60-64세,22723,11147,11576
202102,41173,경기도,안양시 동안구,60-64세,22942,11241,11701
202103,41173,경기도,안양시 동안구,60-64세,23157,11283,11874
202104,41173,경기도,안양시 동안구,60-64세,23279,11340,11939
202105,41173,경기도,안양시 동안구,60-64세,23404,11394,12010
202106,41173,경기도,안양시 동안구,60-64세,23515,11448,12067
202007,41173,경기도,안양시 동안구,65-69세,13259,6634,6625
202008,41173,경기도,안양시 동안구,65-69세,13352,6680,6672
202009,41173,경기도,안양시 동안구,65-69세,13455,6714,6741
202010,41173,경기도,안양시 동안구,65-69세,13602,6808,6794
202011,41173,경기도,안양시 동안구,65-69세,13675,6841,6834
202012,41173,경기도,안양시 동안구,65-69세,13787,6900,6887
202101,41173,경기도,안양시 동안구,65-69세,13962,6996,6966
202102,41173,경기도,안양시 동안구,65-69세,14147,7081,7066
202103,41173,경기도,안양시 동안구,65-69세,14341,7202,7139
202104,41173,경기도,안양시 동안구,65-69세,14470,7261,7209
202105,41173,경기도,안양시 동안구,65-69세,14576,7306,7270
202106,41173,경기도,안양시 동안구,65-69세,14636,7330,7306
202007,41173,경기도,안양시 동안구,70-74세,8675,4050,4625
202008,41173,경기도,안양시 동안구,70-74세,8693,4059,4634
202009,41173,경기도,안양시 동안구,70-74세,8738,4102,4636
202010,41173,경기도,안양시 동안구,70-74세,8776,4114,4662
202011,41173,경기도,안양시 동안구,70-74세,8861,4169,4692
202012,41173,경기도,안양시 동안구,70-74세,8891,4175,4716
202101,41173,경기도,안양시 동안구,70-74세,8994,4215,4779
202102,41173,경기도,안양시 동안구,70-74세,9081,4261,4820
202103,41173,경기도,안양시 동안구,70-74세,9063,4265,4798
202104,41173,경기도,안양시 동안구,70-74세,9053,4252,4801
202105,41173,경기도,안양시 동안구,70-74세,9056,4252,4804
202106,41173,경기도,안양시 동안구,70-74세,9044,4254,4790
202007,41173,경기도,안양시 동안구,75-79세,6477,2734,3743
202008,41173,경기도,안양시 동안구,75-79세,6447,2716,3731
202009,41173,경기도,안양시 동안구,75-79세,6423,2704,3719
202010,41173,경기도,안양시 동안구,75-79세,6382,2699,3683
202011,41173,경기도,안양시 동안구,75-79세,6338,2666,3672
202012,41173,경기도,안양시 동안구,75-79세,6296,2645,3651
202101,41173,경기도,안양시 동안구,75-79세,6268,2647,3621
202102,41173,경기도,안양시 동안구,75-79세,6257,2666,3591
202103,41173,경기도,안양시 동안구,75-79세,6244,2650,3594
202104,41173,경기도,안양시 동안구,75-79세,6225,2659,3566
202105,41173,경기도,안양시 동안구,75-79세,6240,2678,3562
202106,41173,경기도,안양시 동안구,75-79세,6216,2665,3551
202007,41173,경기도,안양시 동안구,80-84세,4517,1607,2910
202008,41173,경기도,안양시 동안구,80-84세,4537,1625,2912
202009,41173,경기도,안양시 동안구,80-84세,4531,1625,2906
202010,41173,경기도,안양시 동안구,80-84세,4555,1628,2927
202011,41173,경기도,안양시 동안구,80-84세,4549,1637,2912
202012,41173,경기도,안양시 동안구,80-84세,4565,1652,2913
202101,41173,경기도,안양시 동안구,80-84세,4568,1645,2923
202102,41173,경기도,안양시 동안구,80-84세,4586,1639,2947
202103,41173,경기도,안양시 동안구,80-84세,4605,1661,2944
202104,41173,경기도,안양시 동안구,80-84세,4601,1660,2941
202105,41173,경기도,안양시 동안구,80-84세,4613,1661,2952
202106,41173,경기도,안양시 동안구,80-84세,4635,1672,2963
202007,41173,경기도,안양시 동안구,85-89세,2546,707,1839
202008,41173,경기도,안양시 동안구,85-89세,2547,697,1850
202009,41173,경기도,안양시 동안구,85-89세,2566,701,1865
202010,41173,경기도,안양시 동안구,85-89세,2578,703,1875
202011,41173,경기도,안양시 동안구,85-89세,2593,714,1879
202012,41173,경기도,안양시 동안구,85-89세,2590,711,1879
202101,41173,경기도,안양시 동안구,85-89세,2601,726,1875
202102,41173,경기도,안양시 동안구,85-89세,2627,735,1892
202103,41173,경기도,안양시 동안구,85-89세,2607,730,1877
202104,41173,경기도,안양시 동안구,85-89세,2615,733,1882
202105,41173,경기도,안양시 동안구,85-89세,2635,731,1904
202106,41173,경기도,안양시 동안구,85-89세,2634,726,1908
202007,41173,경기도,안양시 동안구,90-94세,932,232,700
202008,41173,경기도,안양시 동안구,90-94세,948,241,707
202009,41173,경기도,안양시 동안구,90-94세,948,243,705
202010,41173,경기도,안양시 동안구,90-94세,960,250,710
202011,41173,경기도,안양시 동안구,90-94세,971,249,722
202012,41173,경기도,안양시 동안구,90-94세,978,254,724
202101,41173,경기도,안양시 동안구,90-94세,999,258,741
202102,41173,경기도,안양시 동안구,90-94세,1017,256,761
202103,41173,경기도,안양시 동안구,90-94세,1010,254,756
202104,41173,경기도,안양시 동안구,90-94세,1014,255,759
202105,41173,경기도,안양시 동안구,90-94세,1024,259,765
202106,41173,경기도,안양시 동안구,90-94세,1024,258,766
202007,41173,경기도,안양시 동안구,95-99세,204,45,159
202008,41173,경기도,안양시 동안구,95-99세,211,46,165
202009,41173,경기도,안양시 동안구,95-99세,210,46,164
202010,41173,경기도,안양시 동안구,95-99세,205,43,162
202011,41173,경기도,안양시 동안구,95-99세,203,41,162
202012,41173,경기도,안양시 동안구,95-99세,201,40,161
202101,41173,경기도,안양시 동안구,95-99세,203,38,165
202102,41173,경기도,안양시 동안구,95-99세,207,44,163
202103,41173,경기도,안양시 동안구,95-99세,192,41,151
202104,41173,경기도,안양시 동안구,95-99세,191,41,150
202105,41173,경기도,안양시 동안구,95-99세,191,40,151
202106,41173,경기도,안양시 동안구,95-99세,191,39,152
202007,41173,경기도,안양시 동안구,100+,92,25,67
202008,41173,경기도,안양시 동안구,100+,93,25,68
202009,41173,경기도,안양시 동안구,100+,96,25,71
202010,41173,경기도,안양시 동안구,100+,96,24,72
202011,41173,경기도,안양시 동안구,100+,96,24,72
202012,41173,경기도,안양시 동안구,100+,93,23,70
202101,41173,경기도,안양시 동안구,100+,95,24,71
202102,41173,경기도,안양시 동안구,100+,97,24,73
202103,41173,경기도,안양시 동안구,100+,49,12,37
202104,41173,경기도,안양시 동안구,100+,51,13,38
202105,41173,경기도,안양시 동안구,100+,51,12,39
202106,41173,경기도,안양시 동안구,100+,50,12,38
202007,41190,경기도,부천시,0-4세,26088,13472,12616
202008,41190,경기도,부천시,0-4세,25797,13301,12496
202009,41190,경기도,부천시,0-4세,25629,13204,12425
202010,41190,경기도,부천시,0-4세,25353,13056,12297
202011,41190,경기도,부천시,0-4세,25134,12952,12182
202012,41190,경기도,부천시,0-4세,24837,12808,12029
202101,41190,경기도,부천시,0-4세,24385,12576,11809
202102,41190,경기도,부천시,0-4세,24074,12411,11663
202103,41190,경기도,부천시,0-4세,23858,12327,11531
202104,41190,경기도,부천시,0-4세,23707,12281,11426
202105,41190,경기도,부천시,0-4세,23487,12170,11317
202106,41190,경기도,부천시,0-4세,23336,12074,11262
202007,41190,경기도,부천시,5-9세,33363,17009,16354
202008,41190,경기도,부천시,5-9세,33062,16862,16200
202009,41190,경기도,부천시,5-9세,32861,16775,16086
202010,41190,경기도,부천시,5-9세,32735,16726,16009
202011,41190,경기도,부천시,5-9세,32608,16678,15930
202012,41190,경기도,부천시,5-9세,32387,16573,15814
202101,41190,경기도,부천시,5-9세,32209,16478,15731
202102,41190,경기도,부천시,5-9세,31983,16401,15582
202103,41190,경기도,부천시,5-9세,31851,16320,15531
202104,41190,경기도,부천시,5-9세,31775,16264,15511
202105,41190,경기도,부천시,5-9세,31663,16205,15458
202106,41190,경기도,부천시,5-9세,31576,16165,15411
202007,41190,경기도,부천시,10-14세,33420,17190,16230
202008,41190,경기도,부천시,10-14세,33410,17190,16220
202009,41190,경기도,부천시,10-14세,33509,17250,16259
202010,41190,경기도,부천시,10-14세,33484,17219,16265
202011,41190,경기도,부천시,10-14세,33553,17249,16304
202012,41190,경기도,부천시,10-14세,33516,17216,16300
202101,41190,경기도,부천시,10-14세,33549,17200,16349
202102,41190,경기도,부천시,10-14세,33348,17095,16253
202103,41190,경기도,부천시,10-14세,33292,17045,16247
202104,41190,경기도,부천시,10-14세,33279,17064,16215
202105,41190,경기도,부천시,10-14세,33251,17044,16207
202106,41190,경기도,부천시,10-14세,33223,17020,16203
202007,41190,경기도,부천시,15-19세,38722,19901,18821
202008,41190,경기도,부천시,15-19세,38426,19746,18680
202009,41190,경기도,부천시,15-19세,38076,19510,18566
202010,41190,경기도,부천시,15-19세,37771,19358,18413
202011,41190,경기도,부천시,15-19세,37361,19159,18202
202012,41190,경기도,부천시,15-19세,37060,19018,18042
202101,41190,경기도,부천시,15-19세,36688,18855,17833
202102,41190,경기도,부천시,15-19세,36414,18683,17731
202103,41190,경기도,부천시,15-19세,36150,18566,17584
202104,41190,경기도,부천시,15-19세,35880,18393,17487
202105,41190,경기도,부천시,15-19세,35723,18329,17394
202106,41190,경기도,부천시,15-19세,35627,18290,17337
202007,41190,경기도,부천시,20-24세,55091,28254,26837
202008,41190,경기도,부천시,20-24세,54831,28110,26721
202009,41190,경기도,부천시,20-24세,54654,28019,26635
202010,41190,경기도,부천시,20-24세,54468,27904,26564
202011,41190,경기도,부천시,20-24세,54328,27821,26507
202012,41190,경기도,부천시,20-24세,54014,27674,26340
202101,41190,경기도,부천시,20-24세,53746,27530,26216
202102,41190,경기도,부천시,20-24세,53529,27395,26134
202103,41190,경기도,부천시,20-24세,53286,27274,26012
202104,41190,경기도,부천시,20-24세,52959,27143,25816
202105,41190,경기도,부천시,20-24세,52675,26985,25690
202106,41190,경기도,부천시,20-24세,52323,26786,25537
202007,41190,경기도,부천시,25-29세,63474,32932,30542
202008,41190,경기도,부천시,25-29세,63374,32885,30489
202009,41190,경기도,부천시,25-29세,63300,32842,30458
202010,41190,경기도,부천시,25-29세,63328,32899,30429
202011,41190,경기도,부천시,25-29세,63297,32867,30430
202012,41190,경기도,부천시,25-29세,63394,32903,30491
202101,41190,경기도,부천시,25-29세,63284,32852,30432
202102,41190,경기도,부천시,25-29세,63143,32832,30311
202103,41190,경기도,부천시,25-29세,63039,32729,30310
202104,41190,경기도,부천시,25-29세,62920,32647,30273
202105,41190,경기도,부천시,25-29세,62790,32557,30233
202106,41190,경기도,부천시,25-29세,62788,32535,30253
202007,41190,경기도,부천시,30-34세,55447,28335,27112
202008,41190,경기도,부천시,30-34세,55205,28216,26989
202009,41190,경기도,부천시,30-34세,55140,28185,26955
202010,41190,경기도,부천시,30-34세,54958,28119,26839
202011,41190,경기도,부천시,30-34세,54905,28115,26790
202012,41190,경기도,부천시,30-34세,54637,27997,26640
202101,41190,경기도,부천시,30-34세,54614,27948,26666
202102,41190,경기도,부천시,30-34세,54552,27950,26602
202103,41190,경기도,부천시,30-34세,54567,28002,26565
202104,41190,경기도,부천시,30-34세,54647,28031,26616
202105,41190,경기도,부천시,30-34세,54709,28085,26624
202106,41190,경기도,부천시,30-34세,54844,28163,26681
202007,41190,경기도,부천시,35-39세,62903,32355,30548
202008,41190,경기도,부천시,35-39세,62480,32188,30292
202009,41190,경기도,부천시,35-39세,62179,32018,30161
202010,41190,경기도,부천시,35-39세,61952,31918,30034
202011,41190,경기도,부천시,35-39세,61646,31761,29885
202012,41190,경기도,부천시,35-39세,61397,31620,29777
202101,41190,경기도,부천시,35-39세,60910,31394,29516
202102,41190,경기도,부천시,35-39세,60273,31048,29225
202103,41190,경기도,부천시,35-39세,59699,30803,28896
202104,41190,경기도,부천시,35-39세,59391,30651,28740
202105,41190,경기도,부천시,35-39세,59002,30445,28557
202106,41190,경기도,부천시,35-39세,58712,30303,28409
202007,41190,경기도,부천시,40-44세,61086,31007,30079
202008,41190,경기도,부천시,40-44세,61090,30999,30091
202009,41190,경기도,부천시,40-44세,61156,31003,30153
202010,41190,경기도,부천시,40-44세,61212,31009,30203
202011,41190,경기도,부천시,40-44세,61231,31021,30210
202012,41190,경기도,부천시,40-44세,60959,30895,30064
202101,41190,경기도,부천시,40-44세,60934,30858,30076
202102,41190,경기도,부천시,40-44세,60907,30894,30013
202103,41190,경기도,부천시,40-44세,60686,30771,29915
202104,41190,경기도,부천시,40-44세,60669,30804,29865
202105,41190,경기도,부천시,40-44세,60823,30904,29919
202106,41190,경기도,부천시,40-44세,61028,30994,30034
202007,41190,경기도,부천시,45-49세,70053,34981,35072
202008,41190,경기도,부천시,45-49세,69674,34757,34917
202009,41190,경기도,부천시,45-49세,69247,34604,34643
202010,41190,경기도,부천시,45-49세,68890,34450,34440
202011,41190,경기도,부천시,45-49세,68466,34254,34212
202012,41190,경기도,부천시,45-49세,68192,34135,34057
202101,41190,경기도,부천시,45-49세,67893,34007,33886
202102,41190,경기도,부천시,45-49세,67726,33941,33785
202103,41190,경기도,부천시,45-49세,67170,33678,33492
202104,41190,경기도,부천시,45-49세,66902,33558,33344
202105,41190,경기도,부천시,45-49세,66319,33223,33096
202106,41190,경기도,부천시,45-49세,65919,33029,32890
202007,41190,경기도,부천시,50-54세,73197,35403,37794
202008,41190,경기도,부천시,50-54세,72999,35323,37676
202009,41190,경기도,부천시,50-54세,72944,35294,37650
202010,41190,경기도,부천시,50-54세,72882,35226,37656
202011,41190,경기도,부천시,50-54세,72907,35183,37724
202012,41190,경기도,부천시,50-54세,72701,35101,37600
202101,41190,경기도,부천시,50-54세,73061,35280,37781
202102,41190,경기도,부천시,50-54세,73031,35257,37774
202103,41190,경기도,부천시,50-54세,72705,35090,37615
202104,41190,경기도,부천시,50-54세,72641,35061,37580
202105,41190,경기도,부천시,50-54세,72908,35207,37701
202106,41190,경기도,부천시,50-54세,73040,35272,37768
202007,41190,경기도,부천시,55-59세,76037,37240,38797
202008,41190,경기도,부천시,55-59세,75862,37150,38712
202009,41190,경기도,부천시,55-59세,75614,36977,38637
202010,41190,경기도,부천시,55-59세,75395,36859,38536
202011,41190,경기도,부천시,55-59세,75007,36667,38340
202012,41190,경기도,부천시,55-59세,74895,36579,38316
202101,41190,경기도,부천시,55-59세,74336,36261,38075
202102,41190,경기도,부천시,55-59세,74111,36117,37994
202103,41190,경기도,부천시,55-59세,73588,35866,37722
202104,41190,경기도,부천시,55-59세,73251,35680,37571
202105,41190,경기도,부천시,55-59세,72828,35487,37341
202106,41190,경기도,부천시,55-59세,72169,35158,37011
202007,41190,경기도,부천시,60-64세,66614,32965,33649
202008,41190,경기도,부천시,60-64세,66926,33090,33836
202009,41190,경기도,부천시,60-64세,67344,33287,34057
202010,41190,경기도,부천시,60-64세,67707,33449,34258
202011,41190,경기도,부천시,60-64세,68134,33673,34461
202012,41190,경기도,부천시,60-64세,68442,33800,34642
202101,41190,경기도,부천시,60-64세,69016,34116,34900
202102,41190,경기도,부천시,60-64세,69501,34316,35185
202103,41190,경기도,부천시,60-64세,69697,34429,35268
202104,41190,경기도,부천시,60-64세,70099,34561,35538
202105,41190,경기도,부천시,60-64세,70429,34719,35710
202106,41190,경기도,부천시,60-64세,70974,34982,35992
202007,41190,경기도,부천시,65-69세,40560,20007,20553
202008,41190,경기도,부천시,65-69세,40901,20160,20741
202009,41190,경기도,부천시,65-69세,41212,20336,20876
202010,41190,경기도,부천시,65-69세,41546,20498,21048
202011,41190,경기도,부천시,65-69세,41800,20617,21183
202012,41190,경기도,부천시,65-69세,42172,20795,21377
202101,41190,경기도,부천시,65-69세,42642,21009,21633
202102,41190,경기도,부천시,65-69세,43042,21212,21830
202103,41190,경기도,부천시,65-69세,43546,21426,22120
202104,41190,경기도,부천시,65-69세,43856,21578,22278
202105,41190,경기도,부천시,65-69세,44278,21745,22533
202106,41190,경기도,부천시,65-69세,44594,21865,22729
202007,41190,경기도,부천시,70-74세,26694,12900,13794
202008,41190,경기도,부천시,70-74세,26743,12939,13804
202009,41190,경기도,부천시,70-74세,26957,13029,13928
202010,41190,경기도,부천시,70-74세,27146,13100,14046
202011,41190,경기도,부천시,70-74세,27356,13180,14176
202012,41190,경기도,부천시,70-74세,27532,13252,14280
202101,41190,경기도,부천시,70-74세,27753,13356,14397
202102,41190,경기도,부천시,70-74세,27877,13406,14471
202103,41190,경기도,부천시,70-74세,27776,13352,14424
202104,41190,경기도,부천시,70-74세,27812,13371,14441
202105,41190,경기도,부천시,70-74세,27864,13400,14464
202106,41190,경기도,부천시,70-74세,27977,13457,14520
202007,41190,경기도,부천시,75-79세,19299,8275,11024
202008,41190,경기도,부천시,75-79세,19325,8280,11045
202009,41190,경기도,부천시,75-79세,19258,8254,11004
202010,41190,경기도,부천시,75-79세,19250,8274,10976
202011,41190,경기도,부천시,75-79세,19205,8263,10942
202012,41190,경기도,부천시,75-79세,19106,8249,10857
202101,41190,경기도,부천시,75-79세,19095,8263,10832
202102,41190,경기도,부천시,75-79세,19042,8251,10791
202103,41190,경기도,부천시,75-79세,18926,8210,10716
202104,41190,경기도,부천시,75-79세,18926,8231,10695
202105,41190,경기도,부천시,75-79세,18929,8226,10703
202106,41190,경기도,부천시,75-79세,18976,8253,10723
202007,41190,경기도,부천시,80-84세,12813,4549,8264
202008,41190,경기도,부천시,80-84세,12826,4590,8236
202009,41190,경기도,부천시,80-84세,12881,4637,8244
202010,41190,경기도,부천시,80-84세,12904,4650,8254
202011,41190,경기도,부천시,80-84세,12922,4675,8247
202012,41190,경기도,부천시,80-84세,12925,4652,8273
202101,41190,경기도,부천시,80-84세,13016,4688,8328
202102,41190,경기도,부천시,80-84세,13092,4722,8370
202103,41190,경기도,부천시,80-84세,13043,4709,8334
202104,41190,경기도,부천시,80-84세,13091,4740,8351
202105,41190,경기도,부천시,80-84세,13144,4787,8357
202106,41190,경기도,부천시,80-84세,13218,4830,8388
202007,41190,경기도,부천시,85-89세,6581,1864,4717
202008,41190,경기도,부천시,85-89세,6676,1889,4787
202009,41190,경기도,부천시,85-89세,6718,1900,4818
202010,41190,경기도,부천시,85-89세,6781,1925,4856
202011,41190,경기도,부천시,85-89세,6826,1947,4879
202012,41190,경기도,부천시,85-89세,6875,1987,4888
202101,41190,경기도,부천시,85-89세,6929,2018,4911
202102,41190,경기도,부천시,85-89세,7024,2044,4980
202103,41190,경기도,부천시,85-89세,7057,2027,5030
202104,41190,경기도,부천시,85-89세,7083,2042,5041
202105,41190,경기도,부천시,85-89세,7111,2065,5046
202106,41190,경기도,부천시,85-89세,7123,2079,5044
202007,41190,경기도,부천시,90-94세,2409,552,1857
202008,41190,경기도,부천시,90-94세,2425,557,1868
202009,41190,경기도,부천시,90-94세,2476,577,1899
202010,41190,경기도,부천시,90-94세,2469,579,1890
202011,41190,경기도,부천시,90-94세,2469,575,1894
202012,41190,경기도,부천시,90-94세,2501,587,1914
202101,41190,경기도,부천시,90-94세,2547,597,1950
202102,41190,경기도,부천시,90-94세,2559,605,1954
202103,41190,경기도,부천시,90-94세,2539,607,1932
202104,41190,경기도,부천시,90-94세,2559,604,1955
202105,41190,경기도,부천시,90-94세,2583,610,1973
202106,41190,경기도,부천시,90-94세,2575,600,1975
202007,41190,경기도,부천시,95-99세,583,120,463
202008,41190,경기도,부천시,95-99세,590,120,470
202009,41190,경기도,부천시,95-99세,598,121,477
202010,41190,경기도,부천시,95-99세,586,120,466
202011,41190,경기도,부천시,95-99세,585,120,465
202012,41190,경기도,부천시,95-99세,591,120,471
202101,41190,경기도,부천시,95-99세,588,116,472
202102,41190,경기도,부천시,95-99세,602,120,482
202103,41190,경기도,부천시,95-99세,559,105,454
202104,41190,경기도,부천시,95-99세,563,108,455
202105,41190,경기도,부천시,95-99세,558,105,453
202106,41190,경기도,부천시,95-99세,568,105,463
202007,41190,경기도,부천시,100+,241,60,181
202008,41190,경기도,부천시,100+,243,59,184
202009,41190,경기도,부천시,100+,247,59,188
202010,41190,경기도,부천시,100+,251,63,188
202011,41190,경기도,부천시,100+,250,62,188
202012,41190,경기도,부천시,100+,250,62,188
202101,41190,경기도,부천시,100+,254,62,192
202102,41190,경기도,부천시,100+,257,63,194
202103,41190,경기도,부천시,100+,144,38,106
202104,41190,경기도,부천시,100+,148,39,109
202105,41190,경기도,부천시,100+,151,39,112
202106,41190,경기도,부천시,100+,152,40,112
202007,41210,경기도,광명시,0-4세,10422,5335,5087
202008,41210,경기도,광명시,0-4세,10194,5214,4980
202009,41210,경기도,광명시,0-4세,10056,5149,4907
202010,41210,경기도,광명시,0-4세,9871,5036,4835
202011,41210,경기도,광명시,0-4세,9739,4972,4767
202012,41210,경기도,광명시,0-4세,9623,4919,4704
202101,41210,경기도,광명시,0-4세,9492,4866,4626
202102,41210,경기도,광명시,0-4세,9361,4791,4570
202103,41210,경기도,광명시,0-4세,9249,4725,4524
202104,41210,경기도,광명시,0-4세,9212,4709,4503
202105,41210,경기도,광명시,0-4세,9235,4714,4521
202106,41210,경기도,광명시,0-4세,9211,4711,4500
202007,41210,경기도,광명시,5-9세,14326,7340,6986
202008,41210,경기도,광명시,5-9세,14202,7284,6918
202009,41210,경기도,광명시,5-9세,14017,7177,6840
202010,41210,경기도,광명시,5-9세,13880,7139,6741
202011,41210,경기도,광명시,5-9세,13726,7044,6682
202012,41210,경기도,광명시,5-9세,13660,7019,6641
202101,41210,경기도,광명시,5-9세,13547,6948,6599
202102,41210,경기도,광명시,5-9세,13425,6881,6544
202103,41210,경기도,광명시,5-9세,13369,6846,6523
202104,41210,경기도,광명시,5-9세,13303,6819,6484
202105,41210,경기도,광명시,5-9세,13314,6816,6498
202106,41210,경기도,광명시,5-9세,13308,6793,6515
202007,41210,경기도,광명시,10-14세,15085,7658,7427
202008,41210,경기도,광명시,10-14세,14995,7610,7385
202009,41210,경기도,광명시,10-14세,14940,7581,7359
202010,41210,경기도,광명시,10-14세,14923,7573,7350
202011,41210,경기도,광명시,10-14세,14891,7559,7332
202012,41210,경기도,광명시,10-14세,14855,7532,7323
202101,41210,경기도,광명시,10-14세,14824,7519,7305
202102,41210,경기도,광명시,10-14세,14749,7471,7278
202103,41210,경기도,광명시,10-14세,14678,7450,7228
202104,41210,경기도,광명시,10-14세,14711,7458,7253
202105,41210,경기도,광명시,10-14세,14702,7462,7240
202106,41210,경기도,광명시,10-14세,14684,7456,7228
202007,41210,경기도,광명시,15-19세,16688,8678,8010
202008,41210,경기도,광명시,15-19세,16510,8601,7909
202009,41210,경기도,광명시,15-19세,16317,8528,7789
202010,41210,경기도,광명시,15-19세,16093,8397,7696
202011,41210,경기도,광명시,15-19세,15879,8279,7600
202012,41210,경기도,광명시,15-19세,15726,8186,7540
202101,41210,경기도,광명시,15-19세,15614,8119,7495
202102,41210,경기도,광명시,15-19세,15536,8078,7458
202103,41210,경기도,광명시,15-19세,15460,8045,7415
202104,41210,경기도,광명시,15-19세,15404,8020,7384
202105,41210,경기도,광명시,15-19세,15376,8019,7357
202106,41210,경기도,광명시,15-19세,15344,8011,7333
202007,41210,경기도,광명시,20-24세,19608,10185,9423
202008,41210,경기도,광명시,20-24세,19418,10094,9324
202009,41210,경기도,광명시,20-24세,19167,9951,9216
202010,41210,경기도,광명시,20-24세,18944,9848,9096
202011,41210,경기도,광명시,20-24세,18788,9776,9012
202012,41210,경기도,광명시,20-24세,18690,9701,8989
202101,41210,경기도,광명시,20-24세,18602,9659,8943
202102,41210,경기도,광명시,20-24세,18488,9583,8905
202103,41210,경기도,광명시,20-24세,18461,9560,8901
202104,41210,경기도,광명시,20-24세,18424,9539,8885
202105,41210,경기도,광명시,20-24세,18384,9494,8890
202106,41210,경기도,광명시,20-24세,18350,9469,8881
202007,41210,경기도,광명시,25-29세,20606,10859,9747
202008,41210,경기도,광명시,25-29세,20370,10764,9606
202009,41210,경기도,광명시,25-29세,20134,10635,9499
202010,41210,경기도,광명시,25-29세,19842,10478,9364
202011,41210,경기도,광명시,25-29세,19635,10340,9295
202012,41210,경기도,광명시,25-29세,19566,10317,9249
202101,41210,경기도,광명시,25-29세,19486,10289,9197
202102,41210,경기도,광명시,25-29세,19341,10212,9129
202103,41210,경기도,광명시,25-29세,19312,10201,9111
202104,41210,경기도,광명시,25-29세,19306,10184,9122
202105,41210,경기도,광명시,25-29세,19348,10183,9165
202106,41210,경기도,광명시,25-29세,19335,10173,9162
202007,41210,경기도,광명시,30-34세,19659,10020,9639
202008,41210,경기도,광명시,30-34세,19483,9948,9535
202009,41210,경기도,광명시,30-34세,19308,9866,9442
202010,41210,경기도,광명시,30-34세,19109,9742,9367
202011,41210,경기도,광명시,30-34세,18822,9599,9223
202012,41210,경기도,광명시,30-34세,18687,9511,9176
202101,41210,경기도,광명시,30-34세,18656,9504,9152
202102,41210,경기도,광명시,30-34세,18523,9463,9060
202103,41210,경기도,광명시,30-34세,18531,9483,9048
202104,41210,경기도,광명시,30-34세,18596,9527,9069
202105,41210,경기도,광명시,30-34세,18658,9597,9061
202106,41210,경기도,광명시,30-34세,18749,9641,9108
202007,41210,경기도,광명시,35-39세,24048,12043,12005
202008,41210,경기도,광명시,35-39세,23690,11846,11844
202009,41210,경기도,광명시,35-39세,23315,11687,11628
202010,41210,경기도,광명시,35-39세,22911,11487,11424
202011,41210,경기도,광명시,35-39세,22647,11326,11321
202012,41210,경기도,광명시,35-39세,22521,11263,11258
202101,41210,경기도,광명시,35-39세,22279,11142,11137
202102,41210,경기도,광명시,35-39세,22117,11104,11013
202103,41210,경기도,광명시,35-39세,21984,11036,10948
202104,41210,경기도,광명시,35-39세,21852,10977,10875
202105,41210,경기도,광명시,35-39세,21844,10971,10873
202106,41210,경기도,광명시,35-39세,21777,10935,10842
202007,41210,경기도,광명시,40-44세,24943,12388,12555
202008,41210,경기도,광명시,40-44세,24760,12296,12464
202009,41210,경기도,광명시,40-44세,24611,12203,12408
202010,41210,경기도,광명시,40-44세,24536,12144,12392
202011,41210,경기도,광명시,40-44세,24342,12054,12288
202012,41210,경기도,광명시,40-44세,24155,11958,12197
202101,41210,경기도,광명시,40-44세,24031,11862,12169
202102,41210,경기도,광명시,40-44세,24002,11818,12184
202103,41210,경기도,광명시,40-44세,23880,11745,12135
202104,41210,경기도,광명시,40-44세,23926,11750,12176
202105,41210,경기도,광명시,40-44세,24022,11812,12210
202106,41210,경기도,광명시,40-44세,24134,11866,12268
202007,41210,경기도,광명시,45-49세,28711,14213,14498
202008,41210,경기도,광명시,45-49세,28510,14106,14404
202009,41210,경기도,광명시,45-49세,28168,13944,14224
202010,41210,경기도,광명시,45-49세,27833,13806,14027
202011,41210,경기도,광명시,45-49세,27560,13674,13886
202012,41210,경기도,광명시,45-49세,27444,13588,13856
202101,41210,경기도,광명시,45-49세,27285,13497,13788
202102,41210,경기도,광명시,45-49세,27146,13461,13685
202103,41210,경기도,광명시,45-49세,26933,13345,13588
202104,41210,경기도,광명시,45-49세,26849,13305,13544
202105,41210,경기도,광명시,45-49세,26687,13207,13480
202106,41210,경기도,광명시,45-49세,26566,13161,13405
202007,41210,경기도,광명시,50-54세,26769,13340,13429
202008,41210,경기도,광명시,50-54세,26563,13229,13334
202009,41210,경기도,광명시,50-54세,26378,13120,13258
202010,41210,경기도,광명시,50-54세,26166,13018,13148
202011,41210,경기도,광명시,50-54세,25976,12927,13049
202012,41210,경기도,광명시,50-54세,25806,12834,12972
202101,41210,경기도,광명시,50-54세,25917,12882,13035
202102,41210,경기도,광명시,50-54세,25938,12853,13085
202103,41210,경기도,광명시,50-54세,25900,12820,13080
202104,41210,경기도,광명시,50-54세,25890,12814,13076
202105,41210,경기도,광명시,50-54세,25982,12886,13096
202106,41210,경기도,광명시,50-54세,26042,12900,13142
202007,41210,경기도,광명시,55-59세,25009,12399,12610
202008,41210,경기도,광명시,55-59세,24847,12347,12500
202009,41210,경기도,광명시,55-59세,24576,12217,12359
202010,41210,경기도,광명시,55-59세,24258,12064,12194
202011,41210,경기도,광명시,55-59세,24012,11962,12050
202012,41210,경기도,광명시,55-59세,23871,11898,11973
202101,41210,경기도,광명시,55-59세,23682,11851,11831
202102,41210,경기도,광명시,55-59세,23610,11807,11803
202103,41210,경기도,광명시,55-59세,23506,11781,11725
202104,41210,경기도,광명시,55-59세,23420,11754,11666
202105,41210,경기도,광명시,55-59세,23297,11700,11597
202106,41210,경기도,광명시,55-59세,23142,11632,11510
202007,41210,경기도,광명시,60-64세,22758,10800,11958
202008,41210,경기도,광명시,60-64세,22711,10746,11965
202009,41210,경기도,광명시,60-64세,22621,10724,11897
202010,41210,경기도,광명시,60-64세,22424,10628,11796
202011,41210,경기도,광명시,60-64세,22313,10557,11756
202012,41210,경기도,광명시,60-64세,22312,10522,11790
202101,41210,경기도,광명시,60-64세,22433,10595,11838
202102,41210,경기도,광명시,60-64세,22457,10619,11838
202103,41210,경기도,광명시,60-64세,22488,10625,11863
202104,41210,경기도,광명시,60-64세,22661,10727,11934
202105,41210,경기도,광명시,60-64세,22770,10773,11997
202106,41210,경기도,광명시,60-64세,22924,10852,12072
202007,41210,경기도,광명시,65-69세,15186,7290,7896
202008,41210,경기도,광명시,65-69세,15232,7301,7931
202009,41210,경기도,광명시,65-69세,15219,7270,7949
202010,41210,경기도,광명시,65-69세,15192,7267,7925
202011,41210,경기도,광명시,65-69세,15158,7279,7879
202012,41210,경기도,광명시,65-69세,15180,7279,7901
202101,41210,경기도,광명시,65-69세,15304,7315,7989
202102,41210,경기도,광명시,65-69세,15447,7398,8049
202103,41210,경기도,광명시,65-69세,15568,7465,8103
202104,41210,경기도,광명시,65-69세,15671,7497,8174
202105,41210,경기도,광명시,65-69세,15756,7535,8221
202106,41210,경기도,광명시,65-69세,15897,7601,8296
202007,41210,경기도,광명시,70-74세,10486,4890,5596
202008,41210,경기도,광명시,70-74세,10423,4879,5544
202009,41210,경기도,광명시,70-74세,10378,4860,5518
202010,41210,경기도,광명시,70-74세,10336,4849,5487
202011,41210,경기도,광명시,70-74세,10297,4815,5482
202012,41210,경기도,광명시,70-74세,10307,4836,5471
202101,41210,경기도,광명시,70-74세,10406,4887,5519
202102,41210,경기도,광명시,70-74세,10465,4909,5556
202103,41210,경기도,광명시,70-74세,10427,4889,5538
202104,41210,경기도,광명시,70-74세,10435,4890,5545
202105,41210,경기도,광명시,70-74세,10384,4882,5502
202106,41210,경기도,광명시,70-74세,10353,4879,5474
202007,41210,경기도,광명시,75-79세,7865,3304,4561
202008,41210,경기도,광명시,75-79세,7865,3310,4555
202009,41210,경기도,광명시,75-79세,7793,3302,4491
202010,41210,경기도,광명시,75-79세,7652,3222,4430
202011,41210,경기도,광명시,75-79세,7559,3179,4380
202012,41210,경기도,광명시,75-79세,7476,3162,4314
202101,41210,경기도,광명시,75-79세,7452,3161,4291
202102,41210,경기도,광명시,75-79세,7404,3142,4262
202103,41210,경기도,광명시,75-79세,7355,3128,4227
202104,41210,경기도,광명시,75-79세,7329,3105,4224
202105,41210,경기도,광명시,75-79세,7280,3067,4213
202106,41210,경기도,광명시,75-79세,7300,3083,4217
202007,41210,경기도,광명시,80-84세,5081,1829,3252
202008,41210,경기도,광명시,80-84세,5035,1813,3222
202009,41210,경기도,광명시,80-84세,4969,1799,3170
202010,41210,경기도,광명시,80-84세,4927,1802,3125
202011,41210,경기도,광명시,80-84세,4883,1784,3099
202012,41210,경기도,광명시,80-84세,4852,1770,3082
202101,41210,경기도,광명시,80-84세,4845,1774,3071
202102,41210,경기도,광명시,80-84세,4873,1792,3081
202103,41210,경기도,광명시,80-84세,4891,1807,3084
202104,41210,경기도,광명시,80-84세,4922,1829,3093
202105,41210,경기도,광명시,80-84세,4936,1831,3105
202106,41210,경기도,광명시,80-84세,4963,1835,3128
202007,41210,경기도,광명시,85-89세,2615,707,1908
202008,41210,경기도,광명시,85-89세,2609,705,1904
202009,41210,경기도,광명시,85-89세,2601,692,1909
202010,41210,경기도,광명시,85-89세,2587,688,1899
202011,41210,경기도,광명시,85-89세,2581,687,1894
202012,41210,경기도,광명시,85-89세,2580,692,1888
202101,41210,경기도,광명시,85-89세,2594,693,1901
202102,41210,경기도,광명시,85-89세,2607,694,1913
202103,41210,경기도,광명시,85-89세,2601,693,1908
202104,41210,경기도,광명시,85-89세,2621,700,1921
202105,41210,경기도,광명시,85-89세,2630,708,1922
202106,41210,경기도,광명시,85-89세,2635,711,1924
202007,41210,경기도,광명시,90-94세,877,210,667
202008,41210,경기도,광명시,90-94세,887,208,679
202009,41210,경기도,광명시,90-94세,887,204,683
202010,41210,경기도,광명시,90-94세,895,207,688
202011,41210,경기도,광명시,90-94세,905,208,697
202012,41210,경기도,광명시,90-94세,912,208,704
202101,41210,경기도,광명시,90-94세,921,211,710
202102,41210,경기도,광명시,90-94세,924,210,714
202103,41210,경기도,광명시,90-94세,902,200,702
202104,41210,경기도,광명시,90-94세,902,202,700
202105,41210,경기도,광명시,90-94세,901,192,709
202106,41210,경기도,광명시,90-94세,908,189,719
202007,41210,경기도,광명시,95-99세,235,49,186
202008,41210,경기도,광명시,95-99세,233,48,185
202009,41210,경기도,광명시,95-99세,237,49,188
202010,41210,경기도,광명시,95-99세,238,47,191
202011,41210,경기도,광명시,95-99세,238,47,191
202012,41210,경기도,광명시,95-99세,233,47,186
202101,41210,경기도,광명시,95-99세,234,48,186
202102,41210,경기도,광명시,95-99세,228,48,180
202103,41210,경기도,광명시,95-99세,203,42,161
202104,41210,경기도,광명시,95-99세,203,42,161
202105,41210,경기도,광명시,95-99세,198,43,155
202106,41210,경기도,광명시,95-99세,195,43,152
202007,41210,경기도,광명시,100+,142,38,104
202008,41210,경기도,광명시,100+,141,35,106
202009,41210,경기도,광명시,100+,144,36,108
202010,41210,경기도,광명시,100+,144,36,108
202011,41210,경기도,광명시,100+,141,36,105
202012,41210,경기도,광명시,100+,143,36,107
202101,41210,경기도,광명시,100+,144,36,108
202102,41210,경기도,광명시,100+,144,35,109
202103,41210,경기도,광명시,100+,52,11,41
202104,41210,경기도,광명시,100+,53,11,42
202105,41210,경기도,광명시,100+,38,8,30
202106,41210,경기도,광명시,100+,35,7,28
202007,41220,경기도,평택시,0-4세,21527,10948,10579
202008,41220,경기도,평택시,0-4세,21508,10930,10578
202009,41220,경기도,평택시,0-4세,21470,10901,10569
202010,41220,경기도,평택시,0-4세,21495,10908,10587
202011,41220,경기도,평택시,0-4세,21544,10924,10620
202012,41220,경기도,평택시,0-4세,21672,10977,10695
202101,41220,경기도,평택시,0-4세,21636,10963,10673
202102,41220,경기도,평택시,0-4세,21658,10960,10698
202103,41220,경기도,평택시,0-4세,21595,10905,10690
202104,41220,경기도,평택시,0-4세,21565,10922,10643
202105,41220,경기도,평택시,0-4세,21471,10857,10614
202106,41220,경기도,평택시,0-4세,21439,10848,10591
202007,41220,경기도,평택시,5-9세,27050,13858,13192
202008,41220,경기도,평택시,5-9세,27128,13901,13227
202009,41220,경기도,평택시,5-9세,27204,13919,13285
202010,41220,경기도,평택시,5-9세,27239,13926,13313
202011,41220,경기도,평택시,5-9세,27338,13978,13360
202012,41220,경기도,평택시,5-9세,27481,14055,13426
202101,41220,경기도,평택시,5-9세,27696,14181,13515
202102,41220,경기도,평택시,5-9세,27776,14228,13548
202103,41220,경기도,평택시,5-9세,27876,14265,13611
202104,41220,경기도,평택시,5-9세,27910,14278,13632
202105,41220,경기도,평택시,5-9세,27948,14286,13662
202106,41220,경기도,평택시,5-9세,27997,14295,13702
202007,41220,경기도,평택시,10-14세,26157,13438,12719
202008,41220,경기도,평택시,10-14세,26307,13504,12803
202009,41220,경기도,평택시,10-14세,26451,13595,12856
202010,41220,경기도,평택시,10-14세,26701,13730,12971
202011,41220,경기도,평택시,10-14세,26857,13830,13027
202012,41220,경기도,평택시,10-14세,27000,13900,13100
202101,41220,경기도,평택시,10-14세,27238,14001,13237
202102,41220,경기도,평택시,10-14세,27445,14123,13322
202103,41220,경기도,평택시,10-14세,27575,14184,13391
202104,41220,경기도,평택시,10-14세,27714,14250,13464
202105,41220,경기도,평택시,10-14세,27824,14298,13526
202106,41220,경기도,평택시,10-14세,27857,14304,13553
202007,41220,경기도,평택시,15-19세,26652,13814,12838
202008,41220,경기도,평택시,15-19세,26508,13728,12780
202009,41220,경기도,평택시,15-19세,26445,13673,12772
202010,41220,경기도,평택시,15-19세,26385,13686,12699
202011,41220,경기도,평택시,15-19세,26291,13596,12695
202012,41220,경기도,평택시,15-19세,26214,13550,12664
202101,41220,경기도,평택시,15-19세,26197,13557,12640
202102,41220,경기도,평택시,15-19세,26220,13563,12657
202103,41220,경기도,평택시,15-19세,26093,13507,12586
202104,41220,경기도,평택시,15-19세,25973,13464,12509
202105,41220,경기도,평택시,15-19세,25954,13462,12492
202106,41220,경기도,평택시,15-19세,25989,13505,12484
202007,41220,경기도,평택시,20-24세,33497,17845,15652
202008,41220,경기도,평택시,20-24세,33473,17825,15648
202009,41220,경기도,평택시,20-24세,33447,17841,15606
202010,41220,경기도,평택시,20-24세,33448,17839,15609
202011,41220,경기도,평택시,20-24세,33591,17918,15673
202012,41220,경기도,평택시,20-24세,33625,17974,15651
202101,41220,경기도,평택시,20-24세,33874,18084,15790
202102,41220,경기도,평택시,20-24세,34003,18153,15850
202103,41220,경기도,평택시,20-24세,34143,18233,15910
202104,41220,경기도,평택시,20-24세,34241,18260,15981
202105,41220,경기도,평택시,20-24세,34290,18301,15989
202106,41220,경기도,평택시,20-24세,34327,18316,16011
202007,41220,경기도,평택시,25-29세,38012,21276,16736
202008,41220,경기도,평택시,25-29세,38297,21434,16863
202009,41220,경기도,평택시,25-29세,38577,21608,16969
202010,41220,경기도,평택시,25-29세,38909,21782,17127
202011,41220,경기도,평택시,25-29세,39341,22071,17270
202012,41220,경기도,평택시,25-29세,39805,22294,17511
202101,41220,경기도,평택시,25-29세,40106,22536,17570
202102,41220,경기도,평택시,25-29세,40397,22718,17679
202103,41220,경기도,평택시,25-29세,40852,23020,17832
202104,41220,경기도,평택시,25-29세,41196,23273,17923
202105,41220,경기도,평택시,25-29세,41422,23355,18067
202106,41220,경기도,평택시,25-29세,41616,23471,18145
202007,41220,경기도,평택시,30-34세,35447,19530,15917
202008,41220,경기도,평택시,30-34세,35671,19660,16011
202009,41220,경기도,평택시,30-34세,35970,19835,16135
202010,41220,경기도,평택시,30-34세,36315,20072,16243
202011,41220,경기도,평택시,30-34세,36586,20236,16350
202012,41220,경기도,평택시,30-34세,36969,20455,16514
202101,41220,경기도,평택시,30-34세,37417,20690,16727
202102,41220,경기도,평택시,30-34세,37822,20957,16865
202103,41220,경기도,평택시,30-34세,38142,21158,16984
202104,41220,경기도,평택시,30-34세,38483,21386,17097
202105,41220,경기도,평택시,30-34세,38794,21641,17153
202106,41220,경기도,평택시,30-34세,39062,21829,17233
202007,41220,경기도,평택시,35-39세,43070,22989,20081
202008,41220,경기도,평택시,35-39세,43130,23042,20088
202009,41220,경기도,평택시,35-39세,43088,23008,20080
202010,41220,경기도,평택시,35-39세,43205,23058,20147
202011,41220,경기도,평택시,35-39세,43356,23149,20207
202012,41220,경기도,평택시,35-39세,43728,23393,20335
202101,41220,경기도,평택시,35-39세,43962,23569,20393
202102,41220,경기도,평택시,35-39세,44067,23666,20401
202103,41220,경기도,평택시,35-39세,44110,23678,20432
202104,41220,경기도,평택시,35-39세,44065,23693,20372
202105,41220,경기도,평택시,35-39세,44074,23698,20376
202106,41220,경기도,평택시,35-39세,44070,23706,20364
202007,41220,경기도,평택시,40-44세,43875,23331,20544
202008,41220,경기도,평택시,40-44세,44091,23455,20636
202009,41220,경기도,평택시,40-44세,44462,23680,20782
202010,41220,경기도,평택시,40-44세,44876,23909,20967
202011,41220,경기도,평택시,40-44세,45182,24125,21057
202012,41220,경기도,평택시,40-44세,45350,24241,21109
202101,41220,경기도,평택시,40-44세,45758,24475,21283
202102,41220,경기도,평택시,40-44세,46166,24737,21429
202103,41220,경기도,평택시,40-44세,46168,24836,21332
202104,41220,경기도,평택시,40-44세,46358,24941,21417
202105,41220,경기도,평택시,40-44세,46671,25129,21542
202106,41220,경기도,평택시,40-44세,47054,25350,21704
202007,41220,경기도,평택시,45-49세,48010,25362,22648
202008,41220,경기도,평택시,45-49세,48008,25370,22638
202009,41220,경기도,평택시,45-49세,48060,25396,22664
202010,41220,경기도,평택시,45-49세,48065,25406,22659
202011,41220,경기도,평택시,45-49세,48221,25478,22743
202012,41220,경기도,평택시,45-49세,48450,25645,22805
202101,41220,경기도,평택시,45-49세,48540,25707,22833
202102,41220,경기도,평택시,45-49세,48663,25792,22871
202103,41220,경기도,평택시,45-49세,48513,25732,22781
202104,41220,경기도,평택시,45-49세,48572,25780,22792
202105,41220,경기도,평택시,45-49세,48436,25726,22710
202106,41220,경기도,평택시,45-49세,48334,25655,22679
202007,41220,경기도,평택시,50-54세,44944,23512,21432
202008,41220,경기도,평택시,50-54세,45244,23655,21589
202009,41220,경기도,평택시,50-54세,45439,23788,21651
202010,41220,경기도,평택시,50-54세,45769,23995,21774
202011,41220,경기도,평택시,50-54세,45978,24120,21858
202012,41220,경기도,평택시,50-54세,46075,24154,21921
202101,41220,경기도,평택시,50-54세,46650,24464,22186
202102,41220,경기도,평택시,50-54세,47016,24619,22397
202103,41220,경기도,평택시,50-54세,47006,24603,22403
202104,41220,경기도,평택시,50-54세,47257,24742,22515
202105,41220,경기도,평택시,50-54세,47704,24972,22732
202106,41220,경기도,평택시,50-54세,48009,25137,22872
202007,41220,경기도,평택시,55-59세,40417,21333,19084
202008,41220,경기도,평택시,55-59세,40447,21359,19088
202009,41220,경기도,평택시,55-59세,40502,21402,19100
202010,41220,경기도,평택시,55-59세,40614,21441,19173
202011,41220,경기도,평택시,55-59세,40696,21486,19210
202012,41220,경기도,평택시,55-59세,40838,21530,19308
202101,41220,경기도,평택시,55-59세,40812,21535,19277
202102,41220,경기도,평택시,55-59세,40946,21635,19311
202103,41220,경기도,평택시,55-59세,40784,21642,19142
202104,41220,경기도,평택시,55-59세,40740,21646,19094
202105,41220,경기도,평택시,55-59세,40691,21597,19094
202106,41220,경기도,평택시,55-59세,40560,21538,19022
202007,41220,경기도,평택시,60-64세,32115,16340,15775
202008,41220,경기도,평택시,60-64세,32392,16484,15908
202009,41220,경기도,평택시,60-64세,32698,16659,16039
202010,41220,경기도,평택시,60-64세,32972,16742,16230
202011,41220,경기도,평택시,60-64세,33305,16926,16379
202012,41220,경기도,평택시,60-64세,33614,17126,16488
202101,41220,경기도,평택시,60-64세,34052,17346,16706
202102,41220,경기도,평택시,60-64세,34505,17579,16926
202103,41220,경기도,평택시,60-64세,34503,17686,16817
202104,41220,경기도,평택시,60-64세,34807,17879,16928
202105,41220,경기도,평택시,60-64세,35238,18106,17132
202106,41220,경기도,평택시,60-64세,35696,18346,17350
202007,41220,경기도,평택시,65-69세,20519,9755,10764
202008,41220,경기도,평택시,65-69세,20713,9841,10872
202009,41220,경기도,평택시,65-69세,20928,9937,10991
202010,41220,경기도,평택시,65-69세,21144,10087,11057
202011,41220,경기도,평택시,65-69세,21343,10169,11174
202012,41220,경기도,평택시,65-69세,21595,10298,11297
202101,41220,경기도,평택시,65-69세,21843,10451,11392
202102,41220,경기도,평택시,65-69세,22043,10569,11474
202103,41220,경기도,평택시,65-69세,22202,10753,11449
202104,41220,경기도,평택시,65-69세,22410,10889,11521
202105,41220,경기도,평택시,65-69세,22611,10987,11624
202106,41220,경기도,평택시,65-69세,22774,11063,11711
202007,41220,경기도,평택시,70-74세,15344,6990,8354
202008,41220,경기도,평택시,70-74세,15364,7025,8339
202009,41220,경기도,평택시,70-74세,15431,7044,8387
202010,41220,경기도,평택시,70-74세,15524,7098,8426
202011,41220,경기도,평택시,70-74세,15631,7135,8496
202012,41220,경기도,평택시,70-74세,15775,7198,8577
202101,41220,경기도,평택시,70-74세,15928,7268,8660
202102,41220,경기도,평택시,70-74세,16017,7301,8716
202103,41220,경기도,평택시,70-74세,15855,7264,8591
202104,41220,경기도,평택시,70-74세,15895,7277,8618
202105,41220,경기도,평택시,70-74세,15913,7311,8602
202106,41220,경기도,평택시,70-74세,15912,7312,8600
202007,41220,경기도,평택시,75-79세,12941,5380,7561
202008,41220,경기도,평택시,75-79세,12965,5378,7587
202009,41220,경기도,평택시,75-79세,12936,5355,7581
202010,41220,경기도,평택시,75-79세,12897,5322,7575
202011,41220,경기도,평택시,75-79세,12887,5322,7565
202012,41220,경기도,평택시,75-79세,12779,5263,7516
202101,41220,경기도,평택시,75-79세,12747,5254,7493
202102,41220,경기도,평택시,75-79세,12707,5250,7457
202103,41220,경기도,평택시,75-79세,12603,5220,7383
202104,41220,경기도,평택시,75-79세,12540,5192,7348
202105,41220,경기도,평택시,75-79세,12532,5196,7336
202106,41220,경기도,평택시,75-79세,12559,5220,7339
202007,41220,경기도,평택시,80-84세,9308,3474,5834
202008,41220,경기도,평택시,80-84세,9344,3493,5851
202009,41220,경기도,평택시,80-84세,9362,3505,5857
202010,41220,경기도,평택시,80-84세,9367,3515,5852
202011,41220,경기도,평택시,80-84세,9386,3526,5860
202012,41220,경기도,평택시,80-84세,9445,3551,5894
202101,41220,경기도,평택시,80-84세,9506,3568,5938
202102,41220,경기도,평택시,80-84세,9581,3597,5984
202103,41220,경기도,평택시,80-84세,9502,3563,5939
202104,41220,경기도,평택시,80-84세,9549,3591,5958
202105,41220,경기도,평택시,80-84세,9616,3631,5985
202106,41220,경기도,평택시,80-84세,9690,3662,6028
202007,41220,경기도,평택시,85-89세,4339,1299,3040
202008,41220,경기도,평택시,85-89세,4402,1331,3071
202009,41220,경기도,평택시,85-89세,4457,1348,3109
202010,41220,경기도,평택시,85-89세,4517,1367,3150
202011,41220,경기도,평택시,85-89세,4570,1399,3171
202012,41220,경기도,평택시,85-89세,4651,1438,3213
202101,41220,경기도,평택시,85-89세,4707,1464,3243
202102,41220,경기도,평택시,85-89세,4767,1484,3283
202103,41220,경기도,평택시,85-89세,4798,1499,3299
202104,41220,경기도,평택시,85-89세,4844,1504,3340
202105,41220,경기도,평택시,85-89세,4895,1527,3368
202106,41220,경기도,평택시,85-89세,4906,1539,3367
202007,41220,경기도,평택시,90-94세,1507,389,1118
202008,41220,경기도,평택시,90-94세,1521,389,1132
202009,41220,경기도,평택시,90-94세,1558,395,1163
202010,41220,경기도,평택시,90-94세,1556,391,1165
202011,41220,경기도,평택시,90-94세,1585,392,1193
202012,41220,경기도,평택시,90-94세,1587,389,1198
202101,41220,경기도,평택시,90-94세,1593,387,1206
202102,41220,경기도,평택시,90-94세,1615,397,1218
202103,41220,경기도,평택시,90-94세,1575,375,1200
202104,41220,경기도,평택시,90-94세,1570,370,1200
202105,41220,경기도,평택시,90-94세,1579,365,1214
202106,41220,경기도,평택시,90-94세,1582,370,1212
202007,41220,경기도,평택시,95-99세,410,115,295
202008,41220,경기도,평택시,95-99세,416,114,302
202009,41220,경기도,평택시,95-99세,418,114,304
202010,41220,경기도,평택시,95-99세,422,113,309
202011,41220,경기도,평택시,95-99세,421,114,307
202012,41220,경기도,평택시,95-99세,421,113,308
202101,41220,경기도,평택시,95-99세,430,116,314
202102,41220,경기도,평택시,95-99세,433,119,314
202103,41220,경기도,평택시,95-99세,376,91,285
202104,41220,경기도,평택시,95-99세,374,88,286
202105,41220,경기도,평택시,95-99세,376,88,288
202106,41220,경기도,평택시,95-99세,377,88,289
202007,41220,경기도,평택시,100+,237,73,164
202008,41220,경기도,평택시,100+,237,74,163
202009,41220,경기도,평택시,100+,237,74,163
202010,41220,경기도,평택시,100+,235,74,161
202011,41220,경기도,평택시,100+,234,74,160
202012,41220,경기도,평택시,100+,233,73,160
202101,41220,경기도,평택시,100+,237,74,163
202102,41220,경기도,평택시,100+,238,74,164
202103,41220,경기도,평택시,100+,97,28,69
202104,41220,경기도,평택시,100+,91,25,66
202105,41220,경기도,평택시,100+,92,26,66
202106,41220,경기도,평택시,100+,91,26,65
202007,41250,경기도,동두천시,0-4세,2602,1348,1254
202008,41250,경기도,동두천시,0-4세,2566,1327,1239
202009,41250,경기도,동두천시,0-4세,2537,1307,1230
202010,41250,경기도,동두천시,0-4세,2525,1296,1229
202011,41250,경기도,동두천시,0-4세,2525,1301,1224
202012,41250,경기도,동두천시,0-4세,2488,1285,1203
202101,41250,경기도,동두천시,0-4세,2466,1275,1191
202102,41250,경기도,동두천시,0-4세,2433,1256,1177
202103,41250,경기도,동두천시,0-4세,2394,1231,1163
202104,41250,경기도,동두천시,0-4세,2353,1206,1147
202105,41250,경기도,동두천시,0-4세,2337,1198,1139
202106,41250,경기도,동두천시,0-4세,2310,1172,1138
202007,41250,경기도,동두천시,5-9세,3932,2050,1882
202008,41250,경기도,동두천시,5-9세,3911,2028,1883
202009,41250,경기도,동두천시,5-9세,3892,2016,1876
202010,41250,경기도,동두천시,5-9세,3848,1991,1857
202011,41250,경기도,동두천시,5-9세,3830,1985,1845
202012,41250,경기도,동두천시,5-9세,3810,1977,1833
202101,41250,경기도,동두천시,5-9세,3781,1959,1822
202102,41250,경기도,동두천시,5-9세,3749,1931,1818
202103,41250,경기도,동두천시,5-9세,3731,1932,1799
202104,41250,경기도,동두천시,5-9세,3704,1916,1788
202105,41250,경기도,동두천시,5-9세,3703,1917,1786
202106,41250,경기도,동두천시,5-9세,3694,1922,1772
202007,41250,경기도,동두천시,10-14세,4171,2052,2119
202008,41250,경기도,동두천시,10-14세,4166,2057,2109
202009,41250,경기도,동두천시,10-14세,4178,2070,2108
202010,41250,경기도,동두천시,10-14세,4211,2089,2122
202011,41250,경기도,동두천시,10-14세,4236,2109,2127
202012,41250,경기도,동두천시,10-14세,4258,2122,2136
202101,41250,경기도,동두천시,10-14세,4268,2119,2149
202102,41250,경기도,동두천시,10-14세,4239,2116,2123
202103,41250,경기도,동두천시,10-14세,4237,2107,2130
202104,41250,경기도,동두천시,10-14세,4267,2115,2152
202105,41250,경기도,동두천시,10-14세,4252,2104,2148
202106,41250,경기도,동두천시,10-14세,4252,2109,2143
202007,41250,경기도,동두천시,15-19세,4528,2314,2214
202008,41250,경기도,동두천시,15-19세,4494,2304,2190
202009,41250,경기도,동두천시,15-19세,4457,2287,2170
202010,41250,경기도,동두천시,15-19세,4411,2263,2148
202011,41250,경기도,동두천시,15-19세,4389,2249,2140
202012,41250,경기도,동두천시,15-19세,4346,2219,2127
202101,41250,경기도,동두천시,15-19세,4335,2213,2122
202102,41250,경기도,동두천시,15-19세,4295,2190,2105
202103,41250,경기도,동두천시,15-19세,4253,2167,2086
202104,41250,경기도,동두천시,15-19세,4244,2170,2074
202105,41250,경기도,동두천시,15-19세,4222,2160,2062
202106,41250,경기도,동두천시,15-19세,4216,2161,2055
202007,41250,경기도,동두천시,20-24세,5654,3035,2619
202008,41250,경기도,동두천시,20-24세,5648,3029,2619
202009,41250,경기도,동두천시,20-24세,5600,3003,2597
202010,41250,경기도,동두천시,20-24세,5597,2991,2606
202011,41250,경기도,동두천시,20-24세,5598,2997,2601
202012,41250,경기도,동두천시,20-24세,5614,3011,2603
202101,41250,경기도,동두천시,20-24세,5593,3002,2591
202102,41250,경기도,동두천시,20-24세,5578,2995,2583
202103,41250,경기도,동두천시,20-24세,5549,2975,2574
202104,41250,경기도,동두천시,20-24세,5519,2951,2568
202105,41250,경기도,동두천시,20-24세,5522,2941,2581
202106,41250,경기도,동두천시,20-24세,5514,2935,2579
202007,41250,경기도,동두천시,25-29세,5545,3057,2488
202008,41250,경기도,동두천시,25-29세,5570,3071,2499
202009,41250,경기도,동두천시,25-29세,5603,3091,2512
202010,41250,경기도,동두천시,25-29세,5610,3101,2509
202011,41250,경기도,동두천시,25-29세,5636,3109,2527
202012,41250,경기도,동두천시,25-29세,5689,3131,2558
202101,41250,경기도,동두천시,25-29세,5693,3138,2555
202102,41250,경기도,동두천시,25-29세,5694,3137,2557
202103,41250,경기도,동두천시,25-29세,5636,3118,2518
202104,41250,경기도,동두천시,25-29세,5638,3126,2512
202105,41250,경기도,동두천시,25-29세,5644,3130,2514
202106,41250,경기도,동두천시,25-29세,5643,3130,2513
202007,41250,경기도,동두천시,30-34세,4556,2439,2117
202008,41250,경기도,동두천시,30-34세,4547,2428,2119
202009,41250,경기도,동두천시,30-34세,4501,2395,2106
202010,41250,경기도,동두천시,30-34세,4540,2410,2130
202011,41250,경기도,동두천시,30-34세,4569,2413,2156
202012,41250,경기도,동두천시,30-34세,4566,2415,2151
202101,41250,경기도,동두천시,30-34세,4572,2407,2165
202102,41250,경기도,동두천시,30-34세,4565,2414,2151
202103,41250,경기도,동두천시,30-34세,4570,2412,2158
202104,41250,경기도,동두천시,30-34세,4543,2420,2123
202105,41250,경기도,동두천시,30-34세,4556,2425,2131
202106,41250,경기도,동두천시,30-34세,4593,2435,2158
202007,41250,경기도,동두천시,35-39세,5739,2879,2860
202008,41250,경기도,동두천시,35-39세,5703,2875,2828
202009,41250,경기도,동두천시,35-39세,5681,2868,2813
202010,41250,경기도,동두천시,35-39세,5640,2848,2792
202011,41250,경기도,동두천시,35-39세,5641,2852,2789
202012,41250,경기도,동두천시,35-39세,5649,2859,2790
202101,41250,경기도,동두천시,35-39세,5605,2829,2776
202102,41250,경기도,동두천시,35-39세,5538,2809,2729
202103,41250,경기도,동두천시,35-39세,5483,2786,2697
202104,41250,경기도,동두천시,35-39세,5450,2766,2684
202105,41250,경기도,동두천시,35-39세,5449,2770,2679
202106,41250,경기도,동두천시,35-39세,5420,2767,2653
202007,41250,경기도,동두천시,40-44세,6402,3325,3077
202008,41250,경기도,동두천시,40-44세,6413,3321,3092
202009,41250,경기도,동두천시,40-44세,6403,3309,3094
202010,41250,경기도,동두천시,40-44세,6384,3301,3083
202011,41250,경기도,동두천시,40-44세,6405,3304,3101
202012,41250,경기도,동두천시,40-44세,6391,3308,3083
202101,41250,경기도,동두천시,40-44세,6415,3321,3094
202102,41250,경기도,동두천시,40-44세,6401,3305,3096
202103,41250,경기도,동두천시,40-44세,6293,3253,3040
202104,41250,경기도,동두천시,40-44세,6289,3239,3050
202105,41250,경기도,동두천시,40-44세,6261,3233,3028
202106,41250,경기도,동두천시,40-44세,6263,3223,3040
202007,41250,경기도,동두천시,45-49세,8043,4118,3925
202008,41250,경기도,동두천시,45-49세,8016,4114,3902
202009,41250,경기도,동두천시,45-49세,7973,4103,3870
202010,41250,경기도,동두천시,45-49세,7942,4086,3856
202011,41250,경기도,동두천시,45-49세,7932,4093,3839
202012,41250,경기도,동두천시,45-49세,7943,4102,3841
202101,41250,경기도,동두천시,45-49세,7901,4097,3804
202102,41250,경기도,동두천시,45-49세,7868,4075,3793
202103,41250,경기도,동두천시,45-49세,7786,4034,3752
202104,41250,경기도,동두천시,45-49세,7761,4014,3747
202105,41250,경기도,동두천시,45-49세,7680,3966,3714
202106,41250,경기도,동두천시,45-49세,7664,3963,3701
202007,41250,경기도,동두천시,50-54세,8267,4459,3808
202008,41250,경기도,동두천시,50-54세,8286,4465,3821
202009,41250,경기도,동두천시,50-54세,8285,4453,3832
202010,41250,경기도,동두천시,50-54세,8314,4471,3843
202011,41250,경기도,동두천시,50-54세,8344,4475,3869
202012,41250,경기도,동두천시,50-54세,8346,4459,3887
202101,41250,경기도,동두천시,50-54세,8414,4474,3940
202102,41250,경기도,동두천시,50-54세,8439,4478,3961
202103,41250,경기도,동두천시,50-54세,8329,4408,3921
202104,41250,경기도,동두천시,50-54세,8368,4443,3925
202105,41250,경기도,동두천시,50-54세,8395,4464,3931
202106,41250,경기도,동두천시,50-54세,8413,4469,3944
202007,41250,경기도,동두천시,55-59세,8071,4170,3901
202008,41250,경기도,동두천시,55-59세,8080,4176,3904
202009,41250,경기도,동두천시,55-59세,8093,4173,3920
202010,41250,경기도,동두천시,55-59세,8087,4174,3913
202011,41250,경기도,동두천시,55-59세,8095,4192,3903
202012,41250,경기도,동두천시,55-59세,8135,4212,3923
202101,41250,경기도,동두천시,55-59세,8106,4203,3903
202102,41250,경기도,동두천시,55-59세,8079,4194,3885
202103,41250,경기도,동두천시,55-59세,7997,4181,3816
202104,41250,경기도,동두천시,55-59세,7970,4184,3786
202105,41250,경기도,동두천시,55-59세,7932,4165,3767
202106,41250,경기도,동두천시,55-59세,7920,4157,3763
202007,41250,경기도,동두천시,60-64세,7556,3773,3783
202008,41250,경기도,동두천시,60-64세,7581,3795,3786
202009,41250,경기도,동두천시,60-64세,7598,3815,3783
202010,41250,경기도,동두천시,60-64세,7620,3816,3804
202011,41250,경기도,동두천시,60-64세,7674,3838,3836
202012,41250,경기도,동두천시,60-64세,7721,3876,3845
202101,41250,경기도,동두천시,60-64세,7794,3921,3873
202102,41250,경기도,동두천시,60-64세,7840,3951,3889
202103,41250,경기도,동두천시,60-64세,7843,3952,3891
202104,41250,경기도,동두천시,60-64세,7865,3965,3900
202105,41250,경기도,동두천시,60-64세,7958,4007,3951
202106,41250,경기도,동두천시,60-64세,8018,4027,3991
202007,41250,경기도,동두천시,65-69세,5284,2489,2795
202008,41250,경기도,동두천시,65-69세,5315,2494,2821
202009,41250,경기도,동두천시,65-69세,5365,2521,2844
202010,41250,경기도,동두천시,65-69세,5397,2544,2853
202011,41250,경기도,동두천시,65-69세,5450,2566,2884
202012,41250,경기도,동두천시,65-69세,5504,2589,2915
202101,41250,경기도,동두천시,65-69세,5546,2616,2930
202102,41250,경기도,동두천시,65-69세,5606,2633,2973
202103,41250,경기도,동두천시,65-69세,5532,2639,2893
202104,41250,경기도,동두천시,65-69세,5601,2675,2926
202105,41250,경기도,동두천시,65-69세,5611,2677,2934
202106,41250,경기도,동두천시,65-69세,5651,2698,2953
202007,41250,경기도,동두천시,70-74세,4539,1976,2563
202008,41250,경기도,동두천시,70-74세,4558,1989,2569
202009,41250,경기도,동두천시,70-74세,4597,2006,2591
202010,41250,경기도,동두천시,70-74세,4629,2015,2614
202011,41250,경기도,동두천시,70-74세,4651,2017,2634
202012,41250,경기도,동두천시,70-74세,4656,2014,2642
202101,41250,경기도,동두천시,70-74세,4690,2033,2657
202102,41250,경기도,동두천시,70-74세,4695,2039,2656
202103,41250,경기도,동두천시,70-74세,4622,2020,2602
202104,41250,경기도,동두천시,70-74세,4611,2010,2601
202105,41250,경기도,동두천시,70-74세,4629,2023,2606
202106,41250,경기도,동두천시,70-74세,4630,2029,2601
202007,41250,경기도,동두천시,75-79세,4239,1693,2546
202008,41250,경기도,동두천시,75-79세,4226,1697,2529
202009,41250,경기도,동두천시,75-79세,4200,1688,2512
202010,41250,경기도,동두천시,75-79세,4173,1674,2499
202011,41250,경기도,동두천시,75-79세,4161,1655,2506
202012,41250,경기도,동두천시,75-79세,4143,1651,2492
202101,41250,경기도,동두천시,75-79세,4105,1636,2469
202102,41250,경기도,동두천시,75-79세,4095,1629,2466
202103,41250,경기도,동두천시,75-79세,4031,1616,2415
202104,41250,경기도,동두천시,75-79세,4006,1610,2396
202105,41250,경기도,동두천시,75-79세,4002,1603,2399
202106,41250,경기도,동두천시,75-79세,3988,1604,2384
202007,41250,경기도,동두천시,80-84세,2918,1109,1809
202008,41250,경기도,동두천시,80-84세,2929,1121,1808
202009,41250,경기도,동두천시,80-84세,2970,1133,1837
202010,41250,경기도,동두천시,80-84세,3011,1147,1864
202011,41250,경기도,동두천시,80-84세,3043,1164,1879
202012,41250,경기도,동두천시,80-84세,3052,1164,1888
202101,41250,경기도,동두천시,80-84세,3083,1177,1906
202102,41250,경기도,동두천시,80-84세,3107,1185,1922
202103,41250,경기도,동두천시,80-84세,3080,1168,1912
202104,41250,경기도,동두천시,80-84세,3100,1175,1925
202105,41250,경기도,동두천시,80-84세,3126,1192,1934
202106,41250,경기도,동두천시,80-84세,3137,1190,1947
202007,41250,경기도,동두천시,85-89세,1269,433,836
202008,41250,경기도,동두천시,85-89세,1282,432,850
202009,41250,경기도,동두천시,85-89세,1289,437,852
202010,41250,경기도,동두천시,85-89세,1288,440,848
202011,41250,경기도,동두천시,85-89세,1319,449,870
202012,41250,경기도,동두천시,85-89세,1335,449,886
202101,41250,경기도,동두천시,85-89세,1366,459,907
202102,41250,경기도,동두천시,85-89세,1386,472,914
202103,41250,경기도,동두천시,85-89세,1378,462,916
202104,41250,경기도,동두천시,85-89세,1391,464,927
202105,41250,경기도,동두천시,85-89세,1396,468,928
202106,41250,경기도,동두천시,85-89세,1408,471,937
202007,41250,경기도,동두천시,90-94세,476,131,345
202008,41250,경기도,동두천시,90-94세,482,134,348
202009,41250,경기도,동두천시,90-94세,483,134,349
202010,41250,경기도,동두천시,90-94세,488,135,353
202011,41250,경기도,동두천시,90-94세,500,138,362
202012,41250,경기도,동두천시,90-94세,503,142,361
202101,41250,경기도,동두천시,90-94세,505,144,361
202102,41250,경기도,동두천시,90-94세,504,141,363
202103,41250,경기도,동두천시,90-94세,481,133,348
202104,41250,경기도,동두천시,90-94세,482,135,347
202105,41250,경기도,동두천시,90-94세,490,137,353
202106,41250,경기도,동두천시,90-94세,496,140,356
202007,41250,경기도,동두천시,95-99세,113,36,77
202008,41250,경기도,동두천시,95-99세,113,36,77
202009,41250,경기도,동두천시,95-99세,113,36,77
202010,41250,경기도,동두천시,95-99세,116,35,81
202011,41250,경기도,동두천시,95-99세,117,34,83
202012,41250,경기도,동두천시,95-99세,119,33,86
202101,41250,경기도,동두천시,95-99세,120,33,87
202102,41250,경기도,동두천시,95-99세,121,33,88
202103,41250,경기도,동두천시,95-99세,99,24,75
202104,41250,경기도,동두천시,95-99세,100,23,77
202105,41250,경기도,동두천시,95-99세,101,23,78
202106,41250,경기도,동두천시,95-99세,98,21,77
202007,41250,경기도,동두천시,100+,81,18,63
202008,41250,경기도,동두천시,100+,82,19,63
202009,41250,경기도,동두천시,100+,83,18,65
202010,41250,경기도,동두천시,100+,84,19,65
202011,41250,경기도,동두천시,100+,84,19,65
202012,41250,경기도,동두천시,100+,85,20,65
202101,41250,경기도,동두천시,100+,85,21,64
202102,41250,경기도,동두천시,100+,86,22,64
202103,41250,경기도,동두천시,100+,27,3,24
202104,41250,경기도,동두천시,100+,27,3,24
202105,41250,경기도,동두천시,100+,26,3,23
202106,41250,경기도,동두천시,100+,26,3,23
202007,41271,경기도,안산시 상록구,0-4세,10014,5067,4947
202008,41271,경기도,안산시 상록구,0-4세,9885,5011,4874
202009,41271,경기도,안산시 상록구,0-4세,9774,4962,4812
202010,41271,경기도,안산시 상록구,0-4세,9683,4908,4775
202011,41271,경기도,안산시 상록구,0-4세,9759,4945,4814
202012,41271,경기도,안산시 상록구,0-4세,9781,4953,4828
202101,41271,경기도,안산시 상록구,0-4세,9748,4952,4796
202102,41271,경기도,안산시 상록구,0-4세,9637,4894,4743
202103,41271,경기도,안산시 상록구,0-4세,9581,4884,4697
202104,41271,경기도,안산시 상록구,0-4세,9479,4830,4649
202105,41271,경기도,안산시 상록구,0-4세,9370,4774,4596
202106,41271,경기도,안산시 상록구,0-4세,9252,4706,4546
202007,41271,경기도,안산시 상록구,5-9세,13884,7097,6787
202008,41271,경기도,안산시 상록구,5-9세,13849,7051,6798
202009,41271,경기도,안산시 상록구,5-9세,13767,7022,6745
202010,41271,경기도,안산시 상록구,5-9세,13715,6986,6729
202011,41271,경기도,안산시 상록구,5-9세,13837,7028,6809
202012,41271,경기도,안산시 상록구,5-9세,13915,7060,6855
202101,41271,경기도,안산시 상록구,5-9세,13877,7044,6833
202102,41271,경기도,안산시 상록구,5-9세,13804,7003,6801
202103,41271,경기도,안산시 상록구,5-9세,13757,6967,6790
202104,41271,경기도,안산시 상록구,5-9세,13719,6948,6771
202105,41271,경기도,안산시 상록구,5-9세,13661,6930,6731
202106,41271,경기도,안산시 상록구,5-9세,13631,6926,6705
202007,41271,경기도,안산시 상록구,10-14세,15221,7767,7454
202008,41271,경기도,안산시 상록구,10-14세,15165,7764,7401
202009,41271,경기도,안산시 상록구,10-14세,15132,7732,7400
202010,41271,경기도,안산시 상록구,10-14세,15108,7739,7369
202011,41271,경기도,안산시 상록구,10-14세,15241,7799,7442
202012,41271,경기도,안산시 상록구,10-14세,15335,7846,7489
202101,41271,경기도,안산시 상록구,10-14세,15406,7883,7523
202102,41271,경기도,안산시 상록구,10-14세,15407,7885,7522
202103,41271,경기도,안산시 상록구,10-14세,15416,7894,7522
202104,41271,경기도,안산시 상록구,10-14세,15424,7889,7535
202105,41271,경기도,안산시 상록구,10-14세,15427,7885,7542
202106,41271,경기도,안산시 상록구,10-14세,15429,7887,7542
202007,41271,경기도,안산시 상록구,15-19세,19622,10051,9571
202008,41271,경기도,안산시 상록구,15-19세,19502,9980,9522
202009,41271,경기도,안산시 상록구,15-19세,19329,9889,9440
202010,41271,경기도,안산시 상록구,15-19세,19133,9779,9354
202011,41271,경기도,안산시 상록구,15-19세,19032,9738,9294
202012,41271,경기도,안산시 상록구,15-19세,18957,9709,9248
202101,41271,경기도,안산시 상록구,15-19세,18851,9645,9206
202102,41271,경기도,안산시 상록구,15-19세,18674,9571,9103
202103,41271,경기도,안산시 상록구,15-19세,18862,9669,9193
202104,41271,경기도,안산시 상록구,15-19세,18855,9677,9178
202105,41271,경기도,안산시 상록구,15-19세,18678,9599,9079
202106,41271,경기도,안산시 상록구,15-19세,18489,9501,8988
202007,41271,경기도,안산시 상록구,20-24세,28369,14938,13431
202008,41271,경기도,안산시 상록구,20-24세,28268,14858,13410
202009,41271,경기도,안산시 상록구,20-24세,28211,14826,13385
202010,41271,경기도,안산시 상록구,20-24세,28115,14769,13346
202011,41271,경기도,안산시 상록구,20-24세,28228,14820,13408
202012,41271,경기도,안산시 상록구,20-24세,28253,14822,13431
202101,41271,경기도,안산시 상록구,20-24세,28247,14842,13405
202102,41271,경기도,안산시 상록구,20-24세,28205,14812,13393
202103,41271,경기도,안산시 상록구,20-24세,28627,15042,13585
202104,41271,경기도,안산시 상록구,20-24세,28736,15068,13668
202105,41271,경기도,안산시 상록구,20-24세,28665,14994,13671
202106,41271,경기도,안산시 상록구,20-24세,28472,14863,13609
202007,41271,경기도,안산시 상록구,25-29세,29265,15740,13525
202008,41271,경기도,안산시 상록구,25-29세,29297,15804,13493
202009,41271,경기도,안산시 상록구,25-29세,29299,15803,13496
202010,41271,경기도,안산시 상록구,25-29세,29376,15882,13494
202011,41271,경기도,안산시 상록구,25-29세,29598,16011,13587
202012,41271,경기도,안산시 상록구,25-29세,29898,16179,13719
202101,41271,경기도,안산시 상록구,25-29세,30109,16279,13830
202102,41271,경기도,안산시 상록구,25-29세,30153,16324,13829
202103,41271,경기도,안산시 상록구,25-29세,30281,16419,13862
202104,41271,경기도,안산시 상록구,25-29세,30326,16421,13905
202105,41271,경기도,안산시 상록구,25-29세,30355,16453,13902
202106,41271,경기도,안산시 상록구,25-29세,30336,16464,13872
202007,41271,경기도,안산시 상록구,30-34세,21146,11610,9536
202008,41271,경기도,안산시 상록구,30-34세,21108,11590,9518
202009,41271,경기도,안산시 상록구,30-34세,21170,11634,9536
202010,41271,경기도,안산시 상록구,30-34세,21153,11615,9538
202011,41271,경기도,안산시 상록구,30-34세,21317,11702,9615
202012,41271,경기도,안산시 상록구,30-34세,21424,11796,9628
202101,41271,경기도,안산시 상록구,30-34세,21527,11867,9660
202102,41271,경기도,안산시 상록구,30-34세,21644,11922,9722
202103,41271,경기도,안산시 상록구,30-34세,21689,11940,9749
202104,41271,경기도,안산시 상록구,30-34세,21704,11970,9734
202105,41271,경기도,안산시 상록구,30-34세,21819,12022,9797
202106,41271,경기도,안산시 상록구,30-34세,21879,12050,9829
202007,41271,경기도,안산시 상록구,35-39세,22996,12247,10749
202008,41271,경기도,안산시 상록구,35-39세,22878,12202,10676
202009,41271,경기도,안산시 상록구,35-39세,22654,12103,10551
202010,41271,경기도,안산시 상록구,35-39세,22577,12079,10498
202011,41271,경기도,안산시 상록구,35-39세,22756,12183,10573
202012,41271,경기도,안산시 상록구,35-39세,22888,12241,10647
202101,41271,경기도,안산시 상록구,35-39세,22870,12222,10648
202102,41271,경기도,안산시 상록구,35-39세,22698,12161,10537
202103,41271,경기도,안산시 상록구,35-39세,22551,12069,10482
202104,41271,경기도,안산시 상록구,35-39세,22430,11999,10431
202105,41271,경기도,안산시 상록구,35-39세,22337,11929,10408
202106,41271,경기도,안산시 상록구,35-39세,22273,11910,10363
202007,41271,경기도,안산시 상록구,40-44세,25319,13081,12238
202008,41271,경기도,안산시 상록구,40-44세,25293,13078,12215
202009,41271,경기도,안산시 상록구,40-44세,25322,13094,12228
202010,41271,경기도,안산시 상록구,40-44세,25311,13092,12219
202011,41271,경기도,안산시 상록구,40-44세,25487,13199,12288
202012,41271,경기도,안산시 상록구,40-44세,25485,13191,12294
202101,41271,경기도,안산시 상록구,40-44세,25450,13174,12276
202102,41271,경기도,안산시 상록구,40-44세,25441,13192,12249
202103,41271,경기도,안산시 상록구,40-44세,25369,13166,12203
202104,41271,경기도,안산시 상록구,40-44세,25290,13139,12151
202105,41271,경기도,안산시 상록구,40-44세,25307,13161,12146
202106,41271,경기도,안산시 상록구,40-44세,25335,13189,12146
202007,41271,경기도,안산시 상록구,45-49세,33109,16499,16610
202008,41271,경기도,안산시 상록구,45-49세,32923,16412,16511
202009,41271,경기도,안산시 상록구,45-49세,32758,16340,16418
202010,41271,경기도,안산시 상록구,45-49세,32467,16202,16265
202011,41271,경기도,안산시 상록구,45-49세,32487,16208,16279
202012,41271,경기도,안산시 상록구,45-49세,32594,16291,16303
202101,41271,경기도,안산시 상록구,45-49세,32572,16313,16259
202102,41271,경기도,안산시 상록구,45-49세,32444,16234,16210
202103,41271,경기도,안산시 상록구,45-49세,32175,16113,16062
202104,41271,경기도,안산시 상록구,45-49세,32069,16102,15967
202105,41271,경기도,안산시 상록구,45-49세,31741,15928,15813
202106,41271,경기도,안산시 상록구,45-49세,31522,15813,15709
202007,41271,경기도,안산시 상록구,50-54세,36017,17992,18025
202008,41271,경기도,안산시 상록구,50-54세,36068,17971,18097
202009,41271,경기도,안산시 상록구,50-54세,36121,18013,18108
202010,41271,경기도,안산시 상록구,50-54세,36173,18017,18156
202011,41271,경기도,안산시 상록구,50-54세,36397,18086,18311
202012,41271,경기도,안산시 상록구,50-54세,36380,18077,18303
202101,41271,경기도,안산시 상록구,50-54세,36667,18206,18461
202102,41271,경기도,안산시 상록구,50-54세,36677,18190,18487
202103,41271,경기도,안산시 상록구,50-54세,36522,18107,18415
202104,41271,경기도,안산시 상록구,50-54세,36512,18108,18404
202105,41271,경기도,안산시 상록구,50-54세,36630,18153,18477
202106,41271,경기도,안산시 상록구,50-54세,36692,18197,18495
202007,41271,경기도,안산시 상록구,55-59세,32181,16945,15236
202008,41271,경기도,안산시 상록구,55-59세,32181,16964,15217
202009,41271,경기도,안산시 상록구,55-59세,32194,16961,15233
202010,41271,경기도,안산시 상록구,55-59세,32250,16979,15271
202011,41271,경기도,안산시 상록구,55-59세,32430,17082,15348
202012,41271,경기도,안산시 상록구,55-59세,32680,17193,15487
202101,41271,경기도,안산시 상록구,55-59세,32574,17135,15439
202102,41271,경기도,안산시 상록구,55-59세,32632,17165,15467
202103,41271,경기도,안산시 상록구,55-59세,32635,17151,15484
202104,41271,경기도,안산시 상록구,55-59세,32648,17113,15535
202105,41271,경기도,안산시 상록구,55-59세,32601,17094,15507
202106,41271,경기도,안산시 상록구,55-59세,32449,16970,15479
202007,41271,경기도,안산시 상록구,60-64세,23295,12349,10946
202008,41271,경기도,안산시 상록구,60-64세,23509,12445,11064
202009,41271,경기도,안산시 상록구,60-64세,23717,12532,11185
202010,41271,경기도,안산시 상록구,60-64세,23866,12615,11251
202011,41271,경기도,안산시 상록구,60-64세,24197,12799,11398
202012,41271,경기도,안산시 상록구,60-64세,24485,12938,11547
202101,41271,경기도,안산시 상록구,60-64세,24878,13118,11760
202102,41271,경기도,안산시 상록구,60-64세,25194,13305,11889
202103,41271,경기도,안산시 상록구,60-64세,25485,13482,12003
202104,41271,경기도,안산시 상록구,60-64세,25743,13619,12124
202105,41271,경기도,안산시 상록구,60-64세,25991,13722,12269
202106,41271,경기도,안산시 상록구,60-64세,26272,13883,12389
202007,41271,경기도,안산시 상록구,65-69세,12833,6414,6419
202008,41271,경기도,안산시 상록구,65-69세,12939,6470,6469
202009,41271,경기도,안산시 상록구,65-69세,13075,6546,6529
202010,41271,경기도,안산시 상록구,65-69세,13161,6575,6586
202011,41271,경기도,안산시 상록구,65-69세,13321,6661,6660
202012,41271,경기도,안산시 상록구,65-69세,13459,6735,6724
202101,41271,경기도,안산시 상록구,65-69세,13628,6856,6772
202102,41271,경기도,안산시 상록구,65-69세,13774,6921,6853
202103,41271,경기도,안산시 상록구,65-69세,13953,6993,6960
202104,41271,경기도,안산시 상록구,65-69세,14080,7063,7017
202105,41271,경기도,안산시 상록구,65-69세,14212,7168,7044
202106,41271,경기도,안산시 상록구,65-69세,14303,7225,7078
202007,41271,경기도,안산시 상록구,70-74세,9040,4202,4838
202008,41271,경기도,안산시 상록구,70-74세,9087,4230,4857
202009,41271,경기도,안산시 상록구,70-74세,9120,4247,4873
202010,41271,경기도,안산시 상록구,70-74세,9171,4276,4895
202011,41271,경기도,안산시 상록구,70-74세,9201,4303,4898
202012,41271,경기도,안산시 상록구,70-74세,9275,4329,4946
202101,41271,경기도,안산시 상록구,70-74세,9339,4367,4972
202102,41271,경기도,안산시 상록구,70-74세,9363,4372,4991
202103,41271,경기도,안산시 상록구,70-74세,9364,4371,4993
202104,41271,경기도,안산시 상록구,70-74세,9378,4385,4993
202105,41271,경기도,안산시 상록구,70-74세,9369,4370,4999
202106,41271,경기도,안산시 상록구,70-74세,9371,4370,5001
202007,41271,경기도,안산시 상록구,75-79세,7568,3067,4501
202008,41271,경기도,안산시 상록구,75-79세,7582,3080,4502
202009,41271,경기도,안산시 상록구,75-79세,7550,3077,4473
202010,41271,경기도,안산시 상록구,75-79세,7539,3074,4465
202011,41271,경기도,안산시 상록구,75-79세,7552,3067,4485
202012,41271,경기도,안산시 상록구,75-79세,7529,3054,4475
202101,41271,경기도,안산시 상록구,75-79세,7531,3048,4483
202102,41271,경기도,안산시 상록구,75-79세,7498,3055,4443
202103,41271,경기도,안산시 상록구,75-79세,7495,3081,4414
202104,41271,경기도,안산시 상록구,75-79세,7492,3066,4426
202105,41271,경기도,안산시 상록구,75-79세,7491,3082,4409
202106,41271,경기도,안산시 상록구,75-79세,7524,3100,4424
202007,41271,경기도,안산시 상록구,80-84세,5342,1857,3485
202008,41271,경기도,안산시 상록구,80-84세,5358,1854,3504
202009,41271,경기도,안산시 상록구,80-84세,5397,1878,3519
202010,41271,경기도,안산시 상록구,80-84세,5410,1892,3518
202011,41271,경기도,안산시 상록구,80-84세,5419,1899,3520
202012,41271,경기도,안산시 상록구,80-84세,5408,1906,3502
202101,41271,경기도,안산시 상록구,80-84세,5439,1916,3523
202102,41271,경기도,안산시 상록구,80-84세,5477,1932,3545
202103,41271,경기도,안산시 상록구,80-84세,5471,1918,3553
202104,41271,경기도,안산시 상록구,80-84세,5503,1934,3569
202105,41271,경기도,안산시 상록구,80-84세,5561,1952,3609
202106,41271,경기도,안산시 상록구,80-84세,5597,1962,3635
202007,41271,경기도,안산시 상록구,85-89세,2708,816,1892
202008,41271,경기도,안산시 상록구,85-89세,2738,826,1912
202009,41271,경기도,안산시 상록구,85-89세,2757,824,1933
202010,41271,경기도,안산시 상록구,85-89세,2779,821,1958
202011,41271,경기도,안산시 상록구,85-89세,2798,832,1966
202012,41271,경기도,안산시 상록구,85-89세,2850,847,2003
202101,41271,경기도,안산시 상록구,85-89세,2879,850,2029
202102,41271,경기도,안산시 상록구,85-89세,2916,853,2063
202103,41271,경기도,안산시 상록구,85-89세,2968,878,2090
202104,41271,경기도,안산시 상록구,85-89세,2995,893,2102
202105,41271,경기도,안산시 상록구,85-89세,3021,895,2126
202106,41271,경기도,안산시 상록구,85-89세,3015,900,2115
202007,41271,경기도,안산시 상록구,90-94세,957,208,749
202008,41271,경기도,안산시 상록구,90-94세,967,214,753
202009,41271,경기도,안산시 상록구,90-94세,983,224,759
202010,41271,경기도,안산시 상록구,90-94세,975,224,751
202011,41271,경기도,안산시 상록구,90-94세,979,222,757
202012,41271,경기도,안산시 상록구,90-94세,982,221,761
202101,41271,경기도,안산시 상록구,90-94세,987,225,762
202102,41271,경기도,안산시 상록구,90-94세,995,232,763
202103,41271,경기도,안산시 상록구,90-94세,996,235,761
202104,41271,경기도,안산시 상록구,90-94세,1002,238,764
202105,41271,경기도,안산시 상록구,90-94세,1013,240,773
202106,41271,경기도,안산시 상록구,90-94세,1005,233,772
202007,41271,경기도,안산시 상록구,95-99세,236,49,187
202008,41271,경기도,안산시 상록구,95-99세,234,47,187
202009,41271,경기도,안산시 상록구,95-99세,236,46,190
202010,41271,경기도,안산시 상록구,95-99세,234,45,189
202011,41271,경기도,안산시 상록구,95-99세,236,46,190
202012,41271,경기도,안산시 상록구,95-99세,241,48,193
202101,41271,경기도,안산시 상록구,95-99세,249,50,199
202102,41271,경기도,안산시 상록구,95-99세,257,49,208
202103,41271,경기도,안산시 상록구,95-99세,258,50,208
202104,41271,경기도,안산시 상록구,95-99세,267,52,215
202105,41271,경기도,안산시 상록구,95-99세,276,56,220
202106,41271,경기도,안산시 상록구,95-99세,278,54,224
202007,41271,경기도,안산시 상록구,100+,67,14,53
202008,41271,경기도,안산시 상록구,100+,67,14,53
202009,41271,경기도,안산시 상록구,100+,69,14,55
202010,41271,경기도,안산시 상록구,100+,69,15,54
202011,41271,경기도,안산시 상록구,100+,70,16,54
202012,41271,경기도,안산시 상록구,100+,69,16,53
202101,41271,경기도,안산시 상록구,100+,69,16,53
202102,41271,경기도,안산시 상록구,100+,72,17,55
202103,41271,경기도,안산시 상록구,100+,53,12,41
202104,41271,경기도,안산시 상록구,100+,50,12,38
202105,41271,경기도,안산시 상록구,100+,50,12,38
202106,41271,경기도,안산시 상록구,100+,50,12,38
202007,41273,경기도,안산시 단원구,0-4세,9563,4915,4648
202008,41273,경기도,안산시 단원구,0-4세,9476,4870,4606
202009,41273,경기도,안산시 단원구,0-4세,9455,4862,4593
202010,41273,경기도,안산시 단원구,0-4세,9426,4828,4598
202011,41273,경기도,안산시 단원구,0-4세,9326,4791,4535
202012,41273,경기도,안산시 단원구,0-4세,9283,4785,4498
202101,41273,경기도,안산시 단원구,0-4세,9149,4708,4441
202102,41273,경기도,안산시 단원구,0-4세,9116,4695,4421
202103,41273,경기도,안산시 단원구,0-4세,9041,4684,4357
202104,41273,경기도,안산시 단원구,0-4세,9027,4674,4353
202105,41273,경기도,안산시 단원구,0-4세,8989,4658,4331
202106,41273,경기도,안산시 단원구,0-4세,8974,4669,4305
202007,41273,경기도,안산시 단원구,5-9세,12122,6124,5998
202008,41273,경기도,안산시 단원구,5-9세,12093,6118,5975
202009,41273,경기도,안산시 단원구,5-9세,12035,6091,5944
202010,41273,경기도,안산시 단원구,5-9세,12018,6088,5930
202011,41273,경기도,안산시 단원구,5-9세,11800,5984,5816
202012,41273,경기도,안산시 단원구,5-9세,11653,5920,5733
202101,41273,경기도,안산시 단원구,5-9세,11600,5900,5700
202102,41273,경기도,안산시 단원구,5-9세,11482,5844,5638
202103,41273,경기도,안산시 단원구,5-9세,11443,5817,5626
202104,41273,경기도,안산시 단원구,5-9세,11402,5813,5589
202105,41273,경기도,안산시 단원구,5-9세,11366,5784,5582
202106,41273,경기도,안산시 단원구,5-9세,11324,5738,5586
202007,41273,경기도,안산시 단원구,10-14세,13558,7066,6492
202008,41273,경기도,안산시 단원구,10-14세,13543,7052,6491
202009,41273,경기도,안산시 단원구,10-14세,13572,7075,6497
202010,41273,경기도,안산시 단원구,10-14세,13600,7096,6504
202011,41273,경기도,안산시 단원구,10-14세,13550,7054,6496
202012,41273,경기도,안산시 단원구,10-14세,13501,7030,6471
202101,41273,경기도,안산시 단원구,10-14세,13479,7010,6469
202102,41273,경기도,안산시 단원구,10-14세,13436,6991,6445
202103,41273,경기도,안산시 단원구,10-14세,13403,6973,6430
202104,41273,경기도,안산시 단원구,10-14세,13380,6964,6416
202105,41273,경기도,안산시 단원구,10-14세,13378,6978,6400
202106,41273,경기도,안산시 단원구,10-14세,13380,6969,6411
202007,41273,경기도,안산시 단원구,15-19세,17170,8883,8287
202008,41273,경기도,안산시 단원구,15-19세,17032,8813,8219
202009,41273,경기도,안산시 단원구,15-19세,16823,8694,8129
202010,41273,경기도,안산시 단원구,15-19세,16680,8612,8068
202011,41273,경기도,안산시 단원구,15-19세,16462,8500,7962
202012,41273,경기도,안산시 단원구,15-19세,16252,8408,7844
202101,41273,경기도,안산시 단원구,15-19세,16121,8322,7799
202102,41273,경기도,안산시 단원구,15-19세,15975,8236,7739
202103,41273,경기도,안산시 단원구,15-19세,15808,8157,7651
202104,41273,경기도,안산시 단원구,15-19세,15678,8095,7583
202105,41273,경기도,안산시 단원구,15-19세,15570,8039,7531
202106,41273,경기도,안산시 단원구,15-19세,15461,7978,7483
202007,41273,경기도,안산시 단원구,20-24세,23404,12282,11122
202008,41273,경기도,안산시 단원구,20-24세,23354,12252,11102
202009,41273,경기도,안산시 단원구,20-24세,23324,12243,11081
202010,41273,경기도,안산시 단원구,20-24세,23257,12223,11034
202011,41273,경기도,안산시 단원구,20-24세,23100,12121,10979
202012,41273,경기도,안산시 단원구,20-24세,23016,12074,10942
202101,41273,경기도,안산시 단원구,20-24세,22906,12035,10871
202102,41273,경기도,안산시 단원구,20-24세,22885,12019,10866
202103,41273,경기도,안산시 단원구,20-24세,22863,12012,10851
202104,41273,경기도,안산시 단원구,20-24세,22807,11989,10818
202105,41273,경기도,안산시 단원구,20-24세,22706,11951,10755
202106,41273,경기도,안산시 단원구,20-24세,22673,11948,10725
202007,41273,경기도,안산시 단원구,25-29세,25060,13471,11589
202008,41273,경기도,안산시 단원구,25-29세,25121,13501,11620
202009,41273,경기도,안산시 단원구,25-29세,25224,13543,11681
202010,41273,경기도,안산시 단원구,25-29세,25329,13577,11752
202011,41273,경기도,안산시 단원구,25-29세,25292,13580,11712
202012,41273,경기도,안산시 단원구,25-29세,25320,13591,11729
202101,41273,경기도,안산시 단원구,25-29세,25328,13570,11758
202102,41273,경기도,안산시 단원구,25-29세,25322,13596,11726
202103,41273,경기도,안산시 단원구,25-29세,25366,13604,11762
202104,41273,경기도,안산시 단원구,25-29세,25385,13615,11770
202105,41273,경기도,안산시 단원구,25-29세,25353,13609,11744
202106,41273,경기도,안산시 단원구,25-29세,25317,13555,11762
202007,41273,경기도,안산시 단원구,30-34세,20419,11253,9166
202008,41273,경기도,안산시 단원구,30-34세,20425,11253,9172
202009,41273,경기도,안산시 단원구,30-34세,20447,11279,9168
202010,41273,경기도,안산시 단원구,30-34세,20493,11318,9175
202011,41273,경기도,안산시 단원구,30-34세,20484,11331,9153
202012,41273,경기도,안산시 단원구,30-34세,20479,11370,9109
202101,41273,경기도,안산시 단원구,30-34세,20496,11363,9133
202102,41273,경기도,안산시 단원구,30-34세,20492,11353,9139
202103,41273,경기도,안산시 단원구,30-34세,20581,11426,9155
202104,41273,경기도,안산시 단원구,30-34세,20610,11435,9175
202105,41273,경기도,안산시 단원구,30-34세,20686,11462,9224
202106,41273,경기도,안산시 단원구,30-34세,20771,11540,9231
202007,41273,경기도,안산시 단원구,35-39세,21558,11669,9889
202008,41273,경기도,안산시 단원구,35-39세,21471,11638,9833
202009,41273,경기도,안산시 단원구,35-39세,21340,11571,9769
202010,41273,경기도,안산시 단원구,35-39세,21221,11495,9726
202011,41273,경기도,안산시 단원구,35-39세,21058,11415,9643
202012,41273,경기도,안산시 단원구,35-39세,20952,11339,9613
202101,41273,경기도,안산시 단원구,35-39세,20895,11339,9556
202102,41273,경기도,안산시 단원구,35-39세,20806,11309,9497
202103,41273,경기도,안산시 단원구,35-39세,20669,11243,9426
202104,41273,경기도,안산시 단원구,35-39세,20569,11162,9407
202105,41273,경기도,안산시 단원구,35-39세,20442,11107,9335
202106,41273,경기도,안산시 단원구,35-39세,20305,11018,9287
202007,41273,경기도,안산시 단원구,40-44세,22604,11717,10887
202008,41273,경기도,안산시 단원구,40-44세,22539,11681,10858
202009,41273,경기도,안산시 단원구,40-44세,22553,11665,10888
202010,41273,경기도,안산시 단원구,40-44세,22665,11739,10926
202011,41273,경기도,안산시 단원구,40-44세,22549,11717,10832
202012,41273,경기도,안산시 단원구,40-44세,22352,11648,10704
202101,41273,경기도,안산시 단원구,40-44세,22298,11642,10656
202102,41273,경기도,안산시 단원구,40-44세,22333,11680,10653
202103,41273,경기도,안산시 단원구,40-44세,22226,11652,10574
202104,41273,경기도,안산시 단원구,40-44세,22178,11633,10545
202105,41273,경기도,안산시 단원구,40-44세,22195,11652,10543
202106,41273,경기도,안산시 단원구,40-44세,22353,11754,10599
202007,41273,경기도,안산시 단원구,45-49세,28681,14504,14177
202008,41273,경기도,안산시 단원구,45-49세,28605,14493,14112
202009,41273,경기도,안산시 단원구,45-49세,28432,14403,14029
202010,41273,경기도,안산시 단원구,45-49세,28369,14404,13965
202011,41273,경기도,안산시 단원구,45-49세,28079,14249,13830
202012,41273,경기도,안산시 단원구,45-49세,27928,14190,13738
202101,41273,경기도,안산시 단원구,45-49세,27782,14133,13649
202102,41273,경기도,안산시 단원구,45-49세,27634,14068,13566
202103,41273,경기도,안산시 단원구,45-49세,27409,13945,13464
202104,41273,경기도,안산시 단원구,45-49세,27302,13877,13425
202105,41273,경기도,안산시 단원구,45-49세,27030,13726,13304
202106,41273,경기도,안산시 단원구,45-49세,26851,13633,13218
202007,41273,경기도,안산시 단원구,50-54세,30487,15386,15101
202008,41273,경기도,안산시 단원구,50-54세,30557,15403,15154
202009,41273,경기도,안산시 단원구,50-54세,30608,15417,15191
202010,41273,경기도,안산시 단원구,50-54세,30644,15403,15241
202011,41273,경기도,안산시 단원구,50-54세,30508,15333,15175
202012,41273,경기도,안산시 단원구,50-54세,30338,15231,15107
202101,41273,경기도,안산시 단원구,50-54세,30430,15267,15163
202102,41273,경기도,안산시 단원구,50-54세,30450,15249,15201
202103,41273,경기도,안산시 단원구,50-54세,30356,15187,15169
202104,41273,경기도,안산시 단원구,50-54세,30353,15160,15193
202105,41273,경기도,안산시 단원구,50-54세,30538,15252,15286
202106,41273,경기도,안산시 단원구,50-54세,30590,15267,15323
202007,41273,경기도,안산시 단원구,55-59세,28505,15014,13491
202008,41273,경기도,안산시 단원구,55-59세,28518,15005,13513
202009,41273,경기도,안산시 단원구,55-59세,28524,15003,13521
202010,41273,경기도,안산시 단원구,55-59세,28528,14985,13543
202011,41273,경기도,안산시 단원구,55-59세,28444,14921,13523
202012,41273,경기도,안산시 단원구,55-59세,28373,14873,13500
202101,41273,경기도,안산시 단원구,55-59세,28233,14787,13446
202102,41273,경기도,안산시 단원구,55-59세,28222,14803,13419
202103,41273,경기도,안산시 단원구,55-59세,28209,14796,13413
202104,41273,경기도,안산시 단원구,55-59세,28151,14772,13379
202105,41273,경기도,안산시 단원구,55-59세,28066,14728,13338
202106,41273,경기도,안산시 단원구,55-59세,27921,14658,13263
202007,41273,경기도,안산시 단원구,60-64세,20841,11197,9644
202008,41273,경기도,안산시 단원구,60-64세,21016,11304,9712
202009,41273,경기도,안산시 단원구,60-64세,21252,11419,9833
202010,41273,경기도,안산시 단원구,60-64세,21422,11520,9902
202011,41273,경기도,안산시 단원구,60-64세,21583,11595,9988
202012,41273,경기도,안산시 단원구,60-64세,21773,11672,10101
202101,41273,경기도,안산시 단원구,60-64세,22027,11822,10205
202102,41273,경기도,안산시 단원구,60-64세,22276,11931,10345
202103,41273,경기도,안산시 단원구,60-64세,22511,12057,10454
202104,41273,경기도,안산시 단원구,60-64세,22693,12169,10524
202105,41273,경기도,안산시 단원구,60-64세,22846,12243,10603
202106,41273,경기도,안산시 단원구,60-64세,23039,12345,10694
202007,41273,경기도,안산시 단원구,65-69세,11238,5782,5456
202008,41273,경기도,안산시 단원구,65-69세,11341,5846,5495
202009,41273,경기도,안산시 단원구,65-69세,11451,5914,5537
202010,41273,경기도,안산시 단원구,65-69세,11575,5990,5585
202011,41273,경기도,안산시 단원구,65-69세,11670,6046,5624
202012,41273,경기도,안산시 단원구,65-69세,11754,6088,5666
202101,41273,경기도,안산시 단원구,65-69세,11917,6166,5751
202102,41273,경기도,안산시 단원구,65-69세,12053,6220,5833
202103,41273,경기도,안산시 단원구,65-69세,12239,6314,5925
202104,41273,경기도,안산시 단원구,65-69세,12346,6340,6006
202105,41273,경기도,안산시 단원구,65-69세,12478,6388,6090
202106,41273,경기도,안산시 단원구,65-69세,12570,6438,6132
202007,41273,경기도,안산시 단원구,70-74세,7307,3524,3783
202008,41273,경기도,안산시 단원구,70-74세,7310,3512,3798
202009,41273,경기도,안산시 단원구,70-74세,7382,3559,3823
202010,41273,경기도,안산시 단원구,70-74세,7437,3576,3861
202011,41273,경기도,안산시 단원구,70-74세,7509,3605,3904
202012,41273,경기도,안산시 단원구,70-74세,7572,3642,3930
202101,41273,경기도,안산시 단원구,70-74세,7639,3678,3961
202102,41273,경기도,안산시 단원구,70-74세,7681,3703,3978
202103,41273,경기도,안산시 단원구,70-74세,7689,3712,3977
202104,41273,경기도,안산시 단원구,70-74세,7679,3725,3954
202105,41273,경기도,안산시 단원구,70-74세,7714,3748,3966
202106,41273,경기도,안산시 단원구,70-74세,7738,3764,3974
202007,41273,경기도,안산시 단원구,75-79세,5446,2293,3153
202008,41273,경기도,안산시 단원구,75-79세,5461,2301,3160
202009,41273,경기도,안산시 단원구,75-79세,5443,2297,3146
202010,41273,경기도,안산시 단원구,75-79세,5430,2280,3150
202011,41273,경기도,안산시 단원구,75-79세,5415,2273,3142
202012,41273,경기도,안산시 단원구,75-79세,5404,2274,3130
202101,41273,경기도,안산시 단원구,75-79세,5409,2279,3130
202102,41273,경기도,안산시 단원구,75-79세,5369,2286,3083
202103,41273,경기도,안산시 단원구,75-79세,5350,2280,3070
202104,41273,경기도,안산시 단원구,75-79세,5348,2291,3057
202105,41273,경기도,안산시 단원구,75-79세,5358,2303,3055
202106,41273,경기도,안산시 단원구,75-79세,5340,2301,3039
202007,41273,경기도,안산시 단원구,80-84세,4006,1428,2578
202008,41273,경기도,안산시 단원구,80-84세,4010,1429,2581
202009,41273,경기도,안산시 단원구,80-84세,3989,1421,2568
202010,41273,경기도,안산시 단원구,80-84세,3968,1424,2544
202011,41273,경기도,안산시 단원구,80-84세,3975,1427,2548
202012,41273,경기도,안산시 단원구,80-84세,3989,1433,2556
202101,41273,경기도,안산시 단원구,80-84세,4012,1448,2564
202102,41273,경기도,안산시 단원구,80-84세,4061,1462,2599
202103,41273,경기도,안산시 단원구,80-84세,4056,1470,2586
202104,41273,경기도,안산시 단원구,80-84세,4040,1456,2584
202105,41273,경기도,안산시 단원구,80-84세,4051,1457,2594
202106,41273,경기도,안산시 단원구,80-84세,4088,1455,2633
202007,41273,경기도,안산시 단원구,85-89세,2022,549,1473
202008,41273,경기도,안산시 단원구,85-89세,2041,553,1488
202009,41273,경기도,안산시 단원구,85-89세,2077,569,1508
202010,41273,경기도,안산시 단원구,85-89세,2114,583,1531
202011,41273,경기도,안산시 단원구,85-89세,2122,584,1538
202012,41273,경기도,안산시 단원구,85-89세,2146,589,1557
202101,41273,경기도,안산시 단원구,85-89세,2174,590,1584
202102,41273,경기도,안산시 단원구,85-89세,2197,593,1604
202103,41273,경기도,안산시 단원구,85-89세,2210,589,1621
202104,41273,경기도,안산시 단원구,85-89세,2234,601,1633
202105,41273,경기도,안산시 단원구,85-89세,2271,614,1657
202106,41273,경기도,안산시 단원구,85-89세,2290,621,1669
202007,41273,경기도,안산시 단원구,90-94세,701,141,560
202008,41273,경기도,안산시 단원구,90-94세,700,140,560
202009,41273,경기도,안산시 단원구,90-94세,709,142,567
202010,41273,경기도,안산시 단원구,90-94세,712,139,573
202011,41273,경기도,안산시 단원구,90-94세,711,141,570
202012,41273,경기도,안산시 단원구,90-94세,713,142,571
202101,41273,경기도,안산시 단원구,90-94세,717,145,572
202102,41273,경기도,안산시 단원구,90-94세,723,145,578
202103,41273,경기도,안산시 단원구,90-94세,725,139,586
202104,41273,경기도,안산시 단원구,90-94세,726,137,589
202105,41273,경기도,안산시 단원구,90-94세,737,138,599
202106,41273,경기도,안산시 단원구,90-94세,743,138,605
202007,41273,경기도,안산시 단원구,95-99세,154,37,117
202008,41273,경기도,안산시 단원구,95-99세,163,38,125
202009,41273,경기도,안산시 단원구,95-99세,170,38,132
202010,41273,경기도,안산시 단원구,95-99세,169,35,134
202011,41273,경기도,안산시 단원구,95-99세,168,36,132
202012,41273,경기도,안산시 단원구,95-99세,166,37,129
202101,41273,경기도,안산시 단원구,95-99세,161,37,124
202102,41273,경기도,안산시 단원구,95-99세,162,37,125
202103,41273,경기도,안산시 단원구,95-99세,157,35,122
202104,41273,경기도,안산시 단원구,95-99세,165,36,129
202105,41273,경기도,안산시 단원구,95-99세,165,38,127
202106,41273,경기도,안산시 단원구,95-99세,171,38,133
202007,41273,경기도,안산시 단원구,100+,58,14,44
202008,41273,경기도,안산시 단원구,100+,59,15,44
202009,41273,경기도,안산시 단원구,100+,60,15,45
202010,41273,경기도,안산시 단원구,100+,61,15,46
202011,41273,경기도,안산시 단원구,100+,63,16,47
202012,41273,경기도,안산시 단원구,100+,63,16,47
202101,41273,경기도,안산시 단원구,100+,63,16,47
202102,41273,경기도,안산시 단원구,100+,63,16,47
202103,41273,경기도,안산시 단원구,100+,40,9,31
202104,41273,경기도,안산시 단원구,100+,41,9,32
202105,41273,경기도,안산시 단원구,100+,41,9,32
202106,41273,경기도,안산시 단원구,100+,42,9,33
202007,41281,경기도,고양시 덕양구,0-4세,17347,8823,8524
202008,41281,경기도,고양시 덕양구,0-4세,17203,8750,8453
202009,41281,경기도,고양시 덕양구,0-4세,17015,8656,8359
202010,41281,경기도,고양시 덕양구,0-4세,16961,8609,8352
202011,41281,경기도,고양시 덕양구,0-4세,17052,8656,8396
202012,41281,경기도,고양시 덕양구,0-4세,16966,8617,8349
202101,41281,경기도,고양시 덕양구,0-4세,16902,8573,8329
202102,41281,경기도,고양시 덕양구,0-4세,16826,8552,8274
202103,41281,경기도,고양시 덕양구,0-4세,16824,8566,8258
202104,41281,경기도,고양시 덕양구,0-4세,16725,8510,8215
202105,41281,경기도,고양시 덕양구,0-4세,16582,8441,8141
202106,41281,경기도,고양시 덕양구,0-4세,16455,8377,8078
202007,41281,경기도,고양시 덕양구,5-9세,21753,11094,10659
202008,41281,경기도,고양시 덕양구,5-9세,21621,11025,10596
202009,41281,경기도,고양시 덕양구,5-9세,21597,11035,10562
202010,41281,경기도,고양시 덕양구,5-9세,21626,11036,10590
202011,41281,경기도,고양시 덕양구,5-9세,21585,11027,10558
202012,41281,경기도,고양시 덕양구,5-9세,21616,11071,10545
202101,41281,경기도,고양시 덕양구,5-9세,21615,11084,10531
202102,41281,경기도,고양시 덕양구,5-9세,21680,11094,10586
202103,41281,경기도,고양시 덕양구,5-9세,21699,11115,10584
202104,41281,경기도,고양시 덕양구,5-9세,21723,11116,10607
202105,41281,경기도,고양시 덕양구,5-9세,21693,11073,10620
202106,41281,경기도,고양시 덕양구,5-9세,21674,11064,10610
202007,41281,경기도,고양시 덕양구,10-14세,20032,10232,9800
202008,41281,경기도,고양시 덕양구,10-14세,20035,10249,9786
202009,41281,경기도,고양시 덕양구,10-14세,20069,10262,9807
202010,41281,경기도,고양시 덕양구,10-14세,20112,10296,9816
202011,41281,경기도,고양시 덕양구,10-14세,20243,10364,9879
202012,41281,경기도,고양시 덕양구,10-14세,20282,10356,9926
202101,41281,경기도,고양시 덕양구,10-14세,20389,10402,9987
202102,41281,경기도,고양시 덕양구,10-14세,20397,10424,9973
202103,41281,경기도,고양시 덕양구,10-14세,20396,10451,9945
202104,41281,경기도,고양시 덕양구,10-14세,20444,10470,9974
202105,41281,경기도,고양시 덕양구,10-14세,20488,10484,10004
202106,41281,경기도,고양시 덕양구,10-14세,20558,10528,10030
202007,41281,경기도,고양시 덕양구,15-19세,21919,11263,10656
202008,41281,경기도,고양시 덕양구,15-19세,21738,11164,10574
202009,41281,경기도,고양시 덕양구,15-19세,21532,11032,10500
202010,41281,경기도,고양시 덕양구,15-19세,21423,10975,10448
202011,41281,경기도,고양시 덕양구,15-19세,21305,10896,10409
202012,41281,경기도,고양시 덕양구,15-19세,21231,10874,10357
202101,41281,경기도,고양시 덕양구,15-19세,21079,10801,10278
202102,41281,경기도,고양시 덕양구,15-19세,21002,10759,10243
202103,41281,경기도,고양시 덕양구,15-19세,20911,10652,10259
202104,41281,경기도,고양시 덕양구,15-19세,20851,10629,10222
202105,41281,경기도,고양시 덕양구,15-19세,20766,10592,10174
202106,41281,경기도,고양시 덕양구,15-19세,20640,10527,10113
202007,41281,경기도,고양시 덕양구,20-24세,29865,15572,14293
202008,41281,경기도,고양시 덕양구,20-24세,29740,15504,14236
202009,41281,경기도,고양시 덕양구,20-24세,29548,15409,14139
202010,41281,경기도,고양시 덕양구,20-24세,29531,15385,14146
202011,41281,경기도,고양시 덕양구,20-24세,29503,15342,14161
202012,41281,경기도,고양시 덕양구,20-24세,29396,15254,14142
202101,41281,경기도,고양시 덕양구,20-24세,29312,15201,14111
202102,41281,경기도,고양시 덕양구,20-24세,29294,15204,14090
202103,41281,경기도,고양시 덕양구,20-24세,29159,15147,14012
202104,41281,경기도,고양시 덕양구,20-24세,29081,15105,13976
202105,41281,경기도,고양시 덕양구,20-24세,29015,15054,13961
202106,41281,경기도,고양시 덕양구,20-24세,28916,15009,13907
202007,41281,경기도,고양시 덕양구,25-29세,33052,16982,16070
202008,41281,경기도,고양시 덕양구,25-29세,33010,16954,16056
202009,41281,경기도,고양시 덕양구,25-29세,33175,17088,16087
202010,41281,경기도,고양시 덕양구,25-29세,33266,17117,16149
202011,41281,경기도,고양시 덕양구,25-29세,33391,17216,16175
202012,41281,경기도,고양시 덕양구,25-29세,33483,17256,16227
202101,41281,경기도,고양시 덕양구,25-29세,33475,17271,16204
202102,41281,경기도,고양시 덕양구,25-29세,33480,17249,16231
202103,41281,경기도,고양시 덕양구,25-29세,33596,17329,16267
202104,41281,경기도,고양시 덕양구,25-29세,33555,17298,16257
202105,41281,경기도,고양시 덕양구,25-29세,33544,17300,16244
202106,41281,경기도,고양시 덕양구,25-29세,33534,17306,16228
202007,41281,경기도,고양시 덕양구,30-34세,30551,15331,15220
202008,41281,경기도,고양시 덕양구,30-34세,30536,15307,15229
202009,41281,경기도,고양시 덕양구,30-34세,30586,15320,15266
202010,41281,경기도,고양시 덕양구,30-34세,30699,15380,15319
202011,41281,경기도,고양시 덕양구,30-34세,30930,15488,15442
202012,41281,경기도,고양시 덕양구,30-34세,31056,15593,15463
202101,41281,경기도,고양시 덕양구,30-34세,31220,15613,15607
202102,41281,경기도,고양시 덕양구,30-34세,31337,15638,15699
202103,41281,경기도,고양시 덕양구,30-34세,31553,15749,15804
202104,41281,경기도,고양시 덕양구,30-34세,31667,15813,15854
202105,41281,경기도,고양시 덕양구,30-34세,31801,15877,15924
202106,41281,경기도,고양시 덕양구,30-34세,31964,15948,16016
202007,41281,경기도,고양시 덕양구,35-39세,36710,18532,18178
202008,41281,경기도,고양시 덕양구,35-39세,36587,18475,18112
202009,41281,경기도,고양시 덕양구,35-39세,36475,18446,18029
202010,41281,경기도,고양시 덕양구,35-39세,36575,18534,18041
202011,41281,경기도,고양시 덕양구,35-39세,36785,18653,18132
202012,41281,경기도,고양시 덕양구,35-39세,36844,18688,18156
202101,41281,경기도,고양시 덕양구,35-39세,36965,18741,18224
202102,41281,경기도,고양시 덕양구,35-39세,37036,18801,18235
202103,41281,경기도,고양시 덕양구,35-39세,36875,18727,18148
202104,41281,경기도,고양시 덕양구,35-39세,36830,18706,18124
202105,41281,경기도,고양시 덕양구,35-39세,36721,18670,18051
202106,41281,경기도,고양시 덕양구,35-39세,36505,18570,17935
202007,41281,경기도,고양시 덕양구,40-44세,36759,18559,18200
202008,41281,경기도,고양시 덕양구,40-44세,36660,18510,18150
202009,41281,경기도,고양시 덕양구,40-44세,36679,18506,18173
202010,41281,경기도,고양시 덕양구,40-44세,36832,18553,18279
202011,41281,경기도,고양시 덕양구,40-44세,37063,18692,18371
202012,41281,경기도,고양시 덕양구,40-44세,37099,18699,18400
202101,41281,경기도,고양시 덕양구,40-44세,37307,18788,18519
202102,41281,경기도,고양시 덕양구,40-44세,37450,18851,18599
202103,41281,경기도,고양시 덕양구,40-44세,37489,18870,18619
202104,41281,경기도,고양시 덕양구,40-44세,37616,18934,18682
202105,41281,경기도,고양시 덕양구,40-44세,37783,19015,18768
202106,41281,경기도,고양시 덕양구,40-44세,38009,19111,18898
202007,41281,경기도,고양시 덕양구,45-49세,42317,21151,21166
202008,41281,경기도,고양시 덕양구,45-49세,42101,21032,21069
202009,41281,경기도,고양시 덕양구,45-49세,41816,20878,20938
202010,41281,경기도,고양시 덕양구,45-49세,41711,20882,20829
202011,41281,경기도,고양시 덕양구,45-49세,41690,20838,20852
202012,41281,경기도,고양시 덕양구,45-49세,41655,20809,20846
202101,41281,경기도,고양시 덕양구,45-49세,41505,20750,20755
202102,41281,경기도,고양시 덕양구,45-49세,41492,20722,20770
202103,41281,경기도,고양시 덕양구,45-49세,41273,20599,20674
202104,41281,경기도,고양시 덕양구,45-49세,41238,20579,20659
202105,41281,경기도,고양시 덕양구,45-49세,40922,20431,20491
202106,41281,경기도,고양시 덕양구,45-49세,40694,20306,20388
202007,41281,경기도,고양시 덕양구,50-54세,41991,20711,21280
202008,41281,경기도,고양시 덕양구,50-54세,42019,20712,21307
202009,41281,경기도,고양시 덕양구,50-54세,42109,20769,21340
202010,41281,경기도,고양시 덕양구,50-54세,42243,20807,21436
202011,41281,경기도,고양시 덕양구,50-54세,42324,20880,21444
202012,41281,경기도,고양시 덕양구,50-54세,42238,20864,21374
202101,41281,경기도,고양시 덕양구,50-54세,42532,21015,21517
202102,41281,경기도,고양시 덕양구,50-54세,42757,21162,21595
202103,41281,경기도,고양시 덕양구,50-54세,42781,21173,21608
202104,41281,경기도,고양시 덕양구,50-54세,42855,21218,21637
202105,41281,경기도,고양시 덕양구,50-54세,43141,21336,21805
202106,41281,경기도,고양시 덕양구,50-54세,43254,21396,21858
202007,41281,경기도,고양시 덕양구,55-59세,40268,20315,19953
202008,41281,경기도,고양시 덕양구,55-59세,40347,20350,19997
202009,41281,경기도,고양시 덕양구,55-59세,40340,20320,20020
202010,41281,경기도,고양시 덕양구,55-59세,40340,20306,20034
202011,41281,경기도,고양시 덕양구,55-59세,40409,20310,20099
202012,41281,경기도,고양시 덕양구,55-59세,40511,20295,20216
202101,41281,경기도,고양시 덕양구,55-59세,40376,20273,20103
202102,41281,경기도,고양시 덕양구,55-59세,40425,20277,20148
202103,41281,경기도,고양시 덕양구,55-59세,40379,20280,20099
202104,41281,경기도,고양시 덕양구,55-59세,40360,20235,20125
202105,41281,경기도,고양시 덕양구,55-59세,40301,20255,20046
202106,41281,경기도,고양시 덕양구,55-59세,40157,20157,20000
202007,41281,경기도,고양시 덕양구,60-64세,33544,16891,16653
202008,41281,경기도,고양시 덕양구,60-64세,33774,17007,16767
202009,41281,경기도,고양시 덕양구,60-64세,33992,17128,16864
202010,41281,경기도,고양시 덕양구,60-64세,34201,17219,16982
202011,41281,경기도,고양시 덕양구,60-64세,34466,17348,17118
202012,41281,경기도,고양시 덕양구,60-64세,34652,17452,17200
202101,41281,경기도,고양시 덕양구,60-64세,34939,17546,17393
202102,41281,경기도,고양시 덕양구,60-64세,35232,17678,17554
202103,41281,경기도,고양시 덕양구,60-64세,35465,17775,17690
202104,41281,경기도,고양시 덕양구,60-64세,35746,17933,17813
202105,41281,경기도,고양시 덕양구,60-64세,35954,17999,17955
202106,41281,경기도,고양시 덕양구,60-64세,36281,18201,18080
202007,41281,경기도,고양시 덕양구,65-69세,21153,10251,10902
202008,41281,경기도,고양시 덕양구,65-69세,21317,10342,10975
202009,41281,경기도,고양시 덕양구,65-69세,21520,10434,11086
202010,41281,경기도,고양시 덕양구,65-69세,21802,10551,11251
202011,41281,경기도,고양시 덕양구,65-69세,22027,10657,11370
202012,41281,경기도,고양시 덕양구,65-69세,22234,10767,11467
202101,41281,경기도,고양시 덕양구,65-69세,22582,10970,11612
202102,41281,경기도,고양시 덕양구,65-69세,22826,11080,11746
202103,41281,경기도,고양시 덕양구,65-69세,23097,11194,11903
202104,41281,경기도,고양시 덕양구,65-69세,23276,11277,11999
202105,41281,경기도,고양시 덕양구,65-69세,23509,11385,12124
202106,41281,경기도,고양시 덕양구,65-69세,23728,11482,12246
202007,41281,경기도,고양시 덕양구,70-74세,16285,7279,9006
202008,41281,경기도,고양시 덕양구,70-74세,16283,7284,8999
202009,41281,경기도,고양시 덕양구,70-74세,16358,7316,9042
202010,41281,경기도,고양시 덕양구,70-74세,16492,7384,9108
202011,41281,경기도,고양시 덕양구,70-74세,16593,7432,9161
202012,41281,경기도,고양시 덕양구,70-74세,16634,7430,9204
202101,41281,경기도,고양시 덕양구,70-74세,16765,7503,9262
202102,41281,경기도,고양시 덕양구,70-74세,16814,7506,9308
202103,41281,경기도,고양시 덕양구,70-74세,16701,7487,9214
202104,41281,경기도,고양시 덕양구,70-74세,16669,7458,9211
202105,41281,경기도,고양시 덕양구,70-74세,16604,7459,9145
202106,41281,경기도,고양시 덕양구,70-74세,16573,7437,9136
202007,41281,경기도,고양시 덕양구,75-79세,13886,5719,8167
202008,41281,경기도,고양시 덕양구,75-79세,13927,5745,8182
202009,41281,경기도,고양시 덕양구,75-79세,13847,5696,8151
202010,41281,경기도,고양시 덕양구,75-79세,13832,5706,8126
202011,41281,경기도,고양시 덕양구,75-79세,13832,5699,8133
202012,41281,경기도,고양시 덕양구,75-79세,13783,5688,8095
202101,41281,경기도,고양시 덕양구,75-79세,13747,5662,8085
202102,41281,경기도,고양시 덕양구,75-79세,13734,5676,8058
202103,41281,경기도,고양시 덕양구,75-79세,13649,5637,8012
202104,41281,경기도,고양시 덕양구,75-79세,13669,5657,8012
202105,41281,경기도,고양시 덕양구,75-79세,13707,5667,8040
202106,41281,경기도,고양시 덕양구,75-79세,13694,5673,8021
202007,41281,경기도,고양시 덕양구,80-84세,9848,3745,6103
202008,41281,경기도,고양시 덕양구,80-84세,9872,3747,6125
202009,41281,경기도,고양시 덕양구,80-84세,9957,3801,6156
202010,41281,경기도,고양시 덕양구,80-84세,9975,3815,6160
202011,41281,경기도,고양시 덕양구,80-84세,10050,3836,6214
202012,41281,경기도,고양시 덕양구,80-84세,10122,3880,6242
202101,41281,경기도,고양시 덕양구,80-84세,10182,3908,6274
202102,41281,경기도,고양시 덕양구,80-84세,10244,3934,6310
202103,41281,경기도,고양시 덕양구,80-84세,10248,3919,6329
202104,41281,경기도,고양시 덕양구,80-84세,10257,3925,6332
202105,41281,경기도,고양시 덕양구,80-84세,10277,3943,6334
202106,41281,경기도,고양시 덕양구,80-84세,10382,3996,6386
202007,41281,경기도,고양시 덕양구,85-89세,4638,1507,3131
202008,41281,경기도,고양시 덕양구,85-89세,4697,1535,3162
202009,41281,경기도,고양시 덕양구,85-89세,4740,1553,3187
202010,41281,경기도,고양시 덕양구,85-89세,4780,1564,3216
202011,41281,경기도,고양시 덕양구,85-89세,4831,1583,3248
202012,41281,경기도,고양시 덕양구,85-89세,4869,1604,3265
202101,41281,경기도,고양시 덕양구,85-89세,4937,1618,3319
202102,41281,경기도,고양시 덕양구,85-89세,5026,1654,3372
202103,41281,경기도,고양시 덕양구,85-89세,5056,1660,3396
202104,41281,경기도,고양시 덕양구,85-89세,5070,1677,3393
202105,41281,경기도,고양시 덕양구,85-89세,5146,1695,3451
202106,41281,경기도,고양시 덕양구,85-89세,5171,1685,3486
202007,41281,경기도,고양시 덕양구,90-94세,1618,396,1222
202008,41281,경기도,고양시 덕양구,90-94세,1645,398,1247
202009,41281,경기도,고양시 덕양구,90-94세,1660,400,1260
202010,41281,경기도,고양시 덕양구,90-94세,1674,398,1276
202011,41281,경기도,고양시 덕양구,90-94세,1678,406,1272
202012,41281,경기도,고양시 덕양구,90-94세,1693,413,1280
202101,41281,경기도,고양시 덕양구,90-94세,1706,423,1283
202102,41281,경기도,고양시 덕양구,90-94세,1731,437,1294
202103,41281,경기도,고양시 덕양구,90-94세,1725,428,1297
202104,41281,경기도,고양시 덕양구,90-94세,1740,426,1314
202105,41281,경기도,고양시 덕양구,90-94세,1738,427,1311
202106,41281,경기도,고양시 덕양구,90-94세,1738,430,1308
202007,41281,경기도,고양시 덕양구,95-99세,373,106,267
202008,41281,경기도,고양시 덕양구,95-99세,369,103,266
202009,41281,경기도,고양시 덕양구,95-99세,369,103,266
202010,41281,경기도,고양시 덕양구,95-99세,372,103,269
202011,41281,경기도,고양시 덕양구,95-99세,373,102,271
202012,41281,경기도,고양시 덕양구,95-99세,384,103,281
202101,41281,경기도,고양시 덕양구,95-99세,394,104,290
202102,41281,경기도,고양시 덕양구,95-99세,395,106,289
202103,41281,경기도,고양시 덕양구,95-99세,353,84,269
202104,41281,경기도,고양시 덕양구,95-99세,363,86,277
202105,41281,경기도,고양시 덕양구,95-99세,371,86,285
202106,41281,경기도,고양시 덕양구,95-99세,366,86,280
202007,41281,경기도,고양시 덕양구,100+,209,55,154
202008,41281,경기도,고양시 덕양구,100+,208,56,152
202009,41281,경기도,고양시 덕양구,100+,210,57,153
202010,41281,경기도,고양시 덕양구,100+,211,60,151
202011,41281,경기도,고양시 덕양구,100+,211,60,151
202012,41281,경기도,고양시 덕양구,100+,214,60,154
202101,41281,경기도,고양시 덕양구,100+,218,61,157
202102,41281,경기도,고양시 덕양구,100+,217,58,159
202103,41281,경기도,고양시 덕양구,100+,94,23,71
202104,41281,경기도,고양시 덕양구,100+,93,22,71
202105,41281,경기도,고양시 덕양구,100+,93,22,71
202106,41281,경기도,고양시 덕양구,100+,93,23,70
202007,41285,경기도,고양시 일산동구,0-4세,8733,4460,4273
202008,41285,경기도,고양시 일산동구,0-4세,8593,4400,4193
202009,41285,경기도,고양시 일산동구,0-4세,8524,4351,4173
202010,41285,경기도,고양시 일산동구,0-4세,8455,4310,4145
202011,41285,경기도,고양시 일산동구,0-4세,8403,4280,4123
202012,41285,경기도,고양시 일산동구,0-4세,8461,4307,4154
202101,41285,경기도,고양시 일산동구,0-4세,8447,4317,4130
202102,41285,경기도,고양시 일산동구,0-4세,8427,4286,4141
202103,41285,경기도,고양시 일산동구,0-4세,8344,4248,4096
202104,41285,경기도,고양시 일산동구,0-4세,8321,4219,4102
202105,41285,경기도,고양시 일산동구,0-4세,8269,4201,4068
202106,41285,경기도,고양시 일산동구,0-4세,8185,4154,4031
202007,41285,경기도,고양시 일산동구,5-9세,12646,6480,6166
202008,41285,경기도,고양시 일산동구,5-9세,12609,6466,6143
202009,41285,경기도,고양시 일산동구,5-9세,12534,6429,6105
202010,41285,경기도,고양시 일산동구,5-9세,12428,6383,6045
202011,41285,경기도,고양시 일산동구,5-9세,12371,6343,6028
202012,41285,경기도,고양시 일산동구,5-9세,12399,6349,6050
202101,41285,경기도,고양시 일산동구,5-9세,12421,6361,6060
202102,41285,경기도,고양시 일산동구,5-9세,12409,6358,6051
202103,41285,경기도,고양시 일산동구,5-9세,12368,6347,6021
202104,41285,경기도,고양시 일산동구,5-9세,12375,6366,6009
202105,41285,경기도,고양시 일산동구,5-9세,12322,6359,5963
202106,41285,경기도,고양시 일산동구,5-9세,12298,6359,5939
202007,41285,경기도,고양시 일산동구,10-14세,13728,7102,6626
202008,41285,경기도,고양시 일산동구,10-14세,13770,7122,6648
202009,41285,경기도,고양시 일산동구,10-14세,13763,7135,6628
202010,41285,경기도,고양시 일산동구,10-14세,13823,7162,6661
202011,41285,경기도,고양시 일산동구,10-14세,13811,7162,6649
202012,41285,경기도,고양시 일산동구,10-14세,13827,7172,6655
202101,41285,경기도,고양시 일산동구,10-14세,13906,7230,6676
202102,41285,경기도,고양시 일산동구,10-14세,13905,7234,6671
202103,41285,경기도,고양시 일산동구,10-14세,13874,7205,6669
202104,41285,경기도,고양시 일산동구,10-14세,13843,7178,6665
202105,41285,경기도,고양시 일산동구,10-14세,13839,7169,6670
202106,41285,경기도,고양시 일산동구,10-14세,13825,7159,6666
202007,41285,경기도,고양시 일산동구,15-19세,16389,8490,7899
202008,41285,경기도,고양시 일산동구,15-19세,16241,8403,7838
202009,41285,경기도,고양시 일산동구,15-19세,16094,8315,7779
202010,41285,경기도,고양시 일산동구,15-19세,15973,8263,7710
202011,41285,경기도,고양시 일산동구,15-19세,15858,8182,7676
202012,41285,경기도,고양시 일산동구,15-19세,15798,8133,7665
202101,41285,경기도,고양시 일산동구,15-19세,15712,8067,7645
202102,41285,경기도,고양시 일산동구,15-19세,15623,8032,7591
202103,41285,경기도,고양시 일산동구,15-19세,15455,7950,7505
202104,41285,경기도,고양시 일산동구,15-19세,15361,7868,7493
202105,41285,경기도,고양시 일산동구,15-19세,15273,7814,7459
202106,41285,경기도,고양시 일산동구,15-19세,15199,7756,7443
202007,41285,경기도,고양시 일산동구,20-24세,21637,10950,10687
202008,41285,경기도,고양시 일산동구,20-24세,21615,10919,10696
202009,41285,경기도,고양시 일산동구,20-24세,21574,10889,10685
202010,41285,경기도,고양시 일산동구,20-24세,21446,10807,10639
202011,41285,경기도,고양시 일산동구,20-24세,21404,10828,10576
202012,41285,경기도,고양시 일산동구,20-24세,21367,10811,10556
202101,41285,경기도,고양시 일산동구,20-24세,21364,10818,10546
202102,41285,경기도,고양시 일산동구,20-24세,21322,10768,10554
202103,41285,경기도,고양시 일산동구,20-24세,21286,10746,10540
202104,41285,경기도,고양시 일산동구,20-24세,21215,10735,10480
202105,41285,경기도,고양시 일산동구,20-24세,21205,10709,10496
202106,41285,경기도,고양시 일산동구,20-24세,21131,10694,10437
202007,41285,경기도,고양시 일산동구,25-29세,23321,11654,11667
202008,41285,경기도,고양시 일산동구,25-29세,23314,11674,11640
202009,41285,경기도,고양시 일산동구,25-29세,23405,11728,11677
202010,41285,경기도,고양시 일산동구,25-29세,23473,11795,11678
202011,41285,경기도,고양시 일산동구,25-29세,23539,11816,11723
202012,41285,경기도,고양시 일산동구,25-29세,23659,11899,11760
202101,41285,경기도,고양시 일산동구,25-29세,23688,11891,11797
202102,41285,경기도,고양시 일산동구,25-29세,23626,11877,11749
202103,41285,경기도,고양시 일산동구,25-29세,23619,11885,11734
202104,41285,경기도,고양시 일산동구,25-29세,23543,11823,11720
202105,41285,경기도,고양시 일산동구,25-29세,23534,11831,11703
202106,41285,경기도,고양시 일산동구,25-29세,23525,11796,11729
202007,41285,경기도,고양시 일산동구,30-34세,18367,8982,9385
202008,41285,경기도,고양시 일산동구,30-34세,18362,9009,9353
202009,41285,경기도,고양시 일산동구,30-34세,18281,8977,9304
202010,41285,경기도,고양시 일산동구,30-34세,18254,8950,9304
202011,41285,경기도,고양시 일산동구,30-34세,18265,8959,9306
202012,41285,경기도,고양시 일산동구,30-34세,18418,9033,9385
202101,41285,경기도,고양시 일산동구,30-34세,18601,9100,9501
202102,41285,경기도,고양시 일산동구,30-34세,18672,9129,9543
202103,41285,경기도,고양시 일산동구,30-34세,18698,9155,9543
202104,41285,경기도,고양시 일산동구,30-34세,18751,9187,9564
202105,41285,경기도,고양시 일산동구,30-34세,18791,9236,9555
202106,41285,경기도,고양시 일산동구,30-34세,18827,9259,9568
202007,41285,경기도,고양시 일산동구,35-39세,20142,9724,10418
202008,41285,경기도,고양시 일산동구,35-39세,20007,9658,10349
202009,41285,경기도,고양시 일산동구,35-39세,19941,9654,10287
202010,41285,경기도,고양시 일산동구,35-39세,19871,9623,10248
202011,41285,경기도,고양시 일산동구,35-39세,19854,9621,10233
202012,41285,경기도,고양시 일산동구,35-39세,20013,9727,10286
202101,41285,경기도,고양시 일산동구,35-39세,20057,9758,10299
202102,41285,경기도,고양시 일산동구,35-39세,20000,9744,10256
202103,41285,경기도,고양시 일산동구,35-39세,19956,9729,10227
202104,41285,경기도,고양시 일산동구,35-39세,19874,9699,10175
202105,41285,경기도,고양시 일산동구,35-39세,19754,9645,10109
202106,41285,경기도,고양시 일산동구,35-39세,19682,9633,10049
202007,41285,경기도,고양시 일산동구,40-44세,22644,10751,11893
202008,41285,경기도,고양시 일산동구,40-44세,22663,10750,11913
202009,41285,경기도,고양시 일산동구,40-44세,22620,10728,11892
202010,41285,경기도,고양시 일산동구,40-44세,22608,10718,11890
202011,41285,경기도,고양시 일산동구,40-44세,22585,10724,11861
202012,41285,경기도,고양시 일산동구,40-44세,22637,10786,11851
202101,41285,경기도,고양시 일산동구,40-44세,22744,10820,11924
202102,41285,경기도,고양시 일산동구,40-44세,22773,10820,11953
202103,41285,경기도,고양시 일산동구,40-44세,22671,10754,11917
202104,41285,경기도,고양시 일산동구,40-44세,22704,10793,11911
202105,41285,경기도,고양시 일산동구,40-44세,22761,10806,11955
202106,41285,경기도,고양시 일산동구,40-44세,22799,10823,11976
202007,41285,경기도,고양시 일산동구,45-49세,29339,13878,15461
202008,41285,경기도,고양시 일산동구,45-49세,29123,13770,15353
202009,41285,경기도,고양시 일산동구,45-49세,28962,13673,15289
202010,41285,경기도,고양시 일산동구,45-49세,28768,13590,15178
202011,41285,경기도,고양시 일산동구,45-49세,28635,13498,15137
202012,41285,경기도,고양시 일산동구,45-49세,28650,13501,15149
202101,41285,경기도,고양시 일산동구,45-49세,28551,13486,15065
202102,41285,경기도,고양시 일산동구,45-49세,28420,13442,14978
202103,41285,경기도,고양시 일산동구,45-49세,28277,13415,14862
202104,41285,경기도,고양시 일산동구,45-49세,28183,13325,14858
202105,41285,경기도,고양시 일산동구,45-49세,27949,13218,14731
202106,41285,경기도,고양시 일산동구,45-49세,27766,13139,14627
202007,41285,경기도,고양시 일산동구,50-54세,29274,14108,15166
202008,41285,경기도,고양시 일산동구,50-54세,29352,14130,15222
202009,41285,경기도,고양시 일산동구,50-54세,29350,14135,15215
202010,41285,경기도,고양시 일산동구,50-54세,29406,14182,15224
202011,41285,경기도,고양시 일산동구,50-54세,29411,14199,15212
202012,41285,경기도,고양시 일산동구,50-54세,29375,14206,15169
202101,41285,경기도,고양시 일산동구,50-54세,29645,14318,15327
202102,41285,경기도,고양시 일산동구,50-54세,29736,14349,15387
202103,41285,경기도,고양시 일산동구,50-54세,29678,14326,15352
202104,41285,경기도,고양시 일산동구,50-54세,29824,14396,15428
202105,41285,경기도,고양시 일산동구,50-54세,29961,14460,15501
202106,41285,경기도,고양시 일산동구,50-54세,30072,14507,15565
202007,41285,경기도,고양시 일산동구,55-59세,26418,13232,13186
202008,41285,경기도,고양시 일산동구,55-59세,26368,13206,13162
202009,41285,경기도,고양시 일산동구,55-59세,26333,13157,13176
202010,41285,경기도,고양시 일산동구,55-59세,26299,13098,13201
202011,41285,경기도,고양시 일산동구,55-59세,26284,13080,13204
202012,41285,경기도,고양시 일산동구,55-59세,26400,13103,13297
202101,41285,경기도,고양시 일산동구,55-59세,26340,13078,13262
202102,41285,경기도,고양시 일산동구,55-59세,26378,13075,13303
202103,41285,경기도,고양시 일산동구,55-59세,26271,12973,13298
202104,41285,경기도,고양시 일산동구,55-59세,26247,12969,13278
202105,41285,경기도,고양시 일산동구,55-59세,26227,12949,13278
202106,41285,경기도,고양시 일산동구,55-59세,26125,12867,13258
202007,41285,경기도,고양시 일산동구,60-64세,20044,10199,9845
202008,41285,경기도,고양시 일산동구,60-64세,20279,10304,9975
202009,41285,경기도,고양시 일산동구,60-64세,20469,10438,10031
202010,41285,경기도,고양시 일산동구,60-64세,20653,10543,10110
202011,41285,경기도,고양시 일산동구,60-64세,20795,10594,10201
202012,41285,경기도,고양시 일산동구,60-64세,20952,10681,10271
202101,41285,경기도,고양시 일산동구,60-64세,21139,10743,10396
202102,41285,경기도,고양시 일산동구,60-64세,21286,10820,10466
202103,41285,경기도,고양시 일산동구,60-64세,21433,10878,10555
202104,41285,경기도,고양시 일산동구,60-64세,21576,10970,10606
202105,41285,경기도,고양시 일산동구,60-64세,21740,11070,10670
202106,41285,경기도,고양시 일산동구,60-64세,21949,11213,10736
202007,41285,경기도,고양시 일산동구,65-69세,11232,5653,5579
202008,41285,경기도,고양시 일산동구,65-69세,11369,5720,5649
202009,41285,경기도,고양시 일산동구,65-69세,11504,5786,5718
202010,41285,경기도,고양시 일산동구,65-69세,11592,5816,5776
202011,41285,경기도,고양시 일산동구,65-69세,11727,5880,5847
202012,41285,경기도,고양시 일산동구,65-69세,11873,5939,5934
202101,41285,경기도,고양시 일산동구,65-69세,12056,6061,5995
202102,41285,경기도,고양시 일산동구,65-69세,12233,6136,6097
202103,41285,경기도,고양시 일산동구,65-69세,12395,6231,6164
202104,41285,경기도,고양시 일산동구,65-69세,12526,6285,6241
202105,41285,경기도,고양시 일산동구,65-69세,12710,6374,6336
202106,41285,경기도,고양시 일산동구,65-69세,12801,6423,6378
202007,41285,경기도,고양시 일산동구,70-74세,8227,3613,4614
202008,41285,경기도,고양시 일산동구,70-74세,8243,3628,4615
202009,41285,경기도,고양시 일산동구,70-74세,8267,3621,4646
202010,41285,경기도,고양시 일산동구,70-74세,8339,3651,4688
202011,41285,경기도,고양시 일산동구,70-74세,8409,3695,4714
202012,41285,경기도,고양시 일산동구,70-74세,8480,3741,4739
202101,41285,경기도,고양시 일산동구,70-74세,8543,3773,4770
202102,41285,경기도,고양시 일산동구,70-74세,8555,3788,4767
202103,41285,경기도,고양시 일산동구,70-74세,8558,3801,4757
202104,41285,경기도,고양시 일산동구,70-74세,8551,3794,4757
202105,41285,경기도,고양시 일산동구,70-74세,8567,3805,4762
202106,41285,경기도,고양시 일산동구,70-74세,8542,3792,4750
202007,41285,경기도,고양시 일산동구,75-79세,7250,2991,4259
202008,41285,경기도,고양시 일산동구,75-79세,7241,2987,4254
202009,41285,경기도,고양시 일산동구,75-79세,7219,2986,4233
202010,41285,경기도,고양시 일산동구,75-79세,7188,2980,4208
202011,41285,경기도,고양시 일산동구,75-79세,7173,2978,4195
202012,41285,경기도,고양시 일산동구,75-79세,7147,2963,4184
202101,41285,경기도,고양시 일산동구,75-79세,7127,2953,4174
202102,41285,경기도,고양시 일산동구,75-79세,7102,2954,4148
202103,41285,경기도,고양시 일산동구,75-79세,7063,2939,4124
202104,41285,경기도,고양시 일산동구,75-79세,7044,2947,4097
202105,41285,경기도,고양시 일산동구,75-79세,7023,2934,4089
202106,41285,경기도,고양시 일산동구,75-79세,7034,2933,4101
202007,41285,경기도,고양시 일산동구,80-84세,5554,2108,3446
202008,41285,경기도,고양시 일산동구,80-84세,5551,2108,3443
202009,41285,경기도,고양시 일산동구,80-84세,5577,2120,3457
202010,41285,경기도,고양시 일산동구,80-84세,5607,2130,3477
202011,41285,경기도,고양시 일산동구,80-84세,5612,2123,3489
202012,41285,경기도,고양시 일산동구,80-84세,5635,2122,3513
202101,41285,경기도,고양시 일산동구,80-84세,5652,2127,3525
202102,41285,경기도,고양시 일산동구,80-84세,5670,2122,3548
202103,41285,경기도,고양시 일산동구,80-84세,5681,2144,3537
202104,41285,경기도,고양시 일산동구,80-84세,5723,2158,3565
202105,41285,경기도,고양시 일산동구,80-84세,5734,2169,3565
202106,41285,경기도,고양시 일산동구,80-84세,5781,2195,3586
202007,41285,경기도,고양시 일산동구,85-89세,3006,949,2057
202008,41285,경기도,고양시 일산동구,85-89세,3050,967,2083
202009,41285,경기도,고양시 일산동구,85-89세,3066,978,2088
202010,41285,경기도,고양시 일산동구,85-89세,3110,989,2121
202011,41285,경기도,고양시 일산동구,85-89세,3137,1008,2129
202012,41285,경기도,고양시 일산동구,85-89세,3157,1025,2132
202101,41285,경기도,고양시 일산동구,85-89세,3182,1041,2141
202102,41285,경기도,고양시 일산동구,85-89세,3216,1054,2162
202103,41285,경기도,고양시 일산동구,85-89세,3245,1062,2183
202104,41285,경기도,고양시 일산동구,85-89세,3262,1064,2198
202105,41285,경기도,고양시 일산동구,85-89세,3288,1074,2214
202106,41285,경기도,고양시 일산동구,85-89세,3298,1083,2215
202007,41285,경기도,고양시 일산동구,90-94세,1058,264,794
202008,41285,경기도,고양시 일산동구,90-94세,1066,263,803
202009,41285,경기도,고양시 일산동구,90-94세,1084,263,821
202010,41285,경기도,고양시 일산동구,90-94세,1102,272,830
202011,41285,경기도,고양시 일산동구,90-94세,1124,279,845
202012,41285,경기도,고양시 일산동구,90-94세,1137,284,853
202101,41285,경기도,고양시 일산동구,90-94세,1151,281,870
202102,41285,경기도,고양시 일산동구,90-94세,1158,283,875
202103,41285,경기도,고양시 일산동구,90-94세,1166,287,879
202104,41285,경기도,고양시 일산동구,90-94세,1172,290,882
202105,41285,경기도,고양시 일산동구,90-94세,1177,293,884
202106,41285,경기도,고양시 일산동구,90-94세,1173,294,879
202007,41285,경기도,고양시 일산동구,95-99세,260,77,183
202008,41285,경기도,고양시 일산동구,95-99세,260,78,182
202009,41285,경기도,고양시 일산동구,95-99세,272,79,193
202010,41285,경기도,고양시 일산동구,95-99세,269,76,193
202011,41285,경기도,고양시 일산동구,95-99세,267,72,195
202012,41285,경기도,고양시 일산동구,95-99세,269,71,198
202101,41285,경기도,고양시 일산동구,95-99세,275,72,203
202102,41285,경기도,고양시 일산동구,95-99세,274,72,202
202103,41285,경기도,고양시 일산동구,95-99세,267,66,201
202104,41285,경기도,고양시 일산동구,95-99세,267,66,201
202105,41285,경기도,고양시 일산동구,95-99세,269,64,205
202106,41285,경기도,고양시 일산동구,95-99세,272,66,206
202007,41285,경기도,고양시 일산동구,100+,59,19,40
202008,41285,경기도,고양시 일산동구,100+,62,20,42
202009,41285,경기도,고양시 일산동구,100+,62,20,42
202010,41285,경기도,고양시 일산동구,100+,62,20,42
202011,41285,경기도,고양시 일산동구,100+,61,20,41
202012,41285,경기도,고양시 일산동구,100+,62,21,41
202101,41285,경기도,고양시 일산동구,100+,64,21,43
202102,41285,경기도,고양시 일산동구,100+,65,22,43
202103,41285,경기도,고양시 일산동구,100+,45,16,29
202104,41285,경기도,고양시 일산동구,100+,45,15,30
202105,41285,경기도,고양시 일산동구,100+,44,15,29
202106,41285,경기도,고양시 일산동구,100+,42,15,27
202007,41287,경기도,고양시 일산서구,0-4세,9617,4852,4765
202008,41287,경기도,고양시 일산서구,0-4세,9465,4765,4700
202009,41287,경기도,고양시 일산서구,0-4세,9343,4722,4621
202010,41287,경기도,고양시 일산서구,0-4세,9247,4675,4572
202011,41287,경기도,고양시 일산서구,0-4세,9135,4624,4511
202012,41287,경기도,고양시 일산서구,0-4세,9051,4576,4475
202101,41287,경기도,고양시 일산서구,0-4세,8961,4533,4428
202102,41287,경기도,고양시 일산서구,0-4세,8890,4507,4383
202103,41287,경기도,고양시 일산서구,0-4세,8776,4458,4318
202104,41287,경기도,고양시 일산서구,0-4세,8704,4430,4274
202105,41287,경기도,고양시 일산서구,0-4세,8598,4357,4241
202106,41287,경기도,고양시 일산서구,0-4세,8487,4295,4192
202007,41287,경기도,고양시 일산서구,5-9세,13893,7107,6786
202008,41287,경기도,고양시 일산서구,5-9세,13874,7118,6756
202009,41287,경기도,고양시 일산서구,5-9세,13831,7072,6759
202010,41287,경기도,고양시 일산서구,5-9세,13734,7004,6730
202011,41287,경기도,고양시 일산서구,5-9세,13699,6996,6703
202012,41287,경기도,고양시 일산서구,5-9세,13629,6972,6657
202101,41287,경기도,고양시 일산서구,5-9세,13543,6927,6616
202102,41287,경기도,고양시 일산서구,5-9세,13497,6903,6594
202103,41287,경기도,고양시 일산서구,5-9세,13444,6878,6566
202104,41287,경기도,고양시 일산서구,5-9세,13374,6833,6541
202105,41287,경기도,고양시 일산서구,5-9세,13315,6811,6504
202106,41287,경기도,고양시 일산서구,5-9세,13263,6766,6497
202007,41287,경기도,고양시 일산서구,10-14세,15807,8027,7780
202008,41287,경기도,고양시 일산서구,10-14세,15829,8036,7793
202009,41287,경기도,고양시 일산서구,10-14세,15840,8080,7760
202010,41287,경기도,고양시 일산서구,10-14세,15888,8099,7789
202011,41287,경기도,고양시 일산서구,10-14세,15925,8101,7824
202012,41287,경기도,고양시 일산서구,10-14세,15954,8108,7846
202101,41287,경기도,고양시 일산서구,10-14세,15948,8103,7845
202102,41287,경기도,고양시 일산서구,10-14세,15903,8067,7836
202103,41287,경기도,고양시 일산서구,10-14세,15876,8025,7851
202104,41287,경기도,고양시 일산서구,10-14세,15853,8008,7845
202105,41287,경기도,고양시 일산서구,10-14세,15791,7980,7811
202106,41287,경기도,고양시 일산서구,10-14세,15787,7987,7800
202007,41287,경기도,고양시 일산서구,15-19세,18738,9610,9128
202008,41287,경기도,고양시 일산서구,15-19세,18564,9501,9063
202009,41287,경기도,고양시 일산서구,15-19세,18423,9418,9005
202010,41287,경기도,고양시 일산서구,15-19세,18245,9315,8930
202011,41287,경기도,고양시 일산서구,15-19세,18094,9221,8873
202012,41287,경기도,고양시 일산서구,15-19세,17916,9176,8740
202101,41287,경기도,고양시 일산서구,15-19세,17780,9123,8657
202102,41287,경기도,고양시 일산서구,15-19세,17732,9065,8667
202103,41287,경기도,고양시 일산서구,15-19세,17463,8940,8523
202104,41287,경기도,고양시 일산서구,15-19세,17328,8877,8451
202105,41287,경기도,고양시 일산서구,15-19세,17291,8843,8448
202106,41287,경기도,고양시 일산서구,15-19세,17177,8791,8386
202007,41287,경기도,고양시 일산서구,20-24세,22150,11443,10707
202008,41287,경기도,고양시 일산서구,20-24세,22078,11427,10651
202009,41287,경기도,고양시 일산서구,20-24세,22001,11416,10585
202010,41287,경기도,고양시 일산서구,20-24세,21977,11414,10563
202011,41287,경기도,고양시 일산서구,20-24세,21932,11379,10553
202012,41287,경기도,고양시 일산서구,20-24세,21808,11317,10491
202101,41287,경기도,고양시 일산서구,20-24세,21778,11301,10477
202102,41287,경기도,고양시 일산서구,20-24세,21646,11240,10406
202103,41287,경기도,고양시 일산서구,20-24세,21474,11159,10315
202104,41287,경기도,고양시 일산서구,20-24세,21366,11094,10272
202105,41287,경기도,고양시 일산서구,20-24세,21306,11050,10256
202106,41287,경기도,고양시 일산서구,20-24세,21259,11025,10234
202007,41287,경기도,고양시 일산서구,25-29세,20956,10568,10388
202008,41287,경기도,고양시 일산서구,25-29세,20967,10606,10361
202009,41287,경기도,고양시 일산서구,25-29세,20992,10593,10399
202010,41287,경기도,고양시 일산서구,25-29세,21047,10643,10404
202011,41287,경기도,고양시 일산서구,25-29세,21109,10687,10422
202012,41287,경기도,고양시 일산서구,25-29세,21212,10758,10454
202101,41287,경기도,고양시 일산서구,25-29세,21199,10771,10428
202102,41287,경기도,고양시 일산서구,25-29세,21116,10719,10397
202103,41287,경기도,고양시 일산서구,25-29세,21033,10689,10344
202104,41287,경기도,고양시 일산서구,25-29세,20937,10661,10276
202105,41287,경기도,고양시 일산서구,25-29세,20814,10615,10199
202106,41287,경기도,고양시 일산서구,25-29세,20793,10578,10215
202007,41287,경기도,고양시 일산서구,30-34세,16942,8382,8560
202008,41287,경기도,고양시 일산서구,30-34세,16899,8343,8556
202009,41287,경기도,고양시 일산서구,30-34세,16857,8320,8537
202010,41287,경기도,고양시 일산서구,30-34세,16854,8303,8551
202011,41287,경기도,고양시 일산서구,30-34세,16834,8305,8529
202012,41287,경기도,고양시 일산서구,30-34세,16782,8285,8497
202101,41287,경기도,고양시 일산서구,30-34세,16899,8349,8550
202102,41287,경기도,고양시 일산서구,30-34세,16895,8378,8517
202103,41287,경기도,고양시 일산서구,30-34세,16921,8401,8520
202104,41287,경기도,고양시 일산서구,30-34세,16920,8391,8529
202105,41287,경기도,고양시 일산서구,30-34세,16941,8426,8515
202106,41287,경기도,고양시 일산서구,30-34세,17003,8466,8537
202007,41287,경기도,고양시 일산서구,35-39세,20091,9712,10379
202008,41287,경기도,고양시 일산서구,35-39세,20033,9698,10335
202009,41287,경기도,고양시 일산서구,35-39세,19975,9644,10331
202010,41287,경기도,고양시 일산서구,35-39세,19863,9600,10263
202011,41287,경기도,고양시 일산서구,35-39세,19800,9584,10216
202012,41287,경기도,고양시 일산서구,35-39세,19668,9500,10168
202101,41287,경기도,고양시 일산서구,35-39세,19520,9427,10093
202102,41287,경기도,고양시 일산서구,35-39세,19419,9393,10026
202103,41287,경기도,고양시 일산서구,35-39세,19287,9338,9949
202104,41287,경기도,고양시 일산서구,35-39세,19190,9272,9918
202105,41287,경기도,고양시 일산서구,35-39세,19059,9181,9878
202106,41287,경기도,고양시 일산서구,35-39세,18969,9147,9822
202007,41287,경기도,고양시 일산서구,40-44세,22719,10583,12136
202008,41287,경기도,고양시 일산서구,40-44세,22682,10595,12087
202009,41287,경기도,고양시 일산서구,40-44세,22716,10625,12091
202010,41287,경기도,고양시 일산서구,40-44세,22692,10605,12087
202011,41287,경기도,고양시 일산서구,40-44세,22706,10608,12098
202012,41287,경기도,고양시 일산서구,40-44세,22656,10617,12039
202101,41287,경기도,고양시 일산서구,40-44세,22612,10608,12004
202102,41287,경기도,고양시 일산서구,40-44세,22616,10613,12003
202103,41287,경기도,고양시 일산서구,40-44세,22415,10533,11882
202104,41287,경기도,고양시 일산서구,40-44세,22309,10514,11795
202105,41287,경기도,고양시 일산서구,40-44세,22326,10555,11771
202106,41287,경기도,고양시 일산서구,40-44세,22375,10579,11796
202007,41287,경기도,고양시 일산서구,45-49세,30619,14299,16320
202008,41287,경기도,고양시 일산서구,45-49세,30436,14219,16217
202009,41287,경기도,고양시 일산서구,45-49세,30201,14107,16094
202010,41287,경기도,고양시 일산서구,45-49세,29980,14019,15961
202011,41287,경기도,고양시 일산서구,45-49세,29783,13925,15858
202012,41287,경기도,고양시 일산서구,45-49세,29703,13869,15834
202101,41287,경기도,고양시 일산서구,45-49세,29456,13727,15729
202102,41287,경기도,고양시 일산서구,45-49세,29261,13633,15628
202103,41287,경기도,고양시 일산서구,45-49세,29030,13540,15490
202104,41287,경기도,고양시 일산서구,45-49세,28844,13447,15397
202105,41287,경기도,고양시 일산서구,45-49세,28568,13336,15232
202106,41287,경기도,고양시 일산서구,45-49세,28373,13233,15140
202007,41287,경기도,고양시 일산서구,50-54세,29918,14457,15461
202008,41287,경기도,고양시 일산서구,50-54세,29926,14454,15472
202009,41287,경기도,고양시 일산서구,50-54세,30022,14506,15516
202010,41287,경기도,고양시 일산서구,50-54세,30076,14524,15552
202011,41287,경기도,고양시 일산서구,50-54세,30106,14532,15574
202012,41287,경기도,고양시 일산서구,50-54세,30002,14481,15521
202101,41287,경기도,고양시 일산서구,50-54세,30107,14531,15576
202102,41287,경기도,고양시 일산서구,50-54세,30233,14560,15673
202103,41287,경기도,고양시 일산서구,50-54세,30192,14538,15654
202104,41287,경기도,고양시 일산서구,50-54세,30190,14511,15679
202105,41287,경기도,고양시 일산서구,50-54세,30318,14569,15749
202106,41287,경기도,고양시 일산서구,50-54세,30394,14597,15797
202007,41287,경기도,고양시 일산서구,55-59세,25941,12890,13051
202008,41287,경기도,고양시 일산서구,55-59세,25986,12896,13090
202009,41287,경기도,고양시 일산서구,55-59세,25935,12860,13075
202010,41287,경기도,고양시 일산서구,55-59세,25959,12871,13088
202011,41287,경기도,고양시 일산서구,55-59세,25946,12818,13128
202012,41287,경기도,고양시 일산서구,55-59세,25978,12835,13143
202101,41287,경기도,고양시 일산서구,55-59세,25901,12780,13121
202102,41287,경기도,고양시 일산서구,55-59세,25900,12800,13100
202103,41287,경기도,고양시 일산서구,55-59세,25865,12764,13101
202104,41287,경기도,고양시 일산서구,55-59세,25804,12743,13061
202105,41287,경기도,고양시 일산서구,55-59세,25740,12706,13034
202106,41287,경기도,고양시 일산서구,55-59세,25626,12652,12974
202007,41287,경기도,고양시 일산서구,60-64세,19413,10071,9342
202008,41287,경기도,고양시 일산서구,60-64세,19518,10116,9402
202009,41287,경기도,고양시 일산서구,60-64세,19696,10190,9506
202010,41287,경기도,고양시 일산서구,60-64세,19865,10243,9622
202011,41287,경기도,고양시 일산서구,60-64세,20018,10339,9679
202012,41287,경기도,고양시 일산서구,60-64세,20162,10389,9773
202101,41287,경기도,고양시 일산서구,60-64세,20382,10490,9892
202102,41287,경기도,고양시 일산서구,60-64세,20566,10580,9986
202103,41287,경기도,고양시 일산서구,60-64세,20656,10613,10043
202104,41287,경기도,고양시 일산서구,60-64세,20790,10638,10152
202105,41287,경기도,고양시 일산서구,60-64세,20964,10697,10267
202106,41287,경기도,고양시 일산서구,60-64세,21166,10782,10384
202007,41287,경기도,고양시 일산서구,65-69세,10810,5260,5550
202008,41287,경기도,고양시 일산서구,65-69세,10942,5346,5596
202009,41287,경기도,고양시 일산서구,65-69세,11076,5400,5676
202010,41287,경기도,고양시 일산서구,65-69세,11222,5477,5745
202011,41287,경기도,고양시 일산서구,65-69세,11324,5535,5789
202012,41287,경기도,고양시 일산서구,65-69세,11451,5614,5837
202101,41287,경기도,고양시 일산서구,65-69세,11623,5713,5910
202102,41287,경기도,고양시 일산서구,65-69세,11743,5786,5957
202103,41287,경기도,고양시 일산서구,65-69세,11940,5896,6044
202104,41287,경기도,고양시 일산서구,65-69세,12071,5974,6097
202105,41287,경기도,고양시 일산서구,65-69세,12143,6015,6128
202106,41287,경기도,고양시 일산서구,65-69세,12232,6065,6167
202007,41287,경기도,고양시 일산서구,70-74세,8305,3599,4706
202008,41287,경기도,고양시 일산서구,70-74세,8331,3596,4735
202009,41287,경기도,고양시 일산서구,70-74세,8345,3608,4737
202010,41287,경기도,고양시 일산서구,70-74세,8393,3635,4758
202011,41287,경기도,고양시 일산서구,70-74세,8439,3647,4792
202012,41287,경기도,고양시 일산서구,70-74세,8436,3647,4789
202101,41287,경기도,고양시 일산서구,70-74세,8458,3650,4808
202102,41287,경기도,고양시 일산서구,70-74세,8517,3677,4840
202103,41287,경기도,고양시 일산서구,70-74세,8536,3690,4846
202104,41287,경기도,고양시 일산서구,70-74세,8522,3694,4828
202105,41287,경기도,고양시 일산서구,70-74세,8512,3693,4819
202106,41287,경기도,고양시 일산서구,70-74세,8485,3690,4795
202007,41287,경기도,고양시 일산서구,75-79세,7644,3056,4588
202008,41287,경기도,고양시 일산서구,75-79세,7634,3056,4578
202009,41287,경기도,고양시 일산서구,75-79세,7613,3063,4550
202010,41287,경기도,고양시 일산서구,75-79세,7588,3044,4544
202011,41287,경기도,고양시 일산서구,75-79세,7527,3032,4495
202012,41287,경기도,고양시 일산서구,75-79세,7455,2991,4464
202101,41287,경기도,고양시 일산서구,75-79세,7436,2998,4438
202102,41287,경기도,고양시 일산서구,75-79세,7404,2986,4418
202103,41287,경기도,고양시 일산서구,75-79세,7354,2961,4393
202104,41287,경기도,고양시 일산서구,75-79세,7340,2954,4386
202105,41287,경기도,고양시 일산서구,75-79세,7360,2962,4398
202106,41287,경기도,고양시 일산서구,75-79세,7337,2960,4377
202007,41287,경기도,고양시 일산서구,80-84세,5926,2184,3742
202008,41287,경기도,고양시 일산서구,80-84세,5968,2202,3766
202009,41287,경기도,고양시 일산서구,80-84세,5989,2203,3786
202010,41287,경기도,고양시 일산서구,80-84세,6026,2223,3803
202011,41287,경기도,고양시 일산서구,80-84세,6051,2233,3818
202012,41287,경기도,고양시 일산서구,80-84세,6072,2235,3837
202101,41287,경기도,고양시 일산서구,80-84세,6095,2239,3856
202102,41287,경기도,고양시 일산서구,80-84세,6100,2230,3870
202103,41287,경기도,고양시 일산서구,80-84세,6138,2246,3892
202104,41287,경기도,고양시 일산서구,80-84세,6173,2255,3918
202105,41287,경기도,고양시 일산서구,80-84세,6192,2264,3928
202106,41287,경기도,고양시 일산서구,80-84세,6215,2267,3948
202007,41287,경기도,고양시 일산서구,85-89세,3073,1047,2026
202008,41287,경기도,고양시 일산서구,85-89세,3105,1052,2053
202009,41287,경기도,고양시 일산서구,85-89세,3131,1073,2058
202010,41287,경기도,고양시 일산서구,85-89세,3147,1077,2070
202011,41287,경기도,고양시 일산서구,85-89세,3157,1075,2082
202012,41287,경기도,고양시 일산서구,85-89세,3197,1095,2102
202101,41287,경기도,고양시 일산서구,85-89세,3237,1110,2127
202102,41287,경기도,고양시 일산서구,85-89세,3297,1145,2152
202103,41287,경기도,고양시 일산서구,85-89세,3319,1150,2169
202104,41287,경기도,고양시 일산서구,85-89세,3336,1157,2179
202105,41287,경기도,고양시 일산서구,85-89세,3368,1178,2190
202106,41287,경기도,고양시 일산서구,85-89세,3388,1183,2205
202007,41287,경기도,고양시 일산서구,90-94세,1080,283,797
202008,41287,경기도,고양시 일산서구,90-94세,1080,282,798
202009,41287,경기도,고양시 일산서구,90-94세,1093,283,810
202010,41287,경기도,고양시 일산서구,90-94세,1104,288,816
202011,41287,경기도,고양시 일산서구,90-94세,1119,295,824
202012,41287,경기도,고양시 일산서구,90-94세,1125,300,825
202101,41287,경기도,고양시 일산서구,90-94세,1145,310,835
202102,41287,경기도,고양시 일산서구,90-94세,1151,311,840
202103,41287,경기도,고양시 일산서구,90-94세,1173,322,851
202104,41287,경기도,고양시 일산서구,90-94세,1180,327,853
202105,41287,경기도,고양시 일산서구,90-94세,1183,326,857
202106,41287,경기도,고양시 일산서구,90-94세,1191,331,860
202007,41287,경기도,고양시 일산서구,95-99세,202,61,141
202008,41287,경기도,고양시 일산서구,95-99세,202,63,139
202009,41287,경기도,고양시 일산서구,95-99세,208,60,148
202010,41287,경기도,고양시 일산서구,95-99세,214,58,156
202011,41287,경기도,고양시 일산서구,95-99세,219,59,160
202012,41287,경기도,고양시 일산서구,95-99세,224,56,168
202101,41287,경기도,고양시 일산서구,95-99세,223,50,173
202102,41287,경기도,고양시 일산서구,95-99세,229,51,178
202103,41287,경기도,고양시 일산서구,95-99세,233,54,179
202104,41287,경기도,고양시 일산서구,95-99세,226,51,175
202105,41287,경기도,고양시 일산서구,95-99세,229,51,178
202106,41287,경기도,고양시 일산서구,95-99세,231,50,181
202007,41287,경기도,고양시 일산서구,100+,57,12,45
202008,41287,경기도,고양시 일산서구,100+,60,13,47
202009,41287,경기도,고양시 일산서구,100+,59,14,45
202010,41287,경기도,고양시 일산서구,100+,59,14,45
202011,41287,경기도,고양시 일산서구,100+,58,13,45
202012,41287,경기도,고양시 일산서구,100+,57,12,45
202101,41287,경기도,고양시 일산서구,100+,60,15,45
202102,41287,경기도,고양시 일산서구,100+,60,15,45
202103,41287,경기도,고양시 일산서구,100+,47,10,37
202104,41287,경기도,고양시 일산서구,100+,44,10,34
202105,41287,경기도,고양시 일산서구,100+,45,9,36
202106,41287,경기도,고양시 일산서구,100+,44,8,36
202007,41290,경기도,과천시,0-4세,2187,1157,1030
202008,41290,경기도,과천시,0-4세,2167,1150,1017
202009,41290,경기도,과천시,0-4세,2157,1147,1010
202010,41290,경기도,과천시,0-4세,2155,1149,1006
202011,41290,경기도,과천시,0-4세,2165,1155,1010
202012,41290,경기도,과천시,0-4세,2245,1210,1035
202101,41290,경기도,과천시,0-4세,2336,1240,1096
202102,41290,경기도,과천시,0-4세,2510,1334,1176
202103,41290,경기도,과천시,0-4세,2551,1358,1193
202104,41290,경기도,과천시,0-4세,2571,1369,1202
202105,41290,경기도,과천시,0-4세,2589,1375,1214
202106,41290,경기도,과천시,0-4세,2587,1373,1214
202007,41290,경기도,과천시,5-9세,2818,1447,1371
202008,41290,경기도,과천시,5-9세,2839,1457,1382
202009,41290,경기도,과천시,5-9세,2853,1464,1389
202010,41290,경기도,과천시,5-9세,2839,1452,1387
202011,41290,경기도,과천시,5-9세,2840,1454,1386
202012,41290,경기도,과천시,5-9세,2930,1490,1440
202101,41290,경기도,과천시,5-9세,3041,1544,1497
202102,41290,경기도,과천시,5-9세,3301,1686,1615
202103,41290,경기도,과천시,5-9세,3339,1706,1633
202104,41290,경기도,과천시,5-9세,3363,1719,1644
202105,41290,경기도,과천시,5-9세,3375,1729,1646
202106,41290,경기도,과천시,5-9세,3416,1757,1659
202007,41290,경기도,과천시,10-14세,2915,1511,1404
202008,41290,경기도,과천시,10-14세,2936,1516,1420
202009,41290,경기도,과천시,10-14세,2942,1506,1436
202010,41290,경기도,과천시,10-14세,2934,1499,1435
202011,41290,경기도,과천시,10-14세,2920,1500,1420
202012,41290,경기도,과천시,10-14세,2957,1528,1429
202101,41290,경기도,과천시,10-14세,3059,1581,1478
202102,41290,경기도,과천시,10-14세,3231,1664,1567
202103,41290,경기도,과천시,10-14세,3258,1677,1581
202104,41290,경기도,과천시,10-14세,3275,1682,1593
202105,41290,경기도,과천시,10-14세,3286,1689,1597
202106,41290,경기도,과천시,10-14세,3285,1690,1595
202007,41290,경기도,과천시,15-19세,3393,1758,1635
202008,41290,경기도,과천시,15-19세,3371,1751,1620
202009,41290,경기도,과천시,15-19세,3365,1755,1610
202010,41290,경기도,과천시,15-19세,3354,1756,1598
202011,41290,경기도,과천시,15-19세,3331,1731,1600
202012,41290,경기도,과천시,15-19세,3362,1739,1623
202101,41290,경기도,과천시,15-19세,3376,1740,1636
202102,41290,경기도,과천시,15-19세,3460,1782,1678
202103,41290,경기도,과천시,15-19세,3464,1793,1671
202104,41290,경기도,과천시,15-19세,3461,1795,1666
202105,41290,경기도,과천시,15-19세,3461,1789,1672
202106,41290,경기도,과천시,15-19세,3467,1785,1682
202007,41290,경기도,과천시,20-24세,4277,2254,2023
202008,41290,경기도,과천시,20-24세,4261,2257,2004
202009,41290,경기도,과천시,20-24세,4277,2263,2014
202010,41290,경기도,과천시,20-24세,4263,2251,2012
202011,41290,경기도,과천시,20-24세,4255,2255,2000
202012,41290,경기도,과천시,20-24세,4301,2280,2021
202101,41290,경기도,과천시,20-24세,4371,2316,2055
202102,41290,경기도,과천시,20-24세,4517,2399,2118
202103,41290,경기도,과천시,20-24세,4574,2411,2163
202104,41290,경기도,과천시,20-24세,4588,2425,2163
202105,41290,경기도,과천시,20-24세,4599,2429,2170
202106,41290,경기도,과천시,20-24세,4592,2431,2161
202007,41290,경기도,과천시,25-29세,4269,2235,2034
202008,41290,경기도,과천시,25-29세,4301,2238,2063
202009,41290,경기도,과천시,25-29세,4301,2242,2059
202010,41290,경기도,과천시,25-29세,4323,2255,2068
202011,41290,경기도,과천시,25-29세,4339,2265,2074
202012,41290,경기도,과천시,25-29세,4431,2317,2114
202101,41290,경기도,과천시,25-29세,4454,2314,2140
202102,41290,경기도,과천시,25-29세,4538,2360,2178
202103,41290,경기도,과천시,25-29세,4627,2424,2203
202104,41290,경기도,과천시,25-29세,4690,2440,2250
202105,41290,경기도,과천시,25-29세,4702,2447,2255
202106,41290,경기도,과천시,25-29세,4712,2461,2251
202007,41290,경기도,과천시,30-34세,4006,2042,1964
202008,41290,경기도,과천시,30-34세,4035,2063,1972
202009,41290,경기도,과천시,30-34세,4057,2091,1966
202010,41290,경기도,과천시,30-34세,4065,2096,1969
202011,41290,경기도,과천시,30-34세,4087,2101,1986
202012,41290,경기도,과천시,30-34세,4186,2147,2039
202101,41290,경기도,과천시,30-34세,4266,2183,2083
202102,41290,경기도,과천시,30-34세,4441,2258,2183
202103,41290,경기도,과천시,30-34세,4534,2290,2244
202104,41290,경기도,과천시,30-34세,4570,2308,2262
202105,41290,경기도,과천시,30-34세,4577,2299,2278
202106,41290,경기도,과천시,30-34세,4620,2310,2310
202007,41290,경기도,과천시,35-39세,4489,2243,2246
202008,41290,경기도,과천시,35-39세,4505,2248,2257
202009,41290,경기도,과천시,35-39세,4495,2240,2255
202010,41290,경기도,과천시,35-39세,4511,2247,2264
202011,41290,경기도,과천시,35-39세,4500,2244,2256
202012,41290,경기도,과천시,35-39세,4601,2293,2308
202101,41290,경기도,과천시,35-39세,4721,2353,2368
202102,41290,경기도,과천시,35-39세,4972,2466,2506
202103,41290,경기도,과천시,35-39세,5070,2519,2551
202104,41290,경기도,과천시,35-39세,5121,2547,2574
202105,41290,경기도,과천시,35-39세,5124,2543,2581
202106,41290,경기도,과천시,35-39세,5137,2552,2585
202007,41290,경기도,과천시,40-44세,4194,2041,2153
202008,41290,경기도,과천시,40-44세,4214,2041,2173
202009,41290,경기도,과천시,40-44세,4247,2062,2185
202010,41290,경기도,과천시,40-44세,4251,2064,2187
202011,41290,경기도,과천시,40-44세,4266,2068,2198
202012,41290,경기도,과천시,40-44세,4359,2125,2234
202101,41290,경기도,과천시,40-44세,4509,2209,2300
202102,41290,경기도,과천시,40-44세,4826,2369,2457
202103,41290,경기도,과천시,40-44세,4856,2385,2471
202104,41290,경기도,과천시,40-44세,4898,2407,2491
202105,41290,경기도,과천시,40-44세,4932,2419,2513
202106,41290,경기도,과천시,40-44세,4998,2460,2538
202007,41290,경기도,과천시,45-49세,5295,2499,2796
202008,41290,경기도,과천시,45-49세,5270,2496,2774
202009,41290,경기도,과천시,45-49세,5239,2495,2744
202010,41290,경기도,과천시,45-49세,5182,2479,2703
202011,41290,경기도,과천시,45-49세,5127,2453,2674
202012,41290,경기도,과천시,45-49세,5167,2469,2698
202101,41290,경기도,과천시,45-49세,5249,2485,2764
202102,41290,경기도,과천시,45-49세,5402,2559,2843
202103,41290,경기도,과천시,45-49세,5474,2610,2864
202104,41290,경기도,과천시,45-49세,5490,2615,2875
202105,41290,경기도,과천시,45-49세,5446,2606,2840
202106,41290,경기도,과천시,45-49세,5412,2587,2825
202007,41290,경기도,과천시,50-54세,5621,2695,2926
202008,41290,경기도,과천시,50-54세,5636,2683,2953
202009,41290,경기도,과천시,50-54세,5621,2658,2963
202010,41290,경기도,과천시,50-54세,5641,2663,2978
202011,41290,경기도,과천시,50-54세,5620,2648,2972
202012,41290,경기도,과천시,50-54세,5694,2663,3031
202101,41290,경기도,과천시,50-54세,5785,2724,3061
202102,41290,경기도,과천시,50-54세,5985,2822,3163
202103,41290,경기도,과천시,50-54세,6060,2833,3227
202104,41290,경기도,과천시,50-54세,6122,2854,3268
202105,41290,경기도,과천시,50-54세,6183,2880,3303
202106,41290,경기도,과천시,50-54세,6227,2897,3330
202007,41290,경기도,과천시,55-59세,5239,2602,2637
202008,41290,경기도,과천시,55-59세,5245,2616,2629
202009,41290,경기도,과천시,55-59세,5267,2642,2625
202010,41290,경기도,과천시,55-59세,5263,2644,2619
202011,41290,경기도,과천시,55-59세,5278,2649,2629
202012,41290,경기도,과천시,55-59세,5399,2723,2676
202101,41290,경기도,과천시,55-59세,5495,2752,2743
202102,41290,경기도,과천시,55-59세,5722,2850,2872
202103,41290,경기도,과천시,55-59세,5858,2918,2940
202104,41290,경기도,과천시,55-59세,5899,2936,2963
202105,41290,경기도,과천시,55-59세,5871,2929,2942
202106,41290,경기도,과천시,55-59세,5843,2935,2908
202007,41290,경기도,과천시,60-64세,4338,2109,2229
202008,41290,경기도,과천시,60-64세,4380,2121,2259
202009,41290,경기도,과천시,60-64세,4405,2126,2279
202010,41290,경기도,과천시,60-64세,4418,2136,2282
202011,41290,경기도,과천시,60-64세,4464,2162,2302
202012,41290,경기도,과천시,60-64세,4605,2224,2381
202101,41290,경기도,과천시,60-64세,4723,2293,2430
202102,41290,경기도,과천시,60-64세,4903,2377,2526
202103,41290,경기도,과천시,60-64세,5075,2467,2608
202104,41290,경기도,과천시,60-64세,5155,2506,2649
202105,41290,경기도,과천시,60-64세,5188,2526,2662
202106,41290,경기도,과천시,60-64세,5238,2544,2694
202007,41290,경기도,과천시,65-69세,2774,1354,1420
202008,41290,경기도,과천시,65-69세,2814,1375,1439
202009,41290,경기도,과천시,65-69세,2825,1378,1447
202010,41290,경기도,과천시,65-69세,2847,1387,1460
202011,41290,경기도,과천시,65-69세,2846,1386,1460
202012,41290,경기도,과천시,65-69세,2919,1437,1482
202101,41290,경기도,과천시,65-69세,2991,1472,1519
202102,41290,경기도,과천시,65-69세,3152,1553,1599
202103,41290,경기도,과천시,65-69세,3274,1598,1676
202104,41290,경기도,과천시,65-69세,3309,1611,1698
202105,41290,경기도,과천시,65-69세,3322,1608,1714
202106,41290,경기도,과천시,65-69세,3377,1643,1734
202007,41290,경기도,과천시,70-74세,2024,916,1108
202008,41290,경기도,과천시,70-74세,2040,927,1113
202009,41290,경기도,과천시,70-74세,2051,934,1117
202010,41290,경기도,과천시,70-74세,2076,945,1131
202011,41290,경기도,과천시,70-74세,2076,949,1127
202012,41290,경기도,과천시,70-74세,2104,959,1145
202101,41290,경기도,과천시,70-74세,2147,970,1177
202102,41290,경기도,과천시,70-74세,2212,1003,1209
202103,41290,경기도,과천시,70-74세,2230,1027,1203
202104,41290,경기도,과천시,70-74세,2254,1043,1211
202105,41290,경기도,과천시,70-74세,2245,1049,1196
202106,41290,경기도,과천시,70-74세,2229,1038,1191
202007,41290,경기도,과천시,75-79세,1631,686,945
202008,41290,경기도,과천시,75-79세,1626,682,944
202009,41290,경기도,과천시,75-79세,1601,672,929
202010,41290,경기도,과천시,75-79세,1593,670,923
202011,41290,경기도,과천시,75-79세,1600,673,927
202012,41290,경기도,과천시,75-79세,1618,682,936
202101,41290,경기도,과천시,75-79세,1642,697,945
202102,41290,경기도,과천시,75-79세,1671,711,960
202103,41290,경기도,과천시,75-79세,1701,724,977
202104,41290,경기도,과천시,75-79세,1713,734,979
202105,41290,경기도,과천시,75-79세,1696,726,970
202106,41290,경기도,과천시,75-79세,1705,731,974
202007,41290,경기도,과천시,80-84세,1184,460,724
202008,41290,경기도,과천시,80-84세,1185,462,723
202009,41290,경기도,과천시,80-84세,1195,466,729
202010,41290,경기도,과천시,80-84세,1190,462,728
202011,41290,경기도,과천시,80-84세,1202,464,738
202012,41290,경기도,과천시,80-84세,1208,465,743
202101,41290,경기도,과천시,80-84세,1225,480,745
202102,41290,경기도,과천시,80-84세,1254,493,761
202103,41290,경기도,과천시,80-84세,1274,498,776
202104,41290,경기도,과천시,80-84세,1285,500,785
202105,41290,경기도,과천시,80-84세,1277,500,777
202106,41290,경기도,과천시,80-84세,1277,498,779
202007,41290,경기도,과천시,85-89세,641,191,450
202008,41290,경기도,과천시,85-89세,648,195,453
202009,41290,경기도,과천시,85-89세,655,195,460
202010,41290,경기도,과천시,85-89세,677,210,467
202011,41290,경기도,과천시,85-89세,690,216,474
202012,41290,경기도,과천시,85-89세,709,222,487
202101,41290,경기도,과천시,85-89세,715,224,491
202102,41290,경기도,과천시,85-89세,738,234,504
202103,41290,경기도,과천시,85-89세,748,243,505
202104,41290,경기도,과천시,85-89세,759,249,510
202105,41290,경기도,과천시,85-89세,760,247,513
202106,41290,경기도,과천시,85-89세,760,247,513
202007,41290,경기도,과천시,90-94세,294,70,224
202008,41290,경기도,과천시,90-94세,300,71,229
202009,41290,경기도,과천시,90-94세,297,70,227
202010,41290,경기도,과천시,90-94세,295,69,226
202011,41290,경기도,과천시,90-94세,286,68,218
202012,41290,경기도,과천시,90-94세,300,70,230
202101,41290,경기도,과천시,90-94세,306,73,233
202102,41290,경기도,과천시,90-94세,304,74,230
202103,41290,경기도,과천시,90-94세,303,75,228
202104,41290,경기도,과천시,90-94세,304,80,224
202105,41290,경기도,과천시,90-94세,298,80,218
202106,41290,경기도,과천시,90-94세,301,80,221
202007,41290,경기도,과천시,95-99세,77,17,60
202008,41290,경기도,과천시,95-99세,78,16,62
202009,41290,경기도,과천시,95-99세,81,16,65
202010,41290,경기도,과천시,95-99세,83,16,67
202011,41290,경기도,과천시,95-99세,81,15,66
202012,41290,경기도,과천시,95-99세,83,15,68
202101,41290,경기도,과천시,95-99세,85,15,70
202102,41290,경기도,과천시,95-99세,86,14,72
202103,41290,경기도,과천시,95-99세,92,16,76
202104,41290,경기도,과천시,95-99세,91,17,74
202105,41290,경기도,과천시,95-99세,83,14,69
202106,41290,경기도,과천시,95-99세,81,14,67
202007,41290,경기도,과천시,100+,51,9,42
202008,41290,경기도,과천시,100+,51,9,42
202009,41290,경기도,과천시,100+,51,9,42
202010,41290,경기도,과천시,100+,51,9,42
202011,41290,경기도,과천시,100+,53,10,43
202012,41290,경기도,과천시,100+,53,10,43
202101,41290,경기도,과천시,100+,53,10,43
202102,41290,경기도,과천시,100+,54,11,43
202103,41290,경기도,과천시,100+,37,9,28
202104,41290,경기도,과천시,100+,37,9,28
202105,41290,경기도,과천시,100+,13,3,10
202106,41290,경기도,과천시,100+,12,3,9
202007,41310,경기도,구리시,0-4세,6731,3507,3224
202008,41310,경기도,구리시,0-4세,6685,3485,3200
202009,41310,경기도,구리시,0-4세,6652,3456,3196
202010,41310,경기도,구리시,0-4세,6577,3406,3171
202011,41310,경기도,구리시,0-4세,6486,3350,3136
202012,41310,경기도,구리시,0-4세,6446,3319,3127
202101,41310,경기도,구리시,0-4세,6357,3283,3074
202102,41310,경기도,구리시,0-4세,6264,3230,3034
202103,41310,경기도,구리시,0-4세,6153,3169,2984
202104,41310,경기도,구리시,0-4세,6091,3144,2947
202105,41310,경기도,구리시,0-4세,6025,3114,2911
202106,41310,경기도,구리시,0-4세,5995,3101,2894
202007,41310,경기도,구리시,5-9세,8955,4630,4325
202008,41310,경기도,구리시,5-9세,8915,4593,4322
202009,41310,경기도,구리시,5-9세,8891,4579,4312
202010,41310,경기도,구리시,5-9세,8810,4568,4242
202011,41310,경기도,구리시,5-9세,8782,4552,4230
202012,41310,경기도,구리시,5-9세,8753,4533,4220
202101,41310,경기도,구리시,5-9세,8692,4491,4201
202102,41310,경기도,구리시,5-9세,8654,4476,4178
202103,41310,경기도,구리시,5-9세,8599,4431,4168
202104,41310,경기도,구리시,5-9세,8583,4415,4168
202105,41310,경기도,구리시,5-9세,8571,4398,4173
202106,41310,경기도,구리시,5-9세,8538,4379,4159
202007,41310,경기도,구리시,10-14세,8671,4509,4162
202008,41310,경기도,구리시,10-14세,8669,4519,4150
202009,41310,경기도,구리시,10-14세,8659,4509,4150
202010,41310,경기도,구리시,10-14세,8689,4512,4177
202011,41310,경기도,구리시,10-14세,8707,4512,4195
202012,41310,경기도,구리시,10-14세,8716,4517,4199
202101,41310,경기도,구리시,10-14세,8711,4499,4212
202102,41310,경기도,구리시,10-14세,8654,4466,4188
202103,41310,경기도,구리시,10-14세,8670,4484,4186
202104,41310,경기도,구리시,10-14세,8660,4467,4193
202105,41310,경기도,구리시,10-14세,8618,4443,4175
202106,41310,경기도,구리시,10-14세,8594,4429,4165
202007,41310,경기도,구리시,15-19세,9828,5017,4811
202008,41310,경기도,구리시,15-19세,9703,4956,4747
202009,41310,경기도,구리시,15-19세,9683,4951,4732
202010,41310,경기도,구리시,15-19세,9611,4912,4699
202011,41310,경기도,구리시,15-19세,9528,4884,4644
202012,41310,경기도,구리시,15-19세,9435,4849,4586
202101,41310,경기도,구리시,15-19세,9382,4833,4549
202102,41310,경기도,구리시,15-19세,9298,4800,4498
202103,41310,경기도,구리시,15-19세,9221,4772,4449
202104,41310,경기도,구리시,15-19세,9139,4732,4407
202105,41310,경기도,구리시,15-19세,9084,4698,4386
202106,41310,경기도,구리시,15-19세,9045,4676,4369
202007,41310,경기도,구리시,20-24세,13354,6837,6517
202008,41310,경기도,구리시,20-24세,13300,6811,6489
202009,41310,경기도,구리시,20-24세,13229,6760,6469
202010,41310,경기도,구리시,20-24세,13216,6743,6473
202011,41310,경기도,구리시,20-24세,13161,6711,6450
202012,41310,경기도,구리시,20-24세,13162,6708,6454
202101,41310,경기도,구리시,20-24세,13060,6660,6400
202102,41310,경기도,구리시,20-24세,12964,6615,6349
202103,41310,경기도,구리시,20-24세,12932,6586,6346
202104,41310,경기도,구리시,20-24세,12855,6568,6287
202105,41310,경기도,구리시,20-24세,12801,6547,6254
202106,41310,경기도,구리시,20-24세,12708,6490,6218
202007,41310,경기도,구리시,25-29세,14062,7224,6838
202008,41310,경기도,구리시,25-29세,14031,7217,6814
202009,41310,경기도,구리시,25-29세,14078,7261,6817
202010,41310,경기도,구리시,25-29세,14047,7258,6789
202011,41310,경기도,구리시,25-29세,14119,7280,6839
202012,41310,경기도,구리시,25-29세,14119,7268,6851
202101,41310,경기도,구리시,25-29세,14179,7318,6861
202102,41310,경기도,구리시,25-29세,14165,7333,6832
202103,41310,경기도,구리시,25-29세,14110,7316,6794
202104,41310,경기도,구리시,25-29세,14092,7280,6812
202105,41310,경기도,구리시,25-29세,14036,7251,6785
202106,41310,경기도,구리시,25-29세,14013,7244,6769
202007,41310,경기도,구리시,30-34세,11879,5966,5913
202008,41310,경기도,구리시,30-34세,11832,5952,5880
202009,41310,경기도,구리시,30-34세,11823,5931,5892
202010,41310,경기도,구리시,30-34세,11810,5934,5876
202011,41310,경기도,구리시,30-34세,11781,5909,5872
202012,41310,경기도,구리시,30-34세,11764,5915,5849
202101,41310,경기도,구리시,30-34세,11744,5909,5835
202102,41310,경기도,구리시,30-34세,11676,5874,5802
202103,41310,경기도,구리시,30-34세,11613,5853,5760
202104,41310,경기도,구리시,30-34세,11562,5823,5739
202105,41310,경기도,구리시,30-34세,11572,5821,5751
202106,41310,경기도,구리시,30-34세,11573,5819,5754
202007,41310,경기도,구리시,35-39세,14995,7606,7389
202008,41310,경기도,구리시,35-39세,14925,7549,7376
202009,41310,경기도,구리시,35-39세,14835,7483,7352
202010,41310,경기도,구리시,35-39세,14730,7419,7311
202011,41310,경기도,구리시,35-39세,14641,7374,7267
202012,41310,경기도,구리시,35-39세,14608,7354,7254
202101,41310,경기도,구리시,35-39세,14484,7280,7204
202102,41310,경기도,구리시,35-39세,14368,7220,7148
202103,41310,경기도,구리시,35-39세,14207,7173,7034
202104,41310,경기도,구리시,35-39세,14073,7092,6981
202105,41310,경기도,구리시,35-39세,13952,7036,6916
202106,41310,경기도,구리시,35-39세,13852,6994,6858
202007,41310,경기도,구리시,40-44세,15375,7762,7613
202008,41310,경기도,구리시,40-44세,15410,7806,7604
202009,41310,경기도,구리시,40-44세,15461,7828,7633
202010,41310,경기도,구리시,40-44세,15527,7860,7667
202011,41310,경기도,구리시,40-44세,15560,7893,7667
202012,41310,경기도,구리시,40-44세,15518,7875,7643
202101,41310,경기도,구리시,40-44세,15466,7849,7617
202102,41310,경기도,구리시,40-44세,15473,7855,7618
202103,41310,경기도,구리시,40-44세,15425,7825,7600
202104,41310,경기도,구리시,40-44세,15410,7804,7606
202105,41310,경기도,구리시,40-44세,15414,7822,7592
202106,41310,경기도,구리시,40-44세,15436,7846,7590
202007,41310,경기도,구리시,45-49세,17687,8677,9010
202008,41310,경기도,구리시,45-49세,17618,8638,8980
202009,41310,경기도,구리시,45-49세,17594,8643,8951
202010,41310,경기도,구리시,45-49세,17470,8571,8899
202011,41310,경기도,구리시,45-49세,17366,8507,8859
202012,41310,경기도,구리시,45-49세,17327,8507,8820
202101,41310,경기도,구리시,45-49세,17256,8494,8762
202102,41310,경기도,구리시,45-49세,17109,8434,8675
202103,41310,경기도,구리시,45-49세,17003,8360,8643
202104,41310,경기도,구리시,45-49세,16921,8327,8594
202105,41310,경기도,구리시,45-49세,16778,8249,8529
202106,41310,경기도,구리시,45-49세,16694,8213,8481
202007,41310,경기도,구리시,50-54세,18370,8829,9541
202008,41310,경기도,구리시,50-54세,18384,8849,9535
202009,41310,경기도,구리시,50-54세,18405,8865,9540
202010,41310,경기도,구리시,50-54세,18419,8866,9553
202011,41310,경기도,구리시,50-54세,18396,8865,9531
202012,41310,경기도,구리시,50-54세,18328,8815,9513
202101,41310,경기도,구리시,50-54세,18386,8838,9548
202102,41310,경기도,구리시,50-54세,18363,8847,9516
202103,41310,경기도,구리시,50-54세,18246,8799,9447
202104,41310,경기도,구리시,50-54세,18187,8777,9410
202105,41310,경기도,구리시,50-54세,18200,8781,9419
202106,41310,경기도,구리시,50-54세,18185,8780,9405
202007,41310,경기도,구리시,55-59세,17512,8821,8691
202008,41310,경기도,구리시,55-59세,17456,8803,8653
202009,41310,경기도,구리시,55-59세,17472,8799,8673
202010,41310,경기도,구리시,55-59세,17406,8773,8633
202011,41310,경기도,구리시,55-59세,17424,8775,8649
202012,41310,경기도,구리시,55-59세,17444,8782,8662
202101,41310,경기도,구리시,55-59세,17385,8758,8627
202102,41310,경기도,구리시,55-59세,17335,8728,8607
202103,41310,경기도,구리시,55-59세,17239,8679,8560
202104,41310,경기도,구리시,55-59세,17177,8650,8527
202105,41310,경기도,구리시,55-59세,17043,8585,8458
202106,41310,경기도,구리시,55-59세,16853,8493,8360
202007,41310,경기도,구리시,60-64세,14483,7338,7145
202008,41310,경기도,구리시,60-64세,14541,7351,7190
202009,41310,경기도,구리시,60-64세,14625,7393,7232
202010,41310,경기도,구리시,60-64세,14741,7455,7286
202011,41310,경기도,구리시,60-64세,14813,7499,7314
202012,41310,경기도,구리시,60-64세,14872,7521,7351
202101,41310,경기도,구리시,60-64세,15041,7583,7458
202102,41310,경기도,구리시,60-64세,15160,7615,7545
202103,41310,경기도,구리시,60-64세,15210,7628,7582
202104,41310,경기도,구리시,60-64세,15343,7687,7656
202105,41310,경기도,구리시,60-64세,15405,7712,7693
202106,41310,경기도,구리시,60-64세,15550,7783,7767
202007,41310,경기도,구리시,65-69세,9191,4520,4671
202008,41310,경기도,구리시,65-69세,9257,4570,4687
202009,41310,경기도,구리시,65-69세,9318,4606,4712
202010,41310,경기도,구리시,65-69세,9427,4653,4774
202011,41310,경기도,구리시,65-69세,9464,4671,4793
202012,41310,경기도,구리시,65-69세,9551,4711,4840
202101,41310,경기도,구리시,65-69세,9631,4748,4883
202102,41310,경기도,구리시,65-69세,9728,4810,4918
202103,41310,경기도,구리시,65-69세,9839,4850,4989
202104,41310,경기도,구리시,65-69세,9909,4895,5014
202105,41310,경기도,구리시,65-69세,9962,4902,5060
202106,41310,경기도,구리시,65-69세,9997,4934,5063
202007,41310,경기도,구리시,70-74세,6524,3015,3509
202008,41310,경기도,구리시,70-74세,6530,3016,3514
202009,41310,경기도,구리시,70-74세,6580,3033,3547
202010,41310,경기도,구리시,70-74세,6602,3028,3574
202011,41310,경기도,구리시,70-74세,6658,3057,3601
202012,41310,경기도,구리시,70-74세,6697,3070,3627
202101,41310,경기도,구리시,70-74세,6688,3071,3617
202102,41310,경기도,구리시,70-74세,6701,3077,3624
202103,41310,경기도,구리시,70-74세,6671,3068,3603
202104,41310,경기도,구리시,70-74세,6650,3048,3602
202105,41310,경기도,구리시,70-74세,6679,3072,3607
202106,41310,경기도,구리시,70-74세,6637,3050,3587
202007,41310,경기도,구리시,75-79세,5095,2180,2915
202008,41310,경기도,구리시,75-79세,5097,2182,2915
202009,41310,경기도,구리시,75-79세,5075,2178,2897
202010,41310,경기도,구리시,75-79세,5081,2190,2891
202011,41310,경기도,구리시,75-79세,5073,2186,2887
202012,41310,경기도,구리시,75-79세,5047,2180,2867
202101,41310,경기도,구리시,75-79세,5069,2201,2868
202102,41310,경기도,구리시,75-79세,5058,2200,2858
202103,41310,경기도,구리시,75-79세,4996,2168,2828
202104,41310,경기도,구리시,75-79세,4979,2156,2823
202105,41310,경기도,구리시,75-79세,4965,2142,2823
202106,41310,경기도,구리시,75-79세,4973,2153,2820
202007,41310,경기도,구리시,80-84세,3231,1251,1980
202008,41310,경기도,구리시,80-84세,3257,1264,1993
202009,41310,경기도,구리시,80-84세,3279,1273,2006
202010,41310,경기도,구리시,80-84세,3300,1288,2012
202011,41310,경기도,구리시,80-84세,3313,1297,2016
202012,41310,경기도,구리시,80-84세,3307,1296,2011
202101,41310,경기도,구리시,80-84세,3326,1297,2029
202102,41310,경기도,구리시,80-84세,3334,1297,2037
202103,41310,경기도,구리시,80-84세,3345,1318,2027
202104,41310,경기도,구리시,80-84세,3358,1327,2031
202105,41310,경기도,구리시,80-84세,3385,1352,2033
202106,41310,경기도,구리시,80-84세,3416,1358,2058
202007,41310,경기도,구리시,85-89세,1515,498,1017
202008,41310,경기도,구리시,85-89세,1527,502,1025
202009,41310,경기도,구리시,85-89세,1558,514,1044
202010,41310,경기도,구리시,85-89세,1557,510,1047
202011,41310,경기도,구리시,85-89세,1567,507,1060
202012,41310,경기도,구리시,85-89세,1582,510,1072
202101,41310,경기도,구리시,85-89세,1573,510,1063
202102,41310,경기도,구리시,85-89세,1602,515,1087
202103,41310,경기도,구리시,85-89세,1604,515,1089
202104,41310,경기도,구리시,85-89세,1624,522,1102
202105,41310,경기도,구리시,85-89세,1639,526,1113
202106,41310,경기도,구리시,85-89세,1612,521,1091
202007,41310,경기도,구리시,90-94세,536,138,398
202008,41310,경기도,구리시,90-94세,531,136,395
202009,41310,경기도,구리시,90-94세,535,134,401
202010,41310,경기도,구리시,90-94세,544,135,409
202011,41310,경기도,구리시,90-94세,554,140,414
202012,41310,경기도,구리시,90-94세,563,144,419
202101,41310,경기도,구리시,90-94세,574,149,425
202102,41310,경기도,구리시,90-94세,559,144,415
202103,41310,경기도,구리시,90-94세,541,138,403
202104,41310,경기도,구리시,90-94세,530,134,396
202105,41310,경기도,구리시,90-94세,527,135,392
202106,41310,경기도,구리시,90-94세,533,140,393
202007,41310,경기도,구리시,95-99세,140,37,103
202008,41310,경기도,구리시,95-99세,142,38,104
202009,41310,경기도,구리시,95-99세,140,39,101
202010,41310,경기도,구리시,95-99세,136,39,97
202011,41310,경기도,구리시,95-99세,134,38,96
202012,41310,경기도,구리시,95-99세,133,38,95
202101,41310,경기도,구리시,95-99세,130,38,92
202102,41310,경기도,구리시,95-99세,136,38,98
202103,41310,경기도,구리시,95-99세,126,33,93
202104,41310,경기도,구리시,95-99세,129,33,96
202105,41310,경기도,구리시,95-99세,128,34,94
202106,41310,경기도,구리시,95-99세,133,34,99
202007,41310,경기도,구리시,100+,78,24,54
202008,41310,경기도,구리시,100+,79,25,54
202009,41310,경기도,구리시,100+,82,25,57
202010,41310,경기도,구리시,100+,81,25,56
202011,41310,경기도,구리시,100+,81,26,55
202012,41310,경기도,구리시,100+,82,27,55
202101,41310,경기도,구리시,100+,83,27,56
202102,41310,경기도,구리시,100+,84,27,57
202103,41310,경기도,구리시,100+,54,19,35
202104,41310,경기도,구리시,100+,52,19,33
202105,41310,경기도,구리시,100+,54,20,34
202106,41310,경기도,구리시,100+,52,20,32
202007,41360,경기도,남양주시,0-4세,27031,13990,13041
202008,41360,경기도,남양주시,0-4세,26832,13897,12935
202009,41360,경기도,남양주시,0-4세,26621,13815,12806
202010,41360,경기도,남양주시,0-4세,26383,13710,12673
202011,41360,경기도,남양주시,0-4세,26252,13638,12614
202012,41360,경기도,남양주시,0-4세,26074,13522,12552
202101,41360,경기도,남양주시,0-4세,25832,13378,12454
202102,41360,경기도,남양주시,0-4세,25856,13383,12473
202103,41360,경기도,남양주시,0-4세,25779,13352,12427
202104,41360,경기도,남양주시,0-4세,25599,13278,12321
202105,41360,경기도,남양주시,0-4세,25359,13181,12178
202106,41360,경기도,남양주시,0-4세,25108,13041,12067
202007,41360,경기도,남양주시,5-9세,39349,20151,19198
202008,41360,경기도,남양주시,5-9세,39249,20076,19173
202009,41360,경기도,남양주시,5-9세,39190,20026,19164
202010,41360,경기도,남양주시,5-9세,39106,19973,19133
202011,41360,경기도,남양주시,5-9세,38976,19911,19065
202012,41360,경기도,남양주시,5-9세,38852,19837,19015
202101,41360,경기도,남양주시,5-9세,38787,19847,18940
202102,41360,경기도,남양주시,5-9세,39053,20012,19041
202103,41360,경기도,남양주시,5-9세,39085,20036,19049
202104,41360,경기도,남양주시,5-9세,39091,20033,19058
202105,41360,경기도,남양주시,5-9세,39044,20011,19033
202106,41360,경기도,남양주시,5-9세,38987,19980,19007
202007,41360,경기도,남양주시,10-14세,38975,20005,18970
202008,41360,경기도,남양주시,10-14세,39075,20053,19022
202009,41360,경기도,남양주시,10-14세,39146,20090,19056
202010,41360,경기도,남양주시,10-14세,39332,20224,19108
202011,41360,경기도,남양주시,10-14세,39459,20291,19168
202012,41360,경기도,남양주시,10-14세,39593,20350,19243
202101,41360,경기도,남양주시,10-14세,39875,20480,19395
202102,41360,경기도,남양주시,10-14세,40135,20601,19534
202103,41360,경기도,남양주시,10-14세,40255,20651,19604
202104,41360,경기도,남양주시,10-14세,40349,20718,19631
202105,41360,경기도,남양주시,10-14세,40517,20797,19720
202106,41360,경기도,남양주시,10-14세,40517,20784,19733
202007,41360,경기도,남양주시,15-19세,38726,19969,18757
202008,41360,경기도,남양주시,15-19세,38601,19878,18723
202009,41360,경기도,남양주시,15-19세,38426,19784,18642
202010,41360,경기도,남양주시,15-19세,38234,19669,18565
202011,41360,경기도,남양주시,15-19세,38007,19512,18495
202012,41360,경기도,남양주시,15-19세,37675,19371,18304
202101,41360,경기도,남양주시,15-19세,37515,19275,18240
202102,41360,경기도,남양주시,15-19세,37516,19293,18223
202103,41360,경기도,남양주시,15-19세,37433,19249,18184
202104,41360,경기도,남양주시,15-19세,37393,19175,18218
202105,41360,경기도,남양주시,15-19세,37411,19197,18214
202106,41360,경기도,남양주시,15-19세,37580,19258,18322
202007,41360,경기도,남양주시,20-24세,43438,22577,20861
202008,41360,경기도,남양주시,20-24세,43399,22603,20796
202009,41360,경기도,남양주시,20-24세,43460,22625,20835
202010,41360,경기도,남양주시,20-24세,43518,22702,20816
202011,41360,경기도,남양주시,20-24세,43583,22774,20809
202012,41360,경기도,남양주시,20-24세,43482,22716,20766
202101,41360,경기도,남양주시,20-24세,43481,22714,20767
202102,41360,경기도,남양주시,20-24세,43545,22684,20861
202103,41360,경기도,남양주시,20-24세,43527,22659,20868
202104,41360,경기도,남양주시,20-24세,43535,22651,20884
202105,41360,경기도,남양주시,20-24세,43553,22636,20917
202106,41360,경기도,남양주시,20-24세,43558,22627,20931
202007,41360,경기도,남양주시,25-29세,40684,21161,19523
202008,41360,경기도,남양주시,25-29세,40905,21253,19652
202009,41360,경기도,남양주시,25-29세,40908,21267,19641
202010,41360,경기도,남양주시,25-29세,41107,21409,19698
202011,41360,경기도,남양주시,25-29세,41290,21487,19803
202012,41360,경기도,남양주시,25-29세,41541,21639,19902
202101,41360,경기도,남양주시,25-29세,41684,21733,19951
202102,41360,경기도,남양주시,25-29세,41710,21763,19947
202103,41360,경기도,남양주시,25-29세,42041,21928,20113
202104,41360,경기도,남양주시,25-29세,42192,22014,20178
202105,41360,경기도,남양주시,25-29세,42302,22106,20196
202106,41360,경기도,남양주시,25-29세,42331,22141,20190
202007,41360,경기도,남양주시,30-34세,36351,18099,18252
202008,41360,경기도,남양주시,30-34세,36371,18097,18274
202009,41360,경기도,남양주시,30-34세,36409,18160,18249
202010,41360,경기도,남양주시,30-34세,36403,18189,18214
202011,41360,경기도,남양주시,30-34세,36493,18273,18220
202012,41360,경기도,남양주시,30-34세,36476,18244,18232
202101,41360,경기도,남양주시,30-34세,36543,18276,18267
202102,41360,경기도,남양주시,30-34세,36782,18416,18366
202103,41360,경기도,남양주시,30-34세,37094,18582,18512
202104,41360,경기도,남양주시,30-34세,37311,18704,18607
202105,41360,경기도,남양주시,30-34세,37469,18806,18663
202106,41360,경기도,남양주시,30-34세,37596,18872,18724
202007,41360,경기도,남양주시,35-39세,54307,26467,27840
202008,41360,경기도,남양주시,35-39세,53964,26306,27658
202009,41360,경기도,남양주시,35-39세,53679,26159,27520
202010,41360,경기도,남양주시,35-39세,53458,26032,27426
202011,41360,경기도,남양주시,35-39세,53210,25947,27263
202012,41360,경기도,남양주시,35-39세,52996,25859,27137
202101,41360,경기도,남양주시,35-39세,52731,25744,26987
202102,41360,경기도,남양주시,35-39세,52712,25720,26992
202103,41360,경기도,남양주시,35-39세,52723,25735,26988
202104,41360,경기도,남양주시,35-39세,52531,25643,26888
202105,41360,경기도,남양주시,35-39세,52274,25502,26772
202106,41360,경기도,남양주시,35-39세,51962,25360,26602
202007,41360,경기도,남양주시,40-44세,61983,30661,31322
202008,41360,경기도,남양주시,40-44세,62087,30703,31384
202009,41360,경기도,남양주시,40-44세,62276,30795,31481
202010,41360,경기도,남양주시,40-44세,62459,30892,31567
202011,41360,경기도,남양주시,40-44세,62667,30962,31705
202012,41360,경기도,남양주시,40-44세,62648,31000,31648
202101,41360,경기도,남양주시,40-44세,62774,31002,31772
202102,41360,경기도,남양주시,40-44세,63468,31372,32096
202103,41360,경기도,남양주시,40-44세,63606,31450,32156
202104,41360,경기도,남양주시,40-44세,63657,31461,32196
202105,41360,경기도,남양주시,40-44세,63954,31603,32351
202106,41360,경기도,남양주시,40-44세,64308,31752,32556
202007,41360,경기도,남양주시,45-49세,67885,34617,33268
202008,41360,경기도,남양주시,45-49세,67785,34535,33250
202009,41360,경기도,남양주시,45-49세,67544,34379,33165
202010,41360,경기도,남양주시,45-49세,67467,34349,33118
202011,41360,경기도,남양주시,45-49세,67460,34329,33131
202012,41360,경기도,남양주시,45-49세,67524,34318,33206
202101,41360,경기도,남양주시,45-49세,67636,34416,33220
202102,41360,경기도,남양주시,45-49세,67712,34417,33295
202103,41360,경기도,남양주시,45-49세,67518,34312,33206
202104,41360,경기도,남양주시,45-49세,67575,34315,33260
202105,41360,경기도,남양주시,45-49세,67248,34129,33119
202106,41360,경기도,남양주시,45-49세,67019,34002,33017
202007,41360,경기도,남양주시,50-54세,60991,31089,29902
202008,41360,경기도,남양주시,50-54세,61150,31197,29953
202009,41360,경기도,남양주시,50-54세,61457,31358,30099
202010,41360,경기도,남양주시,50-54세,61822,31502,30320
202011,41360,경기도,남양주시,50-54세,61982,31571,30411
202012,41360,경기도,남양주시,50-54세,61971,31552,30419
202101,41360,경기도,남양주시,50-54세,62433,31755,30678
202102,41360,경기도,남양주시,50-54세,62994,32043,30951
202103,41360,경기도,남양주시,50-54세,63117,32098,31019
202104,41360,경기도,남양주시,50-54세,63414,32246,31168
202105,41360,경기도,남양주시,50-54세,63992,32524,31468
202106,41360,경기도,남양주시,50-54세,64326,32665,31661
202007,41360,경기도,남양주시,55-59세,54559,27945,26614
202008,41360,경기도,남양주시,55-59세,54601,27957,26644
202009,41360,경기도,남양주시,55-59세,54624,27984,26640
202010,41360,경기도,남양주시,55-59세,54716,28027,26689
202011,41360,경기도,남양주시,55-59세,54899,28135,26764
202012,41360,경기도,남양주시,55-59세,55050,28217,26833
202101,41360,경기도,남양주시,55-59세,54986,28198,26788
202102,41360,경기도,남양주시,55-59세,55140,28282,26858
202103,41360,경기도,남양주시,55-59세,55339,28362,26977
202104,41360,경기도,남양주시,55-59세,55390,28443,26947
202105,41360,경기도,남양주시,55-59세,55390,28480,26910
202106,41360,경기도,남양주시,55-59세,55204,28384,26820
202007,41360,경기도,남양주시,60-64세,47222,23371,23851
202008,41360,경기도,남양주시,60-64세,47655,23599,24056
202009,41360,경기도,남양주시,60-64세,47963,23727,24236
202010,41360,경기도,남양주시,60-64세,48393,23932,24461
202011,41360,경기도,남양주시,60-64세,48633,24055,24578
202012,41360,경기도,남양주시,60-64세,48902,24176,24726
202101,41360,경기도,남양주시,60-64세,49207,24370,24837
202102,41360,경기도,남양주시,60-64세,49671,24546,25125
202103,41360,경기도,남양주시,60-64세,50143,24796,25347
202104,41360,경기도,남양주시,60-64세,50575,24945,25630
202105,41360,경기도,남양주시,60-64세,50984,25122,25862
202106,41360,경기도,남양주시,60-64세,51414,25388,26026
202007,41360,경기도,남양주시,65-69세,32921,15655,17266
202008,41360,경기도,남양주시,65-69세,33159,15774,17385
202009,41360,경기도,남양주시,65-69세,33378,15877,17501
202010,41360,경기도,남양주시,65-69세,33730,16052,17678
202011,41360,경기도,남양주시,65-69세,34028,16205,17823
202012,41360,경기도,남양주시,65-69세,34282,16327,17955
202101,41360,경기도,남양주시,65-69세,34679,16549,18130
202102,41360,경기도,남양주시,65-69세,35039,16735,18304
202103,41360,경기도,남양주시,65-69세,35518,16987,18531
202104,41360,경기도,남양주시,65-69세,35802,17121,18681
202105,41360,경기도,남양주시,65-69세,36097,17274,18823
202106,41360,경기도,남양주시,65-69세,36417,17414,19003
202007,41360,경기도,남양주시,70-74세,24698,11530,13168
202008,41360,경기도,남양주시,70-74세,24736,11515,13221
202009,41360,경기도,남양주시,70-74세,24876,11574,13302
202010,41360,경기도,남양주시,70-74세,25034,11650,13384
202011,41360,경기도,남양주시,70-74세,25197,11701,13496
202012,41360,경기도,남양주시,70-74세,25306,11747,13559
202101,41360,경기도,남양주시,70-74세,25499,11841,13658
202102,41360,경기도,남양주시,70-74세,25650,11931,13719
202103,41360,경기도,남양주시,70-74세,25656,11967,13689
202104,41360,경기도,남양주시,70-74세,25766,12034,13732
202105,41360,경기도,남양주시,70-74세,25852,12086,13766
202106,41360,경기도,남양주시,70-74세,25857,12092,13765
202007,41360,경기도,남양주시,75-79세,19465,8637,10828
202008,41360,경기도,남양주시,75-79세,19480,8677,10803
202009,41360,경기도,남양주시,75-79세,19473,8660,10813
202010,41360,경기도,남양주시,75-79세,19441,8643,10798
202011,41360,경기도,남양주시,75-79세,19461,8682,10779
202012,41360,경기도,남양주시,75-79세,19490,8702,10788
202101,41360,경기도,남양주시,75-79세,19518,8680,10838
202102,41360,경기도,남양주시,75-79세,19493,8661,10832
202103,41360,경기도,남양주시,75-79세,19464,8635,10829
202104,41360,경기도,남양주시,75-79세,19441,8619,10822
202105,41360,경기도,남양주시,75-79세,19436,8595,10841
202106,41360,경기도,남양주시,75-79세,19488,8628,10860
202007,41360,경기도,남양주시,80-84세,12207,4869,7338
202008,41360,경기도,남양주시,80-84세,12292,4883,7409
202009,41360,경기도,남양주시,80-84세,12380,4919,7461
202010,41360,경기도,남양주시,80-84세,12493,4976,7517
202011,41360,경기도,남양주시,80-84세,12522,4988,7534
202012,41360,경기도,남양주시,80-84세,12589,5019,7570
202101,41360,경기도,남양주시,80-84세,12691,5081,7610
202102,41360,경기도,남양주시,80-84세,12877,5182,7695
202103,41360,경기도,남양주시,80-84세,12934,5225,7709
202104,41360,경기도,남양주시,80-84세,12982,5265,7717
202105,41360,경기도,남양주시,80-84세,13115,5312,7803
202106,41360,경기도,남양주시,80-84세,13215,5341,7874
202007,41360,경기도,남양주시,85-89세,5700,1775,3925
202008,41360,경기도,남양주시,85-89세,5762,1809,3953
202009,41360,경기도,남양주시,85-89세,5808,1846,3962
202010,41360,경기도,남양주시,85-89세,5878,1889,3989
202011,41360,경기도,남양주시,85-89세,5926,1913,4013
202012,41360,경기도,남양주시,85-89세,5981,1935,4046
202101,41360,경기도,남양주시,85-89세,6037,1963,4074
202102,41360,경기도,남양주시,85-89세,6134,1986,4148
202103,41360,경기도,남양주시,85-89세,6216,2005,4211
202104,41360,경기도,남양주시,85-89세,6312,2035,4277
202105,41360,경기도,남양주시,85-89세,6355,2061,4294
202106,41360,경기도,남양주시,85-89세,6411,2079,4332
202007,41360,경기도,남양주시,90-94세,2027,476,1551
202008,41360,경기도,남양주시,90-94세,2045,477,1568
202009,41360,경기도,남양주시,90-94세,2068,482,1586
202010,41360,경기도,남양주시,90-94세,2093,486,1607
202011,41360,경기도,남양주시,90-94세,2101,482,1619
202012,41360,경기도,남양주시,90-94세,2139,496,1643
202101,41360,경기도,남양주시,90-94세,2150,505,1645
202102,41360,경기도,남양주시,90-94세,2171,505,1666
202103,41360,경기도,남양주시,90-94세,2167,518,1649
202104,41360,경기도,남양주시,90-94세,2179,517,1662
202105,41360,경기도,남양주시,90-94세,2184,517,1667
202106,41360,경기도,남양주시,90-94세,2204,531,1673
202007,41360,경기도,남양주시,95-99세,516,112,404
202008,41360,경기도,남양주시,95-99세,521,114,407
202009,41360,경기도,남양주시,95-99세,534,111,423
202010,41360,경기도,남양주시,95-99세,529,110,419
202011,41360,경기도,남양주시,95-99세,535,112,423
202012,41360,경기도,남양주시,95-99세,527,111,416
202101,41360,경기도,남양주시,95-99세,539,112,427
202102,41360,경기도,남양주시,95-99세,548,116,432
202103,41360,경기도,남양주시,95-99세,535,105,430
202104,41360,경기도,남양주시,95-99세,543,108,435
202105,41360,경기도,남양주시,95-99세,543,106,437
202106,41360,경기도,남양주시,95-99세,540,102,438
202007,41360,경기도,남양주시,100+,212,61,151
202008,41360,경기도,남양주시,100+,212,62,150
202009,41360,경기도,남양주시,100+,213,63,150
202010,41360,경기도,남양주시,100+,219,61,158
202011,41360,경기도,남양주시,100+,219,59,160
202012,41360,경기도,남양주시,100+,223,59,164
202101,41360,경기도,남양주시,100+,225,61,164
202102,41360,경기도,남양주시,100+,228,62,166
202103,41360,경기도,남양주시,100+,132,30,102
202104,41360,경기도,남양주시,100+,130,29,101
202105,41360,경기도,남양주시,100+,136,31,105
202106,41360,경기도,남양주시,100+,141,32,109
202007,41370,경기도,오산시,0-4세,10278,5234,5044
202008,41370,경기도,오산시,0-4세,10148,5146,5002
202009,41370,경기도,오산시,0-4세,10103,5117,4986
202010,41370,경기도,오산시,0-4세,10026,5074,4952
202011,41370,경기도,오산시,0-4세,9940,5020,4920
202012,41370,경기도,오산시,0-4세,9835,4973,4862
202101,41370,경기도,오산시,0-4세,9687,4893,4794
202102,41370,경기도,오산시,0-4세,9570,4848,4722
202103,41370,경기도,오산시,0-4세,9468,4822,4646
202104,41370,경기도,오산시,0-4세,9387,4801,4586
202105,41370,경기도,오산시,0-4세,9271,4762,4509
202106,41370,경기도,오산시,0-4세,9181,4724,4457
202007,41370,경기도,오산시,5-9세,14121,7215,6906
202008,41370,경기도,오산시,5-9세,14143,7221,6922
202009,41370,경기도,오산시,5-9세,14095,7211,6884
202010,41370,경기도,오산시,5-9세,14018,7170,6848
202011,41370,경기도,오산시,5-9세,13990,7144,6846
202012,41370,경기도,오산시,5-9세,13949,7132,6817
202101,41370,경기도,오산시,5-9세,13887,7079,6808
202102,41370,경기도,오산시,5-9세,13839,7055,6784
202103,41370,경기도,오산시,5-9세,13758,7005,6753
202104,41370,경기도,오산시,5-9세,13678,6952,6726
202105,41370,경기도,오산시,5-9세,13656,6943,6713
202106,41370,경기도,오산시,5-9세,13626,6929,6697
202007,41370,경기도,오산시,10-14세,12878,6604,6274
202008,41370,경기도,오산시,10-14세,12905,6623,6282
202009,41370,경기도,오산시,10-14세,12961,6632,6329
202010,41370,경기도,오산시,10-14세,13014,6664,6350
202011,41370,경기도,오산시,10-14세,13024,6669,6355
202012,41370,경기도,오산시,10-14세,13083,6682,6401
202101,41370,경기도,오산시,10-14세,13113,6707,6406
202102,41370,경기도,오산시,10-14세,13137,6706,6431
202103,41370,경기도,오산시,10-14세,13177,6741,6436
202104,41370,경기도,오산시,10-14세,13215,6775,6440
202105,41370,경기도,오산시,10-14세,13238,6792,6446
202106,41370,경기도,오산시,10-14세,13276,6803,6473
202007,41370,경기도,오산시,15-19세,12008,6136,5872
202008,41370,경기도,오산시,15-19세,11983,6105,5878
202009,41370,경기도,오산시,15-19세,11951,6092,5859
202010,41370,경기도,오산시,15-19세,11921,6063,5858
202011,41370,경기도,오산시,15-19세,11862,6038,5824
202012,41370,경기도,오산시,15-19세,11790,6000,5790
202101,41370,경기도,오산시,15-19세,11811,6006,5805
202102,41370,경기도,오산시,15-19세,11788,6006,5782
202103,41370,경기도,오산시,15-19세,11770,5988,5782
202104,41370,경기도,오산시,15-19세,11710,5947,5763
202105,41370,경기도,오산시,15-19세,11703,5949,5754
202106,41370,경기도,오산시,15-19세,11661,5932,5729
202007,41370,경기도,오산시,20-24세,14068,7314,6754
202008,41370,경기도,오산시,20-24세,14111,7360,6751
202009,41370,경기도,오산시,20-24세,14120,7359,6761
202010,41370,경기도,오산시,20-24세,14125,7383,6742
202011,41370,경기도,오산시,20-24세,14176,7400,6776
202012,41370,경기도,오산시,20-24세,14209,7395,6814
202101,41370,경기도,오산시,20-24세,14210,7396,6814
202102,41370,경기도,오산시,20-24세,14314,7449,6865
202103,41370,경기도,오산시,20-24세,14312,7447,6865
202104,41370,경기도,오산시,20-24세,14341,7478,6863
202105,41370,경기도,오산시,20-24세,14311,7431,6880
202106,41370,경기도,오산시,20-24세,14262,7428,6834
202007,41370,경기도,오산시,25-29세,16854,9389,7465
202008,41370,경기도,오산시,25-29세,16872,9402,7470
202009,41370,경기도,오산시,25-29세,16980,9476,7504
202010,41370,경기도,오산시,25-29세,16990,9449,7541
202011,41370,경기도,오산시,25-29세,17068,9490,7578
202012,41370,경기도,오산시,25-29세,17112,9533,7579
202101,41370,경기도,오산시,25-29세,17168,9564,7604
202102,41370,경기도,오산시,25-29세,17178,9565,7613
202103,41370,경기도,오산시,25-29세,17234,9596,7638
202104,41370,경기도,오산시,25-29세,17305,9631,7674
202105,41370,경기도,오산시,25-29세,17272,9634,7638
202106,41370,경기도,오산시,25-29세,17260,9623,7637
202007,41370,경기도,오산시,30-34세,16774,9084,7690
202008,41370,경기도,오산시,30-34세,16787,9108,7679
202009,41370,경기도,오산시,30-34세,16810,9141,7669
202010,41370,경기도,오산시,30-34세,16803,9170,7633
202011,41370,경기도,오산시,30-34세,16701,9125,7576
202012,41370,경기도,오산시,30-34세,16711,9139,7572
202101,41370,경기도,오산시,30-34세,16698,9146,7552
202102,41370,경기도,오산시,30-34세,16694,9142,7552
202103,41370,경기도,오산시,30-34세,16760,9159,7601
202104,41370,경기도,오산시,30-34세,16754,9181,7573
202105,41370,경기도,오산시,30-34세,16769,9211,7558
202106,41370,경기도,오산시,30-34세,16850,9264,7586
202007,41370,경기도,오산시,35-39세,22606,12155,10451
202008,41370,경기도,오산시,35-39세,22561,12123,10438
202009,41370,경기도,오산시,35-39세,22452,12059,10393
202010,41370,경기도,오산시,35-39세,22369,12018,10351
202011,41370,경기도,오산시,35-39세,22288,11961,10327
202012,41370,경기도,오산시,35-39세,22262,11928,10334
202101,41370,경기도,오산시,35-39세,22127,11822,10305
202102,41370,경기도,오산시,35-39세,21969,11754,10215
202103,41370,경기도,오산시,35-39세,21843,11716,10127
202104,41370,경기도,오산시,35-39세,21710,11650,10060
202105,41370,경기도,오산시,35-39세,21561,11558,10003
202106,41370,경기도,오산시,35-39세,21342,11432,9910
202007,41370,경기도,오산시,40-44세,21894,11684,10210
202008,41370,경기도,오산시,40-44세,22025,11746,10279
202009,41370,경기도,오산시,40-44세,22148,11802,10346
202010,41370,경기도,오산시,40-44세,22237,11851,10386
202011,41370,경기도,오산시,40-44세,22302,11903,10399
202012,41370,경기도,오산시,40-44세,22265,11880,10385
202101,41370,경기도,오산시,40-44세,22281,11899,10382
202102,41370,경기도,오산시,40-44세,22465,11997,10468
202103,41370,경기도,오산시,40-44세,22435,11971,10464
202104,41370,경기도,오산시,40-44세,22459,11993,10466
202105,41370,경기도,오산시,40-44세,22561,12069,10492
202106,41370,경기도,오산시,40-44세,22729,12177,10552
202007,41370,경기도,오산시,45-49세,20921,10976,9945
202008,41370,경기도,오산시,45-49세,20990,11058,9932
202009,41370,경기도,오산시,45-49세,20993,11066,9927
202010,41370,경기도,오산시,45-49세,20964,11037,9927
202011,41370,경기도,오산시,45-49세,20944,11006,9938
202012,41370,경기도,오산시,45-49세,20972,11033,9939
202101,41370,경기도,오산시,45-49세,21099,11123,9976
202102,41370,경기도,오산시,45-49세,21124,11142,9982
202103,41370,경기도,오산시,45-49세,21157,11184,9973
202104,41370,경기도,오산시,45-49세,21169,11208,9961
202105,41370,경기도,오산시,45-49세,21062,11148,9914
202106,41370,경기도,오산시,45-49세,20971,11099,9872
202007,41370,경기도,오산시,50-54세,17813,9303,8510
202008,41370,경기도,오산시,50-54세,17853,9316,8537
202009,41370,경기도,오산시,50-54세,17962,9381,8581
202010,41370,경기도,오산시,50-54세,18029,9418,8611
202011,41370,경기도,오산시,50-54세,18129,9477,8652
202012,41370,경기도,오산시,50-54세,18161,9524,8637
202101,41370,경기도,오산시,50-54세,18312,9590,8722
202102,41370,경기도,오산시,50-54세,18422,9656,8766
202103,41370,경기도,오산시,50-54세,18423,9642,8781
202104,41370,경기도,오산시,50-54세,18560,9715,8845
202105,41370,경기도,오산시,50-54세,18687,9761,8926
202106,41370,경기도,오산시,50-54세,18769,9809,8960
202007,41370,경기도,오산시,55-59세,15040,7813,7227
202008,41370,경기도,오산시,55-59세,15062,7815,7247
202009,41370,경기도,오산시,55-59세,15082,7793,7289
202010,41370,경기도,오산시,55-59세,15104,7810,7294
202011,41370,경기도,오산시,55-59세,15085,7816,7269
202012,41370,경기도,오산시,55-59세,15105,7826,7279
202101,41370,경기도,오산시,55-59세,15087,7848,7239
202102,41370,경기도,오산시,55-59세,15114,7862,7252
202103,41370,경기도,오산시,55-59세,15081,7875,7206
202104,41370,경기도,오산시,55-59세,15074,7891,7183
202105,41370,경기도,오산시,55-59세,14988,7870,7118
202106,41370,경기도,오산시,55-59세,14891,7804,7087
202007,41370,경기도,오산시,60-64세,11731,5834,5897
202008,41370,경기도,오산시,60-64세,11836,5888,5948
202009,41370,경기도,오산시,60-64세,11949,5971,5978
202010,41370,경기도,오산시,60-64세,12041,6021,6020
202011,41370,경기도,오산시,60-64세,12151,6066,6085
202012,41370,경기도,오산시,60-64세,12211,6100,6111
202101,41370,경기도,오산시,60-64세,12310,6160,6150
202102,41370,경기도,오산시,60-64세,12457,6227,6230
202103,41370,경기도,오산시,60-64세,12586,6297,6289
202104,41370,경기도,오산시,60-64세,12695,6346,6349
202105,41370,경기도,오산시,60-64세,12821,6414,6407
202106,41370,경기도,오산시,60-64세,12978,6492,6486
202007,41370,경기도,오산시,65-69세,7374,3579,3795
202008,41370,경기도,오산시,65-69세,7457,3623,3834
202009,41370,경기도,오산시,65-69세,7528,3650,3878
202010,41370,경기도,오산시,65-69세,7618,3694,3924
202011,41370,경기도,오산시,65-69세,7665,3722,3943
202012,41370,경기도,오산시,65-69세,7732,3739,3993
202101,41370,경기도,오산시,65-69세,7827,3781,4046
202102,41370,경기도,오산시,65-69세,7947,3854,4093
202103,41370,경기도,오산시,65-69세,8075,3932,4143
202104,41370,경기도,오산시,65-69세,8114,3942,4172
202105,41370,경기도,오산시,65-69세,8168,3975,4193
202106,41370,경기도,오산시,65-69세,8220,4000,4220
202007,41370,경기도,오산시,70-74세,5318,2457,2861
202008,41370,경기도,오산시,70-74세,5339,2462,2877
202009,41370,경기도,오산시,70-74세,5388,2498,2890
202010,41370,경기도,오산시,70-74세,5415,2512,2903
202011,41370,경기도,오산시,70-74세,5479,2526,2953
202012,41370,경기도,오산시,70-74세,5493,2541,2952
202101,41370,경기도,오산시,70-74세,5555,2563,2992
202102,41370,경기도,오산시,70-74세,5577,2572,3005
202103,41370,경기도,오산시,70-74세,5576,2557,3019
202104,41370,경기도,오산시,70-74세,5608,2576,3032
202105,41370,경기도,오산시,70-74세,5613,2572,3041
202106,41370,경기도,오산시,70-74세,5614,2582,3032
202007,41370,경기도,오산시,75-79세,4245,1757,2488
202008,41370,경기도,오산시,75-79세,4261,1774,2487
202009,41370,경기도,오산시,75-79세,4266,1774,2492
202010,41370,경기도,오산시,75-79세,4266,1771,2495
202011,41370,경기도,오산시,75-79세,4282,1782,2500
202012,41370,경기도,오산시,75-79세,4286,1780,2506
202101,41370,경기도,오산시,75-79세,4287,1795,2492
202102,41370,경기도,오산시,75-79세,4290,1792,2498
202103,41370,경기도,오산시,75-79세,4295,1795,2500
202104,41370,경기도,오산시,75-79세,4298,1793,2505
202105,41370,경기도,오산시,75-79세,4289,1796,2493
202106,41370,경기도,오산시,75-79세,4302,1797,2505
202007,41370,경기도,오산시,80-84세,2682,1015,1667
202008,41370,경기도,오산시,80-84세,2704,1024,1680
202009,41370,경기도,오산시,80-84세,2718,1032,1686
202010,41370,경기도,오산시,80-84세,2728,1047,1681
202011,41370,경기도,오산시,80-84세,2723,1040,1683
202012,41370,경기도,오산시,80-84세,2729,1044,1685
202101,41370,경기도,오산시,80-84세,2733,1044,1689
202102,41370,경기도,오산시,80-84세,2766,1055,1711
202103,41370,경기도,오산시,80-84세,2771,1067,1704
202104,41370,경기도,오산시,80-84세,2796,1080,1716
202105,41370,경기도,오산시,80-84세,2828,1088,1740
202106,41370,경기도,오산시,80-84세,2858,1099,1759
202007,41370,경기도,오산시,85-89세,1190,394,796
202008,41370,경기도,오산시,85-89세,1195,396,799
202009,41370,경기도,오산시,85-89세,1188,397,791
202010,41370,경기도,오산시,85-89세,1205,399,806
202011,41370,경기도,오산시,85-89세,1229,408,821
202012,41370,경기도,오산시,85-89세,1269,422,847
202101,41370,경기도,오산시,85-89세,1290,430,860
202102,41370,경기도,오산시,85-89세,1316,439,877
202103,41370,경기도,오산시,85-89세,1343,439,904
202104,41370,경기도,오산시,85-89세,1348,446,902
202105,41370,경기도,오산시,85-89세,1358,450,908
202106,41370,경기도,오산시,85-89세,1366,455,911
202007,41370,경기도,오산시,90-94세,386,77,309
202008,41370,경기도,오산시,90-94세,393,75,318
202009,41370,경기도,오산시,90-94세,416,78,338
202010,41370,경기도,오산시,90-94세,414,77,337
202011,41370,경기도,오산시,90-94세,416,77,339
202012,41370,경기도,오산시,90-94세,414,77,337
202101,41370,경기도,오산시,90-94세,423,82,341
202102,41370,경기도,오산시,90-94세,420,80,340
202103,41370,경기도,오산시,90-94세,418,81,337
202104,41370,경기도,오산시,90-94세,426,80,346
202105,41370,경기도,오산시,90-94세,429,82,347
202106,41370,경기도,오산시,90-94세,431,84,347
202007,41370,경기도,오산시,95-99세,94,23,71
202008,41370,경기도,오산시,95-99세,98,26,72
202009,41370,경기도,오산시,95-99세,94,26,68
202010,41370,경기도,오산시,95-99세,93,25,68
202011,41370,경기도,오산시,95-99세,94,24,70
202012,41370,경기도,오산시,95-99세,95,25,70
202101,41370,경기도,오산시,95-99세,95,24,71
202102,41370,경기도,오산시,95-99세,95,24,71
202103,41370,경기도,오산시,95-99세,91,20,71
202104,41370,경기도,오산시,95-99세,91,19,72
202105,41370,경기도,오산시,95-99세,92,20,72
202106,41370,경기도,오산시,95-99세,93,21,72
202007,41370,경기도,오산시,100+,48,14,34
202008,41370,경기도,오산시,100+,45,13,32
202009,41370,경기도,오산시,100+,45,13,32
202010,41370,경기도,오산시,100+,44,12,32
202011,41370,경기도,오산시,100+,43,12,31
202012,41370,경기도,오산시,100+,42,12,30
202101,41370,경기도,오산시,100+,42,12,30
202102,41370,경기도,오산시,100+,40,12,28
202103,41370,경기도,오산시,100+,31,9,22
202104,41370,경기도,오산시,100+,31,9,22
202105,41370,경기도,오산시,100+,25,7,18
202106,41370,경기도,오산시,100+,25,7,18
202007,41390,경기도,시흥시,0-4세,21109,10707,10402
202008,41390,경기도,시흥시,0-4세,21307,10791,10516
202009,41390,경기도,시흥시,0-4세,21439,10837,10602
202010,41390,경기도,시흥시,0-4세,21387,10804,10583
202011,41390,경기도,시흥시,0-4세,21336,10766,10570
202012,41390,경기도,시흥시,0-4세,21464,10824,10640
202101,41390,경기도,시흥시,0-4세,21685,10912,10773
202102,41390,경기도,시흥시,0-4세,21773,10963,10810
202103,41390,경기도,시흥시,0-4세,21725,10966,10759
202104,41390,경기도,시흥시,0-4세,21637,10915,10722
202105,41390,경기도,시흥시,0-4세,21455,10793,10662
202106,41390,경기도,시흥시,0-4세,21309,10709,10600
202007,41390,경기도,시흥시,5-9세,25902,13347,12555
202008,41390,경기도,시흥시,5-9세,26305,13539,12766
202009,41390,경기도,시흥시,5-9세,26544,13657,12887
202010,41390,경기도,시흥시,5-9세,26609,13679,12930
202011,41390,경기도,시흥시,5-9세,26620,13678,12942
202012,41390,경기도,시흥시,5-9세,26853,13782,13071
202101,41390,경기도,시흥시,5-9세,27190,13960,13230
202102,41390,경기도,시흥시,5-9세,27385,14068,13317
202103,41390,경기도,시흥시,5-9세,27399,14043,13356
202104,41390,경기도,시흥시,5-9세,27482,14057,13425
202105,41390,경기도,시흥시,5-9세,27572,14122,13450
202106,41390,경기도,시흥시,5-9세,27561,14128,13433
202007,41390,경기도,시흥시,10-14세,24377,12416,11961
202008,41390,경기도,시흥시,10-14세,24643,12533,12110
202009,41390,경기도,시흥시,10-14세,24837,12644,12193
202010,41390,경기도,시흥시,10-14세,25009,12726,12283
202011,41390,경기도,시흥시,10-14세,25178,12778,12400
202012,41390,경기도,시흥시,10-14세,25285,12813,12472
202101,41390,경기도,시흥시,10-14세,25553,12959,12594
202102,41390,경기도,시흥시,10-14세,25696,13066,12630
202103,41390,경기도,시흥시,10-14세,25758,13129,12629
202104,41390,경기도,시흥시,10-14세,25769,13132,12637
202105,41390,경기도,시흥시,10-14세,25754,13125,12629
202106,41390,경기도,시흥시,10-14세,25788,13140,12648
202007,41390,경기도,시흥시,15-19세,25113,13071,12042
202008,41390,경기도,시흥시,15-19세,25071,13044,12027
202009,41390,경기도,시흥시,15-19세,25063,13015,12048
202010,41390,경기도,시흥시,15-19세,24961,12962,11999
202011,41390,경기도,시흥시,15-19세,24915,12950,11965
202012,41390,경기도,시흥시,15-19세,24862,12939,11923
202101,41390,경기도,시흥시,15-19세,24844,12928,11916
202102,41390,경기도,시흥시,15-19세,24808,12884,11924
202103,41390,경기도,시흥시,15-19세,24751,12844,11907
202104,41390,경기도,시흥시,15-19세,24642,12796,11846
202105,41390,경기도,시흥시,15-19세,24630,12768,11862
202106,41390,경기도,시흥시,15-19세,24573,12723,11850
202007,41390,경기도,시흥시,20-24세,32620,17334,15286
202008,41390,경기도,시흥시,20-24세,32807,17440,15367
202009,41390,경기도,시흥시,20-24세,33047,17606,15441
202010,41390,경기도,시흥시,20-24세,33056,17596,15460
202011,41390,경기도,시흥시,20-24세,33170,17668,15502
202012,41390,경기도,시흥시,20-24세,33235,17706,15529
202101,41390,경기도,시흥시,20-24세,33353,17768,15585
202102,41390,경기도,시흥시,20-24세,33377,17765,15612
202103,41390,경기도,시흥시,20-24세,33284,17743,15541
202104,41390,경기도,시흥시,20-24세,33260,17699,15561
202105,41390,경기도,시흥시,20-24세,33214,17671,15543
202106,41390,경기도,시흥시,20-24세,33109,17598,15511
202007,41390,경기도,시흥시,25-29세,34772,19190,15582
202008,41390,경기도,시흥시,25-29세,35195,19418,15777
202009,41390,경기도,시흥시,25-29세,35476,19596,15880
202010,41390,경기도,시흥시,25-29세,35743,19741,16002
202011,41390,경기도,시흥시,25-29세,36035,19918,16117
202012,41390,경기도,시흥시,25-29세,36345,20124,16221
202101,41390,경기도,시흥시,25-29세,36506,20190,16316
202102,41390,경기도,시흥시,25-29세,36655,20272,16383
202103,41390,경기도,시흥시,25-29세,36882,20392,16490
202104,41390,경기도,시흥시,25-29세,37038,20474,16564
202105,41390,경기도,시흥시,25-29세,37110,20532,16578
202106,41390,경기도,시흥시,25-29세,37139,20535,16604
202007,41390,경기도,시흥시,30-34세,32583,17552,15031
202008,41390,경기도,시흥시,30-34세,33052,17801,15251
202009,41390,경기도,시흥시,30-34세,33444,17993,15451
202010,41390,경기도,시흥시,30-34세,33626,18062,15564
202011,41390,경기도,시흥시,30-34세,33776,18170,15606
202012,41390,경기도,시흥시,30-34세,34120,18362,15758
202101,41390,경기도,시흥시,30-34세,34461,18513,15948
202102,41390,경기도,시흥시,30-34세,34714,18623,16091
202103,41390,경기도,시흥시,30-34세,34849,18716,16133
202104,41390,경기도,시흥시,30-34세,34927,18747,16180
202105,41390,경기도,시흥시,30-34세,34956,18782,16174
202106,41390,경기도,시흥시,30-34세,35000,18815,16185
202007,41390,경기도,시흥시,35-39세,42135,22548,19587
202008,41390,경기도,시흥시,35-39세,42583,22763,19820
202009,41390,경기도,시흥시,35-39세,42882,22903,19979
202010,41390,경기도,시흥시,35-39세,42891,22923,19968
202011,41390,경기도,시흥시,35-39세,43015,22939,20076
202012,41390,경기도,시흥시,35-39세,43326,23078,20248
202101,41390,경기도,시흥시,35-39세,43751,23251,20500
202102,41390,경기도,시흥시,35-39세,43904,23386,20518
202103,41390,경기도,시흥시,35-39세,43938,23395,20543
202104,41390,경기도,시흥시,35-39세,43842,23362,20480
202105,41390,경기도,시흥시,35-39세,43724,23302,20422
202106,41390,경기도,시흥시,35-39세,43524,23183,20341
202007,41390,경기도,시흥시,40-44세,42382,23017,19365
202008,41390,경기도,시흥시,40-44세,43038,23364,19674
202009,41390,경기도,시흥시,40-44세,43536,23635,19901
202010,41390,경기도,시흥시,40-44세,43904,23851,20053
202011,41390,경기도,시흥시,40-44세,44213,24039,20174
202012,41390,경기도,시흥시,40-44세,44466,24175,20291
202101,41390,경기도,시흥시,40-44세,44976,24487,20489
202102,41390,경기도,시흥시,40-44세,45421,24674,20747
202103,41390,경기도,시흥시,40-44세,45450,24690,20760
202104,41390,경기도,시흥시,40-44세,45637,24781,20856
202105,41390,경기도,시흥시,40-44세,45886,24930,20956
202106,41390,경기도,시흥시,40-44세,46201,25110,21091
202007,41390,경기도,시흥시,45-49세,45620,24136,21484
202008,41390,경기도,시흥시,45-49세,45806,24239,21567
202009,41390,경기도,시흥시,45-49세,45896,24350,21546
202010,41390,경기도,시흥시,45-49세,45949,24394,21555
202011,41390,경기도,시흥시,45-49세,46003,24458,21545
202012,41390,경기도,시흥시,45-49세,46194,24577,21617
202101,41390,경기도,시흥시,45-49세,46449,24721,21728
202102,41390,경기도,시흥시,45-49세,46497,24767,21730
202103,41390,경기도,시흥시,45-49세,46500,24792,21708
202104,41390,경기도,시흥시,45-49세,46496,24830,21666
202105,41390,경기도,시흥시,45-49세,46222,24693,21529
202106,41390,경기도,시흥시,45-49세,46040,24624,21416
202007,41390,경기도,시흥시,50-54세,45389,23645,21744
202008,41390,경기도,시흥시,50-54세,45752,23827,21925
202009,41390,경기도,시흥시,50-54세,46090,23965,22125
202010,41390,경기도,시흥시,50-54세,46323,24047,22276
202011,41390,경기도,시흥시,50-54세,46689,24215,22474
202012,41390,경기도,시흥시,50-54세,46673,24197,22476
202101,41390,경기도,시흥시,50-54세,47044,24382,22662
202102,41390,경기도,시흥시,50-54세,47313,24512,22801
202103,41390,경기도,시흥시,50-54세,47268,24449,22819
202104,41390,경기도,시흥시,50-54세,47382,24484,22898
202105,41390,경기도,시흥시,50-54세,47641,24616,23025
202106,41390,경기도,시흥시,50-54세,47861,24709,23152
202007,41390,경기도,시흥시,55-59세,39698,21571,18127
202008,41390,경기도,시흥시,55-59세,40022,21675,18347
202009,41390,경기도,시흥시,55-59세,40344,21779,18565
202010,41390,경기도,시흥시,55-59세,40568,21871,18697
202011,41390,경기도,시흥시,55-59세,40699,21927,18772
202012,41390,경기도,시흥시,55-59세,40951,22046,18905
202101,41390,경기도,시흥시,55-59세,40975,22037,18938
202102,41390,경기도,시흥시,55-59세,41109,22084,19025
202103,41390,경기도,시흥시,55-59세,41321,22177,19144
202104,41390,경기도,시흥시,55-59세,41330,22168,19162
202105,41390,경기도,시흥시,55-59세,41321,22170,19151
202106,41390,경기도,시흥시,55-59세,41263,22176,19087
202007,41390,경기도,시흥시,60-64세,28207,15186,13021
202008,41390,경기도,시흥시,60-64세,28751,15505,13246
202009,41390,경기도,시흥시,60-64세,29132,15729,13403
202010,41390,경기도,시흥시,60-64세,29575,15987,13588
202011,41390,경기도,시흥시,60-64세,29992,16205,13787
202012,41390,경기도,시흥시,60-64세,30339,16361,13978
202101,41390,경기도,시흥시,60-64세,30854,16649,14205
202102,41390,경기도,시흥시,60-64세,31305,16900,14405
202103,41390,경기도,시흥시,60-64세,31776,17172,14604
202104,41390,경기도,시흥시,60-64세,32084,17346,14738
202105,41390,경기도,시흥시,60-64세,32504,17585,14919
202106,41390,경기도,시흥시,60-64세,32869,17744,15125
202007,41390,경기도,시흥시,65-69세,15581,8059,7522
202008,41390,경기도,시흥시,65-69세,15845,8208,7637
202009,41390,경기도,시흥시,65-69세,16109,8336,7773
202010,41390,경기도,시흥시,65-69세,16380,8473,7907
202011,41390,경기도,시흥시,65-69세,16638,8585,8053
202012,41390,경기도,시흥시,65-69세,16894,8724,8170
202101,41390,경기도,시흥시,65-69세,17187,8860,8327
202102,41390,경기도,시흥시,65-69세,17448,8986,8462
202103,41390,경기도,시흥시,65-69세,17777,9147,8630
202104,41390,경기도,시흥시,65-69세,17997,9263,8734
202105,41390,경기도,시흥시,65-69세,18172,9349,8823
202106,41390,경기도,시흥시,65-69세,18297,9431,8866
202007,41390,경기도,시흥시,70-74세,10500,4997,5503
202008,41390,경기도,시흥시,70-74세,10551,5016,5535
202009,41390,경기도,시흥시,70-74세,10677,5088,5589
202010,41390,경기도,시흥시,70-74세,10812,5147,5665
202011,41390,경기도,시흥시,70-74세,10953,5212,5741
202012,41390,경기도,시흥시,70-74세,11087,5274,5813
202101,41390,경기도,시흥시,70-74세,11223,5358,5865
202102,41390,경기도,시흥시,70-74세,11304,5412,5892
202103,41390,경기도,시흥시,70-74세,11320,5425,5895
202104,41390,경기도,시흥시,70-74세,11378,5452,5926
202105,41390,경기도,시흥시,70-74세,11401,5474,5927
202106,41390,경기도,시흥시,70-74세,11427,5489,5938
202007,41390,경기도,시흥시,75-79세,8319,3490,4829
202008,41390,경기도,시흥시,75-79세,8358,3510,4848
202009,41390,경기도,시흥시,75-79세,8390,3515,4875
202010,41390,경기도,시흥시,75-79세,8418,3531,4887
202011,41390,경기도,시흥시,75-79세,8431,3559,4872
202012,41390,경기도,시흥시,75-79세,8430,3557,4873
202101,41390,경기도,시흥시,75-79세,8416,3552,4864
202102,41390,경기도,시흥시,75-79세,8404,3556,4848
202103,41390,경기도,시흥시,75-79세,8405,3561,4844
202104,41390,경기도,시흥시,75-79세,8403,3566,4837
202105,41390,경기도,시흥시,75-79세,8424,3571,4853
202106,41390,경기도,시흥시,75-79세,8460,3594,4866
202007,41390,경기도,시흥시,80-84세,5768,1992,3776
202008,41390,경기도,시흥시,80-84세,5829,2016,3813
202009,41390,경기도,시흥시,80-84세,5884,2036,3848
202010,41390,경기도,시흥시,80-84세,5925,2056,3869
202011,41390,경기도,시흥시,80-84세,5968,2064,3904
202012,41390,경기도,시흥시,80-84세,5996,2077,3919
202101,41390,경기도,시흥시,80-84세,6041,2098,3943
202102,41390,경기도,시흥시,80-84세,6087,2118,3969
202103,41390,경기도,시흥시,80-84세,6132,2148,3984
202104,41390,경기도,시흥시,80-84세,6177,2177,4000
202105,41390,경기도,시흥시,80-84세,6202,2191,4011
202106,41390,경기도,시흥시,80-84세,6229,2201,4028
202007,41390,경기도,시흥시,85-89세,2749,754,1995
202008,41390,경기도,시흥시,85-89세,2798,766,2032
202009,41390,경기도,시흥시,85-89세,2820,786,2034
202010,41390,경기도,시흥시,85-89세,2846,796,2050
202011,41390,경기도,시흥시,85-89세,2858,806,2052
202012,41390,경기도,시흥시,85-89세,2922,817,2105
202101,41390,경기도,시흥시,85-89세,2954,823,2131
202102,41390,경기도,시흥시,85-89세,2991,829,2162
202103,41390,경기도,시흥시,85-89세,3060,845,2215
202104,41390,경기도,시흥시,85-89세,3092,850,2242
202105,41390,경기도,시흥시,85-89세,3117,858,2259
202106,41390,경기도,시흥시,85-89세,3131,857,2274
202007,41390,경기도,시흥시,90-94세,1010,196,814
202008,41390,경기도,시흥시,90-94세,1027,205,822
202009,41390,경기도,시흥시,90-94세,1050,206,844
202010,41390,경기도,시흥시,90-94세,1063,210,853
202011,41390,경기도,시흥시,90-94세,1088,214,874
202012,41390,경기도,시흥시,90-94세,1106,215,891
202101,41390,경기도,시흥시,90-94세,1128,221,907
202102,41390,경기도,시흥시,90-94세,1140,226,914
202103,41390,경기도,시흥시,90-94세,1167,231,936
202104,41390,경기도,시흥시,90-94세,1176,231,945
202105,41390,경기도,시흥시,90-94세,1171,226,945
202106,41390,경기도,시흥시,90-94세,1175,228,947
202007,41390,경기도,시흥시,95-99세,234,57,177
202008,41390,경기도,시흥시,95-99세,240,57,183
202009,41390,경기도,시흥시,95-99세,250,60,190
202010,41390,경기도,시흥시,95-99세,248,56,192
202011,41390,경기도,시흥시,95-99세,249,55,194
202012,41390,경기도,시흥시,95-99세,251,56,195
202101,41390,경기도,시흥시,95-99세,248,53,195
202102,41390,경기도,시흥시,95-99세,248,52,196
202103,41390,경기도,시흥시,95-99세,250,53,197
202104,41390,경기도,시흥시,95-99세,246,50,196
202105,41390,경기도,시흥시,95-99세,252,51,201
202106,41390,경기도,시흥시,95-99세,253,54,199
202007,41390,경기도,시흥시,100+,96,28,68
202008,41390,경기도,시흥시,100+,97,28,69
202009,41390,경기도,시흥시,100+,95,26,69
202010,41390,경기도,시흥시,100+,98,27,71
202011,41390,경기도,시흥시,100+,99,27,72
202012,41390,경기도,시흥시,100+,96,26,70
202101,41390,경기도,시흥시,100+,97,27,70
202102,41390,경기도,시흥시,100+,102,29,73
202103,41390,경기도,시흥시,100+,103,29,74
202104,41390,경기도,시흥시,100+,103,30,73
202105,41390,경기도,시흥시,100+,105,30,75
202106,41390,경기도,시흥시,100+,105,30,75
202007,41410,경기도,군포시,0-4세,9443,4798,4645
202008,41410,경기도,군포시,0-4세,9321,4729,4592
202009,41410,경기도,군포시,0-4세,9251,4689,4562
202010,41410,경기도,군포시,0-4세,9128,4639,4489
202011,41410,경기도,군포시,0-4세,9014,4583,4431
202012,41410,경기도,군포시,0-4세,8899,4531,4368
202101,41410,경기도,군포시,0-4세,8794,4479,4315
202102,41410,경기도,군포시,0-4세,8628,4398,4230
202103,41410,경기도,군포시,0-4세,8499,4336,4163
202104,41410,경기도,군포시,0-4세,8373,4279,4094
202105,41410,경기도,군포시,0-4세,8298,4246,4052
202106,41410,경기도,군포시,0-4세,8236,4199,4037
202007,41410,경기도,군포시,5-9세,12170,6250,5920
202008,41410,경기도,군포시,5-9세,12082,6216,5866
202009,41410,경기도,군포시,5-9세,11976,6146,5830
202010,41410,경기도,군포시,5-9세,11885,6104,5781
202011,41410,경기도,군포시,5-9세,11778,6037,5741
202012,41410,경기도,군포시,5-9세,11731,6016,5715
202101,41410,경기도,군포시,5-9세,11711,6016,5695
202102,41410,경기도,군포시,5-9세,11567,5925,5642
202103,41410,경기도,군포시,5-9세,11497,5886,5611
202104,41410,경기도,군포시,5-9세,11445,5853,5592
202105,41410,경기도,군포시,5-9세,11399,5822,5577
202106,41410,경기도,군포시,5-9세,11349,5788,5561
202007,41410,경기도,군포시,10-14세,12679,6545,6134
202008,41410,경기도,군포시,10-14세,12672,6545,6127
202009,41410,경기도,군포시,10-14세,12628,6539,6089
202010,41410,경기도,군포시,10-14세,12643,6532,6111
202011,41410,경기도,군포시,10-14세,12658,6564,6094
202012,41410,경기도,군포시,10-14세,12653,6568,6085
202101,41410,경기도,군포시,10-14세,12624,6537,6087
202102,41410,경기도,군포시,10-14세,12541,6517,6024
202103,41410,경기도,군포시,10-14세,12521,6521,6000
202104,41410,경기도,군포시,10-14세,12499,6517,5982
202105,41410,경기도,군포시,10-14세,12468,6505,5963
202106,41410,경기도,군포시,10-14세,12479,6515,5964
202007,41410,경기도,군포시,15-19세,14558,7487,7071
202008,41410,경기도,군포시,15-19세,14425,7403,7022
202009,41410,경기도,군포시,15-19세,14310,7332,6978
202010,41410,경기도,군포시,15-19세,14168,7255,6913
202011,41410,경기도,군포시,15-19세,14094,7207,6887
202012,41410,경기도,군포시,15-19세,14001,7185,6816
202101,41410,경기도,군포시,15-19세,13869,7130,6739
202102,41410,경기도,군포시,15-19세,13749,7054,6695
202103,41410,경기도,군포시,15-19세,13627,6996,6631
202104,41410,경기도,군포시,15-19세,13544,6950,6594
202105,41410,경기도,군포시,15-19세,13485,6942,6543
202106,41410,경기도,군포시,15-19세,13387,6915,6472
202007,41410,경기도,군포시,20-24세,18192,9443,8749
202008,41410,경기도,군포시,20-24세,18093,9378,8715
202009,41410,경기도,군포시,20-24세,18073,9370,8703
202010,41410,경기도,군포시,20-24세,18051,9380,8671
202011,41410,경기도,군포시,20-24세,17967,9335,8632
202012,41410,경기도,군포시,20-24세,17869,9249,8620
202101,41410,경기도,군포시,20-24세,17864,9221,8643
202102,41410,경기도,군포시,20-24세,17710,9157,8553
202103,41410,경기도,군포시,20-24세,17606,9102,8504
202104,41410,경기도,군포시,20-24세,17562,9058,8504
202105,41410,경기도,군포시,20-24세,17560,9038,8522
202106,41410,경기도,군포시,20-24세,17559,9023,8536
202007,41410,경기도,군포시,25-29세,20378,10702,9676
202008,41410,경기도,군포시,25-29세,20382,10744,9638
202009,41410,경기도,군포시,25-29세,20331,10701,9630
202010,41410,경기도,군포시,25-29세,20353,10705,9648
202011,41410,경기도,군포시,25-29세,20363,10702,9661
202012,41410,경기도,군포시,25-29세,20363,10710,9653
202101,41410,경기도,군포시,25-29세,20335,10748,9587
202102,41410,경기도,군포시,25-29세,20275,10716,9559
202103,41410,경기도,군포시,25-29세,20264,10665,9599
202104,41410,경기도,군포시,25-29세,20215,10675,9540
202105,41410,경기도,군포시,25-29세,20151,10629,9522
202106,41410,경기도,군포시,25-29세,20044,10573,9471
202007,41410,경기도,군포시,30-34세,18703,9787,8916
202008,41410,경기도,군포시,30-34세,18680,9789,8891
202009,41410,경기도,군포시,30-34세,18499,9686,8813
202010,41410,경기도,군포시,30-34세,18411,9622,8789
202011,41410,경기도,군포시,30-34세,18372,9593,8779
202012,41410,경기도,군포시,30-34세,18297,9551,8746
202101,41410,경기도,군포시,30-34세,18271,9530,8741
202102,41410,경기도,군포시,30-34세,18206,9492,8714
202103,41410,경기도,군포시,30-34세,18181,9502,8679
202104,41410,경기도,군포시,30-34세,18181,9493,8688
202105,41410,경기도,군포시,30-34세,18252,9552,8700
202106,41410,경기도,군포시,30-34세,18292,9567,8725
202007,41410,경기도,군포시,35-39세,20493,10567,9926
202008,41410,경기도,군포시,35-39세,20402,10528,9874
202009,41410,경기도,군포시,35-39세,20252,10461,9791
202010,41410,경기도,군포시,35-39세,20110,10390,9720
202011,41410,경기도,군포시,35-39세,20022,10348,9674
202012,41410,경기도,군포시,35-39세,19961,10299,9662
202101,41410,경기도,군포시,35-39세,19860,10242,9618
202102,41410,경기도,군포시,35-39세,19647,10130,9517
202103,41410,경기도,군포시,35-39세,19439,10015,9424
202104,41410,경기도,군포시,35-39세,19338,9977,9361
202105,41410,경기도,군포시,35-39세,19178,9884,9294
202106,41410,경기도,군포시,35-39세,19086,9828,9258
202007,41410,경기도,군포시,40-44세,20686,10283,10403
202008,41410,경기도,군포시,40-44세,20638,10242,10396
202009,41410,경기도,군포시,40-44세,20649,10258,10391
202010,41410,경기도,군포시,40-44세,20676,10287,10389
202011,41410,경기도,군포시,40-44세,20675,10294,10381
202012,41410,경기도,군포시,40-44세,20549,10232,10317
202101,41410,경기도,군포시,40-44세,20470,10218,10252
202102,41410,경기도,군포시,40-44세,20397,10183,10214
202103,41410,경기도,군포시,40-44세,20279,10122,10157
202104,41410,경기도,군포시,40-44세,20238,10102,10136
202105,41410,경기도,군포시,40-44세,20274,10134,10140
202106,41410,경기도,군포시,40-44세,20348,10148,10200
202007,41410,경기도,군포시,45-49세,24636,11986,12650
202008,41410,경기도,군포시,45-49세,24472,11929,12543
202009,41410,경기도,군포시,45-49세,24338,11866,12472
202010,41410,경기도,군포시,45-49세,24098,11748,12350
202011,41410,경기도,군포시,45-49세,24028,11715,12313
202012,41410,경기도,군포시,45-49세,23971,11692,12279
202101,41410,경기도,군포시,45-49세,23851,11614,12237
202102,41410,경기도,군포시,45-49세,23665,11534,12131
202103,41410,경기도,군포시,45-49세,23516,11492,12024
202104,41410,경기도,군포시,45-49세,23442,11433,12009
202105,41410,경기도,군포시,45-49세,23246,11346,11900
202106,41410,경기도,군포시,45-49세,23068,11289,11779
202007,41410,경기도,군포시,50-54세,24461,11998,12463
202008,41410,경기도,군포시,50-54세,24491,12010,12481
202009,41410,경기도,군포시,50-54세,24530,12001,12529
202010,41410,경기도,군포시,50-54세,24628,12033,12595
202011,41410,경기도,군포시,50-54세,24556,11998,12558
202012,41410,경기도,군포시,50-54세,24450,11953,12497
202101,41410,경기도,군포시,50-54세,24599,12002,12597
202102,41410,경기도,군포시,50-54세,24576,11975,12601
202103,41410,경기도,군포시,50-54세,24408,11877,12531
202104,41410,경기도,군포시,50-54세,24432,11909,12523
202105,41410,경기도,군포시,50-54세,24508,11922,12586
202106,41410,경기도,군포시,50-54세,24602,11958,12644
202007,41410,경기도,군포시,55-59세,23977,11740,12237
202008,41410,경기도,군포시,55-59세,23904,11677,12227
202009,41410,경기도,군포시,55-59세,23826,11661,12165
202010,41410,경기도,군포시,55-59세,23787,11633,12154
202011,41410,경기도,군포시,55-59세,23761,11609,12152
202012,41410,경기도,군포시,55-59세,23752,11591,12161
202101,41410,경기도,군포시,55-59세,23523,11495,12028
202102,41410,경기도,군포시,55-59세,23473,11488,11985
202103,41410,경기도,군포시,55-59세,23399,11450,11949
202104,41410,경기도,군포시,55-59세,23285,11391,11894
202105,41410,경기도,군포시,55-59세,23125,11334,11791
202106,41410,경기도,군포시,55-59세,22928,11235,11693
202007,41410,경기도,군포시,60-64세,20219,10001,10218
202008,41410,경기도,군포시,60-64세,20345,10088,10257
202009,41410,경기도,군포시,60-64세,20520,10150,10370
202010,41410,경기도,군포시,60-64세,20651,10221,10430
202011,41410,경기도,군포시,60-64세,20812,10297,10515
202012,41410,경기도,군포시,60-64세,20879,10312,10567
202101,41410,경기도,군포시,60-64세,21107,10404,10703
202102,41410,경기도,군포시,60-64세,21250,10468,10782
202103,41410,경기도,군포시,60-64세,21302,10472,10830
202104,41410,경기도,군포시,60-64세,21488,10569,10919
202105,41410,경기도,군포시,60-64세,21650,10618,11032
202106,41410,경기도,군포시,60-64세,21842,10708,11134
202007,41410,경기도,군포시,65-69세,11875,5862,6013
202008,41410,경기도,군포시,65-69세,11970,5901,6069
202009,41410,경기도,군포시,65-69세,12109,5986,6123
202010,41410,경기도,군포시,65-69세,12238,6043,6195
202011,41410,경기도,군포시,65-69세,12341,6081,6260
202012,41410,경기도,군포시,65-69세,12480,6138,6342
202101,41410,경기도,군포시,65-69세,12624,6220,6404
202102,41410,경기도,군포시,65-69세,12740,6261,6479
202103,41410,경기도,군포시,65-69세,12835,6311,6524
202104,41410,경기도,군포시,65-69세,12921,6340,6581
202105,41410,경기도,군포시,65-69세,13043,6392,6651
202106,41410,경기도,군포시,65-69세,13178,6465,6713
202007,41410,경기도,군포시,70-74세,8344,3897,4447
202008,41410,경기도,군포시,70-74세,8377,3907,4470
202009,41410,경기도,군포시,70-74세,8401,3924,4477
202010,41410,경기도,군포시,70-74세,8460,3951,4509
202011,41410,경기도,군포시,70-74세,8502,3969,4533
202012,41410,경기도,군포시,70-74세,8540,4007,4533
202101,41410,경기도,군포시,70-74세,8601,4049,4552
202102,41410,경기도,군포시,70-74세,8596,4050,4546
202103,41410,경기도,군포시,70-74세,8571,4050,4521
202104,41410,경기도,군포시,70-74세,8581,4056,4525
202105,41410,경기도,군포시,70-74세,8592,4073,4519
202106,41410,경기도,군포시,70-74세,8595,4076,4519
202007,41410,경기도,군포시,75-79세,6584,2779,3805
202008,41410,경기도,군포시,75-79세,6614,2796,3818
202009,41410,경기도,군포시,75-79세,6606,2795,3811
202010,41410,경기도,군포시,75-79세,6586,2797,3789
202011,41410,경기도,군포시,75-79세,6580,2792,3788
202012,41410,경기도,군포시,75-79세,6584,2776,3808
202101,41410,경기도,군포시,75-79세,6581,2780,3801
202102,41410,경기도,군포시,75-79세,6576,2774,3802
202103,41410,경기도,군포시,75-79세,6534,2752,3782
202104,41410,경기도,군포시,75-79세,6522,2757,3765
202105,41410,경기도,군포시,75-79세,6514,2754,3760
202106,41410,경기도,군포시,75-79세,6540,2775,3765
202007,41410,경기도,군포시,80-84세,4763,1758,3005
202008,41410,경기도,군포시,80-84세,4777,1758,3019
202009,41410,경기도,군포시,80-84세,4771,1754,3017
202010,41410,경기도,군포시,80-84세,4807,1763,3044
202011,41410,경기도,군포시,80-84세,4827,1769,3058
202012,41410,경기도,군포시,80-84세,4814,1770,3044
202101,41410,경기도,군포시,80-84세,4827,1778,3049
202102,41410,경기도,군포시,80-84세,4852,1800,3052
202103,41410,경기도,군포시,80-84세,4852,1803,3049
202104,41410,경기도,군포시,80-84세,4876,1815,3061
202105,41410,경기도,군포시,80-84세,4909,1829,3080
202106,41410,경기도,군포시,80-84세,4941,1838,3103
202007,41410,경기도,군포시,85-89세,2610,837,1773
202008,41410,경기도,군포시,85-89세,2640,855,1785
202009,41410,경기도,군포시,85-89세,2666,879,1787
202010,41410,경기도,군포시,85-89세,2681,881,1800
202011,41410,경기도,군포시,85-89세,2692,890,1802
202012,41410,경기도,군포시,85-89세,2718,902,1816
202101,41410,경기도,군포시,85-89세,2750,909,1841
202102,41410,경기도,군포시,85-89세,2806,920,1886
202103,41410,경기도,군포시,85-89세,2823,921,1902
202104,41410,경기도,군포시,85-89세,2827,922,1905
202105,41410,경기도,군포시,85-89세,2858,936,1922
202106,41410,경기도,군포시,85-89세,2866,934,1932
202007,41410,경기도,군포시,90-94세,932,261,671
202008,41410,경기도,군포시,90-94세,928,256,672
202009,41410,경기도,군포시,90-94세,949,259,690
202010,41410,경기도,군포시,90-94세,960,272,688
202011,41410,경기도,군포시,90-94세,965,273,692
202012,41410,경기도,군포시,90-94세,980,279,701
202101,41410,경기도,군포시,90-94세,980,279,701
202102,41410,경기도,군포시,90-94세,976,273,703
202103,41410,경기도,군포시,90-94세,974,267,707
202104,41410,경기도,군포시,90-94세,971,266,705
202105,41410,경기도,군포시,90-94세,974,267,707
202106,41410,경기도,군포시,90-94세,979,268,711
202007,41410,경기도,군포시,95-99세,219,50,169
202008,41410,경기도,군포시,95-99세,219,49,170
202009,41410,경기도,군포시,95-99세,223,49,174
202010,41410,경기도,군포시,95-99세,221,49,172
202011,41410,경기도,군포시,95-99세,224,51,173
202012,41410,경기도,군포시,95-99세,222,51,171
202101,41410,경기도,군포시,95-99세,226,54,172
202102,41410,경기도,군포시,95-99세,229,56,173
202103,41410,경기도,군포시,95-99세,224,54,170
202104,41410,경기도,군포시,95-99세,226,55,171
202105,41410,경기도,군포시,95-99세,227,55,172
202106,41410,경기도,군포시,95-99세,221,56,165
202007,41410,경기도,군포시,100+,73,22,51
202008,41410,경기도,군포시,100+,76,23,53
202009,41410,경기도,군포시,100+,77,24,53
202010,41410,경기도,군포시,100+,78,24,54
202011,41410,경기도,군포시,100+,78,23,55
202012,41410,경기도,군포시,100+,78,22,56
202101,41410,경기도,군포시,100+,75,21,54
202102,41410,경기도,군포시,100+,74,21,53
202103,41410,경기도,군포시,100+,41,9,32
202104,41410,경기도,군포시,100+,41,10,31
202105,41410,경기도,군포시,100+,43,10,33
202106,41410,경기도,군포시,100+,44,9,35
202007,41430,경기도,의왕시,0-4세,6031,3183,2848
202008,41430,경기도,의왕시,0-4세,5975,3146,2829
202009,41430,경기도,의왕시,0-4세,5982,3166,2816
202010,41430,경기도,의왕시,0-4세,5951,3140,2811
202011,41430,경기도,의왕시,0-4세,5921,3131,2790
202012,41430,경기도,의왕시,0-4세,5888,3099,2789
202101,41430,경기도,의왕시,0-4세,5818,3062,2756
202102,41430,경기도,의왕시,0-4세,5795,3059,2736
202103,41430,경기도,의왕시,0-4세,5729,3026,2703
202104,41430,경기도,의왕시,0-4세,5679,2998,2681
202105,41430,경기도,의왕시,0-4세,5632,2987,2645
202106,41430,경기도,의왕시,0-4세,5590,2959,2631
202007,41430,경기도,의왕시,5-9세,7337,3756,3581
202008,41430,경기도,의왕시,5-9세,7359,3773,3586
202009,41430,경기도,의왕시,5-9세,7339,3751,3588
202010,41430,경기도,의왕시,5-9세,7330,3751,3579
202011,41430,경기도,의왕시,5-9세,7289,3712,3577
202012,41430,경기도,의왕시,5-9세,7274,3718,3556
202101,41430,경기도,의왕시,5-9세,7198,3687,3511
202102,41430,경기도,의왕시,5-9세,7148,3658,3490
202103,41430,경기도,의왕시,5-9세,7159,3666,3493
202104,41430,경기도,의왕시,5-9세,7170,3664,3506
202105,41430,경기도,의왕시,5-9세,7206,3672,3534
202106,41430,경기도,의왕시,5-9세,7183,3656,3527
202007,41430,경기도,의왕시,10-14세,6886,3559,3327
202008,41430,경기도,의왕시,10-14세,6850,3528,3322
202009,41430,경기도,의왕시,10-14세,6882,3554,3328
202010,41430,경기도,의왕시,10-14세,6917,3573,3344
202011,41430,경기도,의왕시,10-14세,6957,3603,3354
202012,41430,경기도,의왕시,10-14세,6968,3608,3360
202101,41430,경기도,의왕시,10-14세,6990,3614,3376
202102,41430,경기도,의왕시,10-14세,6931,3564,3367
202103,41430,경기도,의왕시,10-14세,6932,3559,3373
202104,41430,경기도,의왕시,10-14세,6923,3551,3372
202105,41430,경기도,의왕시,10-14세,6897,3542,3355
202106,41430,경기도,의왕시,10-14세,6893,3549,3344
202007,41430,경기도,의왕시,15-19세,8013,4121,3892
202008,41430,경기도,의왕시,15-19세,7952,4096,3856
202009,41430,경기도,의왕시,15-19세,7944,4088,3856
202010,41430,경기도,의왕시,15-19세,7839,4021,3818
202011,41430,경기도,의왕시,15-19세,7737,3996,3741
202012,41430,경기도,의왕시,15-19세,7628,3916,3712
202101,41430,경기도,의왕시,15-19세,7571,3892,3679
202102,41430,경기도,의왕시,15-19세,7546,3867,3679
202103,41430,경기도,의왕시,15-19세,7461,3839,3622
202104,41430,경기도,의왕시,15-19세,7362,3794,3568
202105,41430,경기도,의왕시,15-19세,7325,3762,3563
202106,41430,경기도,의왕시,15-19세,7312,3748,3564
202007,41430,경기도,의왕시,20-24세,11208,5795,5413
202008,41430,경기도,의왕시,20-24세,11180,5788,5392
202009,41430,경기도,의왕시,20-24세,11213,5774,5439
202010,41430,경기도,의왕시,20-24세,11199,5778,5421
202011,41430,경기도,의왕시,20-24세,11221,5770,5451
202012,41430,경기도,의왕시,20-24세,11223,5758,5465
202101,41430,경기도,의왕시,20-24세,11187,5748,5439
202102,41430,경기도,의왕시,20-24세,11119,5724,5395
202103,41430,경기도,의왕시,20-24세,11035,5681,5354
202104,41430,경기도,의왕시,20-24세,11037,5669,5368
202105,41430,경기도,의왕시,20-24세,10979,5646,5333
202106,41430,경기도,의왕시,20-24세,10979,5644,5335
202007,41430,경기도,의왕시,25-29세,11754,6337,5417
202008,41430,경기도,의왕시,25-29세,11765,6332,5433
202009,41430,경기도,의왕시,25-29세,12162,6532,5630
202010,41430,경기도,의왕시,25-29세,12267,6570,5697
202011,41430,경기도,의왕시,25-29세,12298,6578,5720
202012,41430,경기도,의왕시,25-29세,12309,6605,5704
202101,41430,경기도,의왕시,25-29세,12269,6584,5685
202102,41430,경기도,의왕시,25-29세,12181,6551,5630
202103,41430,경기도,의왕시,25-29세,12152,6535,5617
202104,41430,경기도,의왕시,25-29세,12111,6520,5591
202105,41430,경기도,의왕시,25-29세,12111,6503,5608
202106,41430,경기도,의왕시,25-29세,12084,6484,5600
202007,41430,경기도,의왕시,30-34세,10531,5406,5125
202008,41430,경기도,의왕시,30-34세,10492,5384,5108
202009,41430,경기도,의왕시,30-34세,10792,5554,5238
202010,41430,경기도,의왕시,30-34세,10855,5571,5284
202011,41430,경기도,의왕시,30-34세,10883,5594,5289
202012,41430,경기도,의왕시,30-34세,10845,5585,5260
202101,41430,경기도,의왕시,30-34세,10873,5598,5275
202102,41430,경기도,의왕시,30-34세,10866,5598,5268
202103,41430,경기도,의왕시,30-34세,10885,5603,5282
202104,41430,경기도,의왕시,30-34세,10875,5603,5272
202105,41430,경기도,의왕시,30-34세,10924,5632,5292
202106,41430,경기도,의왕시,30-34세,10936,5638,5298
202007,41430,경기도,의왕시,35-39세,12044,6157,5887
202008,41430,경기도,의왕시,35-39세,11993,6130,5863
202009,41430,경기도,의왕시,35-39세,12075,6191,5884
202010,41430,경기도,의왕시,35-39세,12127,6224,5903
202011,41430,경기도,의왕시,35-39세,12078,6182,5896
202012,41430,경기도,의왕시,35-39세,12077,6200,5877
202101,41430,경기도,의왕시,35-39세,11953,6155,5798
202102,41430,경기도,의왕시,35-39세,11843,6095,5748
202103,41430,경기도,의왕시,35-39세,11759,6072,5687
202104,41430,경기도,의왕시,35-39세,11696,6039,5657
202105,41430,경기도,의왕시,35-39세,11640,6010,5630
202106,41430,경기도,의왕시,35-39세,11594,5972,5622
202007,41430,경기도,의왕시,40-44세,11356,5771,5585
202008,41430,경기도,의왕시,40-44세,11363,5777,5586
202009,41430,경기도,의왕시,40-44세,11397,5781,5616
202010,41430,경기도,의왕시,40-44세,11472,5832,5640
202011,41430,경기도,의왕시,40-44세,11530,5856,5674
202012,41430,경기도,의왕시,40-44세,11497,5835,5662
202101,41430,경기도,의왕시,40-44세,11520,5837,5683
202102,41430,경기도,의왕시,40-44세,11506,5820,5686
202103,41430,경기도,의왕시,40-44세,11408,5786,5622
202104,41430,경기도,의왕시,40-44세,11389,5791,5598
202105,41430,경기도,의왕시,40-44세,11418,5796,5622
202106,41430,경기도,의왕시,40-44세,11439,5817,5622
202007,41430,경기도,의왕시,45-49세,13570,6482,7088
202008,41430,경기도,의왕시,45-49세,13447,6428,7019
202009,41430,경기도,의왕시,45-49세,13382,6431,6951
202010,41430,경기도,의왕시,45-49세,13271,6386,6885
202011,41430,경기도,의왕시,45-49세,13158,6340,6818
202012,41430,경기도,의왕시,45-49세,13119,6317,6802
202101,41430,경기도,의왕시,45-49세,13067,6291,6776
202102,41430,경기도,의왕시,45-49세,12963,6242,6721
202103,41430,경기도,의왕시,45-49세,12833,6212,6621
202104,41430,경기도,의왕시,45-49세,12795,6200,6595
202105,41430,경기도,의왕시,45-49세,12691,6159,6532
202106,41430,경기도,의왕시,45-49세,12652,6142,6510
202007,41430,경기도,의왕시,50-54세,14674,7070,7604
202008,41430,경기도,의왕시,50-54세,14675,7049,7626
202009,41430,경기도,의왕시,50-54세,14663,7000,7663
202010,41430,경기도,의왕시,50-54세,14657,6979,7678
202011,41430,경기도,의왕시,50-54세,14707,7011,7696
202012,41430,경기도,의왕시,50-54세,14642,6966,7676
202101,41430,경기도,의왕시,50-54세,14655,6981,7674
202102,41430,경기도,의왕시,50-54세,14636,6974,7662
202103,41430,경기도,의왕시,50-54세,14584,6928,7656
202104,41430,경기도,의왕시,50-54세,14588,6909,7679
202105,41430,경기도,의왕시,50-54세,14662,6936,7726
202106,41430,경기도,의왕시,50-54세,14682,6951,7731
202007,41430,경기도,의왕시,55-59세,14964,7284,7680
202008,41430,경기도,의왕시,55-59세,14910,7259,7651
202009,41430,경기도,의왕시,55-59세,14870,7261,7609
202010,41430,경기도,의왕시,55-59세,14864,7258,7606
202011,41430,경기도,의왕시,55-59세,14819,7212,7607
202012,41430,경기도,의왕시,55-59세,14813,7208,7605
202101,41430,경기도,의왕시,55-59세,14734,7164,7570
202102,41430,경기도,의왕시,55-59세,14700,7158,7542
202103,41430,경기도,의왕시,55-59세,14593,7122,7471
202104,41430,경기도,의왕시,55-59세,14517,7083,7434
202105,41430,경기도,의왕시,55-59세,14456,7055,7401
202106,41430,경기도,의왕시,55-59세,14342,7002,7340
202007,41430,경기도,의왕시,60-64세,12895,6428,6467
202008,41430,경기도,의왕시,60-64세,12947,6444,6503
202009,41430,경기도,의왕시,60-64세,13058,6502,6556
202010,41430,경기도,의왕시,60-64세,13121,6525,6596
202011,41430,경기도,의왕시,60-64세,13209,6563,6646
202012,41430,경기도,의왕시,60-64세,13232,6579,6653
202101,41430,경기도,의왕시,60-64세,13329,6622,6707
202102,41430,경기도,의왕시,60-64세,13411,6646,6765
202103,41430,경기도,의왕시,60-64세,13409,6626,6783
202104,41430,경기도,의왕시,60-64세,13513,6673,6840
202105,41430,경기도,의왕시,60-64세,13629,6744,6885
202106,41430,경기도,의왕시,60-64세,13735,6780,6955
202007,41430,경기도,의왕시,65-69세,7866,4006,3860
202008,41430,경기도,의왕시,65-69세,7935,4054,3881
202009,41430,경기도,의왕시,65-69세,8041,4106,3935
202010,41430,경기도,의왕시,65-69세,8107,4155,3952
202011,41430,경기도,의왕시,65-69세,8132,4156,3976
202012,41430,경기도,의왕시,65-69세,8187,4167,4020
202101,41430,경기도,의왕시,65-69세,8281,4215,4066
202102,41430,경기도,의왕시,65-69세,8359,4244,4115
202103,41430,경기도,의왕시,65-69세,8399,4257,4142
202104,41430,경기도,의왕시,65-69세,8472,4292,4180
202105,41430,경기도,의왕시,65-69세,8543,4316,4227
202106,41430,경기도,의왕시,65-69세,8634,4360,4274
202007,41430,경기도,의왕시,70-74세,5164,2527,2637
202008,41430,경기도,의왕시,70-74세,5154,2511,2643
202009,41430,경기도,의왕시,70-74세,5143,2505,2638
202010,41430,경기도,의왕시,70-74세,5197,2527,2670
202011,41430,경기도,의왕시,70-74세,5252,2555,2697
202012,41430,경기도,의왕시,70-74세,5304,2584,2720
202101,41430,경기도,의왕시,70-74세,5340,2595,2745
202102,41430,경기도,의왕시,70-74세,5360,2616,2744
202103,41430,경기도,의왕시,70-74세,5326,2596,2730
202104,41430,경기도,의왕시,70-74세,5310,2587,2723
202105,41430,경기도,의왕시,70-74세,5309,2594,2715
202106,41430,경기도,의왕시,70-74세,5300,2585,2715
202007,41430,경기도,의왕시,75-79세,3870,1711,2159
202008,41430,경기도,의왕시,75-79세,3864,1715,2149
202009,41430,경기도,의왕시,75-79세,3847,1706,2141
202010,41430,경기도,의왕시,75-79세,3826,1693,2133
202011,41430,경기도,의왕시,75-79세,3809,1695,2114
202012,41430,경기도,의왕시,75-79세,3793,1685,2108
202101,41430,경기도,의왕시,75-79세,3779,1689,2090
202102,41430,경기도,의왕시,75-79세,3795,1700,2095
202103,41430,경기도,의왕시,75-79세,3783,1691,2092
202104,41430,경기도,의왕시,75-79세,3772,1693,2079
202105,41430,경기도,의왕시,75-79세,3770,1693,2077
202106,41430,경기도,의왕시,75-79세,3791,1706,2085
202007,41430,경기도,의왕시,80-84세,2660,994,1666
202008,41430,경기도,의왕시,80-84세,2654,996,1658
202009,41430,경기도,의왕시,80-84세,2668,1000,1668
202010,41430,경기도,의왕시,80-84세,2687,1011,1676
202011,41430,경기도,의왕시,80-84세,2700,1013,1687
202012,41430,경기도,의왕시,80-84세,2712,1024,1688
202101,41430,경기도,의왕시,80-84세,2725,1031,1694
202102,41430,경기도,의왕시,80-84세,2743,1043,1700
202103,41430,경기도,의왕시,80-84세,2726,1034,1692
202104,41430,경기도,의왕시,80-84세,2741,1042,1699
202105,41430,경기도,의왕시,80-84세,2762,1058,1704
202106,41430,경기도,의왕시,80-84세,2786,1069,1717
202007,41430,경기도,의왕시,85-89세,1476,416,1060
202008,41430,경기도,의왕시,85-89세,1476,423,1053
202009,41430,경기도,의왕시,85-89세,1489,429,1060
202010,41430,경기도,의왕시,85-89세,1509,439,1070
202011,41430,경기도,의왕시,85-89세,1518,445,1073
202012,41430,경기도,의왕시,85-89세,1514,442,1072
202101,41430,경기도,의왕시,85-89세,1510,433,1077
202102,41430,경기도,의왕시,85-89세,1517,435,1082
202103,41430,경기도,의왕시,85-89세,1517,439,1078
202104,41430,경기도,의왕시,85-89세,1523,438,1085
202105,41430,경기도,의왕시,85-89세,1526,434,1092
202106,41430,경기도,의왕시,85-89세,1526,435,1091
202007,41430,경기도,의왕시,90-94세,554,131,423
202008,41430,경기도,의왕시,90-94세,565,132,433
202009,41430,경기도,의왕시,90-94세,575,131,444
202010,41430,경기도,의왕시,90-94세,572,130,442
202011,41430,경기도,의왕시,90-94세,574,132,442
202012,41430,경기도,의왕시,90-94세,583,135,448
202101,41430,경기도,의왕시,90-94세,597,140,457
202102,41430,경기도,의왕시,90-94세,597,140,457
202103,41430,경기도,의왕시,90-94세,591,136,455
202104,41430,경기도,의왕시,90-94세,590,137,453
202105,41430,경기도,의왕시,90-94세,593,140,453
202106,41430,경기도,의왕시,90-94세,594,142,452
202007,41430,경기도,의왕시,95-99세,144,26,118
202008,41430,경기도,의왕시,95-99세,143,26,117
202009,41430,경기도,의왕시,95-99세,147,28,119
202010,41430,경기도,의왕시,95-99세,143,27,116
202011,41430,경기도,의왕시,95-99세,138,27,111
202012,41430,경기도,의왕시,95-99세,139,26,113
202101,41430,경기도,의왕시,95-99세,142,28,114
202102,41430,경기도,의왕시,95-99세,144,28,116
202103,41430,경기도,의왕시,95-99세,138,28,110
202104,41430,경기도,의왕시,95-99세,139,28,111
202105,41430,경기도,의왕시,95-99세,144,28,116
202106,41430,경기도,의왕시,95-99세,142,25,117
202007,41430,경기도,의왕시,100+,52,15,37
202008,41430,경기도,의왕시,100+,52,15,37
202009,41430,경기도,의왕시,100+,51,14,37
202010,41430,경기도,의왕시,100+,49,13,36
202011,41430,경기도,의왕시,100+,48,13,35
202012,41430,경기도,의왕시,100+,48,13,35
202101,41430,경기도,의왕시,100+,47,13,34
202102,41430,경기도,의왕시,100+,48,13,35
202103,41430,경기도,의왕시,100+,24,3,21
202104,41430,경기도,의왕시,100+,25,3,22
202105,41430,경기도,의왕시,100+,22,3,19
202106,41430,경기도,의왕시,100+,21,3,18
202007,41450,경기도,하남시,0-4세,13597,7020,6577
202008,41450,경기도,하남시,0-4세,13419,6918,6501
202009,41450,경기도,하남시,0-4세,13339,6869,6470
202010,41450,경기도,하남시,0-4세,13226,6813,6413
202011,41450,경기도,하남시,0-4세,13250,6849,6401
202012,41450,경기도,하남시,0-4세,13270,6873,6397
202101,41450,경기도,하남시,0-4세,13164,6811,6353
202102,41450,경기도,하남시,0-4세,13129,6793,6336
202103,41450,경기도,하남시,0-4세,13145,6800,6345
202104,41450,경기도,하남시,0-4세,13100,6784,6316
202105,41450,경기도,하남시,0-4세,13068,6770,6298
202106,41450,경기도,하남시,0-4세,13163,6820,6343
202007,41450,경기도,하남시,5-9세,16630,8404,8226
202008,41450,경기도,하남시,5-9세,16712,8442,8270
202009,41450,경기도,하남시,5-9세,16791,8504,8287
202010,41450,경기도,하남시,5-9세,16739,8494,8245
202011,41450,경기도,하남시,5-9세,16818,8535,8283
202012,41450,경기도,하남시,5-9세,16924,8565,8359
202101,41450,경기도,하남시,5-9세,17000,8626,8374
202102,41450,경기도,하남시,5-9세,17211,8753,8458
202103,41450,경기도,하남시,5-9세,17394,8858,8536
202104,41450,경기도,하남시,5-9세,17450,8881,8569
202105,41450,경기도,하남시,5-9세,17417,8860,8557
202106,41450,경기도,하남시,5-9세,17718,9010,8708
202007,41450,경기도,하남시,10-14세,13051,6692,6359
202008,41450,경기도,하남시,10-14세,13112,6726,6386
202009,41450,경기도,하남시,10-14세,13219,6757,6462
202010,41450,경기도,하남시,10-14세,13365,6824,6541
202011,41450,경기도,하남시,10-14세,13535,6914,6621
202012,41450,경기도,하남시,10-14세,13735,7009,6726
202101,41450,경기도,하남시,10-14세,13926,7085,6841
202102,41450,경기도,하남시,10-14세,14173,7183,6990
202103,41450,경기도,하남시,10-14세,14346,7251,7095
202104,41450,경기도,하남시,10-14세,14470,7318,7152
202105,41450,경기도,하남시,10-14세,14600,7390,7210
202106,41450,경기도,하남시,10-14세,14816,7497,7319
202007,41450,경기도,하남시,15-19세,11334,5759,5575
202008,41450,경기도,하남시,15-19세,11306,5751,5555
202009,41450,경기도,하남시,15-19세,11281,5740,5541
202010,41450,경기도,하남시,15-19세,11314,5760,5554
202011,41450,경기도,하남시,15-19세,11322,5775,5547
202012,41450,경기도,하남시,15-19세,11404,5826,5578
202101,41450,경기도,하남시,15-19세,11452,5848,5604
202102,41450,경기도,하남시,15-19세,11579,5907,5672
202103,41450,경기도,하남시,15-19세,11654,5947,5707
202104,41450,경기도,하남시,15-19세,11713,5945,5768
202105,41450,경기도,하남시,15-19세,11707,5927,5780
202106,41450,경기도,하남시,15-19세,11851,6016,5835
202007,41450,경기도,하남시,20-24세,15009,7681,7328
202008,41450,경기도,하남시,20-24세,15089,7719,7370
202009,41450,경기도,하남시,20-24세,15154,7718,7436
202010,41450,경기도,하남시,20-24세,15167,7701,7466
202011,41450,경기도,하남시,20-24세,15275,7745,7530
202012,41450,경기도,하남시,20-24세,15407,7825,7582
202101,41450,경기도,하남시,20-24세,15499,7857,7642
202102,41450,경기도,하남시,20-24세,15591,7894,7697
202103,41450,경기도,하남시,20-24세,15766,7968,7798
202104,41450,경기도,하남시,20-24세,15872,8043,7829
202105,41450,경기도,하남시,20-24세,15902,8043,7859
202106,41450,경기도,하남시,20-24세,16038,8121,7917
202007,41450,경기도,하남시,25-29세,19327,9956,9371
202008,41450,경기도,하남시,25-29세,19602,10057,9545
202009,41450,경기도,하남시,25-29세,19929,10229,9700
202010,41450,경기도,하남시,25-29세,20337,10396,9941
202011,41450,경기도,하남시,25-29세,20686,10570,10116
202012,41450,경기도,하남시,25-29세,21000,10710,10290
202101,41450,경기도,하남시,25-29세,21133,10776,10357
202102,41450,경기도,하남시,25-29세,21391,10871,10520
202103,41450,경기도,하남시,25-29세,21574,10965,10609
202104,41450,경기도,하남시,25-29세,21667,10972,10695
202105,41450,경기도,하남시,25-29세,21633,10949,10684
202106,41450,경기도,하남시,25-29세,21818,11016,10802
202007,41450,경기도,하남시,30-34세,20819,10543,10276
202008,41450,경기도,하남시,30-34세,21042,10676,10366
202009,41450,경기도,하남시,30-34세,21300,10793,10507
202010,41450,경기도,하남시,30-34세,21381,10890,10491
202011,41450,경기도,하남시,30-34세,21587,11003,10584
202012,41450,경기도,하남시,30-34세,21783,11103,10680
202101,41450,경기도,하남시,30-34세,21887,11149,10738
202102,41450,경기도,하남시,30-34세,22110,11282,10828
202103,41450,경기도,하남시,30-34세,22409,11392,11017
202104,41450,경기도,하남시,30-34세,22524,11431,11093
202105,41450,경기도,하남시,30-34세,22632,11504,11128
202106,41450,경기도,하남시,30-34세,22901,11605,11296
202007,41450,경기도,하남시,35-39세,27957,14090,13867
202008,41450,경기도,하남시,35-39세,27943,14077,13866
202009,41450,경기도,하남시,35-39세,28065,14156,13909
202010,41450,경기도,하남시,35-39세,28086,14167,13919
202011,41450,경기도,하남시,35-39세,28157,14213,13944
202012,41450,경기도,하남시,35-39세,28326,14303,14023
202101,41450,경기도,하남시,35-39세,28284,14288,13996
202102,41450,경기도,하남시,35-39세,28400,14333,14067
202103,41450,경기도,하남시,35-39세,28429,14357,14072
202104,41450,경기도,하남시,35-39세,28418,14363,14055
202105,41450,경기도,하남시,35-39세,28306,14323,13983
202106,41450,경기도,하남시,35-39세,28415,14365,14050
202007,41450,경기도,하남시,40-44세,26436,13790,12646
202008,41450,경기도,하남시,40-44세,26611,13894,12717
202009,41450,경기도,하남시,40-44세,26839,14026,12813
202010,41450,경기도,하남시,40-44세,27056,14151,12905
202011,41450,경기도,하남시,40-44세,27346,14271,13075
202012,41450,경기도,하남시,40-44세,27529,14368,13161
202101,41450,경기도,하남시,40-44세,27803,14467,13336
202102,41450,경기도,하남시,40-44세,28238,14685,13553
202103,41450,경기도,하남시,40-44세,28507,14823,13684
202104,41450,경기도,하남시,40-44세,28687,14878,13809
202105,41450,경기도,하남시,40-44세,28951,14991,13960
202106,41450,경기도,하남시,40-44세,29417,15198,14219
202007,41450,경기도,하남시,45-49세,23390,12411,10979
202008,41450,경기도,하남시,45-49세,23434,12438,10996
202009,41450,경기도,하남시,45-49세,23511,12481,11030
202010,41450,경기도,하남시,45-49세,23597,12501,11096
202011,41450,경기도,하남시,45-49세,23707,12549,11158
202012,41450,경기도,하남시,45-49세,23894,12631,11263
202101,41450,경기도,하남시,45-49세,24109,12750,11359
202102,41450,경기도,하남시,45-49세,24386,12901,11485
202103,41450,경기도,하남시,45-49세,24506,12956,11550
202104,41450,경기도,하남시,45-49세,24697,13066,11631
202105,41450,경기도,하남시,45-49세,24618,13029,11589
202106,41450,경기도,하남시,45-49세,24851,13148,11703
202007,41450,경기도,하남시,50-54세,20520,10317,10203
202008,41450,경기도,하남시,50-54세,20644,10370,10274
202009,41450,경기도,하남시,50-54세,20725,10402,10323
202010,41450,경기도,하남시,50-54세,20884,10487,10397
202011,41450,경기도,하남시,50-54세,21051,10556,10495
202012,41450,경기도,하남시,50-54세,21204,10631,10573
202101,41450,경기도,하남시,50-54세,21404,10736,10668
202102,41450,경기도,하남시,50-54세,21662,10876,10786
202103,41450,경기도,하남시,50-54세,21933,11010,10923
202104,41450,경기도,하남시,50-54세,22144,11141,11003
202105,41450,경기도,하남시,50-54세,22376,11242,11134
202106,41450,경기도,하남시,50-54세,22755,11439,11316
202007,41450,경기도,하남시,55-59세,20665,10059,10606
202008,41450,경기도,하남시,55-59세,20608,10035,10573
202009,41450,경기도,하남시,55-59세,20635,10073,10562
202010,41450,경기도,하남시,55-59세,20633,10099,10534
202011,41450,경기도,하남시,55-59세,20726,10190,10536
202012,41450,경기도,하남시,55-59세,20864,10266,10598
202101,41450,경기도,하남시,55-59세,20850,10288,10562
202102,41450,경기도,하남시,55-59세,20903,10314,10589
202103,41450,경기도,하남시,55-59세,20942,10361,10581
202104,41450,경기도,하남시,55-59세,21038,10413,10625
202105,41450,경기도,하남시,55-59세,20984,10408,10576
202106,41450,경기도,하남시,55-59세,21034,10458,10576
202007,41450,경기도,하남시,60-64세,19859,9592,10267
202008,41450,경기도,하남시,60-64세,19971,9660,10311
202009,41450,경기도,하남시,60-64세,20117,9730,10387
202010,41450,경기도,하남시,60-64세,20219,9762,10457
202011,41450,경기도,하남시,60-64세,20358,9828,10530
202012,41450,경기도,하남시,60-64세,20539,9904,10635
202101,41450,경기도,하남시,60-64세,20696,9974,10722
202102,41450,경기도,하남시,60-64세,20955,10113,10842
202103,41450,경기도,하남시,60-64세,21151,10229,10922
202104,41450,경기도,하남시,60-64세,21297,10278,11019
202105,41450,경기도,하남시,60-64세,21463,10353,11110
202106,41450,경기도,하남시,60-64세,21750,10483,11267
202007,41450,경기도,하남시,65-69세,13702,6699,7003
202008,41450,경기도,하남시,65-69세,13865,6767,7098
202009,41450,경기도,하남시,65-69세,14069,6867,7202
202010,41450,경기도,하남시,65-69세,14301,6962,7339
202011,41450,경기도,하남시,65-69세,14447,7007,7440
202012,41450,경기도,하남시,65-69세,14566,7056,7510
202101,41450,경기도,하남시,65-69세,14711,7140,7571
202102,41450,경기도,하남시,65-69세,14835,7165,7670
202103,41450,경기도,하남시,65-69세,15004,7234,7770
202104,41450,경기도,하남시,65-69세,15212,7349,7863
202105,41450,경기도,하남시,65-69세,15328,7425,7903
202106,41450,경기도,하남시,65-69세,15490,7499,7991
202007,41450,경기도,하남시,70-74세,9519,4879,4640
202008,41450,경기도,하남시,70-74세,9583,4908,4675
202009,41450,경기도,하남시,70-74세,9668,4943,4725
202010,41450,경기도,하남시,70-74세,9745,4999,4746
202011,41450,경기도,하남시,70-74세,9847,5049,4798
202012,41450,경기도,하남시,70-74세,9961,5111,4850
202101,41450,경기도,하남시,70-74세,10087,5165,4922
202102,41450,경기도,하남시,70-74세,10224,5233,4991
202103,41450,경기도,하남시,70-74세,10248,5243,5005
202104,41450,경기도,하남시,70-74세,10259,5242,5017
202105,41450,경기도,하남시,70-74세,10332,5267,5065
202106,41450,경기도,하남시,70-74세,10393,5311,5082
202007,41450,경기도,하남시,75-79세,6075,2885,3190
202008,41450,경기도,하남시,75-79세,6092,2901,3191
202009,41450,경기도,하남시,75-79세,6117,2918,3199
202010,41450,경기도,하남시,75-79세,6143,2918,3225
202011,41450,경기도,하남시,75-79세,6193,2939,3254
202012,41450,경기도,하남시,75-79세,6217,2965,3252
202101,41450,경기도,하남시,75-79세,6232,2963,3269
202102,41450,경기도,하남시,75-79세,6235,2963,3272
202103,41450,경기도,하남시,75-79세,6230,2976,3254
202104,41450,경기도,하남시,75-79세,6252,2996,3256
202105,41450,경기도,하남시,75-79세,6303,3026,3277
202106,41450,경기도,하남시,75-79세,6359,3043,3316
202007,41450,경기도,하남시,80-84세,3672,1461,2211
202008,41450,경기도,하남시,80-84세,3695,1473,2222
202009,41450,경기도,하남시,80-84세,3693,1460,2233
202010,41450,경기도,하남시,80-84세,3712,1472,2240
202011,41450,경기도,하남시,80-84세,3730,1478,2252
202012,41450,경기도,하남시,80-84세,3750,1481,2269
202101,41450,경기도,하남시,80-84세,3772,1505,2267
202102,41450,경기도,하남시,80-84세,3836,1516,2320
202103,41450,경기도,하남시,80-84세,3862,1509,2353
202104,41450,경기도,하남시,80-84세,3887,1522,2365
202105,41450,경기도,하남시,80-84세,3928,1544,2384
202106,41450,경기도,하남시,80-84세,3973,1560,2413
202007,41450,경기도,하남시,85-89세,1857,489,1368
202008,41450,경기도,하남시,85-89세,1878,498,1380
202009,41450,경기도,하남시,85-89세,1892,513,1379
202010,41450,경기도,하남시,85-89세,1906,520,1386
202011,41450,경기도,하남시,85-89세,1928,532,1396
202012,41450,경기도,하남시,85-89세,1957,543,1414
202101,41450,경기도,하남시,85-89세,1981,543,1438
202102,41450,경기도,하남시,85-89세,2000,552,1448
202103,41450,경기도,하남시,85-89세,1994,553,1441
202104,41450,경기도,하남시,85-89세,2018,565,1453
202105,41450,경기도,하남시,85-89세,2033,579,1454
202106,41450,경기도,하남시,85-89세,2060,594,1466
202007,41450,경기도,하남시,90-94세,764,157,607
202008,41450,경기도,하남시,90-94세,755,158,597
202009,41450,경기도,하남시,90-94세,774,167,607
202010,41450,경기도,하남시,90-94세,779,167,612
202011,41450,경기도,하남시,90-94세,784,169,615
202012,41450,경기도,하남시,90-94세,789,170,619
202101,41450,경기도,하남시,90-94세,798,172,626
202102,41450,경기도,하남시,90-94세,808,176,632
202103,41450,경기도,하남시,90-94세,816,177,639
202104,41450,경기도,하남시,90-94세,822,177,645
202105,41450,경기도,하남시,90-94세,826,181,645
202106,41450,경기도,하남시,90-94세,833,180,653
202007,41450,경기도,하남시,95-99세,200,54,146
202008,41450,경기도,하남시,95-99세,209,55,154
202009,41450,경기도,하남시,95-99세,212,55,157
202010,41450,경기도,하남시,95-99세,209,52,157
202011,41450,경기도,하남시,95-99세,205,51,154
202012,41450,경기도,하남시,95-99세,209,51,158
202101,41450,경기도,하남시,95-99세,211,52,159
202102,41450,경기도,하남시,95-99세,221,55,166
202103,41450,경기도,하남시,95-99세,215,54,161
202104,41450,경기도,하남시,95-99세,214,51,163
202105,41450,경기도,하남시,95-99세,214,49,165
202106,41450,경기도,하남시,95-99세,213,50,163
202007,41450,경기도,하남시,100+,124,35,89
202008,41450,경기도,하남시,100+,123,32,91
202009,41450,경기도,하남시,100+,122,32,90
202010,41450,경기도,하남시,100+,123,32,91
202011,41450,경기도,하남시,100+,123,32,91
202012,41450,경기도,하남시,100+,124,33,91
202101,41450,경기도,하남시,100+,123,34,89
202102,41450,경기도,하남시,100+,118,30,88
202103,41450,경기도,하남시,100+,62,15,47
202104,41450,경기도,하남시,100+,60,14,46
202105,41450,경기도,하남시,100+,60,14,46
202106,41450,경기도,하남시,100+,60,14,46
202007,41461,경기도,용인시 처인구,0-4세,9221,4723,4498
202008,41461,경기도,용인시 처인구,0-4세,9119,4651,4468
202009,41461,경기도,용인시 처인구,0-4세,9054,4628,4426
202010,41461,경기도,용인시 처인구,0-4세,8992,4595,4397
202011,41461,경기도,용인시 처인구,0-4세,8961,4589,4372
202012,41461,경기도,용인시 처인구,0-4세,8917,4574,4343
202101,41461,경기도,용인시 처인구,0-4세,8818,4533,4285
202102,41461,경기도,용인시 처인구,0-4세,8743,4490,4253
202103,41461,경기도,용인시 처인구,0-4세,8681,4467,4214
202104,41461,경기도,용인시 처인구,0-4세,8615,4424,4191
202105,41461,경기도,용인시 처인구,0-4세,8562,4399,4163
202106,41461,경기도,용인시 처인구,0-4세,8509,4376,4133
202007,41461,경기도,용인시 처인구,5-9세,12433,6335,6098
202008,41461,경기도,용인시 처인구,5-9세,12400,6317,6083
202009,41461,경기도,용인시 처인구,5-9세,12351,6283,6068
202010,41461,경기도,용인시 처인구,5-9세,12364,6297,6067
202011,41461,경기도,용인시 처인구,5-9세,12310,6271,6039
202012,41461,경기도,용인시 처인구,5-9세,12305,6260,6045
202101,41461,경기도,용인시 처인구,5-9세,12262,6243,6019
202102,41461,경기도,용인시 처인구,5-9세,12262,6240,6022
202103,41461,경기도,용인시 처인구,5-9세,12286,6230,6056
202104,41461,경기도,용인시 처인구,5-9세,12252,6225,6027
202105,41461,경기도,용인시 처인구,5-9세,12247,6215,6032
202106,41461,경기도,용인시 처인구,5-9세,12201,6188,6013
202007,41461,경기도,용인시 처인구,10-14세,12191,6299,5892
202008,41461,경기도,용인시 처인구,10-14세,12205,6312,5893
202009,41461,경기도,용인시 처인구,10-14세,12258,6345,5913
202010,41461,경기도,용인시 처인구,10-14세,12256,6336,5920
202011,41461,경기도,용인시 처인구,10-14세,12319,6359,5960
202012,41461,경기도,용인시 처인구,10-14세,12366,6400,5966
202101,41461,경기도,용인시 처인구,10-14세,12452,6432,6020
202102,41461,경기도,용인시 처인구,10-14세,12458,6423,6035
202103,41461,경기도,용인시 처인구,10-14세,12483,6426,6057
202104,41461,경기도,용인시 처인구,10-14세,12514,6437,6077
202105,41461,경기도,용인시 처인구,10-14세,12527,6435,6092
202106,41461,경기도,용인시 처인구,10-14세,12543,6442,6101
202007,41461,경기도,용인시 처인구,15-19세,14749,8045,6704
202008,41461,경기도,용인시 처인구,15-19세,15005,8203,6802
202009,41461,경기도,용인시 처인구,15-19세,14757,8064,6693
202010,41461,경기도,용인시 처인구,15-19세,14297,7758,6539
202011,41461,경기도,용인시 처인구,15-19세,13524,7268,6256
202012,41461,경기도,용인시 처인구,15-19세,12517,6555,5962
202101,41461,경기도,용인시 처인구,15-19세,12279,6427,5852
202102,41461,경기도,용인시 처인구,15-19세,12177,6349,5828
202103,41461,경기도,용인시 처인구,15-19세,12162,6329,5833
202104,41461,경기도,용인시 처인구,15-19세,12984,7005,5979
202105,41461,경기도,용인시 처인구,15-19세,13450,7326,6124
202106,41461,경기도,용인시 처인구,15-19세,13590,7396,6194
202007,41461,경기도,용인시 처인구,20-24세,17442,9337,8105
202008,41461,경기도,용인시 처인구,20-24세,17509,9376,8133
202009,41461,경기도,용인시 처인구,20-24세,17568,9413,8155
202010,41461,경기도,용인시 처인구,20-24세,17526,9355,8171
202011,41461,경기도,용인시 처인구,20-24세,17518,9344,8174
202012,41461,경기도,용인시 처인구,20-24세,17352,9227,8125
202101,41461,경기도,용인시 처인구,20-24세,17308,9195,8113
202102,41461,경기도,용인시 처인구,20-24세,17281,9194,8087
202103,41461,경기도,용인시 처인구,20-24세,17176,9138,8038
202104,41461,경기도,용인시 처인구,20-24세,17239,9156,8083
202105,41461,경기도,용인시 처인구,20-24세,17301,9188,8113
202106,41461,경기도,용인시 처인구,20-24세,17277,9187,8090
202007,41461,경기도,용인시 처인구,25-29세,16724,9261,7463
202008,41461,경기도,용인시 처인구,25-29세,16818,9320,7498
202009,41461,경기도,용인시 처인구,25-29세,16855,9353,7502
202010,41461,경기도,용인시 처인구,25-29세,16960,9429,7531
202011,41461,경기도,용인시 처인구,25-29세,17084,9506,7578
202012,41461,경기도,용인시 처인구,25-29세,17152,9532,7620
202101,41461,경기도,용인시 처인구,25-29세,17177,9525,7652
202102,41461,경기도,용인시 처인구,25-29세,17172,9479,7693
202103,41461,경기도,용인시 처인구,25-29세,17315,9571,7744
202104,41461,경기도,용인시 처인구,25-29세,17379,9616,7763
202105,41461,경기도,용인시 처인구,25-29세,17472,9681,7791
202106,41461,경기도,용인시 처인구,25-29세,17493,9714,7779
202007,41461,경기도,용인시 처인구,30-34세,14587,7795,6792
202008,41461,경기도,용인시 처인구,30-34세,14574,7796,6778
202009,41461,경기도,용인시 처인구,30-34세,14579,7805,6774
202010,41461,경기도,용인시 처인구,30-34세,14595,7816,6779
202011,41461,경기도,용인시 처인구,30-34세,14625,7859,6766
202012,41461,경기도,용인시 처인구,30-34세,14707,7928,6779
202101,41461,경기도,용인시 처인구,30-34세,14770,7972,6798
202102,41461,경기도,용인시 처인구,30-34세,14807,7998,6809
202103,41461,경기도,용인시 처인구,30-34세,14895,8034,6861
202104,41461,경기도,용인시 처인구,30-34세,14956,8073,6883
202105,41461,경기도,용인시 처인구,30-34세,15013,8084,6929
202106,41461,경기도,용인시 처인구,30-34세,15085,8134,6951
202007,41461,경기도,용인시 처인구,35-39세,19606,10203,9403
202008,41461,경기도,용인시 처인구,35-39세,19552,10208,9344
202009,41461,경기도,용인시 처인구,35-39세,19413,10128,9285
202010,41461,경기도,용인시 처인구,35-39세,19343,10111,9232
202011,41461,경기도,용인시 처인구,35-39세,19310,10095,9215
202012,41461,경기도,용인시 처인구,35-39세,19299,10090,9209
202101,41461,경기도,용인시 처인구,35-39세,19194,10054,9140
202102,41461,경기도,용인시 처인구,35-39세,19132,10032,9100
202103,41461,경기도,용인시 처인구,35-39세,19033,10005,9028
202104,41461,경기도,용인시 처인구,35-39세,18976,9965,9011
202105,41461,경기도,용인시 처인구,35-39세,18861,9891,8970
202106,41461,경기도,용인시 처인구,35-39세,18725,9820,8905
202007,41461,경기도,용인시 처인구,40-44세,20610,10858,9752
202008,41461,경기도,용인시 처인구,40-44세,20600,10840,9760
202009,41461,경기도,용인시 처인구,40-44세,20694,10884,9810
202010,41461,경기도,용인시 처인구,40-44세,20822,10917,9905
202011,41461,경기도,용인시 처인구,40-44세,20824,10918,9906
202012,41461,경기도,용인시 처인구,40-44세,20876,10964,9912
202101,41461,경기도,용인시 처인구,40-44세,20944,10964,9980
202102,41461,경기도,용인시 처인구,40-44세,20918,10954,9964
202103,41461,경기도,용인시 처인구,40-44세,20852,10916,9936
202104,41461,경기도,용인시 처인구,40-44세,20887,10930,9957
202105,41461,경기도,용인시 처인구,40-44세,20941,10997,9944
202106,41461,경기도,용인시 처인구,40-44세,21093,11076,10017
202007,41461,경기도,용인시 처인구,45-49세,22891,12114,10777
202008,41461,경기도,용인시 처인구,45-49세,22824,12075,10749
202009,41461,경기도,용인시 처인구,45-49세,22770,12039,10731
202010,41461,경기도,용인시 처인구,45-49세,22704,12016,10688
202011,41461,경기도,용인시 처인구,45-49세,22655,11966,10689
202012,41461,경기도,용인시 처인구,45-49세,22652,11937,10715
202101,41461,경기도,용인시 처인구,45-49세,22707,11998,10709
202102,41461,경기도,용인시 처인구,45-49세,22703,11990,10713
202103,41461,경기도,용인시 처인구,45-49세,22626,11978,10648
202104,41461,경기도,용인시 처인구,45-49세,22605,11979,10626
202105,41461,경기도,용인시 처인구,45-49세,22556,11940,10616
202106,41461,경기도,용인시 처인구,45-49세,22497,11885,10612
202007,41461,경기도,용인시 처인구,50-54세,22008,11302,10706
202008,41461,경기도,용인시 처인구,50-54세,22081,11350,10731
202009,41461,경기도,용인시 처인구,50-54세,22128,11362,10766
202010,41461,경기도,용인시 처인구,50-54세,22156,11383,10773
202011,41461,경기도,용인시 처인구,50-54세,22263,11456,10807
202012,41461,경기도,용인시 처인구,50-54세,22249,11445,10804
202101,41461,경기도,용인시 처인구,50-54세,22401,11518,10883
202102,41461,경기도,용인시 처인구,50-54세,22503,11539,10964
202103,41461,경기도,용인시 처인구,50-54세,22463,11535,10928
202104,41461,경기도,용인시 처인구,50-54세,22547,11590,10957
202105,41461,경기도,용인시 처인구,50-54세,22658,11663,10995
202106,41461,경기도,용인시 처인구,50-54세,22768,11736,11032
202007,41461,경기도,용인시 처인구,55-59세,20865,10891,9974
202008,41461,경기도,용인시 처인구,55-59세,20911,10902,10009
202009,41461,경기도,용인시 처인구,55-59세,20931,10908,10023
202010,41461,경기도,용인시 처인구,55-59세,20951,10917,10034
202011,41461,경기도,용인시 처인구,55-59세,20948,10894,10054
202012,41461,경기도,용인시 처인구,55-59세,21021,10905,10116
202101,41461,경기도,용인시 처인구,55-59세,20942,10866,10076
202102,41461,경기도,용인시 처인구,55-59세,20946,10882,10064
202103,41461,경기도,용인시 처인구,55-59세,20971,10870,10101
202104,41461,경기도,용인시 처인구,55-59세,20908,10850,10058
202105,41461,경기도,용인시 처인구,55-59세,20856,10797,10059
202106,41461,경기도,용인시 처인구,55-59세,20738,10744,9994
202007,41461,경기도,용인시 처인구,60-64세,17784,9067,8717
202008,41461,경기도,용인시 처인구,60-64세,17873,9124,8749
202009,41461,경기도,용인시 처인구,60-64세,18075,9247,8828
202010,41461,경기도,용인시 처인구,60-64세,18209,9310,8899
202011,41461,경기도,용인시 처인구,60-64세,18337,9393,8944
202012,41461,경기도,용인시 처인구,60-64세,18506,9482,9024
202101,41461,경기도,용인시 처인구,60-64세,18659,9582,9077
202102,41461,경기도,용인시 처인구,60-64세,18836,9674,9162
202103,41461,경기도,용인시 처인구,60-64세,19000,9754,9246
202104,41461,경기도,용인시 처인구,60-64세,19159,9841,9318
202105,41461,경기도,용인시 처인구,60-64세,19335,9937,9398
202106,41461,경기도,용인시 처인구,60-64세,19625,10084,9541
202007,41461,경기도,용인시 처인구,65-69세,12263,5961,6302
202008,41461,경기도,용인시 처인구,65-69세,12385,6017,6368
202009,41461,경기도,용인시 처인구,65-69세,12503,6069,6434
202010,41461,경기도,용인시 처인구,65-69세,12627,6151,6476
202011,41461,경기도,용인시 처인구,65-69세,12794,6258,6536
202012,41461,경기도,용인시 처인구,65-69세,12872,6294,6578
202101,41461,경기도,용인시 처인구,65-69세,13056,6376,6680
202102,41461,경기도,용인시 처인구,65-69세,13197,6461,6736
202103,41461,경기도,용인시 처인구,65-69세,13352,6549,6803
202104,41461,경기도,용인시 처인구,65-69세,13509,6631,6878
202105,41461,경기도,용인시 처인구,65-69세,13629,6699,6930
202106,41461,경기도,용인시 처인구,65-69세,13678,6718,6960
202007,41461,경기도,용인시 처인구,70-74세,8856,4291,4565
202008,41461,경기도,용인시 처인구,70-74세,8851,4283,4568
202009,41461,경기도,용인시 처인구,70-74세,8891,4295,4596
202010,41461,경기도,용인시 처인구,70-74세,8931,4322,4609
202011,41461,경기도,용인시 처인구,70-74세,8978,4336,4642
202012,41461,경기도,용인시 처인구,70-74세,9048,4368,4680
202101,41461,경기도,용인시 처인구,70-74세,9104,4394,4710
202102,41461,경기도,용인시 처인구,70-74세,9114,4401,4713
202103,41461,경기도,용인시 처인구,70-74세,9089,4391,4698
202104,41461,경기도,용인시 처인구,70-74세,9136,4393,4743
202105,41461,경기도,용인시 처인구,70-74세,9149,4392,4757
202106,41461,경기도,용인시 처인구,70-74세,9137,4384,4753
202007,41461,경기도,용인시 처인구,75-79세,7055,3079,3976
202008,41461,경기도,용인시 처인구,75-79세,7084,3097,3987
202009,41461,경기도,용인시 처인구,75-79세,7057,3083,3974
202010,41461,경기도,용인시 처인구,75-79세,7037,3060,3977
202011,41461,경기도,용인시 처인구,75-79세,7008,3056,3952
202012,41461,경기도,용인시 처인구,75-79세,6977,3038,3939
202101,41461,경기도,용인시 처인구,75-79세,6979,3036,3943
202102,41461,경기도,용인시 처인구,75-79세,7026,3062,3964
202103,41461,경기도,용인시 처인구,75-79세,6995,3045,3950
202104,41461,경기도,용인시 처인구,75-79세,6974,3057,3917
202105,41461,경기도,용인시 처인구,75-79세,6974,3061,3913
202106,41461,경기도,용인시 처인구,75-79세,7018,3088,3930
202007,41461,경기도,용인시 처인구,80-84세,4739,1846,2893
202008,41461,경기도,용인시 처인구,80-84세,4749,1842,2907
202009,41461,경기도,용인시 처인구,80-84세,4784,1850,2934
202010,41461,경기도,용인시 처인구,80-84세,4779,1846,2933
202011,41461,경기도,용인시 처인구,80-84세,4783,1847,2936
202012,41461,경기도,용인시 처인구,80-84세,4796,1852,2944
202101,41461,경기도,용인시 처인구,80-84세,4811,1854,2957
202102,41461,경기도,용인시 처인구,80-84세,4828,1868,2960
202103,41461,경기도,용인시 처인구,80-84세,4821,1857,2964
202104,41461,경기도,용인시 처인구,80-84세,4830,1859,2971
202105,41461,경기도,용인시 처인구,80-84세,4893,1889,3004
202106,41461,경기도,용인시 처인구,80-84세,4920,1899,3021
202007,41461,경기도,용인시 처인구,85-89세,2517,806,1711
202008,41461,경기도,용인시 처인구,85-89세,2539,813,1726
202009,41461,경기도,용인시 처인구,85-89세,2560,825,1735
202010,41461,경기도,용인시 처인구,85-89세,2571,821,1750
202011,41461,경기도,용인시 처인구,85-89세,2587,824,1763
202012,41461,경기도,용인시 처인구,85-89세,2630,849,1781
202101,41461,경기도,용인시 처인구,85-89세,2652,866,1786
202102,41461,경기도,용인시 처인구,85-89세,2687,876,1811
202103,41461,경기도,용인시 처인구,85-89세,2701,881,1820
202104,41461,경기도,용인시 처인구,85-89세,2740,890,1850
202105,41461,경기도,용인시 처인구,85-89세,2742,896,1846
202106,41461,경기도,용인시 처인구,85-89세,2741,902,1839
202007,41461,경기도,용인시 처인구,90-94세,896,209,687
202008,41461,경기도,용인시 처인구,90-94세,912,211,701
202009,41461,경기도,용인시 처인구,90-94세,918,209,709
202010,41461,경기도,용인시 처인구,90-94세,925,211,714
202011,41461,경기도,용인시 처인구,90-94세,940,212,728
202012,41461,경기도,용인시 처인구,90-94세,943,210,733
202101,41461,경기도,용인시 처인구,90-94세,939,214,725
202102,41461,경기도,용인시 처인구,90-94세,951,217,734
202103,41461,경기도,용인시 처인구,90-94세,961,219,742
202104,41461,경기도,용인시 처인구,90-94세,968,220,748
202105,41461,경기도,용인시 처인구,90-94세,961,218,743
202106,41461,경기도,용인시 처인구,90-94세,971,220,751
202007,41461,경기도,용인시 처인구,95-99세,225,47,178
202008,41461,경기도,용인시 처인구,95-99세,229,48,181
202009,41461,경기도,용인시 처인구,95-99세,237,51,186
202010,41461,경기도,용인시 처인구,95-99세,234,51,183
202011,41461,경기도,용인시 처인구,95-99세,233,52,181
202012,41461,경기도,용인시 처인구,95-99세,235,51,184
202101,41461,경기도,용인시 처인구,95-99세,237,49,188
202102,41461,경기도,용인시 처인구,95-99세,241,49,192
202103,41461,경기도,용인시 처인구,95-99세,224,41,183
202104,41461,경기도,용인시 처인구,95-99세,223,43,180
202105,41461,경기도,용인시 처인구,95-99세,227,44,183
202106,41461,경기도,용인시 처인구,95-99세,225,43,182
202007,41461,경기도,용인시 처인구,100+,70,12,58
202008,41461,경기도,용인시 처인구,100+,71,13,58
202009,41461,경기도,용인시 처인구,100+,72,12,60
202010,41461,경기도,용인시 처인구,100+,76,13,63
202011,41461,경기도,용인시 처인구,100+,78,13,65
202012,41461,경기도,용인시 처인구,100+,78,13,65
202101,41461,경기도,용인시 처인구,100+,82,14,68
202102,41461,경기도,용인시 처인구,100+,83,15,68
202103,41461,경기도,용인시 처인구,100+,44,9,35
202104,41461,경기도,용인시 처인구,100+,44,9,35
202105,41461,경기도,용인시 처인구,100+,44,9,35
202106,41461,경기도,용인시 처인구,100+,43,9,34
202007,41463,경기도,용인시 기흥구,0-4세,18237,9402,8835
202008,41463,경기도,용인시 기흥구,0-4세,18006,9301,8705
202009,41463,경기도,용인시 기흥구,0-4세,17802,9197,8605
202010,41463,경기도,용인시 기흥구,0-4세,17551,9069,8482
202011,41463,경기도,용인시 기흥구,0-4세,17412,8990,8422
202012,41463,경기도,용인시 기흥구,0-4세,17329,8948,8381
202101,41463,경기도,용인시 기흥구,0-4세,17136,8832,8304
202102,41463,경기도,용인시 기흥구,0-4세,16989,8770,8219
202103,41463,경기도,용인시 기흥구,0-4세,16779,8668,8111
202104,41463,경기도,용인시 기흥구,0-4세,16554,8541,8013
202105,41463,경기도,용인시 기흥구,0-4세,16362,8454,7908
202106,41463,경기도,용인시 기흥구,0-4세,16202,8362,7840
202007,41463,경기도,용인시 기흥구,5-9세,26014,13280,12734
202008,41463,경기도,용인시 기흥구,5-9세,25931,13258,12673
202009,41463,경기도,용인시 기흥구,5-9세,25848,13230,12618
202010,41463,경기도,용인시 기흥구,5-9세,25708,13150,12558
202011,41463,경기도,용인시 기흥구,5-9세,25595,13102,12493
202012,41463,경기도,용인시 기흥구,5-9세,25470,13010,12460
202101,41463,경기도,용인시 기흥구,5-9세,25299,12911,12388
202102,41463,경기도,용인시 기흥구,5-9세,25102,12822,12280
202103,41463,경기도,용인시 기흥구,5-9세,25073,12824,12249
202104,41463,경기도,용인시 기흥구,5-9세,25057,12821,12236
202105,41463,경기도,용인시 기흥구,5-9세,25020,12805,12215
202106,41463,경기도,용인시 기흥구,5-9세,24938,12789,12149
202007,41463,경기도,용인시 기흥구,10-14세,26077,13448,12629
202008,41463,경기도,용인시 기흥구,10-14세,26082,13429,12653
202009,41463,경기도,용인시 기흥구,10-14세,26110,13427,12683
202010,41463,경기도,용인시 기흥구,10-14세,26181,13464,12717
202011,41463,경기도,용인시 기흥구,10-14세,26204,13473,12731
202012,41463,경기도,용인시 기흥구,10-14세,26202,13474,12728
202101,41463,경기도,용인시 기흥구,10-14세,26269,13514,12755
202102,41463,경기도,용인시 기흥구,10-14세,26272,13483,12789
202103,41463,경기도,용인시 기흥구,10-14세,26253,13461,12792
202104,41463,경기도,용인시 기흥구,10-14세,26230,13433,12797
202105,41463,경기도,용인시 기흥구,10-14세,26248,13427,12821
202106,41463,경기도,용인시 기흥구,10-14세,26267,13425,12842
202007,41463,경기도,용인시 기흥구,15-19세,25242,12984,12258
202008,41463,경기도,용인시 기흥구,15-19세,25135,12940,12195
202009,41463,경기도,용인시 기흥구,15-19세,24995,12875,12120
202010,41463,경기도,용인시 기흥구,15-19세,24854,12781,12073
202011,41463,경기도,용인시 기흥구,15-19세,24717,12703,12014
202012,41463,경기도,용인시 기흥구,15-19세,24630,12641,11989
202101,41463,경기도,용인시 기흥구,15-19세,24521,12576,11945
202102,41463,경기도,용인시 기흥구,15-19세,24421,12523,11898
202103,41463,경기도,용인시 기흥구,15-19세,24252,12466,11786
202104,41463,경기도,용인시 기흥구,15-19세,24212,12460,11752
202105,41463,경기도,용인시 기흥구,15-19세,24185,12447,11738
202106,41463,경기도,용인시 기흥구,15-19세,24165,12448,11717
202007,41463,경기도,용인시 기흥구,20-24세,28779,14715,14064
202008,41463,경기도,용인시 기흥구,20-24세,28871,14779,14092
202009,41463,경기도,용인시 기흥구,20-24세,28936,14822,14114
202010,41463,경기도,용인시 기흥구,20-24세,28982,14866,14116
202011,41463,경기도,용인시 기흥구,20-24세,29033,14878,14155
202012,41463,경기도,용인시 기흥구,20-24세,29032,14859,14173
202101,41463,경기도,용인시 기흥구,20-24세,29146,14935,14211
202102,41463,경기도,용인시 기흥구,20-24세,29167,14925,14242
202103,41463,경기도,용인시 기흥구,20-24세,29136,14881,14255
202104,41463,경기도,용인시 기흥구,20-24세,29095,14866,14229
202105,41463,경기도,용인시 기흥구,20-24세,29100,14926,14174
202106,41463,경기도,용인시 기흥구,20-24세,29099,14915,14184
202007,41463,경기도,용인시 기흥구,25-29세,27162,14188,12974
202008,41463,경기도,용인시 기흥구,25-29세,27180,14213,12967
202009,41463,경기도,용인시 기흥구,25-29세,27268,14239,13029
202010,41463,경기도,용인시 기흥구,25-29세,27436,14368,13068
202011,41463,경기도,용인시 기흥구,25-29세,27576,14441,13135
202012,41463,경기도,용인시 기흥구,25-29세,27749,14516,13233
202101,41463,경기도,용인시 기흥구,25-29세,27857,14591,13266
202102,41463,경기도,용인시 기흥구,25-29세,27789,14585,13204
202103,41463,경기도,용인시 기흥구,25-29세,27939,14678,13261
202104,41463,경기도,용인시 기흥구,25-29세,27840,14649,13191
202105,41463,경기도,용인시 기흥구,25-29세,27878,14718,13160
202106,41463,경기도,용인시 기흥구,25-29세,27831,14692,13139
202007,41463,경기도,용인시 기흥구,30-34세,25352,12582,12770
202008,41463,경기도,용인시 기흥구,30-34세,25307,12559,12748
202009,41463,경기도,용인시 기흥구,30-34세,25203,12511,12692
202010,41463,경기도,용인시 기흥구,30-34세,25115,12448,12667
202011,41463,경기도,용인시 기흥구,30-34세,25024,12379,12645
202012,41463,경기도,용인시 기흥구,30-34세,24945,12371,12574
202101,41463,경기도,용인시 기흥구,30-34세,24907,12305,12602
202102,41463,경기도,용인시 기흥구,30-34세,24853,12262,12591
202103,41463,경기도,용인시 기흥구,30-34세,24879,12277,12602
202104,41463,경기도,용인시 기흥구,30-34세,24894,12267,12627
202105,41463,경기도,용인시 기흥구,30-34세,24911,12259,12652
202106,41463,경기도,용인시 기흥구,30-34세,24929,12268,12661
202007,41463,경기도,용인시 기흥구,35-39세,35890,17433,18457
202008,41463,경기도,용인시 기흥구,35-39세,35582,17253,18329
202009,41463,경기도,용인시 기흥구,35-39세,35298,17131,18167
202010,41463,경기도,용인시 기흥구,35-39세,34936,16940,17996
202011,41463,경기도,용인시 기흥구,35-39세,34753,16853,17900
202012,41463,경기도,용인시 기흥구,35-39세,34581,16793,17788
202101,41463,경기도,용인시 기흥구,35-39세,34254,16648,17606
202102,41463,경기도,용인시 기흥구,35-39세,33916,16493,17423
202103,41463,경기도,용인시 기흥구,35-39세,33614,16363,17251
202104,41463,경기도,용인시 기흥구,35-39세,33428,16263,17165
202105,41463,경기도,용인시 기흥구,35-39세,33202,16150,17052
202106,41463,경기도,용인시 기흥구,35-39세,32886,16003,16883
202007,41463,경기도,용인시 기흥구,40-44세,40057,19489,20568
202008,41463,경기도,용인시 기흥구,40-44세,40115,19512,20603
202009,41463,경기도,용인시 기흥구,40-44세,40169,19535,20634
202010,41463,경기도,용인시 기흥구,40-44세,40233,19577,20656
202011,41463,경기도,용인시 기흥구,40-44세,40228,19584,20644
202012,41463,경기도,용인시 기흥구,40-44세,40151,19556,20595
202101,41463,경기도,용인시 기흥구,40-44세,40106,19544,20562
202102,41463,경기도,용인시 기흥구,40-44세,40153,19564,20589
202103,41463,경기도,용인시 기흥구,40-44세,39996,19432,20564
202104,41463,경기도,용인시 기흥구,40-44세,39985,19414,20571
202105,41463,경기도,용인시 기흥구,40-44세,40010,19407,20603
202106,41463,경기도,용인시 기흥구,40-44세,40182,19499,20683
202007,41463,경기도,용인시 기흥구,45-49세,44338,21914,22424
202008,41463,경기도,용인시 기흥구,45-49세,44218,21855,22363
202009,41463,경기도,용인시 기흥구,45-49세,44021,21764,22257
202010,41463,경기도,용인시 기흥구,45-49세,43847,21701,22146
202011,41463,경기도,용인시 기흥구,45-49세,43759,21629,22130
202012,41463,경기도,용인시 기흥구,45-49세,43732,21580,22152
202101,41463,경기도,용인시 기흥구,45-49세,43616,21507,22109
202102,41463,경기도,용인시 기흥구,45-49세,43543,21457,22086
202103,41463,경기도,용인시 기흥구,45-49세,43230,21308,21922
202104,41463,경기도,용인시 기흥구,45-49세,43117,21233,21884
202105,41463,경기도,용인시 기흥구,45-49세,42870,21102,21768
202106,41463,경기도,용인시 기흥구,45-49세,42665,20998,21667
202007,41463,경기도,용인시 기흥구,50-54세,36811,18542,18269
202008,41463,경기도,용인시 기흥구,50-54세,37054,18658,18396
202009,41463,경기도,용인시 기흥구,50-54세,37223,18707,18516
202010,41463,경기도,용인시 기흥구,50-54세,37455,18760,18695
202011,41463,경기도,용인시 기흥구,50-54세,37583,18839,18744
202012,41463,경기도,용인시 기흥구,50-54세,37633,18900,18733
202101,41463,경기도,용인시 기흥구,50-54세,37995,19074,18921
202102,41463,경기도,용인시 기흥구,50-54세,38175,19164,19011
202103,41463,경기도,용인시 기흥구,50-54세,38440,19329,19111
202104,41463,경기도,용인시 기흥구,50-54세,38617,19404,19213
202105,41463,경기도,용인시 기흥구,50-54세,38983,19569,19414
202106,41463,경기도,용인시 기흥구,50-54세,39113,19628,19485
202007,41463,경기도,용인시 기흥구,55-59세,28607,14548,14059
202008,41463,경기도,용인시 기흥구,55-59세,28674,14602,14072
202009,41463,경기도,용인시 기흥구,55-59세,28779,14627,14152
202010,41463,경기도,용인시 기흥구,55-59세,28867,14685,14182
202011,41463,경기도,용인시 기흥구,55-59세,28916,14698,14218
202012,41463,경기도,용인시 기흥구,55-59세,29100,14769,14331
202101,41463,경기도,용인시 기흥구,55-59세,28991,14758,14233
202102,41463,경기도,용인시 기흥구,55-59세,29058,14780,14278
202103,41463,경기도,용인시 기흥구,55-59세,28960,14712,14248
202104,41463,경기도,용인시 기흥구,55-59세,28920,14702,14218
202105,41463,경기도,용인시 기흥구,55-59세,28903,14699,14204
202106,41463,경기도,용인시 기흥구,55-59세,28811,14649,14162
202007,41463,경기도,용인시 기흥구,60-64세,23030,11000,12030
202008,41463,경기도,용인시 기흥구,60-64세,23096,11050,12046
202009,41463,경기도,용인시 기흥구,60-64세,23214,11132,12082
202010,41463,경기도,용인시 기흥구,60-64세,23356,11230,12126
202011,41463,경기도,용인시 기흥구,60-64세,23478,11303,12175
202012,41463,경기도,용인시 기흥구,60-64세,23538,11324,12214
202101,41463,경기도,용인시 기흥구,60-64세,23736,11423,12313
202102,41463,경기도,용인시 기흥구,60-64세,23865,11496,12369
202103,41463,경기도,용인시 기흥구,60-64세,24006,11579,12427
202104,41463,경기도,용인시 기흥구,60-64세,24153,11656,12497
202105,41463,경기도,용인시 기흥구,60-64세,24296,11735,12561
202106,41463,경기도,용인시 기흥구,60-64세,24513,11843,12670
202007,41463,경기도,용인시 기흥구,65-69세,17186,7670,9516
202008,41463,경기도,용인시 기흥구,65-69세,17331,7739,9592
202009,41463,경기도,용인시 기흥구,65-69세,17423,7785,9638
202010,41463,경기도,용인시 기흥구,65-69세,17473,7818,9655
202011,41463,경기도,용인시 기흥구,65-69세,17527,7858,9669
202012,41463,경기도,용인시 기흥구,65-69세,17629,7902,9727
202101,41463,경기도,용인시 기흥구,65-69세,17749,7957,9792
202102,41463,경기도,용인시 기흥구,65-69세,17831,8017,9814
202103,41463,경기도,용인시 기흥구,65-69세,18004,8108,9896
202104,41463,경기도,용인시 기흥구,65-69세,18147,8171,9976
202105,41463,경기도,용인시 기흥구,65-69세,18221,8234,9987
202106,41463,경기도,용인시 기흥구,65-69세,18344,8304,10040
202007,41463,경기도,용인시 기흥구,70-74세,14640,6507,8133
202008,41463,경기도,용인시 기흥구,70-74세,14644,6510,8134
202009,41463,경기도,용인시 기흥구,70-74세,14684,6525,8159
202010,41463,경기도,용인시 기흥구,70-74세,14755,6530,8225
202011,41463,경기도,용인시 기흥구,70-74세,14797,6552,8245
202012,41463,경기도,용인시 기흥구,70-74세,14828,6580,8248
202101,41463,경기도,용인시 기흥구,70-74세,14927,6635,8292
202102,41463,경기도,용인시 기흥구,70-74세,14934,6618,8316
202103,41463,경기도,용인시 기흥구,70-74세,14909,6588,8321
202104,41463,경기도,용인시 기흥구,70-74세,14865,6569,8296
202105,41463,경기도,용인시 기흥구,70-74세,14848,6546,8302
202106,41463,경기도,용인시 기흥구,70-74세,14768,6490,8278
202007,41463,경기도,용인시 기흥구,75-79세,11506,5340,6166
202008,41463,경기도,용인시 기흥구,75-79세,11511,5343,6168
202009,41463,경기도,용인시 기흥구,75-79세,11478,5322,6156
202010,41463,경기도,용인시 기흥구,75-79세,11460,5324,6136
202011,41463,경기도,용인시 기흥구,75-79세,11447,5290,6157
202012,41463,경기도,용인시 기흥구,75-79세,11450,5267,6183
202101,41463,경기도,용인시 기흥구,75-79세,11444,5242,6202
202102,41463,경기도,용인시 기흥구,75-79세,11452,5245,6207
202103,41463,경기도,용인시 기흥구,75-79세,11487,5255,6232
202104,41463,경기도,용인시 기흥구,75-79세,11510,5262,6248
202105,41463,경기도,용인시 기흥구,75-79세,11535,5274,6261
202106,41463,경기도,용인시 기흥구,75-79세,11578,5294,6284
202007,41463,경기도,용인시 기흥구,80-84세,7160,3130,4030
202008,41463,경기도,용인시 기흥구,80-84세,7224,3154,4070
202009,41463,경기도,용인시 기흥구,80-84세,7273,3185,4088
202010,41463,경기도,용인시 기흥구,80-84세,7355,3217,4138
202011,41463,경기도,용인시 기흥구,80-84세,7414,3254,4160
202012,41463,경기도,용인시 기흥구,80-84세,7469,3269,4200
202101,41463,경기도,용인시 기흥구,80-84세,7538,3318,4220
202102,41463,경기도,용인시 기흥구,80-84세,7606,3353,4253
202103,41463,경기도,용인시 기흥구,80-84세,7668,3382,4286
202104,41463,경기도,용인시 기흥구,80-84세,7710,3407,4303
202105,41463,경기도,용인시 기흥구,80-84세,7751,3434,4317
202106,41463,경기도,용인시 기흥구,80-84세,7822,3470,4352
202007,41463,경기도,용인시 기흥구,85-89세,3460,1331,2129
202008,41463,경기도,용인시 기흥구,85-89세,3481,1331,2150
202009,41463,경기도,용인시 기흥구,85-89세,3509,1346,2163
202010,41463,경기도,용인시 기흥구,85-89세,3549,1366,2183
202011,41463,경기도,용인시 기흥구,85-89세,3567,1386,2181
202012,41463,경기도,용인시 기흥구,85-89세,3616,1411,2205
202101,41463,경기도,용인시 기흥구,85-89세,3686,1434,2252
202102,41463,경기도,용인시 기흥구,85-89세,3746,1453,2293
202103,41463,경기도,용인시 기흥구,85-89세,3781,1473,2308
202104,41463,경기도,용인시 기흥구,85-89세,3806,1485,2321
202105,41463,경기도,용인시 기흥구,85-89세,3853,1509,2344
202106,41463,경기도,용인시 기흥구,85-89세,3883,1523,2360
202007,41463,경기도,용인시 기흥구,90-94세,1278,365,913
202008,41463,경기도,용인시 기흥구,90-94세,1292,378,914
202009,41463,경기도,용인시 기흥구,90-94세,1296,379,917
202010,41463,경기도,용인시 기흥구,90-94세,1316,387,929
202011,41463,경기도,용인시 기흥구,90-94세,1330,390,940
202012,41463,경기도,용인시 기흥구,90-94세,1343,401,942
202101,41463,경기도,용인시 기흥구,90-94세,1346,403,943
202102,41463,경기도,용인시 기흥구,90-94세,1346,405,941
202103,41463,경기도,용인시 기흥구,90-94세,1343,402,941
202104,41463,경기도,용인시 기흥구,90-94세,1366,406,960
202105,41463,경기도,용인시 기흥구,90-94세,1372,400,972
202106,41463,경기도,용인시 기흥구,90-94세,1389,404,985
202007,41463,경기도,용인시 기흥구,95-99세,297,64,233
202008,41463,경기도,용인시 기흥구,95-99세,307,68,239
202009,41463,경기도,용인시 기흥구,95-99세,324,72,252
202010,41463,경기도,용인시 기흥구,95-99세,325,73,252
202011,41463,경기도,용인시 기흥구,95-99세,333,75,258
202012,41463,경기도,용인시 기흥구,95-99세,335,75,260
202101,41463,경기도,용인시 기흥구,95-99세,343,76,267
202102,41463,경기도,용인시 기흥구,95-99세,358,78,280
202103,41463,경기도,용인시 기흥구,95-99세,350,74,276
202104,41463,경기도,용인시 기흥구,95-99세,350,76,274
202105,41463,경기도,용인시 기흥구,95-99세,343,77,266
202106,41463,경기도,용인시 기흥구,95-99세,342,79,263
202007,41463,경기도,용인시 기흥구,100+,67,16,51
202008,41463,경기도,용인시 기흥구,100+,68,16,52
202009,41463,경기도,용인시 기흥구,100+,70,17,53
202010,41463,경기도,용인시 기흥구,100+,72,18,54
202011,41463,경기도,용인시 기흥구,100+,71,17,54
202012,41463,경기도,용인시 기흥구,100+,73,17,56
202101,41463,경기도,용인시 기흥구,100+,74,17,57
202102,41463,경기도,용인시 기흥구,100+,73,18,55
202103,41463,경기도,용인시 기흥구,100+,65,13,52
202104,41463,경기도,용인시 기흥구,100+,66,13,53
202105,41463,경기도,용인시 기흥구,100+,62,12,50
202106,41463,경기도,용인시 기흥구,100+,64,11,53
202007,41465,경기도,용인시 수지구,0-4세,15395,7754,7641
202008,41465,경기도,용인시 수지구,0-4세,15220,7695,7525
202009,41465,경기도,용인시 수지구,0-4세,15101,7626,7475
202010,41465,경기도,용인시 수지구,0-4세,14942,7539,7403
202011,41465,경기도,용인시 수지구,0-4세,14812,7500,7312
202012,41465,경기도,용인시 수지구,0-4세,14752,7493,7259
202101,41465,경기도,용인시 수지구,0-4세,14627,7434,7193
202102,41465,경기도,용인시 수지구,0-4세,14633,7442,7191
202103,41465,경기도,용인시 수지구,0-4세,14481,7341,7140
202104,41465,경기도,용인시 수지구,0-4세,14361,7283,7078
202105,41465,경기도,용인시 수지구,0-4세,14232,7217,7015
202106,41465,경기도,용인시 수지구,0-4세,14128,7183,6945
202007,41465,경기도,용인시 수지구,5-9세,22260,11385,10875
202008,41465,경기도,용인시 수지구,5-9세,22271,11355,10916
202009,41465,경기도,용인시 수지구,5-9세,22194,11311,10883
202010,41465,경기도,용인시 수지구,5-9세,22090,11257,10833
202011,41465,경기도,용인시 수지구,5-9세,22011,11219,10792
202012,41465,경기도,용인시 수지구,5-9세,21998,11222,10776
202101,41465,경기도,용인시 수지구,5-9세,21942,11189,10753
202102,41465,경기도,용인시 수지구,5-9세,22069,11271,10798
202103,41465,경기도,용인시 수지구,5-9세,21974,11231,10743
202104,41465,경기도,용인시 수지구,5-9세,21989,11228,10761
202105,41465,경기도,용인시 수지구,5-9세,21934,11214,10720
202106,41465,경기도,용인시 수지구,5-9세,21842,11143,10699
202007,41465,경기도,용인시 수지구,10-14세,22963,11652,11311
202008,41465,경기도,용인시 수지구,10-14세,23060,11711,11349
202009,41465,경기도,용인시 수지구,10-14세,23186,11780,11406
202010,41465,경기도,용인시 수지구,10-14세,23247,11815,11432
202011,41465,경기도,용인시 수지구,10-14세,23249,11815,11434
202012,41465,경기도,용인시 수지구,10-14세,23252,11824,11428
202101,41465,경기도,용인시 수지구,10-14세,23416,11909,11507
202102,41465,경기도,용인시 수지구,10-14세,23453,11942,11511
202103,41465,경기도,용인시 수지구,10-14세,23539,11983,11556
202104,41465,경기도,용인시 수지구,10-14세,23520,11976,11544
202105,41465,경기도,용인시 수지구,10-14세,23569,12008,11561
202106,41465,경기도,용인시 수지구,10-14세,23569,12000,11569
202007,41465,경기도,용인시 수지구,15-19세,22660,11468,11192
202008,41465,경기도,용인시 수지구,15-19세,22542,11410,11132
202009,41465,경기도,용인시 수지구,15-19세,22441,11358,11083
202010,41465,경기도,용인시 수지구,15-19세,22376,11360,11016
202011,41465,경기도,용인시 수지구,15-19세,22285,11335,10950
202012,41465,경기도,용인시 수지구,15-19세,22198,11300,10898
202101,41465,경기도,용인시 수지구,15-19세,22141,11276,10865
202102,41465,경기도,용인시 수지구,15-19세,22094,11246,10848
202103,41465,경기도,용인시 수지구,15-19세,21972,11160,10812
202104,41465,경기도,용인시 수지구,15-19세,21923,11151,10772
202105,41465,경기도,용인시 수지구,15-19세,21847,11103,10744
202106,41465,경기도,용인시 수지구,15-19세,21836,11104,10732
202007,41465,경기도,용인시 수지구,20-24세,23568,11858,11710
202008,41465,경기도,용인시 수지구,20-24세,23631,11870,11761
202009,41465,경기도,용인시 수지구,20-24세,23610,11865,11745
202010,41465,경기도,용인시 수지구,20-24세,23616,11855,11761
202011,41465,경기도,용인시 수지구,20-24세,23650,11842,11808
202012,41465,경기도,용인시 수지구,20-24세,23687,11871,11816
202101,41465,경기도,용인시 수지구,20-24세,23750,11897,11853
202102,41465,경기도,용인시 수지구,20-24세,23772,11941,11831
202103,41465,경기도,용인시 수지구,20-24세,23760,11943,11817
202104,41465,경기도,용인시 수지구,20-24세,23729,11912,11817
202105,41465,경기도,용인시 수지구,20-24세,23768,11914,11854
202106,41465,경기도,용인시 수지구,20-24세,23703,11898,11805
202007,41465,경기도,용인시 수지구,25-29세,22733,11352,11381
202008,41465,경기도,용인시 수지구,25-29세,22757,11360,11397
202009,41465,경기도,용인시 수지구,25-29세,22755,11395,11360
202010,41465,경기도,용인시 수지구,25-29세,22766,11385,11381
202011,41465,경기도,용인시 수지구,25-29세,22771,11396,11375
202012,41465,경기도,용인시 수지구,25-29세,22790,11339,11451
202101,41465,경기도,용인시 수지구,25-29세,22746,11334,11412
202102,41465,경기도,용인시 수지구,25-29세,22719,11343,11376
202103,41465,경기도,용인시 수지구,25-29세,22824,11416,11408
202104,41465,경기도,용인시 수지구,25-29세,22947,11472,11475
202105,41465,경기도,용인시 수지구,25-29세,22917,11473,11444
202106,41465,경기도,용인시 수지구,25-29세,22924,11460,11464
202007,41465,경기도,용인시 수지구,30-34세,22156,10482,11674
202008,41465,경기도,용인시 수지구,30-34세,22098,10471,11627
202009,41465,경기도,용인시 수지구,30-34세,22103,10473,11630
202010,41465,경기도,용인시 수지구,30-34세,22098,10474,11624
202011,41465,경기도,용인시 수지구,30-34세,22057,10456,11601
202012,41465,경기도,용인시 수지구,30-34세,22022,10438,11584
202101,41465,경기도,용인시 수지구,30-34세,22010,10427,11583
202102,41465,경기도,용인시 수지구,30-34세,21960,10386,11574
202103,41465,경기도,용인시 수지구,30-34세,22021,10418,11603
202104,41465,경기도,용인시 수지구,30-34세,22068,10458,11610
202105,41465,경기도,용인시 수지구,30-34세,22064,10463,11601
202106,41465,경기도,용인시 수지구,30-34세,22152,10543,11609
202007,41465,경기도,용인시 수지구,35-39세,30516,14581,15935
202008,41465,경기도,용인시 수지구,35-39세,30455,14533,15922
202009,41465,경기도,용인시 수지구,35-39세,30275,14431,15844
202010,41465,경기도,용인시 수지구,35-39세,30125,14359,15766
202011,41465,경기도,용인시 수지구,35-39세,29965,14266,15699
202012,41465,경기도,용인시 수지구,35-39세,29749,14126,15623
202101,41465,경기도,용인시 수지구,35-39세,29615,14037,15578
202102,41465,경기도,용인시 수지구,35-39세,29573,14013,15560
202103,41465,경기도,용인시 수지구,35-39세,29406,13952,15454
202104,41465,경기도,용인시 수지구,35-39세,29299,13909,15390
202105,41465,경기도,용인시 수지구,35-39세,29124,13832,15292
202106,41465,경기도,용인시 수지구,35-39세,28859,13711,15148
202007,41465,경기도,용인시 수지구,40-44세,34813,16277,18536
202008,41465,경기도,용인시 수지구,40-44세,34803,16282,18521
202009,41465,경기도,용인시 수지구,40-44세,34903,16354,18549
202010,41465,경기도,용인시 수지구,40-44세,34906,16345,18561
202011,41465,경기도,용인시 수지구,40-44세,34868,16309,18559
202012,41465,경기도,용인시 수지구,40-44세,34846,16332,18514
202101,41465,경기도,용인시 수지구,40-44세,34844,16348,18496
202102,41465,경기도,용인시 수지구,40-44세,35027,16445,18582
202103,41465,경기도,용인시 수지구,40-44세,34954,16403,18551
202104,41465,경기도,용인시 수지구,40-44세,34908,16348,18560
202105,41465,경기도,용인시 수지구,40-44세,34965,16376,18589
202106,41465,경기도,용인시 수지구,40-44세,35079,16433,18646
202007,41465,경기도,용인시 수지구,45-49세,38175,18712,19463
202008,41465,경기도,용인시 수지구,45-49세,38060,18643,19417
202009,41465,경기도,용인시 수지구,45-49세,38001,18613,19388
202010,41465,경기도,용인시 수지구,45-49세,37874,18546,19328
202011,41465,경기도,용인시 수지구,45-49세,37772,18492,19280
202012,41465,경기도,용인시 수지구,45-49세,37758,18464,19294
202101,41465,경기도,용인시 수지구,45-49세,37704,18386,19318
202102,41465,경기도,용인시 수지구,45-49세,37652,18359,19293
202103,41465,경기도,용인시 수지구,45-49세,37548,18297,19251
202104,41465,경기도,용인시 수지구,45-49세,37521,18291,19230
202105,41465,경기도,용인시 수지구,45-49세,37335,18187,19148
202106,41465,경기도,용인시 수지구,45-49세,37174,18092,19082
202007,41465,경기도,용인시 수지구,50-54세,30837,15528,15309
202008,41465,경기도,용인시 수지구,50-54세,31028,15590,15438
202009,41465,경기도,용인시 수지구,50-54세,31180,15680,15500
202010,41465,경기도,용인시 수지구,50-54세,31387,15749,15638
202011,41465,경기도,용인시 수지구,50-54세,31499,15834,15665
202012,41465,경기도,용인시 수지구,50-54세,31520,15884,15636
202101,41465,경기도,용인시 수지구,50-54세,31878,16045,15833
202102,41465,경기도,용인시 수지구,50-54세,32165,16176,15989
202103,41465,경기도,용인시 수지구,50-54세,32289,16229,16060
202104,41465,경기도,용인시 수지구,50-54세,32432,16287,16145
202105,41465,경기도,용인시 수지구,50-54세,32682,16412,16270
202106,41465,경기도,용인시 수지구,50-54세,32866,16522,16344
202007,41465,경기도,용인시 수지구,55-59세,23434,12032,11402
202008,41465,경기도,용인시 수지구,55-59세,23513,12068,11445
202009,41465,경기도,용인시 수지구,55-59세,23502,12050,11452
202010,41465,경기도,용인시 수지구,55-59세,23513,12081,11432
202011,41465,경기도,용인시 수지구,55-59세,23510,12052,11458
202012,41465,경기도,용인시 수지구,55-59세,23549,12027,11522
202101,41465,경기도,용인시 수지구,55-59세,23499,12033,11466
202102,41465,경기도,용인시 수지구,55-59세,23547,12072,11475
202103,41465,경기도,용인시 수지구,55-59세,23609,12105,11504
202104,41465,경기도,용인시 수지구,55-59세,23683,12140,11543
202105,41465,경기도,용인시 수지구,55-59세,23649,12113,11536
202106,41465,경기도,용인시 수지구,55-59세,23581,12067,11514
202007,41465,경기도,용인시 수지구,60-64세,18613,8956,9657
202008,41465,경기도,용인시 수지구,60-64세,18682,8995,9687
202009,41465,경기도,용인시 수지구,60-64세,18730,9027,9703
202010,41465,경기도,용인시 수지구,60-64세,18779,9041,9738
202011,41465,경기도,용인시 수지구,60-64세,18852,9097,9755
202012,41465,경기도,용인시 수지구,60-64세,18948,9162,9786
202101,41465,경기도,용인시 수지구,60-64세,19088,9249,9839
202102,41465,경기도,용인시 수지구,60-64세,19250,9340,9910
202103,41465,경기도,용인시 수지구,60-64세,19354,9390,9964
202104,41465,경기도,용인시 수지구,60-64세,19431,9444,9987
202105,41465,경기도,용인시 수지구,60-64세,19550,9515,10035
202106,41465,경기도,용인시 수지구,60-64세,19629,9560,10069
202007,41465,경기도,용인시 수지구,65-69세,14383,6283,8100
202008,41465,경기도,용인시 수지구,65-69세,14467,6327,8140
202009,41465,경기도,용인시 수지구,65-69세,14559,6385,8174
202010,41465,경기도,용인시 수지구,65-69세,14667,6451,8216
202011,41465,경기도,용인시 수지구,65-69세,14718,6483,8235
202012,41465,경기도,용인시 수지구,65-69세,14771,6509,8262
202101,41465,경기도,용인시 수지구,65-69세,14856,6537,8319
202102,41465,경기도,용인시 수지구,65-69세,14975,6597,8378
202103,41465,경기도,용인시 수지구,65-69세,15049,6642,8407
202104,41465,경기도,용인시 수지구,65-69세,15130,6676,8454
202105,41465,경기도,용인시 수지구,65-69세,15180,6698,8482
202106,41465,경기도,용인시 수지구,65-69세,15227,6707,8520
202007,41465,경기도,용인시 수지구,70-74세,13030,5751,7279
202008,41465,경기도,용인시 수지구,70-74세,13027,5736,7291
202009,41465,경기도,용인시 수지구,70-74세,13058,5716,7342
202010,41465,경기도,용인시 수지구,70-74세,13128,5732,7396
202011,41465,경기도,용인시 수지구,70-74세,13120,5724,7396
202012,41465,경기도,용인시 수지구,70-74세,13128,5736,7392
202101,41465,경기도,용인시 수지구,70-74세,13180,5769,7411
202102,41465,경기도,용인시 수지구,70-74세,13159,5750,7409
202103,41465,경기도,용인시 수지구,70-74세,13131,5733,7398
202104,41465,경기도,용인시 수지구,70-74세,13109,5715,7394
202105,41465,경기도,용인시 수지구,70-74세,13040,5678,7362
202106,41465,경기도,용인시 수지구,70-74세,13011,5667,7344
202007,41465,경기도,용인시 수지구,75-79세,10214,4905,5309
202008,41465,경기도,용인시 수지구,75-79세,10297,4958,5339
202009,41465,경기도,용인시 수지구,75-79세,10280,4965,5315
202010,41465,경기도,용인시 수지구,75-79세,10269,4959,5310
202011,41465,경기도,용인시 수지구,75-79세,10218,4943,5275
202012,41465,경기도,용인시 수지구,75-79세,10193,4907,5286
202101,41465,경기도,용인시 수지구,75-79세,10223,4910,5313
202102,41465,경기도,용인시 수지구,75-79세,10250,4906,5344
202103,41465,경기도,용인시 수지구,75-79세,10232,4887,5345
202104,41465,경기도,용인시 수지구,75-79세,10257,4893,5364
202105,41465,경기도,용인시 수지구,75-79세,10293,4892,5401
202106,41465,경기도,용인시 수지구,75-79세,10318,4884,5434
202007,41465,경기도,용인시 수지구,80-84세,6114,2919,3195
202008,41465,경기도,용인시 수지구,80-84세,6115,2915,3200
202009,41465,경기도,용인시 수지구,80-84세,6169,2943,3226
202010,41465,경기도,용인시 수지구,80-84세,6231,2968,3263
202011,41465,경기도,용인시 수지구,80-84세,6280,3001,3279
202012,41465,경기도,용인시 수지구,80-84세,6356,3053,3303
202101,41465,경기도,용인시 수지구,80-84세,6417,3086,3331
202102,41465,경기도,용인시 수지구,80-84세,6469,3112,3357
202103,41465,경기도,용인시 수지구,80-84세,6505,3131,3374
202104,41465,경기도,용인시 수지구,80-84세,6581,3167,3414
202105,41465,경기도,용인시 수지구,80-84세,6629,3184,3445
202106,41465,경기도,용인시 수지구,80-84세,6692,3210,3482
202007,41465,경기도,용인시 수지구,85-89세,2817,1078,1739
202008,41465,경기도,용인시 수지구,85-89세,2853,1097,1756
202009,41465,경기도,용인시 수지구,85-89세,2875,1107,1768
202010,41465,경기도,용인시 수지구,85-89세,2900,1124,1776
202011,41465,경기도,용인시 수지구,85-89세,2926,1126,1800
202012,41465,경기도,용인시 수지구,85-89세,2939,1130,1809
202101,41465,경기도,용인시 수지구,85-89세,2999,1148,1851
202102,41465,경기도,용인시 수지구,85-89세,3019,1159,1860
202103,41465,경기도,용인시 수지구,85-89세,3067,1176,1891
202104,41465,경기도,용인시 수지구,85-89세,3097,1194,1903
202105,41465,경기도,용인시 수지구,85-89세,3143,1215,1928
202106,41465,경기도,용인시 수지구,85-89세,3139,1216,1923
202007,41465,경기도,용인시 수지구,90-94세,1042,298,744
202008,41465,경기도,용인시 수지구,90-94세,1055,308,747
202009,41465,경기도,용인시 수지구,90-94세,1068,319,749
202010,41465,경기도,용인시 수지구,90-94세,1064,319,745
202011,41465,경기도,용인시 수지구,90-94세,1062,314,748
202012,41465,경기도,용인시 수지구,90-94세,1065,318,747
202101,41465,경기도,용인시 수지구,90-94세,1066,318,748
202102,41465,경기도,용인시 수지구,90-94세,1080,319,761
202103,41465,경기도,용인시 수지구,90-94세,1089,324,765
202104,41465,경기도,용인시 수지구,90-94세,1091,323,768
202105,41465,경기도,용인시 수지구,90-94세,1097,322,775
202106,41465,경기도,용인시 수지구,90-94세,1096,327,769
202007,41465,경기도,용인시 수지구,95-99세,267,64,203
202008,41465,경기도,용인시 수지구,95-99세,268,63,205
202009,41465,경기도,용인시 수지구,95-99세,275,67,208
202010,41465,경기도,용인시 수지구,95-99세,277,68,209
202011,41465,경기도,용인시 수지구,95-99세,269,67,202
202012,41465,경기도,용인시 수지구,95-99세,268,68,200
202101,41465,경기도,용인시 수지구,95-99세,278,71,207
202102,41465,경기도,용인시 수지구,95-99세,279,72,207
202103,41465,경기도,용인시 수지구,95-99세,282,73,209
202104,41465,경기도,용인시 수지구,95-99세,287,75,212
202105,41465,경기도,용인시 수지구,95-99세,289,76,213
202106,41465,경기도,용인시 수지구,95-99세,288,74,214
202007,41465,경기도,용인시 수지구,100+,56,8,48
202008,41465,경기도,용인시 수지구,100+,57,7,50
202009,41465,경기도,용인시 수지구,100+,54,7,47
202010,41465,경기도,용인시 수지구,100+,54,7,47
202011,41465,경기도,용인시 수지구,100+,53,7,46
202012,41465,경기도,용인시 수지구,100+,54,7,47
202101,41465,경기도,용인시 수지구,100+,53,7,46
202102,41465,경기도,용인시 수지구,100+,59,9,50
202103,41465,경기도,용인시 수지구,100+,41,4,37
202104,41465,경기도,용인시 수지구,100+,43,5,38
202105,41465,경기도,용인시 수지구,100+,43,5,38
202106,41465,경기도,용인시 수지구,100+,45,6,39
202007,41480,경기도,파주시,0-4세,18698,9605,9093
202008,41480,경기도,파주시,0-4세,18748,9618,9130
202009,41480,경기도,파주시,0-4세,18801,9640,9161
202010,41480,경기도,파주시,0-4세,18702,9599,9103
202011,41480,경기도,파주시,0-4세,18625,9560,9065
202012,41480,경기도,파주시,0-4세,18504,9502,9002
202101,41480,경기도,파주시,0-4세,18361,9421,8940
202102,41480,경기도,파주시,0-4세,18248,9358,8890
202103,41480,경기도,파주시,0-4세,18140,9293,8847
202104,41480,경기도,파주시,0-4세,18025,9229,8796
202105,41480,경기도,파주시,0-4세,17881,9136,8745
202106,41480,경기도,파주시,0-4세,17778,9063,8715
202007,41480,경기도,파주시,5-9세,25661,13027,12634
202008,41480,경기도,파주시,5-9세,25782,13114,12668
202009,41480,경기도,파주시,5-9세,25795,13132,12663
202010,41480,경기도,파주시,5-9세,25822,13140,12682
202011,41480,경기도,파주시,5-9세,25793,13144,12649
202012,41480,경기도,파주시,5-9세,25810,13152,12658
202101,41480,경기도,파주시,5-9세,25703,13089,12614
202102,41480,경기도,파주시,5-9세,25731,13096,12635
202103,41480,경기도,파주시,5-9세,25715,13115,12600
202104,41480,경기도,파주시,5-9세,25719,13104,12615
202105,41480,경기도,파주시,5-9세,25722,13139,12583
202106,41480,경기도,파주시,5-9세,25757,13162,12595
202007,41480,경기도,파주시,10-14세,24504,12511,11993
202008,41480,경기도,파주시,10-14세,24668,12583,12085
202009,41480,경기도,파주시,10-14세,24841,12661,12180
202010,41480,경기도,파주시,10-14세,25038,12766,12272
202011,41480,경기도,파주시,10-14세,25196,12817,12379
202012,41480,경기도,파주시,10-14세,25369,12927,12442
202101,41480,경기도,파주시,10-14세,25547,13028,12519
202102,41480,경기도,파주시,10-14세,25618,13047,12571
202103,41480,경기도,파주시,10-14세,25751,13096,12655
202104,41480,경기도,파주시,10-14세,25890,13182,12708
202105,41480,경기도,파주시,10-14세,25914,13192,12722
202106,41480,경기도,파주시,10-14세,25943,13223,12720
202007,41480,경기도,파주시,15-19세,23777,12401,11376
202008,41480,경기도,파주시,15-19세,23776,12385,11391
202009,41480,경기도,파주시,15-19세,23779,12369,11410
202010,41480,경기도,파주시,15-19세,23756,12346,11410
202011,41480,경기도,파주시,15-19세,23735,12329,11406
202012,41480,경기도,파주시,15-19세,23693,12309,11384
202101,41480,경기도,파주시,15-19세,23649,12275,11374
202102,41480,경기도,파주시,15-19세,23647,12290,11357
202103,41480,경기도,파주시,15-19세,23554,12234,11320
202104,41480,경기도,파주시,15-19세,23541,12220,11321
202105,41480,경기도,파주시,15-19세,23527,12204,11323
202106,41480,경기도,파주시,15-19세,23524,12182,11342
202007,41480,경기도,파주시,20-24세,26501,14158,12343
202008,41480,경기도,파주시,20-24세,26547,14189,12358
202009,41480,경기도,파주시,20-24세,26640,14245,12395
202010,41480,경기도,파주시,20-24세,26740,14298,12442
202011,41480,경기도,파주시,20-24세,26846,14387,12459
202012,41480,경기도,파주시,20-24세,26894,14383,12511
202101,41480,경기도,파주시,20-24세,27009,14425,12584
202102,41480,경기도,파주시,20-24세,27058,14409,12649
202103,41480,경기도,파주시,20-24세,27127,14461,12666
202104,41480,경기도,파주시,20-24세,27293,14568,12725
202105,41480,경기도,파주시,20-24세,27341,14618,12723
202106,41480,경기도,파주시,20-24세,27440,14677,12763
202007,41480,경기도,파주시,25-29세,29300,15300,14000
202008,41480,경기도,파주시,25-29세,29470,15380,14090
202009,41480,경기도,파주시,25-29세,29645,15475,14170
202010,41480,경기도,파주시,25-29세,29774,15575,14199
202011,41480,경기도,파주시,25-29세,29849,15639,14210
202012,41480,경기도,파주시,25-29세,29982,15747,14235
202101,41480,경기도,파주시,25-29세,29936,15778,14158
202102,41480,경기도,파주시,25-29세,29953,15782,14171
202103,41480,경기도,파주시,25-29세,30167,15943,14224
202104,41480,경기도,파주시,25-29세,30358,16058,14300
202105,41480,경기도,파주시,25-29세,30468,16111,14357
202106,41480,경기도,파주시,25-29세,30564,16191,14373
202007,41480,경기도,파주시,30-34세,29430,15920,13510
202008,41480,경기도,파주시,30-34세,29554,15898,13656
202009,41480,경기도,파주시,30-34세,29626,15885,13741
202010,41480,경기도,파주시,30-34세,29649,15894,13755
202011,41480,경기도,파주시,30-34세,29648,15841,13807
202012,41480,경기도,파주시,30-34세,29691,15845,13846
202101,41480,경기도,파주시,30-34세,29619,15750,13869
202102,41480,경기도,파주시,30-34세,29579,15700,13879
202103,41480,경기도,파주시,30-34세,29757,15742,14015
202104,41480,경기도,파주시,30-34세,29962,15852,14110
202105,41480,경기도,파주시,30-34세,30150,15942,14208
202106,41480,경기도,파주시,30-34세,30251,15990,14261
202007,41480,경기도,파주시,35-39세,36960,19387,17573
202008,41480,경기도,파주시,35-39세,37244,19564,17680
202009,41480,경기도,파주시,35-39세,37300,19585,17715
202010,41480,경기도,파주시,35-39세,37370,19613,17757
202011,41480,경기도,파주시,35-39세,37376,19654,17722
202012,41480,경기도,파주시,35-39세,37344,19579,17765
202101,41480,경기도,파주시,35-39세,37312,19610,17702
202102,41480,경기도,파주시,35-39세,37213,19618,17595
202103,41480,경기도,파주시,35-39세,37135,19605,17530
202104,41480,경기도,파주시,35-39세,37054,19582,17472
202105,41480,경기도,파주시,35-39세,36940,19509,17431
202106,41480,경기도,파주시,35-39세,36822,19421,17401
202007,41480,경기도,파주시,40-44세,37513,19157,18356
202008,41480,경기도,파주시,40-44세,37819,19344,18475
202009,41480,경기도,파주시,40-44세,38227,19545,18682
202010,41480,경기도,파주시,40-44세,38517,19708,18809
202011,41480,경기도,파주시,40-44세,38735,19809,18926
202012,41480,경기도,파주시,40-44세,38803,19850,18953
202101,41480,경기도,파주시,40-44세,38843,19842,19001
202102,41480,경기도,파주시,40-44세,39158,19986,19172
202103,41480,경기도,파주시,40-44세,39144,19993,19151
202104,41480,경기도,파주시,40-44세,39334,20065,19269
202105,41480,경기도,파주시,40-44세,39530,20210,19320
202106,41480,경기도,파주시,40-44세,39875,20410,19465
202007,41480,경기도,파주시,45-49세,41792,21586,20206
202008,41480,경기도,파주시,45-49세,41885,21583,20302
202009,41480,경기도,파주시,45-49세,41856,21608,20248
202010,41480,경기도,파주시,45-49세,41854,21588,20266
202011,41480,경기도,파주시,45-49세,41853,21519,20334
202012,41480,경기도,파주시,45-49세,42037,21606,20431
202101,41480,경기도,파주시,45-49세,41962,21577,20385
202102,41480,경기도,파주시,45-49세,41953,21571,20382
202103,41480,경기도,파주시,45-49세,41868,21492,20376
202104,41480,경기도,파주시,45-49세,41948,21531,20417
202105,41480,경기도,파주시,45-49세,41805,21435,20370
202106,41480,경기도,파주시,45-49세,41628,21350,20278
202007,41480,경기도,파주시,50-54세,37588,19828,17760
202008,41480,경기도,파주시,50-54세,37821,19963,17858
202009,41480,경기도,파주시,50-54세,38110,20069,18041
202010,41480,경기도,파주시,50-54세,38389,20191,18198
202011,41480,경기도,파주시,50-54세,38659,20364,18295
202012,41480,경기도,파주시,50-54세,38726,20411,18315
202101,41480,경기도,파주시,50-54세,39131,20614,18517
202102,41480,경기도,파주시,50-54세,39471,20746,18725
202103,41480,경기도,파주시,50-54세,39585,20803,18782
202104,41480,경기도,파주시,50-54세,39808,20889,18919
202105,41480,경기도,파주시,50-54세,40175,21066,19109
202106,41480,경기도,파주시,50-54세,40403,21168,19235
202007,41480,경기도,파주시,55-59세,33509,17403,16106
202008,41480,경기도,파주시,55-59세,33633,17463,16170
202009,41480,경기도,파주시,55-59세,33816,17582,16234
202010,41480,경기도,파주시,55-59세,34012,17707,16305
202011,41480,경기도,파주시,55-59세,34055,17726,16329
202012,41480,경기도,파주시,55-59세,34126,17763,16363
202101,41480,경기도,파주시,55-59세,34101,17749,16352
202102,41480,경기도,파주시,55-59세,34222,17819,16403
202103,41480,경기도,파주시,55-59세,34340,17906,16434
202104,41480,경기도,파주시,55-59세,34426,17969,16457
202105,41480,경기도,파주시,55-59세,34367,17916,16451
202106,41480,경기도,파주시,55-59세,34266,17889,16377
202007,41480,경기도,파주시,60-64세,28467,14379,14088
202008,41480,경기도,파주시,60-64세,28704,14508,14196
202009,41480,경기도,파주시,60-64세,28982,14642,14340
202010,41480,경기도,파주시,60-64세,29201,14787,14414
202011,41480,경기도,파주시,60-64세,29482,14910,14572
202012,41480,경기도,파주시,60-64세,29723,15027,14696
202101,41480,경기도,파주시,60-64세,30024,15172,14852
202102,41480,경기도,파주시,60-64세,30292,15312,14980
202103,41480,경기도,파주시,60-64세,30498,15445,15053
202104,41480,경기도,파주시,60-64세,30758,15603,15155
202105,41480,경기도,파주시,60-64세,31066,15782,15284
202106,41480,경기도,파주시,60-64세,31396,15945,15451
202007,41480,경기도,파주시,65-69세,18764,9078,9686
202008,41480,경기도,파주시,65-69세,18964,9169,9795
202009,41480,경기도,파주시,65-69세,19178,9281,9897
202010,41480,경기도,파주시,65-69세,19420,9388,10032
202011,41480,경기도,파주시,65-69세,19532,9465,10067
202012,41480,경기도,파주시,65-69세,19695,9532,10163
202101,41480,경기도,파주시,65-69세,19894,9626,10268
202102,41480,경기도,파주시,65-69세,20165,9788,10377
202103,41480,경기도,파주시,65-69세,20345,9893,10452
202104,41480,경기도,파주시,65-69세,20509,9977,10532
202105,41480,경기도,파주시,65-69세,20709,10073,10636
202106,41480,경기도,파주시,65-69세,20872,10148,10724
202007,41480,경기도,파주시,70-74세,15142,6912,8230
202008,41480,경기도,파주시,70-74세,15174,6918,8256
202009,41480,경기도,파주시,70-74세,15257,6945,8312
202010,41480,경기도,파주시,70-74세,15374,7003,8371
202011,41480,경기도,파주시,70-74세,15468,7047,8421
202012,41480,경기도,파주시,70-74세,15569,7083,8486
202101,41480,경기도,파주시,70-74세,15640,7123,8517
202102,41480,경기도,파주시,70-74세,15653,7108,8545
202103,41480,경기도,파주시,70-74세,15593,7106,8487
202104,41480,경기도,파주시,70-74세,15620,7121,8499
202105,41480,경기도,파주시,70-74세,15653,7140,8513
202106,41480,경기도,파주시,70-74세,15640,7116,8524
202007,41480,경기도,파주시,75-79세,13346,5608,7738
202008,41480,경기도,파주시,75-79세,13386,5622,7764
202009,41480,경기도,파주시,75-79세,13364,5635,7729
202010,41480,경기도,파주시,75-79세,13274,5585,7689
202011,41480,경기도,파주시,75-79세,13254,5577,7677
202012,41480,경기도,파주시,75-79세,13212,5567,7645
202101,41480,경기도,파주시,75-79세,13207,5580,7627
202102,41480,경기도,파주시,75-79세,13213,5589,7624
202103,41480,경기도,파주시,75-79세,13128,5550,7578
202104,41480,경기도,파주시,75-79세,13104,5548,7556
202105,41480,경기도,파주시,75-79세,13123,5568,7555
202106,41480,경기도,파주시,75-79세,13117,5549,7568
202007,41480,경기도,파주시,80-84세,9243,3559,5684
202008,41480,경기도,파주시,80-84세,9290,3583,5707
202009,41480,경기도,파주시,80-84세,9327,3590,5737
202010,41480,경기도,파주시,80-84세,9409,3636,5773
202011,41480,경기도,파주시,80-84세,9459,3642,5817
202012,41480,경기도,파주시,80-84세,9484,3644,5840
202101,41480,경기도,파주시,80-84세,9561,3679,5882
202102,41480,경기도,파주시,80-84세,9635,3709,5926
202103,41480,경기도,파주시,80-84세,9617,3712,5905
202104,41480,경기도,파주시,80-84세,9657,3731,5926
202105,41480,경기도,파주시,80-84세,9696,3744,5952
202106,41480,경기도,파주시,80-84세,9784,3786,5998
202007,41480,경기도,파주시,85-89세,4410,1449,2961
202008,41480,경기도,파주시,85-89세,4487,1465,3022
202009,41480,경기도,파주시,85-89세,4548,1483,3065
202010,41480,경기도,파주시,85-89세,4595,1501,3094
202011,41480,경기도,파주시,85-89세,4631,1511,3120
202012,41480,경기도,파주시,85-89세,4684,1528,3156
202101,41480,경기도,파주시,85-89세,4733,1544,3189
202102,41480,경기도,파주시,85-89세,4826,1585,3241
202103,41480,경기도,파주시,85-89세,4887,1591,3296
202104,41480,경기도,파주시,85-89세,4933,1608,3325
202105,41480,경기도,파주시,85-89세,4986,1627,3359
202106,41480,경기도,파주시,85-89세,5018,1634,3384
202007,41480,경기도,파주시,90-94세,1604,412,1192
202008,41480,경기도,파주시,90-94세,1624,425,1199
202009,41480,경기도,파주시,90-94세,1626,429,1197
202010,41480,경기도,파주시,90-94세,1662,441,1221
202011,41480,경기도,파주시,90-94세,1656,445,1211
202012,41480,경기도,파주시,90-94세,1673,448,1225
202101,41480,경기도,파주시,90-94세,1704,459,1245
202102,41480,경기도,파주시,90-94세,1709,454,1255
202103,41480,경기도,파주시,90-94세,1686,449,1237
202104,41480,경기도,파주시,90-94세,1695,451,1244
202105,41480,경기도,파주시,90-94세,1700,451,1249
202106,41480,경기도,파주시,90-94세,1708,451,1257
202007,41480,경기도,파주시,95-99세,385,86,299
202008,41480,경기도,파주시,95-99세,386,86,300
202009,41480,경기도,파주시,95-99세,399,88,311
202010,41480,경기도,파주시,95-99세,399,88,311
202011,41480,경기도,파주시,95-99세,403,90,313
202012,41480,경기도,파주시,95-99세,402,86,316
202101,41480,경기도,파주시,95-99세,404,87,317
202102,41480,경기도,파주시,95-99세,410,91,319
202103,41480,경기도,파주시,95-99세,380,78,302
202104,41480,경기도,파주시,95-99세,386,81,305
202105,41480,경기도,파주시,95-99세,391,78,313
202106,41480,경기도,파주시,95-99세,400,81,319
202007,41480,경기도,파주시,100+,194,59,135
202008,41480,경기도,파주시,100+,196,59,137
202009,41480,경기도,파주시,100+,197,60,137
202010,41480,경기도,파주시,100+,198,61,137
202011,41480,경기도,파주시,100+,198,61,137
202012,41480,경기도,파주시,100+,196,60,136
202101,41480,경기도,파주시,100+,199,60,139
202102,41480,경기도,파주시,100+,200,60,140
202103,41480,경기도,파주시,100+,84,21,63
202104,41480,경기도,파주시,100+,76,20,56
202105,41480,경기도,파주시,100+,75,19,56
202106,41480,경기도,파주시,100+,74,18,56
202007,41500,경기도,이천시,0-4세,8343,4299,4044
202008,41500,경기도,이천시,0-4세,8261,4278,3983
202009,41500,경기도,이천시,0-4세,8170,4232,3938
202010,41500,경기도,이천시,0-4세,8080,4196,3884
202011,41500,경기도,이천시,0-4세,8010,4169,3841
202012,41500,경기도,이천시,0-4세,7949,4120,3829
202101,41500,경기도,이천시,0-4세,7874,4072,3802
202102,41500,경기도,이천시,0-4세,7801,4030,3771
202103,41500,경기도,이천시,0-4세,7716,3994,3722
202104,41500,경기도,이천시,0-4세,7665,3963,3702
202105,41500,경기도,이천시,0-4세,7597,3932,3665
202106,41500,경기도,이천시,0-4세,7557,3924,3633
202007,41500,경기도,이천시,5-9세,11011,5667,5344
202008,41500,경기도,이천시,5-9세,10993,5666,5327
202009,41500,경기도,이천시,5-9세,10999,5672,5327
202010,41500,경기도,이천시,5-9세,10951,5638,5313
202011,41500,경기도,이천시,5-9세,10895,5613,5282
202012,41500,경기도,이천시,5-9세,10874,5609,5265
202101,41500,경기도,이천시,5-9세,10815,5581,5234
202102,41500,경기도,이천시,5-9세,10811,5599,5212
202103,41500,경기도,이천시,5-9세,10799,5589,5210
202104,41500,경기도,이천시,5-9세,10757,5572,5185
202105,41500,경기도,이천시,5-9세,10761,5558,5203
202106,41500,경기도,이천시,5-9세,10749,5536,5213
202007,41500,경기도,이천시,10-14세,10784,5587,5197
202008,41500,경기도,이천시,10-14세,10787,5591,5196
202009,41500,경기도,이천시,10-14세,10820,5606,5214
202010,41500,경기도,이천시,10-14세,10847,5613,5234
202011,41500,경기도,이천시,10-14세,10858,5616,5242
202012,41500,경기도,이천시,10-14세,10880,5626,5254
202101,41500,경기도,이천시,10-14세,10922,5651,5271
202102,41500,경기도,이천시,10-14세,10883,5620,5263
202103,41500,경기도,이천시,10-14세,10921,5636,5285
202104,41500,경기도,이천시,10-14세,10935,5636,5299
202105,41500,경기도,이천시,10-14세,10988,5679,5309
202106,41500,경기도,이천시,10-14세,10976,5683,5293
202007,41500,경기도,이천시,15-19세,12846,6861,5985
202008,41500,경기도,이천시,15-19세,13028,6964,6064
202009,41500,경기도,이천시,15-19세,12843,6840,6003
202010,41500,경기도,이천시,15-19세,12704,6767,5937
202011,41500,경기도,이천시,15-19세,12579,6710,5869
202012,41500,경기도,이천시,15-19세,11351,5933,5418
202101,41500,경기도,이천시,15-19세,11120,5808,5312
202102,41500,경기도,이천시,15-19세,11011,5730,5281
202103,41500,경기도,이천시,15-19세,11035,5751,5284
202104,41500,경기도,이천시,15-19세,11281,5930,5351
202105,41500,경기도,이천시,15-19세,11257,5919,5338
202106,41500,경기도,이천시,15-19세,12173,6435,5738
202007,41500,경기도,이천시,20-24세,13627,7436,6191
202008,41500,경기도,이천시,20-24세,13730,7517,6213
202009,41500,경기도,이천시,20-24세,13726,7532,6194
202010,41500,경기도,이천시,20-24세,13797,7549,6248
202011,41500,경기도,이천시,20-24세,13830,7551,6279
202012,41500,경기도,이천시,20-24세,13604,7430,6174
202101,41500,경기도,이천시,20-24세,13632,7424,6208
202102,41500,경기도,이천시,20-24세,13610,7407,6203
202103,41500,경기도,이천시,20-24세,13557,7364,6193
202104,41500,경기도,이천시,20-24세,13574,7383,6191
202105,41500,경기도,이천시,20-24세,13586,7399,6187
202106,41500,경기도,이천시,20-24세,13687,7453,6234
202007,41500,경기도,이천시,25-29세,16112,9380,6732
202008,41500,경기도,이천시,25-29세,16164,9398,6766
202009,41500,경기도,이천시,25-29세,16187,9404,6783
202010,41500,경기도,이천시,25-29세,16229,9474,6755
202011,41500,경기도,이천시,25-29세,16342,9520,6822
202012,41500,경기도,이천시,25-29세,16501,9607,6894
202101,41500,경기도,이천시,25-29세,16625,9713,6912
202102,41500,경기도,이천시,25-29세,16672,9752,6920
202103,41500,경기도,이천시,25-29세,16743,9783,6960
202104,41500,경기도,이천시,25-29세,16825,9844,6981
202105,41500,경기도,이천시,25-29세,16861,9850,7011
202106,41500,경기도,이천시,25-29세,16866,9858,7008
202007,41500,경기도,이천시,30-34세,14405,7645,6760
202008,41500,경기도,이천시,30-34세,14430,7680,6750
202009,41500,경기도,이천시,30-34세,14391,7675,6716
202010,41500,경기도,이천시,30-34세,14299,7638,6661
202011,41500,경기도,이천시,30-34세,14261,7638,6623
202012,41500,경기도,이천시,30-34세,14274,7657,6617
202101,41500,경기도,이천시,30-34세,14323,7683,6640
202102,41500,경기도,이천시,30-34세,14277,7700,6577
202103,41500,경기도,이천시,30-34세,14253,7697,6556
202104,41500,경기도,이천시,30-34세,14312,7748,6564
202105,41500,경기도,이천시,30-34세,14390,7806,6584
202106,41500,경기도,이천시,30-34세,14482,7855,6627
202007,41500,경기도,이천시,35-39세,16281,8774,7507
202008,41500,경기도,이천시,35-39세,16289,8771,7518
202009,41500,경기도,이천시,35-39세,16283,8754,7529
202010,41500,경기도,이천시,35-39세,16230,8715,7515
202011,41500,경기도,이천시,35-39세,16237,8712,7525
202012,41500,경기도,이천시,35-39세,16252,8720,7532
202101,41500,경기도,이천시,35-39세,16217,8689,7528
202102,41500,경기도,이천시,35-39세,16198,8645,7553
202103,41500,경기도,이천시,35-39세,16125,8623,7502
202104,41500,경기도,이천시,35-39세,16096,8617,7479
202105,41500,경기도,이천시,35-39세,16005,8551,7454
202106,41500,경기도,이천시,35-39세,15952,8522,7430
202007,41500,경기도,이천시,40-44세,16938,8543,8395
202008,41500,경기도,이천시,40-44세,16951,8565,8386
202009,41500,경기도,이천시,40-44세,16974,8590,8384
202010,41500,경기도,이천시,40-44세,17020,8624,8396
202011,41500,경기도,이천시,40-44세,17036,8658,8378
202012,41500,경기도,이천시,40-44세,16967,8653,8314
202101,41500,경기도,이천시,40-44세,16962,8685,8277
202102,41500,경기도,이천시,40-44세,17002,8729,8273
202103,41500,경기도,이천시,40-44세,16938,8719,8219
202104,41500,경기도,이천시,40-44세,16933,8727,8206
202105,41500,경기도,이천시,40-44세,17021,8795,8226
202106,41500,경기도,이천시,40-44세,17089,8825,8264
202007,41500,경기도,이천시,45-49세,17906,9460,8446
202008,41500,경기도,이천시,45-49세,17907,9437,8470
202009,41500,경기도,이천시,45-49세,17837,9394,8443
202010,41500,경기도,이천시,45-49세,17739,9323,8416
202011,41500,경기도,이천시,45-49세,17686,9280,8406
202012,41500,경기도,이천시,45-49세,17723,9287,8436
202101,41500,경기도,이천시,45-49세,17751,9263,8488
202102,41500,경기도,이천시,45-49세,17765,9241,8524
202103,41500,경기도,이천시,45-49세,17728,9211,8517
202104,41500,경기도,이천시,45-49세,17800,9215,8585
202105,41500,경기도,이천시,45-49세,17687,9154,8533
202106,41500,경기도,이천시,45-49세,17653,9137,8516
202007,41500,경기도,이천시,50-54세,17915,9249,8666
202008,41500,경기도,이천시,50-54세,17911,9267,8644
202009,41500,경기도,이천시,50-54세,17981,9302,8679
202010,41500,경기도,이천시,50-54세,18070,9360,8710
202011,41500,경기도,이천시,50-54세,18066,9352,8714
202012,41500,경기도,이천시,50-54세,18039,9328,8711
202101,41500,경기도,이천시,50-54세,18187,9430,8757
202102,41500,경기도,이천시,50-54세,18192,9424,8768
202103,41500,경기도,이천시,50-54세,18103,9383,8720
202104,41500,경기도,이천시,50-54세,18106,9413,8693
202105,41500,경기도,이천시,50-54세,18264,9483,8781
202106,41500,경기도,이천시,50-54세,18335,9513,8822
202007,41500,경기도,이천시,55-59세,17240,9009,8231
202008,41500,경기도,이천시,55-59세,17286,9032,8254
202009,41500,경기도,이천시,55-59세,17321,9063,8258
202010,41500,경기도,이천시,55-59세,17305,9049,8256
202011,41500,경기도,이천시,55-59세,17232,9005,8227
202012,41500,경기도,이천시,55-59세,17207,8999,8208
202101,41500,경기도,이천시,55-59세,17127,8942,8185
202102,41500,경기도,이천시,55-59세,17144,8964,8180
202103,41500,경기도,이천시,55-59세,17083,8946,8137
202104,41500,경기도,이천시,55-59세,17023,8895,8128
202105,41500,경기도,이천시,55-59세,16904,8836,8068
202106,41500,경기도,이천시,55-59세,16793,8782,8011
202007,41500,경기도,이천시,60-64세,15121,7841,7280
202008,41500,경기도,이천시,60-64세,15224,7887,7337
202009,41500,경기도,이천시,60-64세,15250,7891,7359
202010,41500,경기도,이천시,60-64세,15342,7947,7395
202011,41500,경기도,이천시,60-64세,15487,8014,7473
202012,41500,경기도,이천시,60-64세,15633,8064,7569
202101,41500,경기도,이천시,60-64세,15728,8109,7619
202102,41500,경기도,이천시,60-64세,15893,8181,7712
202103,41500,경기도,이천시,60-64세,16029,8249,7780
202104,41500,경기도,이천시,60-64세,16213,8360,7853
202105,41500,경기도,이천시,60-64세,16400,8475,7925
202106,41500,경기도,이천시,60-64세,16552,8554,7998
202007,41500,경기도,이천시,65-69세,9827,4875,4952
202008,41500,경기도,이천시,65-69세,9926,4940,4986
202009,41500,경기도,이천시,65-69세,10070,5012,5058
202010,41500,경기도,이천시,65-69세,10160,5058,5102
202011,41500,경기도,이천시,65-69세,10223,5092,5131
202012,41500,경기도,이천시,65-69세,10314,5164,5150
202101,41500,경기도,이천시,65-69세,10457,5260,5197
202102,41500,경기도,이천시,65-69세,10530,5309,5221
202103,41500,경기도,이천시,65-69세,10657,5392,5265
202104,41500,경기도,이천시,65-69세,10765,5448,5317
202105,41500,경기도,이천시,65-69세,10882,5508,5374
202106,41500,경기도,이천시,65-69세,11000,5571,5429
202007,41500,경기도,이천시,70-74세,7067,3430,3637
202008,41500,경기도,이천시,70-74세,7074,3426,3648
202009,41500,경기도,이천시,70-74세,7096,3442,3654
202010,41500,경기도,이천시,70-74세,7143,3465,3678
202011,41500,경기도,이천시,70-74세,7181,3481,3700
202012,41500,경기도,이천시,70-74세,7223,3493,3730
202101,41500,경기도,이천시,70-74세,7290,3516,3774
202102,41500,경기도,이천시,70-74세,7336,3532,3804
202103,41500,경기도,이천시,70-74세,7301,3500,3801
202104,41500,경기도,이천시,70-74세,7302,3504,3798
202105,41500,경기도,이천시,70-74세,7298,3491,3807
202106,41500,경기도,이천시,70-74세,7300,3497,3803
202007,41500,경기도,이천시,75-79세,5915,2556,3359
202008,41500,경기도,이천시,75-79세,5936,2562,3374
202009,41500,경기도,이천시,75-79세,5904,2547,3357
202010,41500,경기도,이천시,75-79세,5904,2547,3357
202011,41500,경기도,이천시,75-79세,5880,2537,3343
202012,41500,경기도,이천시,75-79세,5842,2520,3322
202101,41500,경기도,이천시,75-79세,5824,2519,3305
202102,41500,경기도,이천시,75-79세,5787,2508,3279
202103,41500,경기도,이천시,75-79세,5758,2509,3249
202104,41500,경기도,이천시,75-79세,5757,2517,3240
202105,41500,경기도,이천시,75-79세,5766,2530,3236
202106,41500,경기도,이천시,75-79세,5788,2545,3243
202007,41500,경기도,이천시,80-84세,4377,1689,2688
202008,41500,경기도,이천시,80-84세,4389,1708,2681
202009,41500,경기도,이천시,80-84세,4408,1722,2686
202010,41500,경기도,이천시,80-84세,4394,1724,2670
202011,41500,경기도,이천시,80-84세,4411,1731,2680
202012,41500,경기도,이천시,80-84세,4401,1729,2672
202101,41500,경기도,이천시,80-84세,4410,1728,2682
202102,41500,경기도,이천시,80-84세,4457,1746,2711
202103,41500,경기도,이천시,80-84세,4442,1732,2710
202104,41500,경기도,이천시,80-84세,4490,1751,2739
202105,41500,경기도,이천시,80-84세,4510,1764,2746
202106,41500,경기도,이천시,80-84세,4526,1760,2766
202007,41500,경기도,이천시,85-89세,2243,727,1516
202008,41500,경기도,이천시,85-89세,2249,723,1526
202009,41500,경기도,이천시,85-89세,2260,726,1534
202010,41500,경기도,이천시,85-89세,2288,727,1561
202011,41500,경기도,이천시,85-89세,2305,735,1570
202012,41500,경기도,이천시,85-89세,2341,750,1591
202101,41500,경기도,이천시,85-89세,2360,765,1595
202102,41500,경기도,이천시,85-89세,2383,780,1603
202103,41500,경기도,이천시,85-89세,2394,779,1615
202104,41500,경기도,이천시,85-89세,2412,785,1627
202105,41500,경기도,이천시,85-89세,2434,784,1650
202106,41500,경기도,이천시,85-89세,2446,793,1653
202007,41500,경기도,이천시,90-94세,727,171,556
202008,41500,경기도,이천시,90-94세,731,173,558
202009,41500,경기도,이천시,90-94세,732,176,556
202010,41500,경기도,이천시,90-94세,733,177,556
202011,41500,경기도,이천시,90-94세,730,178,552
202012,41500,경기도,이천시,90-94세,741,183,558
202101,41500,경기도,이천시,90-94세,750,183,567
202102,41500,경기도,이천시,90-94세,760,184,576
202103,41500,경기도,이천시,90-94세,747,175,572
202104,41500,경기도,이천시,90-94세,741,174,567
202105,41500,경기도,이천시,90-94세,746,177,569
202106,41500,경기도,이천시,90-94세,749,176,573
202007,41500,경기도,이천시,95-99세,205,54,151
202008,41500,경기도,이천시,95-99세,208,55,153
202009,41500,경기도,이천시,95-99세,215,57,158
202010,41500,경기도,이천시,95-99세,215,58,157
202011,41500,경기도,이천시,95-99세,213,57,156
202012,41500,경기도,이천시,95-99세,209,56,153
202101,41500,경기도,이천시,95-99세,213,54,159
202102,41500,경기도,이천시,95-99세,216,55,161
202103,41500,경기도,이천시,95-99세,203,47,156
202104,41500,경기도,이천시,95-99세,203,48,155
202105,41500,경기도,이천시,95-99세,201,47,154
202106,41500,경기도,이천시,95-99세,198,45,153
202007,41500,경기도,이천시,100+,64,18,46
202008,41500,경기도,이천시,100+,63,18,45
202009,41500,경기도,이천시,100+,64,18,46
202010,41500,경기도,이천시,100+,63,18,45
202011,41500,경기도,이천시,100+,63,19,44
202012,41500,경기도,이천시,100+,63,19,44
202101,41500,경기도,이천시,100+,64,20,44
202102,41500,경기도,이천시,100+,65,20,45
202103,41500,경기도,이천시,100+,33,8,25
202104,41500,경기도,이천시,100+,34,8,26
202105,41500,경기도,이천시,100+,33,7,26
202106,41500,경기도,이천시,100+,33,7,26
202007,41550,경기도,안성시,0-4세,5891,3026,2865
202008,41550,경기도,안성시,0-4세,5846,3003,2843
202009,41550,경기도,안성시,0-4세,5811,2988,2823
202010,41550,경기도,안성시,0-4세,5733,2951,2782
202011,41550,경기도,안성시,0-4세,5679,2935,2744
202012,41550,경기도,안성시,0-4세,5624,2911,2713
202101,41550,경기도,안성시,0-4세,5604,2899,2705
202102,41550,경기도,안성시,0-4세,5555,2876,2679
202103,41550,경기도,안성시,0-4세,5519,2859,2660
202104,41550,경기도,안성시,0-4세,5475,2846,2629
202105,41550,경기도,안성시,0-4세,5421,2804,2617
202106,41550,경기도,안성시,0-4세,5380,2787,2593
202007,41550,경기도,안성시,5-9세,8545,4387,4158
202008,41550,경기도,안성시,5-9세,8532,4390,4142
202009,41550,경기도,안성시,5-9세,8467,4349,4118
202010,41550,경기도,안성시,5-9세,8460,4346,4114
202011,41550,경기도,안성시,5-9세,8416,4316,4100
202012,41550,경기도,안성시,5-9세,8424,4308,4116
202101,41550,경기도,안성시,5-9세,8369,4283,4086
202102,41550,경기도,안성시,5-9세,8317,4246,4071
202103,41550,경기도,안성시,5-9세,8277,4235,4042
202104,41550,경기도,안성시,5-9세,8232,4204,4028
202105,41550,경기도,안성시,5-9세,8220,4213,4007
202106,41550,경기도,안성시,5-9세,8208,4199,4009
202007,41550,경기도,안성시,10-14세,8782,4531,4251
202008,41550,경기도,안성시,10-14세,8803,4524,4279
202009,41550,경기도,안성시,10-14세,8816,4535,4281
202010,41550,경기도,안성시,10-14세,8825,4545,4280
202011,41550,경기도,안성시,10-14세,8840,4552,4288
202012,41550,경기도,안성시,10-14세,8875,4580,4295
202101,41550,경기도,안성시,10-14세,8897,4584,4313
202102,41550,경기도,안성시,10-14세,8913,4602,4311
202103,41550,경기도,안성시,10-14세,8955,4605,4350
202104,41550,경기도,안성시,10-14세,9006,4639,4367
202105,41550,경기도,안성시,10-14세,9012,4637,4375
202106,41550,경기도,안성시,10-14세,9008,4635,4373
202007,41550,경기도,안성시,15-19세,9715,5120,4595
202008,41550,경기도,안성시,15-19세,9776,5153,4623
202009,41550,경기도,안성시,15-19세,9687,5099,4588
202010,41550,경기도,안성시,15-19세,9516,4998,4518
202011,41550,경기도,안성시,15-19세,9395,4922,4473
202012,41550,경기도,안성시,15-19세,9124,4760,4364
202101,41550,경기도,안성시,15-19세,9011,4722,4289
202102,41550,경기도,안성시,15-19세,8972,4698,4274
202103,41550,경기도,안성시,15-19세,8971,4715,4256
202104,41550,경기도,안성시,15-19세,9070,4803,4267
202105,41550,경기도,안성시,15-19세,9258,4895,4363
202106,41550,경기도,안성시,15-19세,9268,4877,4391
202007,41550,경기도,안성시,20-24세,11221,6008,5213
202008,41550,경기도,안성시,20-24세,11310,6064,5246
202009,41550,경기도,안성시,20-24세,11361,6093,5268
202010,41550,경기도,안성시,20-24세,11371,6065,5306
202011,41550,경기도,안성시,20-24세,11383,6049,5334
202012,41550,경기도,안성시,20-24세,11386,6034,5352
202101,41550,경기도,안성시,20-24세,11405,6046,5359
202102,41550,경기도,안성시,20-24세,11483,6092,5391
202103,41550,경기도,안성시,20-24세,11487,6109,5378
202104,41550,경기도,안성시,20-24세,11478,6121,5357
202105,41550,경기도,안성시,20-24세,11514,6140,5374
202106,41550,경기도,안성시,20-24세,11569,6131,5438
202007,41550,경기도,안성시,25-29세,10816,6154,4662
202008,41550,경기도,안성시,25-29세,10880,6205,4675
202009,41550,경기도,안성시,25-29세,10961,6253,4708
202010,41550,경기도,안성시,25-29세,11016,6283,4733
202011,41550,경기도,안성시,25-29세,11088,6335,4753
202012,41550,경기도,안성시,25-29세,11158,6372,4786
202101,41550,경기도,안성시,25-29세,11180,6385,4795
202102,41550,경기도,안성시,25-29세,11178,6387,4791
202103,41550,경기도,안성시,25-29세,11256,6438,4818
202104,41550,경기도,안성시,25-29세,11327,6497,4830
202105,41550,경기도,안성시,25-29세,11436,6572,4864
202106,41550,경기도,안성시,25-29세,11484,6616,4868
202007,41550,경기도,안성시,30-34세,10063,5526,4537
202008,41550,경기도,안성시,30-34세,10082,5526,4556
202009,41550,경기도,안성시,30-34세,10091,5557,4534
202010,41550,경기도,안성시,30-34세,10119,5589,4530
202011,41550,경기도,안성시,30-34세,10098,5573,4525
202012,41550,경기도,안성시,30-34세,10072,5553,4519
202101,41550,경기도,안성시,30-34세,10128,5595,4533
202102,41550,경기도,안성시,30-34세,10120,5631,4489
202103,41550,경기도,안성시,30-34세,10185,5666,4519
202104,41550,경기도,안성시,30-34세,10234,5683,4551
202105,41550,경기도,안성시,30-34세,10315,5736,4579
202106,41550,경기도,안성시,30-34세,10344,5760,4584
202007,41550,경기도,안성시,35-39세,13082,7078,6004
202008,41550,경기도,안성시,35-39세,13093,7084,6009
202009,41550,경기도,안성시,35-39세,13112,7104,6008
202010,41550,경기도,안성시,35-39세,13056,7078,5978
202011,41550,경기도,안성시,35-39세,13053,7094,5959
202012,41550,경기도,안성시,35-39세,13055,7107,5948
202101,41550,경기도,안성시,35-39세,12956,7031,5925
202102,41550,경기도,안성시,35-39세,12826,6929,5897
202103,41550,경기도,안성시,35-39세,12706,6854,5852
202104,41550,경기도,안성시,35-39세,12653,6820,5833
202105,41550,경기도,안성시,35-39세,12562,6794,5768
202106,41550,경기도,안성시,35-39세,12546,6797,5749
202007,41550,경기도,안성시,40-44세,14184,7563,6621
202008,41550,경기도,안성시,40-44세,14246,7609,6637
202009,41550,경기도,안성시,40-44세,14293,7634,6659
202010,41550,경기도,안성시,40-44세,14358,7674,6684
202011,41550,경기도,안성시,40-44세,14385,7685,6700
202012,41550,경기도,안성시,40-44세,14395,7695,6700
202101,41550,경기도,안성시,40-44세,14429,7726,6703
202102,41550,경기도,안성시,40-44세,14498,7759,6739
202103,41550,경기도,안성시,40-44세,14500,7774,6726
202104,41550,경기도,안성시,40-44세,14530,7800,6730
202105,41550,경기도,안성시,40-44세,14642,7860,6782
202106,41550,경기도,안성시,40-44세,14703,7888,6815
202007,41550,경기도,안성시,45-49세,15960,8552,7408
202008,41550,경기도,안성시,45-49세,15885,8486,7399
202009,41550,경기도,안성시,45-49세,15779,8441,7338
202010,41550,경기도,안성시,45-49세,15769,8412,7357
202011,41550,경기도,안성시,45-49세,15733,8395,7338
202012,41550,경기도,안성시,45-49세,15776,8400,7376
202101,41550,경기도,안성시,45-49세,15779,8392,7387
202102,41550,경기도,안성시,45-49세,15777,8403,7374
202103,41550,경기도,안성시,45-49세,15650,8339,7311
202104,41550,경기도,안성시,45-49세,15691,8354,7337
202105,41550,경기도,안성시,45-49세,15610,8304,7306
202106,41550,경기도,안성시,45-49세,15565,8288,7277
202007,41550,경기도,안성시,50-54세,15721,8395,7326
202008,41550,경기도,안성시,50-54세,15776,8441,7335
202009,41550,경기도,안성시,50-54세,15891,8493,7398
202010,41550,경기도,안성시,50-54세,15999,8562,7437
202011,41550,경기도,안성시,50-54세,16077,8597,7480
202012,41550,경기도,안성시,50-54세,16040,8561,7479
202101,41550,경기도,안성시,50-54세,16089,8564,7525
202102,41550,경기도,안성시,50-54세,16152,8599,7553
202103,41550,경기도,안성시,50-54세,16121,8593,7528
202104,41550,경기도,안성시,50-54세,16142,8581,7561
202105,41550,경기도,안성시,50-54세,16264,8669,7595
202106,41550,경기도,안성시,50-54세,16347,8697,7650
202007,41550,경기도,안성시,55-59세,15396,8069,7327
202008,41550,경기도,안성시,55-59세,15424,8087,7337
202009,41550,경기도,안성시,55-59세,15440,8098,7342
202010,41550,경기도,안성시,55-59세,15396,8088,7308
202011,41550,경기도,안성시,55-59세,15384,8096,7288
202012,41550,경기도,안성시,55-59세,15425,8136,7289
202101,41550,경기도,안성시,55-59세,15369,8131,7238
202102,41550,경기도,안성시,55-59세,15378,8110,7268
202103,41550,경기도,안성시,55-59세,15331,8097,7234
202104,41550,경기도,안성시,55-59세,15358,8142,7216
202105,41550,경기도,안성시,55-59세,15290,8086,7204
202106,41550,경기도,안성시,55-59세,15185,8044,7141
202007,41550,경기도,안성시,60-64세,14178,7173,7005
202008,41550,경기도,안성시,60-64세,14277,7227,7050
202009,41550,경기도,안성시,60-64세,14409,7304,7105
202010,41550,경기도,안성시,60-64세,14524,7365,7159
202011,41550,경기도,안성시,60-64세,14664,7439,7225
202012,41550,경기도,안성시,60-64세,14814,7522,7292
202101,41550,경기도,안성시,60-64세,14917,7583,7334
202102,41550,경기도,안성시,60-64세,15044,7673,7371
202103,41550,경기도,안성시,60-64세,15195,7747,7448
202104,41550,경기도,안성시,60-64세,15319,7790,7529
202105,41550,경기도,안성시,60-64세,15463,7889,7574
202106,41550,경기도,안성시,60-64세,15654,7973,7681
202007,41550,경기도,안성시,65-69세,10046,5015,5031
202008,41550,경기도,안성시,65-69세,10166,5075,5091
202009,41550,경기도,안성시,65-69세,10266,5123,5143
202010,41550,경기도,안성시,65-69세,10362,5185,5177
202011,41550,경기도,안성시,65-69세,10413,5203,5210
202012,41550,경기도,안성시,65-69세,10514,5243,5271
202101,41550,경기도,안성시,65-69세,10657,5315,5342
202102,41550,경기도,안성시,65-69세,10771,5366,5405
202103,41550,경기도,안성시,65-69세,10915,5455,5460
202104,41550,경기도,안성시,65-69세,11023,5507,5516
202105,41550,경기도,안성시,65-69세,11129,5556,5573
202106,41550,경기도,안성시,65-69세,11186,5588,5598
202007,41550,경기도,안성시,70-74세,7290,3498,3792
202008,41550,경기도,안성시,70-74세,7330,3524,3806
202009,41550,경기도,안성시,70-74세,7378,3556,3822
202010,41550,경기도,안성시,70-74세,7442,3585,3857
202011,41550,경기도,안성시,70-74세,7494,3604,3890
202012,41550,경기도,안성시,70-74세,7557,3650,3907
202101,41550,경기도,안성시,70-74세,7629,3671,3958
202102,41550,경기도,안성시,70-74세,7677,3701,3976
202103,41550,경기도,안성시,70-74세,7644,3682,3962
202104,41550,경기도,안성시,70-74세,7646,3682,3964
202105,41550,경기도,안성시,70-74세,7699,3698,4001
202106,41550,경기도,안성시,70-74세,7709,3695,4014
202007,41550,경기도,안성시,75-79세,6189,2642,3547
202008,41550,경기도,안성시,75-79세,6190,2647,3543
202009,41550,경기도,안성시,75-79세,6157,2640,3517
202010,41550,경기도,안성시,75-79세,6167,2644,3523
202011,41550,경기도,안성시,75-79세,6133,2623,3510
202012,41550,경기도,안성시,75-79세,6087,2599,3488
202101,41550,경기도,안성시,75-79세,6090,2609,3481
202102,41550,경기도,안성시,75-79세,6066,2589,3477
202103,41550,경기도,안성시,75-79세,6077,2595,3482
202104,41550,경기도,안성시,75-79세,6050,2597,3453
202105,41550,경기도,안성시,75-79세,6020,2593,3427
202106,41550,경기도,안성시,75-79세,6029,2597,3432
202007,41550,경기도,안성시,80-84세,4890,1877,3013
202008,41550,경기도,안성시,80-84세,4895,1870,3025
202009,41550,경기도,안성시,80-84세,4901,1865,3036
202010,41550,경기도,안성시,80-84세,4919,1867,3052
202011,41550,경기도,안성시,80-84세,4938,1879,3059
202012,41550,경기도,안성시,80-84세,4959,1885,3074
202101,41550,경기도,안성시,80-84세,4958,1890,3068
202102,41550,경기도,안성시,80-84세,4947,1899,3048
202103,41550,경기도,안성시,80-84세,4924,1881,3043
202104,41550,경기도,안성시,80-84세,4952,1890,3062
202105,41550,경기도,안성시,80-84세,4961,1894,3067
202106,41550,경기도,안성시,80-84세,4980,1910,3070
202007,41550,경기도,안성시,85-89세,2524,750,1774
202008,41550,경기도,안성시,85-89세,2535,753,1782
202009,41550,경기도,안성시,85-89세,2573,770,1803
202010,41550,경기도,안성시,85-89세,2582,783,1799
202011,41550,경기도,안성시,85-89세,2597,794,1803
202012,41550,경기도,안성시,85-89세,2637,819,1818
202101,41550,경기도,안성시,85-89세,2666,826,1840
202102,41550,경기도,안성시,85-89세,2714,839,1875
202103,41550,경기도,안성시,85-89세,2744,853,1891
202104,41550,경기도,안성시,85-89세,2761,856,1905
202105,41550,경기도,안성시,85-89세,2786,860,1926
202106,41550,경기도,안성시,85-89세,2779,857,1922
202007,41550,경기도,안성시,90-94세,811,158,653
202008,41550,경기도,안성시,90-94세,814,160,654
202009,41550,경기도,안성시,90-94세,815,166,649
202010,41550,경기도,안성시,90-94세,827,168,659
202011,41550,경기도,안성시,90-94세,832,168,664
202012,41550,경기도,안성시,90-94세,833,165,668
202101,41550,경기도,안성시,90-94세,836,169,667
202102,41550,경기도,안성시,90-94세,836,173,663
202103,41550,경기도,안성시,90-94세,837,169,668
202104,41550,경기도,안성시,90-94세,846,167,679
202105,41550,경기도,안성시,90-94세,850,171,679
202106,41550,경기도,안성시,90-94세,863,175,688
202007,41550,경기도,안성시,95-99세,184,41,143
202008,41550,경기도,안성시,95-99세,188,40,148
202009,41550,경기도,안성시,95-99세,195,42,153
202010,41550,경기도,안성시,95-99세,196,41,155
202011,41550,경기도,안성시,95-99세,193,42,151
202012,41550,경기도,안성시,95-99세,201,43,158
202101,41550,경기도,안성시,95-99세,208,42,166
202102,41550,경기도,안성시,95-99세,208,39,169
202103,41550,경기도,안성시,95-99세,207,39,168
202104,41550,경기도,안성시,95-99세,207,40,167
202105,41550,경기도,안성시,95-99세,213,42,171
202106,41550,경기도,안성시,95-99세,214,41,173
202007,41550,경기도,안성시,100+,56,12,44
202008,41550,경기도,안성시,100+,56,12,44
202009,41550,경기도,안성시,100+,57,12,45
202010,41550,경기도,안성시,100+,58,12,46
202011,41550,경기도,안성시,100+,58,12,46
202012,41550,경기도,안성시,100+,56,12,44
202101,41550,경기도,안성시,100+,55,11,44
202102,41550,경기도,안성시,100+,56,11,45
202103,41550,경기도,안성시,100+,39,6,33
202104,41550,경기도,안성시,100+,38,6,32
202105,41550,경기도,안성시,100+,39,6,33
202106,41550,경기도,안성시,100+,39,6,33
202007,41570,경기도,김포시,0-4세,22768,11680,11088
202008,41570,경기도,김포시,0-4세,23147,11860,11287
202009,41570,경기도,김포시,0-4세,23422,12013,11409
202010,41570,경기도,김포시,0-4세,23434,12064,11370
202011,41570,경기도,김포시,0-4세,23429,12098,11331
202012,41570,경기도,김포시,0-4세,23727,12270,11457
202101,41570,경기도,김포시,0-4세,23671,12242,11429
202102,41570,경기도,김포시,0-4세,23615,12202,11413
202103,41570,경기도,김포시,0-4세,23445,12107,11338
202104,41570,경기도,김포시,0-4세,23284,12017,11267
202105,41570,경기도,김포시,0-4세,23053,11937,11116
202106,41570,경기도,김포시,0-4세,22943,11877,11066
202007,41570,경기도,김포시,5-9세,29929,15266,14663
202008,41570,경기도,김포시,5-9세,30546,15548,14998
202009,41570,경기도,김포시,5-9세,30806,15652,15154
202010,41570,경기도,김포시,5-9세,31095,15747,15348
202011,41570,경기도,김포시,5-9세,31166,15741,15425
202012,41570,경기도,김포시,5-9세,31526,15891,15635
202101,41570,경기도,김포시,5-9세,31797,16039,15758
202102,41570,경기도,김포시,5-9세,31894,16077,15817
202103,41570,경기도,김포시,5-9세,31984,16091,15893
202104,41570,경기도,김포시,5-9세,32045,16145,15900
202105,41570,경기도,김포시,5-9세,32148,16194,15954
202106,41570,경기도,김포시,5-9세,32162,16213,15949
202007,41570,경기도,김포시,10-14세,24950,12691,12259
202008,41570,경기도,김포시,10-14세,25283,12885,12398
202009,41570,경기도,김포시,10-14세,25661,13109,12552
202010,41570,경기도,김포시,10-14세,25879,13221,12658
202011,41570,경기도,김포시,10-14세,26130,13348,12782
202012,41570,경기도,김포시,10-14세,26365,13467,12898
202101,41570,경기도,김포시,10-14세,26734,13664,13070
202102,41570,경기도,김포시,10-14세,26918,13773,13145
202103,41570,경기도,김포시,10-14세,27047,13860,13187
202104,41570,경기도,김포시,10-14세,27231,13925,13306
202105,41570,경기도,김포시,10-14세,27365,13989,13376
202106,41570,경기도,김포시,10-14세,27544,14081,13463
202007,41570,경기도,김포시,15-19세,21081,10766,10315
202008,41570,경기도,김포시,15-19세,21217,10829,10388
202009,41570,경기도,김포시,15-19세,21283,10857,10426
202010,41570,경기도,김포시,15-19세,21307,10873,10434
202011,41570,경기도,김포시,15-19세,21265,10819,10446
202012,41570,경기도,김포시,15-19세,21358,10843,10515
202101,41570,경기도,김포시,15-19세,21368,10850,10518
202102,41570,경기도,김포시,15-19세,21409,10852,10557
202103,41570,경기도,김포시,15-19세,21385,10862,10523
202104,41570,경기도,김포시,15-19세,21391,10871,10520
202105,41570,경기도,김포시,15-19세,21376,10864,10512
202106,41570,경기도,김포시,15-19세,21398,10870,10528
202007,41570,경기도,김포시,20-24세,23522,12377,11145
202008,41570,경기도,김포시,20-24세,23802,12479,11323
202009,41570,경기도,김포시,20-24세,23972,12586,11386
202010,41570,경기도,김포시,20-24세,24073,12610,11463
202011,41570,경기도,김포시,20-24세,24195,12713,11482
202012,41570,경기도,김포시,20-24세,24406,12814,11592
202101,41570,경기도,김포시,20-24세,24645,12921,11724
202102,41570,경기도,김포시,20-24세,24717,12920,11797
202103,41570,경기도,김포시,20-24세,24796,12956,11840
202104,41570,경기도,김포시,20-24세,24818,12986,11832
202105,41570,경기도,김포시,20-24세,24822,12959,11863
202106,41570,경기도,김포시,20-24세,24849,12960,11889
202007,41570,경기도,김포시,25-29세,25789,13201,12588
202008,41570,경기도,김포시,25-29세,26237,13390,12847
202009,41570,경기도,김포시,25-29세,26655,13568,13087
202010,41570,경기도,김포시,25-29세,26928,13713,13215
202011,41570,경기도,김포시,25-29세,27228,13884,13344
202012,41570,경기도,김포시,25-29세,27632,14082,13550
202101,41570,경기도,김포시,25-29세,27800,14144,13656
202102,41570,경기도,김포시,25-29세,27825,14156,13669
202103,41570,경기도,김포시,25-29세,28037,14225,13812
202104,41570,경기도,김포시,25-29세,28223,14360,13863
202105,41570,경기도,김포시,25-29세,28233,14367,13866
202106,41570,경기도,김포시,25-29세,28209,14370,13839
202007,41570,경기도,김포시,30-34세,28352,13744,14608
202008,41570,경기도,김포시,30-34세,28962,14052,14910
202009,41570,경기도,김포시,30-34세,29438,14291,15147
202010,41570,경기도,김포시,30-34세,29724,14459,15265
202011,41570,경기도,김포시,30-34세,29895,14524,15371
202012,41570,경기도,김포시,30-34세,30412,14785,15627
202101,41570,경기도,김포시,30-34세,30603,14862,15741
202102,41570,경기도,김포시,30-34세,30682,14889,15793
202103,41570,경기도,김포시,30-34세,30801,14932,15869
202104,41570,경기도,김포시,30-34세,30878,14945,15933
202105,41570,경기도,김포시,30-34세,30993,15013,15980
202106,41570,경기도,김포시,30-34세,31143,15061,16082
202007,41570,경기도,김포시,35-39세,43671,21611,22060
202008,41570,경기도,김포시,35-39세,44430,22024,22406
202009,41570,경기도,김포시,35-39세,45075,22388,22687
202010,41570,경기도,김포시,35-39세,45331,22467,22864
202011,41570,경기도,김포시,35-39세,45429,22513,22916
202012,41570,경기도,김포시,35-39세,45980,22783,23197
202101,41570,경기도,김포시,35-39세,46125,22839,23286
202102,41570,경기도,김포시,35-39세,46083,22815,23268
202103,41570,경기도,김포시,35-39세,45899,22703,23196
202104,41570,경기도,김포시,35-39세,45786,22672,23114
202105,41570,경기도,김포시,35-39세,45525,22555,22970
202106,41570,경기도,김포시,35-39세,45290,22456,22834
202007,41570,경기도,김포시,40-44세,43985,22587,21398
202008,41570,경기도,김포시,40-44세,44876,23038,21838
202009,41570,경기도,김포시,40-44세,45552,23354,22198
202010,41570,경기도,김포시,40-44세,46093,23669,22424
202011,41570,경기도,김포시,40-44세,46418,23836,22582
202012,41570,경기도,김포시,40-44세,46910,24123,22787
202101,41570,경기도,김포시,40-44세,47391,24372,23019
202102,41570,경기도,김포시,40-44세,47783,24579,23204
202103,41570,경기도,김포시,40-44세,47911,24660,23251
202104,41570,경기도,김포시,40-44세,48200,24761,23439
202105,41570,경기도,김포시,40-44세,48508,24869,23639
202106,41570,경기도,김포시,40-44세,48888,25041,23847
202007,41570,경기도,김포시,45-49세,39945,21047,18898
202008,41570,경기도,김포시,45-49세,40398,21318,19080
202009,41570,경기도,김포시,45-49세,40711,21488,19223
202010,41570,경기도,김포시,45-49세,40912,21586,19326
202011,41570,경기도,김포시,45-49세,41164,21698,19466
202012,41570,경기도,김포시,45-49세,41522,21883,19639
202101,41570,경기도,김포시,45-49세,41819,22095,19724
202102,41570,경기도,김포시,45-49세,41995,22157,19838
202103,41570,경기도,김포시,45-49세,42111,22196,19915
202104,41570,경기도,김포시,45-49세,42228,22259,19969
202105,41570,경기도,김포시,45-49세,42098,22219,19879
202106,41570,경기도,김포시,45-49세,42089,22230,19859
202007,41570,경기도,김포시,50-54세,33741,17230,16511
202008,41570,경기도,김포시,50-54세,34180,17456,16724
202009,41570,경기도,김포시,50-54세,34595,17655,16940
202010,41570,경기도,김포시,50-54세,34835,17760,17075
202011,41570,경기도,김포시,50-54세,34893,17818,17075
202012,41570,경기도,김포시,50-54세,35092,17929,17163
202101,41570,경기도,김포시,50-54세,35481,18102,17379
202102,41570,경기도,김포시,50-54세,35704,18230,17474
202103,41570,경기도,김포시,50-54세,35693,18267,17426
202104,41570,경기도,김포시,50-54세,35891,18376,17515
202105,41570,경기도,김포시,50-54세,36213,18527,17686
202106,41570,경기도,김포시,50-54세,36326,18579,17747
202007,41570,경기도,김포시,55-59세,30943,15876,15067
202008,41570,경기도,김포시,55-59세,31226,16006,15220
202009,41570,경기도,김포시,55-59세,31373,16068,15305
202010,41570,경기도,김포시,55-59세,31530,16133,15397
202011,41570,경기도,김포시,55-59세,31628,16179,15449
202012,41570,경기도,김포시,55-59세,31793,16231,15562
202101,41570,경기도,김포시,55-59세,31751,16196,15555
202102,41570,경기도,김포시,55-59세,31883,16278,15605
202103,41570,경기도,김포시,55-59세,31928,16286,15642
202104,41570,경기도,김포시,55-59세,31904,16281,15623
202105,41570,경기도,김포시,55-59세,31843,16243,15600
202106,41570,경기도,김포시,55-59세,31719,16189,15530
202007,41570,경기도,김포시,60-64세,27620,13677,13943
202008,41570,경기도,김포시,60-64세,27965,13859,14106
202009,41570,경기도,김포시,60-64세,28317,14013,14304
202010,41570,경기도,김포시,60-64세,28558,14139,14419
202011,41570,경기도,김포시,60-64세,28810,14251,14559
202012,41570,경기도,김포시,60-64세,29123,14385,14738
202101,41570,경기도,김포시,60-64세,29499,14591,14908
202102,41570,경기도,김포시,60-64세,29695,14700,14995
202103,41570,경기도,김포시,60-64세,29877,14787,15090
202104,41570,경기도,김포시,60-64세,30066,14883,15183
202105,41570,경기도,김포시,60-64세,30244,15002,15242
202106,41570,경기도,김포시,60-64세,30575,15143,15432
202007,41570,경기도,김포시,65-69세,18997,9040,9957
202008,41570,경기도,김포시,65-69세,19341,9202,10139
202009,41570,경기도,김포시,65-69세,19664,9360,10304
202010,41570,경기도,김포시,65-69세,19921,9483,10438
202011,41570,경기도,김포시,65-69세,20077,9543,10534
202012,41570,경기도,김포시,65-69세,20308,9679,10629
202101,41570,경기도,김포시,65-69세,20564,9783,10781
202102,41570,경기도,김포시,65-69세,20766,9862,10904
202103,41570,경기도,김포시,65-69세,20995,9988,11007
202104,41570,경기도,김포시,65-69세,21253,10100,11153
202105,41570,경기도,김포시,65-69세,21454,10169,11285
202106,41570,경기도,김포시,65-69세,21629,10243,11386
202007,41570,경기도,김포시,70-74세,14444,6996,7448
202008,41570,경기도,김포시,70-74세,14582,7062,7520
202009,41570,경기도,김포시,70-74세,14736,7131,7605
202010,41570,경기도,김포시,70-74세,14883,7184,7699
202011,41570,경기도,김포시,70-74세,14965,7218,7747
202012,41570,경기도,김포시,70-74세,15075,7245,7830
202101,41570,경기도,김포시,70-74세,15184,7311,7873
202102,41570,경기도,김포시,70-74세,15266,7357,7909
202103,41570,경기도,김포시,70-74세,15241,7336,7905
202104,41570,경기도,김포시,70-74세,15262,7335,7927
202105,41570,경기도,김포시,70-74세,15313,7347,7966
202106,41570,경기도,김포시,70-74세,15361,7365,7996
202007,41570,경기도,김포시,75-79세,10578,4679,5899
202008,41570,경기도,김포시,75-79세,10643,4714,5929
202009,41570,경기도,김포시,75-79세,10703,4747,5956
202010,41570,경기도,김포시,75-79세,10699,4745,5954
202011,41570,경기도,김포시,75-79세,10698,4746,5952
202012,41570,경기도,김포시,75-79세,10709,4778,5931
202101,41570,경기도,김포시,75-79세,10717,4770,5947
202102,41570,경기도,김포시,75-79세,10702,4788,5914
202103,41570,경기도,김포시,75-79세,10758,4811,5947
202104,41570,경기도,김포시,75-79세,10819,4845,5974
202105,41570,경기도,김포시,75-79세,10842,4880,5962
202106,41570,경기도,김포시,75-79세,10861,4892,5969
202007,41570,경기도,김포시,80-84세,6714,2709,4005
202008,41570,경기도,김포시,80-84세,6785,2750,4035
202009,41570,경기도,김포시,80-84세,6826,2763,4063
202010,41570,경기도,김포시,80-84세,6868,2778,4090
202011,41570,경기도,김포시,80-84세,6894,2801,4093
202012,41570,경기도,김포시,80-84세,6921,2807,4114
202101,41570,경기도,김포시,80-84세,6998,2850,4148
202102,41570,경기도,김포시,80-84세,7101,2878,4223
202103,41570,경기도,김포시,80-84세,7106,2890,4216
202104,41570,경기도,김포시,80-84세,7168,2920,4248
202105,41570,경기도,김포시,80-84세,7214,2930,4284
202106,41570,경기도,김포시,80-84세,7299,2977,4322
202007,41570,경기도,김포시,85-89세,3322,1069,2253
202008,41570,경기도,김포시,85-89세,3384,1091,2293
202009,41570,경기도,김포시,85-89세,3415,1098,2317
202010,41570,경기도,김포시,85-89세,3468,1115,2353
202011,41570,경기도,김포시,85-89세,3493,1123,2370
202012,41570,경기도,김포시,85-89세,3522,1133,2389
202101,41570,경기도,김포시,85-89세,3577,1152,2425
202102,41570,경기도,김포시,85-89세,3617,1170,2447
202103,41570,경기도,김포시,85-89세,3640,1173,2467
202104,41570,경기도,김포시,85-89세,3644,1175,2469
202105,41570,경기도,김포시,85-89세,3690,1194,2496
202106,41570,경기도,김포시,85-89세,3698,1197,2501
202007,41570,경기도,김포시,90-94세,1158,274,884
202008,41570,경기도,김포시,90-94세,1165,277,888
202009,41570,경기도,김포시,90-94세,1188,278,910
202010,41570,경기도,김포시,90-94세,1201,286,915
202011,41570,경기도,김포시,90-94세,1220,291,929
202012,41570,경기도,김포시,90-94세,1246,296,950
202101,41570,경기도,김포시,90-94세,1254,298,956
202102,41570,경기도,김포시,90-94세,1272,309,963
202103,41570,경기도,김포시,90-94세,1291,310,981
202104,41570,경기도,김포시,90-94세,1302,311,991
202105,41570,경기도,김포시,90-94세,1316,314,1002
202106,41570,경기도,김포시,90-94세,1327,318,1009
202007,41570,경기도,김포시,95-99세,262,64,198
202008,41570,경기도,김포시,95-99세,263,63,200
202009,41570,경기도,김포시,95-99세,270,63,207
202010,41570,경기도,김포시,95-99세,273,66,207
202011,41570,경기도,김포시,95-99세,270,67,203
202012,41570,경기도,김포시,95-99세,270,64,206
202101,41570,경기도,김포시,95-99세,279,64,215
202102,41570,경기도,김포시,95-99세,289,65,224
202103,41570,경기도,김포시,95-99세,277,60,217
202104,41570,경기도,김포시,95-99세,276,61,215
202105,41570,경기도,김포시,95-99세,273,61,212
202106,41570,경기도,김포시,95-99세,276,62,214
202007,41570,경기도,김포시,100+,71,18,53
202008,41570,경기도,김포시,100+,73,19,54
202009,41570,경기도,김포시,100+,73,19,54
202010,41570,경기도,김포시,100+,72,19,53
202011,41570,경기도,김포시,100+,73,19,54
202012,41570,경기도,김포시,100+,73,19,54
202101,41570,경기도,김포시,100+,75,20,55
202102,41570,경기도,김포시,100+,74,19,55
202103,41570,경기도,김포시,100+,53,14,39
202104,41570,경기도,김포시,100+,50,11,39
202105,41570,경기도,김포시,100+,55,12,43
202106,41570,경기도,김포시,100+,56,12,44
202007,41590,경기도,화성시,0-4세,46683,23986,22697
202008,41590,경기도,화성시,0-4세,46422,23858,22564
202009,41590,경기도,화성시,0-4세,46175,23747,22428
202010,41590,경기도,화성시,0-4세,45918,23621,22297
202011,41590,경기도,화성시,0-4세,45689,23503,22186
202012,41590,경기도,화성시,0-4세,45396,23330,22066
202101,41590,경기도,화성시,0-4세,44878,23056,21822
202102,41590,경기도,화성시,0-4세,44427,22824,21603
202103,41590,경기도,화성시,0-4세,44000,22580,21420
202104,41590,경기도,화성시,0-4세,43955,22584,21371
202105,41590,경기도,화성시,0-4세,43778,22532,21246
202106,41590,경기도,화성시,0-4세,43597,22414,21183
202007,41590,경기도,화성시,5-9세,59109,30163,28946
202008,41590,경기도,화성시,5-9세,59254,30264,28990
202009,41590,경기도,화성시,5-9세,59295,30257,29038
202010,41590,경기도,화성시,5-9세,59233,30195,29038
202011,41590,경기도,화성시,5-9세,59179,30141,29038
202012,41590,경기도,화성시,5-9세,59089,30086,29003
202101,41590,경기도,화성시,5-9세,59038,30037,29001
202102,41590,경기도,화성시,5-9세,58928,29959,28969
202103,41590,경기도,화성시,5-9세,59000,30018,28982
202104,41590,경기도,화성시,5-9세,59116,30060,29056
202105,41590,경기도,화성시,5-9세,59065,30052,29013
202106,41590,경기도,화성시,5-9세,59084,30070,29014
202007,41590,경기도,화성시,10-14세,51993,26483,25510
202008,41590,경기도,화성시,10-14세,52293,26594,25699
202009,41590,경기도,화성시,10-14세,52708,26796,25912
202010,41590,경기도,화성시,10-14세,53118,27034,26084
202011,41590,경기도,화성시,10-14세,53449,27205,26244
202012,41590,경기도,화성시,10-14세,53715,27340,26375
202101,41590,경기도,화성시,10-14세,54052,27505,26547
202102,41590,경기도,화성시,10-14세,54209,27599,26610
202103,41590,경기도,화성시,10-14세,54470,27738,26732
202104,41590,경기도,화성시,10-14세,54788,27917,26871
202105,41590,경기도,화성시,10-14세,55163,28094,27069
202106,41590,경기도,화성시,10-14세,55362,28197,27165
202007,41590,경기도,화성시,15-19세,43098,22110,20988
202008,41590,경기도,화성시,15-19세,43166,22177,20989
202009,41590,경기도,화성시,15-19세,43146,22148,20998
202010,41590,경기도,화성시,15-19세,43130,22110,21020
202011,41590,경기도,화성시,15-19세,43059,22071,20988
202012,41590,경기도,화성시,15-19세,43034,22106,20928
202101,41590,경기도,화성시,15-19세,43034,22098,20936
202102,41590,경기도,화성시,15-19세,43038,22083,20955
202103,41590,경기도,화성시,15-19세,43048,22075,20973
202104,41590,경기도,화성시,15-19세,43149,22105,21044
202105,41590,경기도,화성시,15-19세,43195,22087,21108
202106,41590,경기도,화성시,15-19세,43320,22141,21179
202007,41590,경기도,화성시,20-24세,45566,23963,21603
202008,41590,경기도,화성시,20-24세,45847,24081,21766
202009,41590,경기도,화성시,20-24세,46115,24213,21902
202010,41590,경기도,화성시,20-24세,46282,24285,21997
202011,41590,경기도,화성시,20-24세,46519,24415,22104
202012,41590,경기도,화성시,20-24세,46676,24484,22192
202101,41590,경기도,화성시,20-24세,46901,24600,22301
202102,41590,경기도,화성시,20-24세,47070,24688,22382
202103,41590,경기도,화성시,20-24세,47190,24779,22411
202104,41590,경기도,화성시,20-24세,47320,24858,22462
202105,41590,경기도,화성시,20-24세,47514,24964,22550
202106,41590,경기도,화성시,20-24세,47583,24999,22584
202007,41590,경기도,화성시,25-29세,55553,30546,25007
202008,41590,경기도,화성시,25-29세,55949,30768,25181
202009,41590,경기도,화성시,25-29세,56604,31163,25441
202010,41590,경기도,화성시,25-29세,57018,31389,25629
202011,41590,경기도,화성시,25-29세,57375,31640,25735
202012,41590,경기도,화성시,25-29세,57862,31996,25866
202101,41590,경기도,화성시,25-29세,58093,32227,25866
202102,41590,경기도,화성시,25-29세,58356,32399,25957
202103,41590,경기도,화성시,25-29세,58894,32795,26099
202104,41590,경기도,화성시,25-29세,59355,33060,26295
202105,41590,경기도,화성시,25-29세,59591,33220,26371
202106,41590,경기도,화성시,25-29세,59807,33368,26439
202007,41590,경기도,화성시,30-34세,64535,33627,30908
202008,41590,경기도,화성시,30-34세,64756,33775,30981
202009,41590,경기도,화성시,30-34세,65116,34005,31111
202010,41590,경기도,화성시,30-34세,65181,34043,31138
202011,41590,경기도,화성시,30-34세,65316,34134,31182
202012,41590,경기도,화성시,30-34세,65336,34176,31160
202101,41590,경기도,화성시,30-34세,65360,34250,31110
202102,41590,경기도,화성시,30-34세,65296,34308,30988
202103,41590,경기도,화성시,30-34세,65525,34463,31062
202104,41590,경기도,화성시,30-34세,65995,34744,31251
202105,41590,경기도,화성시,30-34세,66254,34894,31360
202106,41590,경기도,화성시,30-34세,66494,35079,31415
202007,41590,경기도,화성시,35-39세,86159,44679,41480
202008,41590,경기도,화성시,35-39세,86145,44713,41432
202009,41590,경기도,화성시,35-39세,86103,44710,41393
202010,41590,경기도,화성시,35-39세,85984,44666,41318
202011,41590,경기도,화성시,35-39세,85932,44625,41307
202012,41590,경기도,화성시,35-39세,85845,44475,41370
202101,41590,경기도,화성시,35-39세,85467,44229,41238
202102,41590,경기도,화성시,35-39세,84968,43939,41029
202103,41590,경기도,화성시,35-39세,84352,43594,40758
202104,41590,경기도,화성시,35-39세,84424,43640,40784
202105,41590,경기도,화성시,35-39세,84379,43602,40777
202106,41590,경기도,화성시,35-39세,84253,43612,40641
202007,41590,경기도,화성시,40-44세,84593,44811,39782
202008,41590,경기도,화성시,40-44세,84997,44975,40022
202009,41590,경기도,화성시,40-44세,85656,45330,40326
202010,41590,경기도,화성시,40-44세,86294,45689,40605
202011,41590,경기도,화성시,40-44세,86815,46001,40814
202012,41590,경기도,화성시,40-44세,86924,46116,40808
202101,41590,경기도,화성시,40-44세,87377,46366,41011
202102,41590,경기도,화성시,40-44세,87895,46679,41216
202103,41590,경기도,화성시,40-44세,88064,46707,41357
202104,41590,경기도,화성시,40-44세,88526,46988,41538
202105,41590,경기도,화성시,40-44세,88945,47221,41724
202106,41590,경기도,화성시,40-44세,89549,47510,42039
202007,41590,경기도,화성시,45-49세,75938,40909,35029
202008,41590,경기도,화성시,45-49세,76215,41008,35207
202009,41590,경기도,화성시,45-49세,76349,41074,35275
202010,41590,경기도,화성시,45-49세,76472,41085,35387
202011,41590,경기도,화성시,45-49세,76684,41190,35494
202012,41590,경기도,화성시,45-49세,77135,41402,35733
202101,41590,경기도,화성시,45-49세,77341,41456,35885
202102,41590,경기도,화성시,45-49세,77567,41515,36052
202103,41590,경기도,화성시,45-49세,77809,41684,36125
202104,41590,경기도,화성시,45-49세,78144,41848,36296
202105,41590,경기도,화성시,45-49세,78094,41774,36320
202106,41590,경기도,화성시,45-49세,78155,41813,36342
202007,41590,경기도,화성시,50-54세,61237,32947,28290
202008,41590,경기도,화성시,50-54세,61756,33236,28520
202009,41590,경기도,화성시,50-54세,62263,33467,28796
202010,41590,경기도,화성시,50-54세,62700,33744,28956
202011,41590,경기도,화성시,50-54세,63108,33943,29165
202012,41590,경기도,화성시,50-54세,63252,34018,29234
202101,41590,경기도,화성시,50-54세,64026,34445,29581
202102,41590,경기도,화성시,50-54세,64465,34733,29732
202103,41590,경기도,화성시,50-54세,64630,34844,29786
202104,41590,경기도,화성시,50-54세,65002,34999,30003
202105,41590,경기도,화성시,50-54세,65821,35429,30392
202106,41590,경기도,화성시,50-54세,66239,35634,30605
202007,41590,경기도,화성시,55-59세,51207,27359,23848
202008,41590,경기도,화성시,55-59세,51326,27426,23900
202009,41590,경기도,화성시,55-59세,51556,27591,23965
202010,41590,경기도,화성시,55-59세,51956,27823,24133
202011,41590,경기도,화성시,55-59세,52064,27898,24166
202012,41590,경기도,화성시,55-59세,52195,27952,24243
202101,41590,경기도,화성시,55-59세,52044,27927,24117
202102,41590,경기도,화성시,55-59세,52169,28019,24150
202103,41590,경기도,화성시,55-59세,52161,28018,24143
202104,41590,경기도,화성시,55-59세,52228,28092,24136
202105,41590,경기도,화성시,55-59세,52242,28153,24089
202106,41590,경기도,화성시,55-59세,52003,28015,23988
202007,41590,경기도,화성시,60-64세,40440,20857,19583
202008,41590,경기도,화성시,60-64세,40830,21058,19772
202009,41590,경기도,화성시,60-64세,41250,21284,19966
202010,41590,경기도,화성시,60-64세,41633,21508,20125
202011,41590,경기도,화성시,60-64세,42203,21811,20392
202012,41590,경기도,화성시,60-64세,42609,22049,20560
202101,41590,경기도,화성시,60-64세,43077,22253,20824
202102,41590,경기도,화성시,60-64세,43486,22468,21018
202103,41590,경기도,화성시,60-64세,43906,22667,21239
202104,41590,경기도,화성시,60-64세,44451,22950,21501
202105,41590,경기도,화성시,60-64세,44916,23172,21744
202106,41590,경기도,화성시,60-64세,45548,23501,22047
202007,41590,경기도,화성시,65-69세,25840,12887,12953
202008,41590,경기도,화성시,65-69세,26112,12998,13114
202009,41590,경기도,화성시,65-69세,26479,13195,13284
202010,41590,경기도,화성시,65-69세,26777,13323,13454
202011,41590,경기도,화성시,65-69세,27085,13477,13608
202012,41590,경기도,화성시,65-69세,27389,13638,13751
202101,41590,경기도,화성시,65-69세,27798,13894,13904
202102,41590,경기도,화성시,65-69세,28146,14045,14101
202103,41590,경기도,화성시,65-69세,28555,14277,14278
202104,41590,경기도,화성시,65-69세,28860,14435,14425
202105,41590,경기도,화성시,65-69세,29230,14635,14595
202106,41590,경기도,화성시,65-69세,29519,14767,14752
202007,41590,경기도,화성시,70-74세,18166,8799,9367
202008,41590,경기도,화성시,70-74세,18209,8825,9384
202009,41590,경기도,화성시,70-74세,18339,8879,9460
202010,41590,경기도,화성시,70-74세,18515,8983,9532
202011,41590,경기도,화성시,70-74세,18660,9060,9600
202012,41590,경기도,화성시,70-74세,18755,9110,9645
202101,41590,경기도,화성시,70-74세,18908,9163,9745
202102,41590,경기도,화성시,70-74세,19001,9214,9787
202103,41590,경기도,화성시,70-74세,18957,9173,9784
202104,41590,경기도,화성시,70-74세,18942,9166,9776
202105,41590,경기도,화성시,70-74세,19025,9196,9829
202106,41590,경기도,화성시,70-74세,19078,9235,9843
202007,41590,경기도,화성시,75-79세,13303,5859,7444
202008,41590,경기도,화성시,75-79세,13363,5886,7477
202009,41590,경기도,화성시,75-79세,13324,5871,7453
202010,41590,경기도,화성시,75-79세,13360,5892,7468
202011,41590,경기도,화성시,75-79세,13381,5911,7470
202012,41590,경기도,화성시,75-79세,13360,5903,7457
202101,41590,경기도,화성시,75-79세,13353,5908,7445
202102,41590,경기도,화성시,75-79세,13332,5920,7412
202103,41590,경기도,화성시,75-79세,13327,5931,7396
202104,41590,경기도,화성시,75-79세,13348,5933,7415
202105,41590,경기도,화성시,75-79세,13403,5982,7421
202106,41590,경기도,화성시,75-79세,13472,6005,7467
202007,41590,경기도,화성시,80-84세,9267,3563,5704
202008,41590,경기도,화성시,80-84세,9348,3589,5759
202009,41590,경기도,화성시,80-84세,9384,3633,5751
202010,41590,경기도,화성시,80-84세,9429,3669,5760
202011,41590,경기도,화성시,80-84세,9460,3673,5787
202012,41590,경기도,화성시,80-84세,9490,3692,5798
202101,41590,경기도,화성시,80-84세,9534,3716,5818
202102,41590,경기도,화성시,80-84세,9615,3750,5865
202103,41590,경기도,화성시,80-84세,9611,3738,5873
202104,41590,경기도,화성시,80-84세,9669,3772,5897
202105,41590,경기도,화성시,80-84세,9724,3795,5929
202106,41590,경기도,화성시,80-84세,9810,3836,5974
202007,41590,경기도,화성시,85-89세,4746,1386,3360
202008,41590,경기도,화성시,85-89세,4772,1399,3373
202009,41590,경기도,화성시,85-89세,4836,1424,3412
202010,41590,경기도,화성시,85-89세,4870,1439,3431
202011,41590,경기도,화성시,85-89세,4941,1476,3465
202012,41590,경기도,화성시,85-89세,4991,1505,3486
202101,41590,경기도,화성시,85-89세,5045,1533,3512
202102,41590,경기도,화성시,85-89세,5100,1549,3551
202103,41590,경기도,화성시,85-89세,5160,1562,3598
202104,41590,경기도,화성시,85-89세,5205,1573,3632
202105,41590,경기도,화성시,85-89세,5266,1591,3675
202106,41590,경기도,화성시,85-89세,5285,1612,3673
202007,41590,경기도,화성시,90-94세,1603,335,1268
202008,41590,경기도,화성시,90-94세,1635,341,1294
202009,41590,경기도,화성시,90-94세,1658,342,1316
202010,41590,경기도,화성시,90-94세,1678,342,1336
202011,41590,경기도,화성시,90-94세,1687,342,1345
202012,41590,경기도,화성시,90-94세,1693,346,1347
202101,41590,경기도,화성시,90-94세,1725,355,1370
202102,41590,경기도,화성시,90-94세,1757,360,1397
202103,41590,경기도,화성시,90-94세,1754,358,1396
202104,41590,경기도,화성시,90-94세,1760,369,1391
202105,41590,경기도,화성시,90-94세,1759,373,1386
202106,41590,경기도,화성시,90-94세,1746,365,1381
202007,41590,경기도,화성시,95-99세,352,75,277
202008,41590,경기도,화성시,95-99세,359,77,282
202009,41590,경기도,화성시,95-99세,382,79,303
202010,41590,경기도,화성시,95-99세,387,78,309
202011,41590,경기도,화성시,95-99세,385,79,306
202012,41590,경기도,화성시,95-99세,386,81,305
202101,41590,경기도,화성시,95-99세,380,81,299
202102,41590,경기도,화성시,95-99세,383,81,302
202103,41590,경기도,화성시,95-99세,369,73,296
202104,41590,경기도,화성시,95-99세,370,74,296
202105,41590,경기도,화성시,95-99세,371,71,300
202106,41590,경기도,화성시,95-99세,376,72,304
202007,41590,경기도,화성시,100+,105,33,72
202008,41590,경기도,화성시,100+,110,35,75
202009,41590,경기도,화성시,100+,112,35,77
202010,41590,경기도,화성시,100+,115,36,79
202011,41590,경기도,화성시,100+,115,36,79
202012,41590,경기도,화성시,100+,116,36,80
202101,41590,경기도,화성시,100+,119,36,83
202102,41590,경기도,화성시,100+,121,36,85
202103,41590,경기도,화성시,100+,83,18,65
202104,41590,경기도,화성시,100+,80,17,63
202105,41590,경기도,화성시,100+,84,18,66
202106,41590,경기도,화성시,100+,81,18,63
202007,41610,경기도,광주시,0-4세,16486,8409,8077
202008,41610,경기도,광주시,0-4세,16350,8334,8016
202009,41610,경기도,광주시,0-4세,16263,8312,7951
202010,41610,경기도,광주시,0-4세,16124,8240,7884
202011,41610,경기도,광주시,0-4세,15996,8148,7848
202012,41610,경기도,광주시,0-4세,15889,8096,7793
202101,41610,경기도,광주시,0-4세,15711,8002,7709
202102,41610,경기도,광주시,0-4세,15563,7952,7611
202103,41610,경기도,광주시,0-4세,15356,7844,7512
202104,41610,경기도,광주시,0-4세,15224,7761,7463
202105,41610,경기도,광주시,0-4세,15068,7670,7398
202106,41610,경기도,광주시,0-4세,14907,7567,7340
202007,41610,경기도,광주시,5-9세,19245,9955,9290
202008,41610,경기도,광주시,5-9세,19283,9976,9307
202009,41610,경기도,광주시,5-9세,19278,9970,9308
202010,41610,경기도,광주시,5-9세,19280,9973,9307
202011,41610,경기도,광주시,5-9세,19237,9959,9278
202012,41610,경기도,광주시,5-9세,19301,9978,9323
202101,41610,경기도,광주시,5-9세,19246,9953,9293
202102,41610,경기도,광주시,5-9세,19174,9901,9273
202103,41610,경기도,광주시,5-9세,19162,9911,9251
202104,41610,경기도,광주시,5-9세,19138,9893,9245
202105,41610,경기도,광주시,5-9세,19125,9904,9221
202106,41610,경기도,광주시,5-9세,19127,9912,9215
202007,41610,경기도,광주시,10-14세,16579,8402,8177
202008,41610,경기도,광주시,10-14세,16658,8437,8221
202009,41610,경기도,광주시,10-14세,16757,8497,8260
202010,41610,경기도,광주시,10-14세,16845,8554,8291
202011,41610,경기도,광주시,10-14세,16993,8629,8364
202012,41610,경기도,광주시,10-14세,17054,8658,8396
202101,41610,경기도,광주시,10-14세,17194,8751,8443
202102,41610,경기도,광주시,10-14세,17224,8742,8482
202103,41610,경기도,광주시,10-14세,17308,8784,8524
202104,41610,경기도,광주시,10-14세,17424,8859,8565
202105,41610,경기도,광주시,10-14세,17446,8843,8603
202106,41610,경기도,광주시,10-14세,17478,8858,8620
202007,41610,경기도,광주시,15-19세,17268,8946,8322
202008,41610,경기도,광주시,15-19세,17196,8897,8299
202009,41610,경기도,광주시,15-19세,17063,8814,8249
202010,41610,경기도,광주시,15-19세,16954,8740,8214
202011,41610,경기도,광주시,15-19세,16745,8604,8141
202012,41610,경기도,광주시,15-19세,16565,8533,8032
202101,41610,경기도,광주시,15-19세,16427,8432,7995
202102,41610,경기도,광주시,15-19세,16351,8409,7942
202103,41610,경기도,광주시,15-19세,16463,8483,7980
202104,41610,경기도,광주시,15-19세,16700,8606,8094
202105,41610,경기도,광주시,15-19세,16673,8603,8070
202106,41610,경기도,광주시,15-19세,16676,8602,8074
202007,41610,경기도,광주시,20-24세,21272,11328,9944
202008,41610,경기도,광주시,20-24세,21328,11349,9979
202009,41610,경기도,광주시,20-24세,21367,11379,9988
202010,41610,경기도,광주시,20-24세,21422,11407,10015
202011,41610,경기도,광주시,20-24세,21404,11401,10003
202012,41610,경기도,광주시,20-24세,21328,11303,10025
202101,41610,경기도,광주시,20-24세,21328,11314,10014
202102,41610,경기도,광주시,20-24세,21271,11282,9989
202103,41610,경기도,광주시,20-24세,21208,11275,9933
202104,41610,경기도,광주시,20-24세,21151,11253,9898
202105,41610,경기도,광주시,20-24세,21181,11243,9938
202106,41610,경기도,광주시,20-24세,21165,11230,9935
202007,41610,경기도,광주시,25-29세,23438,12285,11153
202008,41610,경기도,광주시,25-29세,23500,12332,11168
202009,41610,경기도,광주시,25-29세,23519,12358,11161
202010,41610,경기도,광주시,25-29세,23638,12439,11199
202011,41610,경기도,광주시,25-29세,23753,12526,11227
202012,41610,경기도,광주시,25-29세,23892,12630,11262
202101,41610,경기도,광주시,25-29세,23875,12632,11243
202102,41610,경기도,광주시,25-29세,23889,12663,11226
202103,41610,경기도,광주시,25-29세,23947,12708,11239
202104,41610,경기도,광주시,25-29세,24002,12758,11244
202105,41610,경기도,광주시,25-29세,24045,12768,11277
202106,41610,경기도,광주시,25-29세,23989,12778,11211
202007,41610,경기도,광주시,30-34세,24374,12651,11723
202008,41610,경기도,광주시,30-34세,24372,12662,11710
202009,41610,경기도,광주시,30-34세,24391,12652,11739
202010,41610,경기도,광주시,30-34세,24260,12570,11690
202011,41610,경기도,광주시,30-34세,24209,12558,11651
202012,41610,경기도,광주시,30-34세,24220,12566,11654
202101,41610,경기도,광주시,30-34세,24246,12576,11670
202102,41610,경기도,광주시,30-34세,24147,12561,11586
202103,41610,경기도,광주시,30-34세,24188,12567,11621
202104,41610,경기도,광주시,30-34세,24126,12544,11582
202105,41610,경기도,광주시,30-34세,24164,12587,11577
202106,41610,경기도,광주시,30-34세,24185,12575,11610
202007,41610,경기도,광주시,35-39세,34210,17948,16262
202008,41610,경기도,광주시,35-39세,34084,17888,16196
202009,41610,경기도,광주시,35-39세,34015,17838,16177
202010,41610,경기도,광주시,35-39세,33834,17720,16114
202011,41610,경기도,광주시,35-39세,33702,17620,16082
202012,41610,경기도,광주시,35-39세,33624,17564,16060
202101,41610,경기도,광주시,35-39세,33433,17437,15996
202102,41610,경기도,광주시,35-39세,33102,17256,15846
202103,41610,경기도,광주시,35-39세,32821,17123,15698
202104,41610,경기도,광주시,35-39세,32650,16982,15668
202105,41610,경기도,광주시,35-39세,32432,16857,15575
202106,41610,경기도,광주시,35-39세,32251,16747,15504
202007,41610,경기도,광주시,40-44세,32413,17247,15166
202008,41610,경기도,광주시,40-44세,32569,17304,15265
202009,41610,경기도,광주시,40-44세,32773,17386,15387
202010,41610,경기도,광주시,40-44세,33014,17527,15487
202011,41610,경기도,광주시,40-44세,33213,17628,15585
202012,41610,경기도,광주시,40-44세,33260,17638,15622
202101,41610,경기도,광주시,40-44세,33375,17697,15678
202102,41610,경기도,광주시,40-44세,33578,17836,15742
202103,41610,경기도,광주시,40-44세,33605,17829,15776
202104,41610,경기도,광주시,40-44세,33780,17938,15842
202105,41610,경기도,광주시,40-44세,33920,18007,15913
202106,41610,경기도,광주시,40-44세,34114,18113,16001
202007,41610,경기도,광주시,45-49세,33442,17637,15805
202008,41610,경기도,광주시,45-49세,33532,17666,15866
202009,41610,경기도,광주시,45-49세,33530,17659,15871
202010,41610,경기도,광주시,45-49세,33412,17587,15825
202011,41610,경기도,광주시,45-49세,33407,17605,15802
202012,41610,경기도,광주시,45-49세,33563,17705,15858
202101,41610,경기도,광주시,45-49세,33529,17678,15851
202102,41610,경기도,광주시,45-49세,33507,17603,15904
202103,41610,경기도,광주시,45-49세,33477,17588,15889
202104,41610,경기도,광주시,45-49세,33451,17568,15883
202105,41610,경기도,광주시,45-49세,33379,17533,15846
202106,41610,경기도,광주시,45-49세,33311,17493,15818
202007,41610,경기도,광주시,50-54세,31952,16380,15572
202008,41610,경기도,광주시,50-54세,32057,16427,15630
202009,41610,경기도,광주시,50-54세,32237,16552,15685
202010,41610,경기도,광주시,50-54세,32433,16650,15783
202011,41610,경기도,광주시,50-54세,32620,16733,15887
202012,41610,경기도,광주시,50-54세,32645,16729,15916
202101,41610,경기도,광주시,50-54세,32903,16881,16022
202102,41610,경기도,광주시,50-54세,33053,16962,16091
202103,41610,경기도,광주시,50-54세,33005,16917,16088
202104,41610,경기도,광주시,50-54세,33172,16987,16185
202105,41610,경기도,광주시,50-54세,33404,17132,16272
202106,41610,경기도,광주시,50-54세,33592,17245,16347
202007,41610,경기도,광주시,55-59세,30788,15603,15185
202008,41610,경기도,광주시,55-59세,30795,15625,15170
202009,41610,경기도,광주시,55-59세,30838,15636,15202
202010,41610,경기도,광주시,55-59세,30862,15636,15226
202011,41610,경기도,광주시,55-59세,30791,15615,15176
202012,41610,경기도,광주시,55-59세,30889,15682,15207
202101,41610,경기도,광주시,55-59세,30778,15601,15177
202102,41610,경기도,광주시,55-59세,30812,15630,15182
202103,41610,경기도,광주시,55-59세,30840,15683,15157
202104,41610,경기도,광주시,55-59세,30784,15651,15133
202105,41610,경기도,광주시,55-59세,30700,15605,15095
202106,41610,경기도,광주시,55-59세,30514,15532,14982
202007,41610,경기도,광주시,60-64세,27835,13978,13857
202008,41610,경기도,광주시,60-64세,28008,14061,13947
202009,41610,경기도,광주시,60-64세,28193,14143,14050
202010,41610,경기도,광주시,60-64세,28345,14245,14100
202011,41610,경기도,광주시,60-64세,28549,14328,14221
202012,41610,경기도,광주시,60-64세,28745,14428,14317
202101,41610,경기도,광주시,60-64세,28983,14566,14417
202102,41610,경기도,광주시,60-64세,29240,14680,14560
202103,41610,경기도,광주시,60-64세,29408,14747,14661
202104,41610,경기도,광주시,60-64세,29643,14874,14769
202105,41610,경기도,광주시,60-64세,29867,14946,14921
202106,41610,경기도,광주시,60-64세,30196,15104,15092
202007,41610,경기도,광주시,65-69세,18467,9232,9235
202008,41610,경기도,광주시,65-69세,18638,9316,9322
202009,41610,경기도,광주시,65-69세,18839,9418,9421
202010,41610,경기도,광주시,65-69세,19021,9514,9507
202011,41610,경기도,광주시,65-69세,19214,9600,9614
202012,41610,경기도,광주시,65-69세,19402,9690,9712
202101,41610,경기도,광주시,65-69세,19626,9823,9803
202102,41610,경기도,광주시,65-69세,19851,9927,9924
202103,41610,경기도,광주시,65-69세,20124,10065,10059
202104,41610,경기도,광주시,65-69세,20281,10145,10136
202105,41610,경기도,광주시,65-69세,20473,10279,10194
202106,41610,경기도,광주시,65-69세,20628,10344,10284
202007,41610,경기도,광주시,70-74세,12616,6233,6383
202008,41610,경기도,광주시,70-74세,12660,6240,6420
202009,41610,경기도,광주시,70-74세,12693,6259,6434
202010,41610,경기도,광주시,70-74세,12779,6303,6476
202011,41610,경기도,광주시,70-74세,12877,6347,6530
202012,41610,경기도,광주시,70-74세,12974,6371,6603
202101,41610,경기도,광주시,70-74세,13137,6430,6707
202102,41610,경기도,광주시,70-74세,13206,6478,6728
202103,41610,경기도,광주시,70-74세,13233,6491,6742
202104,41610,경기도,광주시,70-74세,13265,6488,6777
202105,41610,경기도,광주시,70-74세,13288,6483,6805
202106,41610,경기도,광주시,70-74세,13313,6514,6799
202007,41610,경기도,광주시,75-79세,9020,4266,4754
202008,41610,경기도,광주시,75-79세,9043,4288,4755
202009,41610,경기도,광주시,75-79세,9052,4286,4766
202010,41610,경기도,광주시,75-79세,9051,4278,4773
202011,41610,경기도,광주시,75-79세,8993,4243,4750
202012,41610,경기도,광주시,75-79세,8995,4242,4753
202101,41610,경기도,광주시,75-79세,9013,4255,4758
202102,41610,경기도,광주시,75-79세,9018,4263,4755
202103,41610,경기도,광주시,75-79세,9064,4284,4780
202104,41610,경기도,광주시,75-79세,9068,4294,4774
202105,41610,경기도,광주시,75-79세,9085,4312,4773
202106,41610,경기도,광주시,75-79세,9135,4328,4807
202007,41610,경기도,광주시,80-84세,5407,2189,3218
202008,41610,경기도,광주시,80-84세,5458,2226,3232
202009,41610,경기도,광주시,80-84세,5487,2237,3250
202010,41610,경기도,광주시,80-84세,5542,2267,3275
202011,41610,경기도,광주시,80-84세,5590,2305,3285
202012,41610,경기도,광주시,80-84세,5628,2316,3312
202101,41610,경기도,광주시,80-84세,5670,2338,3332
202102,41610,경기도,광주시,80-84세,5693,2326,3367
202103,41610,경기도,광주시,80-84세,5714,2350,3364
202104,41610,경기도,광주시,80-84세,5752,2373,3379
202105,41610,경기도,광주시,80-84세,5833,2404,3429
202106,41610,경기도,광주시,80-84세,5898,2430,3468
202007,41610,경기도,광주시,85-89세,2595,814,1781
202008,41610,경기도,광주시,85-89세,2616,818,1798
202009,41610,경기도,광주시,85-89세,2646,824,1822
202010,41610,경기도,광주시,85-89세,2655,826,1829
202011,41610,경기도,광주시,85-89세,2686,836,1850
202012,41610,경기도,광주시,85-89세,2711,861,1850
202101,41610,경기도,광주시,85-89세,2733,876,1857
202102,41610,경기도,광주시,85-89세,2779,899,1880
202103,41610,경기도,광주시,85-89세,2820,914,1906
202104,41610,경기도,광주시,85-89세,2862,923,1939
202105,41610,경기도,광주시,85-89세,2897,935,1962
202106,41610,경기도,광주시,85-89세,2900,933,1967
202007,41610,경기도,광주시,90-94세,954,214,740
202008,41610,경기도,광주시,90-94세,971,221,750
202009,41610,경기도,광주시,90-94세,984,224,760
202010,41610,경기도,광주시,90-94세,991,229,762
202011,41610,경기도,광주시,90-94세,984,230,754
202012,41610,경기도,광주시,90-94세,1002,231,771
202101,41610,경기도,광주시,90-94세,1000,228,772
202102,41610,경기도,광주시,90-94세,1012,232,780
202103,41610,경기도,광주시,90-94세,1000,230,770
202104,41610,경기도,광주시,90-94세,1009,231,778
202105,41610,경기도,광주시,90-94세,1016,225,791
202106,41610,경기도,광주시,90-94세,1024,225,799
202007,41610,경기도,광주시,95-99세,264,56,208
202008,41610,경기도,광주시,95-99세,261,55,206
202009,41610,경기도,광주시,95-99세,265,54,211
202010,41610,경기도,광주시,95-99세,257,51,206
202011,41610,경기도,광주시,95-99세,258,48,210
202012,41610,경기도,광주시,95-99세,262,50,212
202101,41610,경기도,광주시,95-99세,267,51,216
202102,41610,경기도,광주시,95-99세,263,51,212
202103,41610,경기도,광주시,95-99세,255,47,208
202104,41610,경기도,광주시,95-99세,258,46,212
202105,41610,경기도,광주시,95-99세,258,46,212
202106,41610,경기도,광주시,95-99세,258,46,212
202007,41610,경기도,광주시,100+,98,23,75
202008,41610,경기도,광주시,100+,101,24,77
202009,41610,경기도,광주시,100+,101,26,75
202010,41610,경기도,광주시,100+,102,27,75
202011,41610,경기도,광주시,100+,103,28,75
202012,41610,경기도,광주시,100+,105,27,78
202101,41610,경기도,광주시,100+,104,27,77
202102,41610,경기도,광주시,100+,102,27,75
202103,41610,경기도,광주시,100+,54,11,43
202104,41610,경기도,광주시,100+,54,11,43
202105,41610,경기도,광주시,100+,52,11,41
202106,41610,경기도,광주시,100+,53,12,41
202007,41630,경기도,양주시,0-4세,8530,4368,4162
202008,41630,경기도,양주시,0-4세,8507,4358,4149
202009,41630,경기도,양주시,0-4세,8455,4329,4126
202010,41630,경기도,양주시,0-4세,8423,4298,4125
202011,41630,경기도,양주시,0-4세,8430,4291,4139
202012,41630,경기도,양주시,0-4세,8398,4306,4092
202101,41630,경기도,양주시,0-4세,8361,4269,4092
202102,41630,경기도,양주시,0-4세,8448,4309,4139
202103,41630,경기도,양주시,0-4세,8423,4306,4117
202104,41630,경기도,양주시,0-4세,8451,4312,4139
202105,41630,경기도,양주시,0-4세,8382,4276,4106
202106,41630,경기도,양주시,0-4세,8298,4244,4054
202007,41630,경기도,양주시,5-9세,11536,5857,5679
202008,41630,경기도,양주시,5-9세,11620,5888,5732
202009,41630,경기도,양주시,5-9세,11642,5920,5722
202010,41630,경기도,양주시,5-9세,11620,5924,5696
202011,41630,경기도,양주시,5-9세,11597,5909,5688
202012,41630,경기도,양주시,5-9세,11542,5872,5670
202101,41630,경기도,양주시,5-9세,11586,5889,5697
202102,41630,경기도,양주시,5-9세,11752,5978,5774
202103,41630,경기도,양주시,5-9세,11818,6016,5802
202104,41630,경기도,양주시,5-9세,11813,6023,5790
202105,41630,경기도,양주시,5-9세,11829,6025,5804
202106,41630,경기도,양주시,5-9세,11859,6048,5811
202007,41630,경기도,양주시,10-14세,11784,5972,5812
202008,41630,경기도,양주시,10-14세,11883,6013,5870
202009,41630,경기도,양주시,10-14세,11934,6025,5909
202010,41630,경기도,양주시,10-14세,11961,6027,5934
202011,41630,경기도,양주시,10-14세,11996,6035,5961
202012,41630,경기도,양주시,10-14세,12034,6040,5994
202101,41630,경기도,양주시,10-14세,12147,6102,6045
202102,41630,경기도,양주시,10-14세,12311,6183,6128
202103,41630,경기도,양주시,10-14세,12385,6220,6165
202104,41630,경기도,양주시,10-14세,12402,6225,6177
202105,41630,경기도,양주시,10-14세,12408,6238,6170
202106,41630,경기도,양주시,10-14세,12427,6251,6176
202007,41630,경기도,양주시,15-19세,12297,6357,5940
202008,41630,경기도,양주시,15-19세,12284,6328,5956
202009,41630,경기도,양주시,15-19세,12208,6279,5929
202010,41630,경기도,양주시,15-19세,12195,6274,5921
202011,41630,경기도,양주시,15-19세,12134,6236,5898
202012,41630,경기도,양주시,15-19세,12023,6184,5839
202101,41630,경기도,양주시,15-19세,11990,6172,5818
202102,41630,경기도,양주시,15-19세,12021,6182,5839
202103,41630,경기도,양주시,15-19세,12022,6208,5814
202104,41630,경기도,양주시,15-19세,12006,6182,5824
202105,41630,경기도,양주시,15-19세,11991,6188,5803
202106,41630,경기도,양주시,15-19세,11934,6154,5780
202007,41630,경기도,양주시,20-24세,13757,7324,6433
202008,41630,경기도,양주시,20-24세,13781,7357,6424
202009,41630,경기도,양주시,20-24세,13794,7371,6423
202010,41630,경기도,양주시,20-24세,13854,7399,6455
202011,41630,경기도,양주시,20-24세,13849,7406,6443
202012,41630,경기도,양주시,20-24세,13908,7460,6448
202101,41630,경기도,양주시,20-24세,13945,7448,6497
202102,41630,경기도,양주시,20-24세,14004,7482,6522
202103,41630,경기도,양주시,20-24세,14002,7452,6550
202104,41630,경기도,양주시,20-24세,14056,7489,6567
202105,41630,경기도,양주시,20-24세,14026,7455,6571
202106,41630,경기도,양주시,20-24세,14012,7437,6575
202007,41630,경기도,양주시,25-29세,13288,7160,6128
202008,41630,경기도,양주시,25-29세,13357,7177,6180
202009,41630,경기도,양주시,25-29세,13425,7231,6194
202010,41630,경기도,양주시,25-29세,13484,7259,6225
202011,41630,경기도,양주시,25-29세,13498,7287,6211
202012,41630,경기도,양주시,25-29세,13541,7296,6245
202101,41630,경기도,양주시,25-29세,13553,7313,6240
202102,41630,경기도,양주시,25-29세,13580,7327,6253
202103,41630,경기도,양주시,25-29세,13676,7396,6280
202104,41630,경기도,양주시,25-29세,13750,7421,6329
202105,41630,경기도,양주시,25-29세,13765,7444,6321
202106,41630,경기도,양주시,25-29세,13752,7449,6303
202007,41630,경기도,양주시,30-34세,12051,6350,5701
202008,41630,경기도,양주시,30-34세,12135,6380,5755
202009,41630,경기도,양주시,30-34세,12169,6375,5794
202010,41630,경기도,양주시,30-34세,12196,6379,5817
202011,41630,경기도,양주시,30-34세,12179,6352,5827
202012,41630,경기도,양주시,30-34세,12148,6361,5787
202101,41630,경기도,양주시,30-34세,12228,6410,5818
202102,41630,경기도,양주시,30-34세,12374,6459,5915
202103,41630,경기도,양주시,30-34세,12522,6529,5993
202104,41630,경기도,양주시,30-34세,12585,6562,6023
202105,41630,경기도,양주시,30-34세,12634,6586,6048
202106,41630,경기도,양주시,30-34세,12664,6601,6063
202007,41630,경기도,양주시,35-39세,15976,8127,7849
202008,41630,경기도,양주시,35-39세,16012,8155,7857
202009,41630,경기도,양주시,35-39세,15983,8160,7823
202010,41630,경기도,양주시,35-39세,15939,8140,7799
202011,41630,경기도,양주시,35-39세,15941,8140,7801
202012,41630,경기도,양주시,35-39세,15900,8103,7797
202101,41630,경기도,양주시,35-39세,15923,8131,7792
202102,41630,경기도,양주시,35-39세,16037,8211,7826
202103,41630,경기도,양주시,35-39세,16072,8220,7852
202104,41630,경기도,양주시,35-39세,16044,8204,7840
202105,41630,경기도,양주시,35-39세,15990,8183,7807
202106,41630,경기도,양주시,35-39세,15836,8091,7745
202007,41630,경기도,양주시,40-44세,17897,9036,8861
202008,41630,경기도,양주시,40-44세,17983,9075,8908
202009,41630,경기도,양주시,40-44세,18039,9082,8957
202010,41630,경기도,양주시,40-44세,18098,9145,8953
202011,41630,경기도,양주시,40-44세,18141,9163,8978
202012,41630,경기도,양주시,40-44세,18076,9148,8928
202101,41630,경기도,양주시,40-44세,18132,9186,8946
202102,41630,경기도,양주시,40-44세,18355,9267,9088
202103,41630,경기도,양주시,40-44세,18460,9335,9125
202104,41630,경기도,양주시,40-44세,18541,9383,9158
202105,41630,경기도,양주시,40-44세,18575,9399,9176
202106,41630,경기도,양주시,40-44세,18678,9470,9208
202007,41630,경기도,양주시,45-49세,21355,11182,10173
202008,41630,경기도,양주시,45-49세,21428,11230,10198
202009,41630,경기도,양주시,45-49세,21350,11205,10145
202010,41630,경기도,양주시,45-49세,21348,11206,10142
202011,41630,경기도,양주시,45-49세,21335,11184,10151
202012,41630,경기도,양주시,45-49세,21368,11197,10171
202101,41630,경기도,양주시,45-49세,21426,11189,10237
202102,41630,경기도,양주시,45-49세,21515,11231,10284
202103,41630,경기도,양주시,45-49세,21557,11278,10279
202104,41630,경기도,양주시,45-49세,21574,11301,10273
202105,41630,경기도,양주시,45-49세,21484,11246,10238
202106,41630,경기도,양주시,45-49세,21382,11199,10183
202007,41630,경기도,양주시,50-54세,19583,10213,9370
202008,41630,경기도,양주시,50-54세,19638,10229,9409
202009,41630,경기도,양주시,50-54세,19730,10270,9460
202010,41630,경기도,양주시,50-54세,19813,10308,9505
202011,41630,경기도,양주시,50-54세,19821,10347,9474
202012,41630,경기도,양주시,50-54세,19851,10353,9498
202101,41630,경기도,양주시,50-54세,20015,10457,9558
202102,41630,경기도,양주시,50-54세,20260,10562,9698
202103,41630,경기도,양주시,50-54세,20266,10539,9727
202104,41630,경기도,양주시,50-54세,20354,10584,9770
202105,41630,경기도,양주시,50-54세,20485,10648,9837
202106,41630,경기도,양주시,50-54세,20611,10700,9911
202007,41630,경기도,양주시,55-59세,18055,9514,8541
202008,41630,경기도,양주시,55-59세,18164,9574,8590
202009,41630,경기도,양주시,55-59세,18142,9566,8576
202010,41630,경기도,양주시,55-59세,18213,9594,8619
202011,41630,경기도,양주시,55-59세,18220,9591,8629
202012,41630,경기도,양주시,55-59세,18238,9608,8630
202101,41630,경기도,양주시,55-59세,18189,9596,8593
202102,41630,경기도,양주시,55-59세,18265,9657,8608
202103,41630,경기도,양주시,55-59세,18392,9758,8634
202104,41630,경기도,양주시,55-59세,18410,9757,8653
202105,41630,경기도,양주시,55-59세,18375,9726,8649
202106,41630,경기도,양주시,55-59세,18290,9681,8609
202007,41630,경기도,양주시,60-64세,16641,8445,8196
202008,41630,경기도,양주시,60-64세,16754,8514,8240
202009,41630,경기도,양주시,60-64세,16860,8589,8271
202010,41630,경기도,양주시,60-64세,16934,8642,8292
202011,41630,경기도,양주시,60-64세,17011,8687,8324
202012,41630,경기도,양주시,60-64세,17087,8718,8369
202101,41630,경기도,양주시,60-64세,17157,8756,8401
202102,41630,경기도,양주시,60-64세,17300,8822,8478
202103,41630,경기도,양주시,60-64세,17443,8876,8567
202104,41630,경기도,양주시,60-64세,17621,8946,8675
202105,41630,경기도,양주시,60-64세,17745,9038,8707
202106,41630,경기도,양주시,60-64세,17845,9087,8758
202007,41630,경기도,양주시,65-69세,11218,5505,5713
202008,41630,경기도,양주시,65-69세,11359,5575,5784
202009,41630,경기도,양주시,65-69세,11506,5635,5871
202010,41630,경기도,양주시,65-69세,11617,5687,5930
202011,41630,경기도,양주시,65-69세,11735,5748,5987
202012,41630,경기도,양주시,65-69세,11773,5779,5994
202101,41630,경기도,양주시,65-69세,11952,5871,6081
202102,41630,경기도,양주시,65-69세,12077,5941,6136
202103,41630,경기도,양주시,65-69세,12289,6047,6242
202104,41630,경기도,양주시,65-69세,12437,6135,6302
202105,41630,경기도,양주시,65-69세,12575,6181,6394
202106,41630,경기도,양주시,65-69세,12696,6242,6454
202007,41630,경기도,양주시,70-74세,8857,4199,4658
202008,41630,경기도,양주시,70-74세,8881,4200,4681
202009,41630,경기도,양주시,70-74세,8907,4223,4684
202010,41630,경기도,양주시,70-74세,8946,4243,4703
202011,41630,경기도,양주시,70-74세,8982,4259,4723
202012,41630,경기도,양주시,70-74세,9055,4285,4770
202101,41630,경기도,양주시,70-74세,9116,4308,4808
202102,41630,경기도,양주시,70-74세,9151,4313,4838
202103,41630,경기도,양주시,70-74세,9137,4319,4818
202104,41630,경기도,양주시,70-74세,9154,4336,4818
202105,41630,경기도,양주시,70-74세,9143,4336,4807
202106,41630,경기도,양주시,70-74세,9143,4324,4819
202007,41630,경기도,양주시,75-79세,7275,3258,4017
202008,41630,경기도,양주시,75-79세,7311,3284,4027
202009,41630,경기도,양주시,75-79세,7283,3284,3999
202010,41630,경기도,양주시,75-79세,7272,3273,3999
202011,41630,경기도,양주시,75-79세,7260,3265,3995
202012,41630,경기도,양주시,75-79세,7232,3252,3980
202101,41630,경기도,양주시,75-79세,7223,3250,3973
202102,41630,경기도,양주시,75-79세,7196,3254,3942
202103,41630,경기도,양주시,75-79세,7238,3289,3949
202104,41630,경기도,양주시,75-79세,7261,3304,3957
202105,41630,경기도,양주시,75-79세,7297,3328,3969
202106,41630,경기도,양주시,75-79세,7303,3347,3956
202007,41630,경기도,양주시,80-84세,4627,1885,2742
202008,41630,경기도,양주시,80-84세,4650,1886,2764
202009,41630,경기도,양주시,80-84세,4656,1896,2760
202010,41630,경기도,양주시,80-84세,4721,1922,2799
202011,41630,경기도,양주시,80-84세,4749,1939,2810
202012,41630,경기도,양주시,80-84세,4761,1935,2826
202101,41630,경기도,양주시,80-84세,4816,1958,2858
202102,41630,경기도,양주시,80-84세,4870,1975,2895
202103,41630,경기도,양주시,80-84세,4881,1965,2916
202104,41630,경기도,양주시,80-84세,4908,1974,2934
202105,41630,경기도,양주시,80-84세,4937,1978,2959
202106,41630,경기도,양주시,80-84세,5011,2003,3008
202007,41630,경기도,양주시,85-89세,2203,696,1507
202008,41630,경기도,양주시,85-89세,2234,717,1517
202009,41630,경기도,양주시,85-89세,2263,732,1531
202010,41630,경기도,양주시,85-89세,2279,744,1535
202011,41630,경기도,양주시,85-89세,2302,754,1548
202012,41630,경기도,양주시,85-89세,2338,769,1569
202101,41630,경기도,양주시,85-89세,2377,790,1587
202102,41630,경기도,양주시,85-89세,2429,810,1619
202103,41630,경기도,양주시,85-89세,2481,828,1653
202104,41630,경기도,양주시,85-89세,2498,827,1671
202105,41630,경기도,양주시,85-89세,2513,833,1680
202106,41630,경기도,양주시,85-89세,2518,836,1682
202007,41630,경기도,양주시,90-94세,757,181,576
202008,41630,경기도,양주시,90-94세,778,185,593
202009,41630,경기도,양주시,90-94세,788,185,603
202010,41630,경기도,양주시,90-94세,796,183,613
202011,41630,경기도,양주시,90-94세,794,181,613
202012,41630,경기도,양주시,90-94세,791,176,615
202101,41630,경기도,양주시,90-94세,812,178,634
202102,41630,경기도,양주시,90-94세,833,183,650
202103,41630,경기도,양주시,90-94세,846,179,667
202104,41630,경기도,양주시,90-94세,850,181,669
202105,41630,경기도,양주시,90-94세,848,181,667
202106,41630,경기도,양주시,90-94세,854,188,666
202007,41630,경기도,양주시,95-99세,215,55,160
202008,41630,경기도,양주시,95-99세,221,58,163
202009,41630,경기도,양주시,95-99세,221,60,161
202010,41630,경기도,양주시,95-99세,226,60,166
202011,41630,경기도,양주시,95-99세,230,61,169
202012,41630,경기도,양주시,95-99세,230,62,168
202101,41630,경기도,양주시,95-99세,229,61,168
202102,41630,경기도,양주시,95-99세,233,60,173
202103,41630,경기도,양주시,95-99세,224,51,173
202104,41630,경기도,양주시,95-99세,224,50,174
202105,41630,경기도,양주시,95-99세,227,50,177
202106,41630,경기도,양주시,95-99세,234,49,185
202007,41630,경기도,양주시,100+,70,11,59
202008,41630,경기도,양주시,100+,72,11,61
202009,41630,경기도,양주시,100+,72,11,61
202010,41630,경기도,양주시,100+,70,12,58
202011,41630,경기도,양주시,100+,69,12,57
202012,41630,경기도,양주시,100+,65,12,53
202101,41630,경기도,양주시,100+,64,12,52
202102,41630,경기도,양주시,100+,61,12,49
202103,41630,경기도,양주시,100+,47,10,37
202104,41630,경기도,양주시,100+,51,11,40
202105,41630,경기도,양주시,100+,47,10,37
202106,41630,경기도,양주시,100+,47,10,37
202007,41650,경기도,포천시,0-4세,3799,1995,1804
202008,41650,경기도,포천시,0-4세,3773,1967,1806
202009,41650,경기도,포천시,0-4세,3746,1956,1790
202010,41650,경기도,포천시,0-4세,3711,1939,1772
202011,41650,경기도,포천시,0-4세,3669,1925,1744
202012,41650,경기도,포천시,0-4세,3624,1886,1738
202101,41650,경기도,포천시,0-4세,3581,1871,1710
202102,41650,경기도,포천시,0-4세,3541,1837,1704
202103,41650,경기도,포천시,0-4세,3515,1821,1694
202104,41650,경기도,포천시,0-4세,3500,1807,1693
202105,41650,경기도,포천시,0-4세,3488,1793,1695
202106,41650,경기도,포천시,0-4세,3454,1774,1680
202007,41650,경기도,포천시,5-9세,5080,2615,2465
202008,41650,경기도,포천시,5-9세,5044,2602,2442
202009,41650,경기도,포천시,5-9세,5024,2586,2438
202010,41650,경기도,포천시,5-9세,4977,2572,2405
202011,41650,경기도,포천시,5-9세,4946,2544,2402
202012,41650,경기도,포천시,5-9세,4955,2553,2402
202101,41650,경기도,포천시,5-9세,4928,2527,2401
202102,41650,경기도,포천시,5-9세,4880,2494,2386
202103,41650,경기도,포천시,5-9세,4828,2476,2352
202104,41650,경기도,포천시,5-9세,4826,2482,2344
202105,41650,경기도,포천시,5-9세,4833,2487,2346
202106,41650,경기도,포천시,5-9세,4835,2481,2354
202007,41650,경기도,포천시,10-14세,5680,2999,2681
202008,41650,경기도,포천시,10-14세,5654,2978,2676
202009,41650,경기도,포천시,10-14세,5652,2977,2675
202010,41650,경기도,포천시,10-14세,5649,2959,2690
202011,41650,경기도,포천시,10-14세,5653,2963,2690
202012,41650,경기도,포천시,10-14세,5630,2945,2685
202101,41650,경기도,포천시,10-14세,5634,2957,2677
202102,41650,경기도,포천시,10-14세,5625,2962,2663
202103,41650,경기도,포천시,10-14세,5615,2964,2651
202104,41650,경기도,포천시,10-14세,5624,2964,2660
202105,41650,경기도,포천시,10-14세,5607,2946,2661
202106,41650,경기도,포천시,10-14세,5609,2956,2653
202007,41650,경기도,포천시,15-19세,6874,3583,3291
202008,41650,경기도,포천시,15-19세,6945,3617,3328
202009,41650,경기도,포천시,15-19세,6846,3570,3276
202010,41650,경기도,포천시,15-19세,6738,3520,3218
202011,41650,경기도,포천시,15-19세,6685,3493,3192
202012,41650,경기도,포천시,15-19세,6613,3461,3152
202101,41650,경기도,포천시,15-19세,6507,3404,3103
202102,41650,경기도,포천시,15-19세,6438,3351,3087
202103,41650,경기도,포천시,15-19세,6384,3324,3060
202104,41650,경기도,포천시,15-19세,6358,3308,3050
202105,41650,경기도,포천시,15-19세,6341,3299,3042
202106,41650,경기도,포천시,15-19세,6289,3264,3025
202007,41650,경기도,포천시,20-24세,9020,5092,3928
202008,41650,경기도,포천시,20-24세,8997,5079,3918
202009,41650,경기도,포천시,20-24세,9035,5100,3935
202010,41650,경기도,포천시,20-24세,9028,5083,3945
202011,41650,경기도,포천시,20-24세,9012,5078,3934
202012,41650,경기도,포천시,20-24세,8978,5072,3906
202101,41650,경기도,포천시,20-24세,8971,5049,3922
202102,41650,경기도,포천시,20-24세,9001,5086,3915
202103,41650,경기도,포천시,20-24세,8956,5055,3901
202104,41650,경기도,포천시,20-24세,8937,5045,3892
202105,41650,경기도,포천시,20-24세,8925,5036,3889
202106,41650,경기도,포천시,20-24세,8917,5021,3896
202007,41650,경기도,포천시,25-29세,8905,5314,3591
202008,41650,경기도,포천시,25-29세,8910,5315,3595
202009,41650,경기도,포천시,25-29세,8908,5299,3609
202010,41650,경기도,포천시,25-29세,8903,5296,3607
202011,41650,경기도,포천시,25-29세,8883,5285,3598
202012,41650,경기도,포천시,25-29세,8863,5272,3591
202101,41650,경기도,포천시,25-29세,8924,5309,3615
202102,41650,경기도,포천시,25-29세,8933,5313,3620
202103,41650,경기도,포천시,25-29세,8963,5344,3619
202104,41650,경기도,포천시,25-29세,8995,5381,3614
202105,41650,경기도,포천시,25-29세,8985,5362,3623
202106,41650,경기도,포천시,25-29세,9021,5382,3639
202007,41650,경기도,포천시,30-34세,7093,3961,3132
202008,41650,경기도,포천시,30-34세,7094,3973,3121
202009,41650,경기도,포천시,30-34세,7108,3980,3128
202010,41650,경기도,포천시,30-34세,7093,3997,3096
202011,41650,경기도,포천시,30-34세,7071,3994,3077
202012,41650,경기도,포천시,30-34세,7028,3982,3046
202101,41650,경기도,포천시,30-34세,7025,3979,3046
202102,41650,경기도,포천시,30-34세,7060,4003,3057
202103,41650,경기도,포천시,30-34세,7077,4034,3043
202104,41650,경기도,포천시,30-34세,7119,4049,3070
202105,41650,경기도,포천시,30-34세,7151,4072,3079
202106,41650,경기도,포천시,30-34세,7183,4091,3092
202007,41650,경기도,포천시,35-39세,7689,4207,3482
202008,41650,경기도,포천시,35-39세,7637,4187,3450
202009,41650,경기도,포천시,35-39세,7606,4180,3426
202010,41650,경기도,포천시,35-39세,7570,4139,3431
202011,41650,경기도,포천시,35-39세,7537,4123,3414
202012,41650,경기도,포천시,35-39세,7548,4126,3422
202101,41650,경기도,포천시,35-39세,7534,4115,3419
202102,41650,경기도,포천시,35-39세,7506,4118,3388
202103,41650,경기도,포천시,35-39세,7446,4085,3361
202104,41650,경기도,포천시,35-39세,7463,4110,3353
202105,41650,경기도,포천시,35-39세,7444,4109,3335
202106,41650,경기도,포천시,35-39세,7401,4078,3323
202007,41650,경기도,포천시,40-44세,8778,4663,4115
202008,41650,경기도,포천시,40-44세,8746,4660,4086
202009,41650,경기도,포천시,40-44세,8760,4665,4095
202010,41650,경기도,포천시,40-44세,8757,4675,4082
202011,41650,경기도,포천시,40-44세,8757,4672,4085
202012,41650,경기도,포천시,40-44세,8691,4638,4053
202101,41650,경기도,포천시,40-44세,8689,4639,4050
202102,41650,경기도,포천시,40-44세,8637,4607,4030
202103,41650,경기도,포천시,40-44세,8561,4579,3982
202104,41650,경기도,포천시,40-44세,8536,4552,3984
202105,41650,경기도,포천시,40-44세,8525,4552,3973
202106,41650,경기도,포천시,40-44세,8566,4590,3976
202007,41650,경기도,포천시,45-49세,12066,6559,5507
202008,41650,경기도,포천시,45-49세,12046,6527,5519
202009,41650,경기도,포천시,45-49세,11962,6497,5465
202010,41650,경기도,포천시,45-49세,11878,6443,5435
202011,41650,경기도,포천시,45-49세,11784,6390,5394
202012,41650,경기도,포천시,45-49세,11781,6388,5393
202101,41650,경기도,포천시,45-49세,11736,6362,5374
202102,41650,경기도,포천시,45-49세,11653,6300,5353
202103,41650,경기도,포천시,45-49세,11543,6239,5304
202104,41650,경기도,포천시,45-49세,11559,6250,5309
202105,41650,경기도,포천시,45-49세,11492,6212,5280
202106,41650,경기도,포천시,45-49세,11416,6174,5242
202007,41650,경기도,포천시,50-54세,14110,7733,6377
202008,41650,경기도,포천시,50-54세,14056,7707,6349
202009,41650,경기도,포천시,50-54세,14073,7696,6377
202010,41650,경기도,포천시,50-54세,14017,7671,6346
202011,41650,경기도,포천시,50-54세,13996,7650,6346
202012,41650,경기도,포천시,50-54세,13893,7593,6300
202101,41650,경기도,포천시,50-54세,13934,7604,6330
202102,41650,경기도,포천시,50-54세,13969,7650,6319
202103,41650,경기도,포천시,50-54세,13873,7606,6267
202104,41650,경기도,포천시,50-54세,13865,7584,6281
202105,41650,경기도,포천시,50-54세,13921,7595,6326
202106,41650,경기도,포천시,50-54세,13960,7598,6362
202007,41650,경기도,포천시,55-59세,15310,8424,6886
202008,41650,경기도,포천시,55-59세,15301,8412,6889
202009,41650,경기도,포천시,55-59세,15266,8424,6842
202010,41650,경기도,포천시,55-59세,15239,8399,6840
202011,41650,경기도,포천시,55-59세,15251,8401,6850
202012,41650,경기도,포천시,55-59세,15283,8395,6888
202101,41650,경기도,포천시,55-59세,15213,8377,6836
202102,41650,경기도,포천시,55-59세,15174,8369,6805
202103,41650,경기도,포천시,55-59세,15122,8375,6747
202104,41650,경기도,포천시,55-59세,15147,8389,6758
202105,41650,경기도,포천시,55-59세,15091,8361,6730
202106,41650,경기도,포천시,55-59세,15029,8337,6692
202007,41650,경기도,포천시,60-64세,14644,8010,6634
202008,41650,경기도,포천시,60-64세,14750,8089,6661
202009,41650,경기도,포천시,60-64세,14802,8114,6688
202010,41650,경기도,포천시,60-64세,14893,8158,6735
202011,41650,경기도,포천시,60-64세,14984,8205,6779
202012,41650,경기도,포천시,60-64세,15073,8250,6823
202101,41650,경기도,포천시,60-64세,15184,8301,6883
202102,41650,경기도,포천시,60-64세,15331,8350,6981
202103,41650,경기도,포천시,60-64세,15412,8389,7023
202104,41650,경기도,포천시,60-64세,15512,8466,7046
202105,41650,경기도,포천시,60-64세,15645,8551,7094
202106,41650,경기도,포천시,60-64세,15830,8636,7194
202007,41650,경기도,포천시,65-69세,8933,4730,4203
202008,41650,경기도,포천시,65-69세,9027,4778,4249
202009,41650,경기도,포천시,65-69세,9087,4822,4265
202010,41650,경기도,포천시,65-69세,9169,4873,4296
202011,41650,경기도,포천시,65-69세,9254,4918,4336
202012,41650,경기도,포천시,65-69세,9320,4961,4359
202101,41650,경기도,포천시,65-69세,9462,5044,4418
202102,41650,경기도,포천시,65-69세,9636,5154,4482
202103,41650,경기도,포천시,65-69세,9779,5248,4531
202104,41650,경기도,포천시,65-69세,9893,5304,4589
202105,41650,경기도,포천시,65-69세,9977,5341,4636
202106,41650,경기도,포천시,65-69세,10061,5393,4668
202007,41650,경기도,포천시,70-74세,6764,3287,3477
202008,41650,경기도,포천시,70-74세,6775,3283,3492
202009,41650,경기도,포천시,70-74세,6784,3287,3497
202010,41650,경기도,포천시,70-74세,6790,3297,3493
202011,41650,경기도,포천시,70-74세,6801,3307,3494
202012,41650,경기도,포천시,70-74세,6817,3318,3499
202101,41650,경기도,포천시,70-74세,6864,3332,3532
202102,41650,경기도,포천시,70-74세,6870,3339,3531
202103,41650,경기도,포천시,70-74세,6802,3327,3475
202104,41650,경기도,포천시,70-74세,6792,3325,3467
202105,41650,경기도,포천시,70-74세,6792,3331,3461
202106,41650,경기도,포천시,70-74세,6792,3325,3467
202007,41650,경기도,포천시,75-79세,5719,2463,3256
202008,41650,경기도,포천시,75-79세,5720,2472,3248
202009,41650,경기도,포천시,75-79세,5709,2473,3236
202010,41650,경기도,포천시,75-79세,5692,2457,3235
202011,41650,경기도,포천시,75-79세,5666,2450,3216
202012,41650,경기도,포천시,75-79세,5648,2439,3209
202101,41650,경기도,포천시,75-79세,5624,2450,3174
202102,41650,경기도,포천시,75-79세,5579,2437,3142
202103,41650,경기도,포천시,75-79세,5554,2423,3131
202104,41650,경기도,포천시,75-79세,5565,2432,3133
202105,41650,경기도,포천시,75-79세,5548,2424,3124
202106,41650,경기도,포천시,75-79세,5540,2425,3115
202007,41650,경기도,포천시,80-84세,4281,1625,2656
202008,41650,경기도,포천시,80-84세,4288,1631,2657
202009,41650,경기도,포천시,80-84세,4323,1643,2680
202010,41650,경기도,포천시,80-84세,4328,1651,2677
202011,41650,경기도,포천시,80-84세,4346,1666,2680
202012,41650,경기도,포천시,80-84세,4332,1659,2673
202101,41650,경기도,포천시,80-84세,4358,1668,2690
202102,41650,경기도,포천시,80-84세,4394,1682,2712
202103,41650,경기도,포천시,80-84세,4378,1674,2704
202104,41650,경기도,포천시,80-84세,4378,1671,2707
202105,41650,경기도,포천시,80-84세,4402,1686,2716
202106,41650,경기도,포천시,80-84세,4407,1691,2716
202007,41650,경기도,포천시,85-89세,2020,656,1364
202008,41650,경기도,포천시,85-89세,2035,665,1370
202009,41650,경기도,포천시,85-89세,2049,671,1378
202010,41650,경기도,포천시,85-89세,2084,678,1406
202011,41650,경기도,포천시,85-89세,2119,690,1429
202012,41650,경기도,포천시,85-89세,2143,707,1436
202101,41650,경기도,포천시,85-89세,2162,713,1449
202102,41650,경기도,포천시,85-89세,2184,720,1464
202103,41650,경기도,포천시,85-89세,2221,741,1480
202104,41650,경기도,포천시,85-89세,2257,740,1517
202105,41650,경기도,포천시,85-89세,2269,738,1531
202106,41650,경기도,포천시,85-89세,2287,733,1554
202007,41650,경기도,포천시,90-94세,742,157,585
202008,41650,경기도,포천시,90-94세,751,158,593
202009,41650,경기도,포천시,90-94세,757,162,595
202010,41650,경기도,포천시,90-94세,755,161,594
202011,41650,경기도,포천시,90-94세,763,162,601
202012,41650,경기도,포천시,90-94세,755,166,589
202101,41650,경기도,포천시,90-94세,764,168,596
202102,41650,경기도,포천시,90-94세,761,167,594
202103,41650,경기도,포천시,90-94세,740,163,577
202104,41650,경기도,포천시,90-94세,740,170,570
202105,41650,경기도,포천시,90-94세,741,170,571
202106,41650,경기도,포천시,90-94세,749,177,572
202007,41650,경기도,포천시,95-99세,229,66,163
202008,41650,경기도,포천시,95-99세,229,64,165
202009,41650,경기도,포천시,95-99세,231,65,166
202010,41650,경기도,포천시,95-99세,228,67,161
202011,41650,경기도,포천시,95-99세,220,66,154
202012,41650,경기도,포천시,95-99세,221,64,157
202101,41650,경기도,포천시,95-99세,220,65,155
202102,41650,경기도,포천시,95-99세,227,66,161
202103,41650,경기도,포천시,95-99세,210,61,149
202104,41650,경기도,포천시,95-99세,215,60,155
202105,41650,경기도,포천시,95-99세,213,61,152
202106,41650,경기도,포천시,95-99세,213,60,153
202007,41650,경기도,포천시,100+,73,27,46
202008,41650,경기도,포천시,100+,76,30,46
202009,41650,경기도,포천시,100+,75,29,46
202010,41650,경기도,포천시,100+,79,31,48
202011,41650,경기도,포천시,100+,80,30,50
202012,41650,경기도,포천시,100+,78,30,48
202101,41650,경기도,포천시,100+,79,30,49
202102,41650,경기도,포천시,100+,81,31,50
202103,41650,경기도,포천시,100+,35,14,21
202104,41650,경기도,포천시,100+,36,13,23
202105,41650,경기도,포천시,100+,35,12,23
202106,41650,경기도,포천시,100+,38,14,24
202007,41670,경기도,여주시,0-4세,3164,1593,1571
202008,41670,경기도,여주시,0-4세,3143,1577,1566
202009,41670,경기도,여주시,0-4세,3120,1557,1563
202010,41670,경기도,여주시,0-4세,3090,1541,1549
202011,41670,경기도,여주시,0-4세,3066,1529,1537
202012,41670,경기도,여주시,0-4세,3072,1541,1531
202101,41670,경기도,여주시,0-4세,3041,1523,1518
202102,41670,경기도,여주시,0-4세,3005,1506,1499
202103,41670,경기도,여주시,0-4세,2987,1492,1495
202104,41670,경기도,여주시,0-4세,2986,1497,1489
202105,41670,경기도,여주시,0-4세,2942,1473,1469
202106,41670,경기도,여주시,0-4세,2915,1460,1455
202007,41670,경기도,여주시,5-9세,4437,2322,2115
202008,41670,경기도,여주시,5-9세,4438,2334,2104
202009,41670,경기도,여주시,5-9세,4423,2334,2089
202010,41670,경기도,여주시,5-9세,4398,2311,2087
202011,41670,경기도,여주시,5-9세,4355,2295,2060
202012,41670,경기도,여주시,5-9세,4342,2272,2070
202101,41670,경기도,여주시,5-9세,4325,2265,2060
202102,41670,경기도,여주시,5-9세,4322,2259,2063
202103,41670,경기도,여주시,5-9세,4319,2262,2057
202104,41670,경기도,여주시,5-9세,4274,2238,2036
202105,41670,경기도,여주시,5-9세,4266,2234,2032
202106,41670,경기도,여주시,5-9세,4252,2231,2021
202007,41670,경기도,여주시,10-14세,4558,2380,2178
202008,41670,경기도,여주시,10-14세,4568,2378,2190
202009,41670,경기도,여주시,10-14세,4562,2359,2203
202010,41670,경기도,여주시,10-14세,4588,2371,2217
202011,41670,경기도,여주시,10-14세,4599,2364,2235
202012,41670,경기도,여주시,10-14세,4589,2365,2224
202101,41670,경기도,여주시,10-14세,4589,2375,2214
202102,41670,경기도,여주시,10-14세,4592,2393,2199
202103,41670,경기도,여주시,10-14세,4606,2392,2214
202104,41670,경기도,여주시,10-14세,4638,2410,2228
202105,41670,경기도,여주시,10-14세,4635,2414,2221
202106,41670,경기도,여주시,10-14세,4642,2423,2219
202007,41670,경기도,여주시,15-19세,5139,2633,2506
202008,41670,경기도,여주시,15-19세,5066,2601,2465
202009,41670,경기도,여주시,15-19세,5084,2606,2478
202010,41670,경기도,여주시,15-19세,5050,2592,2458
202011,41670,경기도,여주시,15-19세,5028,2600,2428
202012,41670,경기도,여주시,15-19세,5003,2567,2436
202101,41670,경기도,여주시,15-19세,4969,2538,2431
202102,41670,경기도,여주시,15-19세,4919,2508,2411
202103,41670,경기도,여주시,15-19세,4871,2482,2389
202104,41670,경기도,여주시,15-19세,4804,2450,2354
202105,41670,경기도,여주시,15-19세,4807,2445,2362
202106,41670,경기도,여주시,15-19세,4876,2487,2389
202007,41670,경기도,여주시,20-24세,6241,3329,2912
202008,41670,경기도,여주시,20-24세,6228,3319,2909
202009,41670,경기도,여주시,20-24세,6188,3300,2888
202010,41670,경기도,여주시,20-24세,6200,3299,2901
202011,41670,경기도,여주시,20-24세,6203,3293,2910
202012,41670,경기도,여주시,20-24세,6195,3301,2894
202101,41670,경기도,여주시,20-24세,6204,3309,2895
202102,41670,경기도,여주시,20-24세,6233,3318,2915
202103,41670,경기도,여주시,20-24세,6216,3316,2900
202104,41670,경기도,여주시,20-24세,6213,3310,2903
202105,41670,경기도,여주시,20-24세,6171,3294,2877
202106,41670,경기도,여주시,20-24세,6200,3309,2891
202007,41670,경기도,여주시,25-29세,5843,3309,2534
202008,41670,경기도,여주시,25-29세,5888,3321,2567
202009,41670,경기도,여주시,25-29세,5898,3349,2549
202010,41670,경기도,여주시,25-29세,5924,3363,2561
202011,41670,경기도,여주시,25-29세,5954,3371,2583
202012,41670,경기도,여주시,25-29세,5982,3381,2601
202101,41670,경기도,여주시,25-29세,6021,3398,2623
202102,41670,경기도,여주시,25-29세,5990,3383,2607
202103,41670,경기도,여주시,25-29세,5977,3367,2610
202104,41670,경기도,여주시,25-29세,5953,3361,2592
202105,41670,경기도,여주시,25-29세,5972,3360,2612
202106,41670,경기도,여주시,25-29세,6000,3374,2626
202007,41670,경기도,여주시,30-34세,5074,2746,2328
202008,41670,경기도,여주시,30-34세,5071,2767,2304
202009,41670,경기도,여주시,30-34세,5083,2776,2307
202010,41670,경기도,여주시,30-34세,5059,2773,2286
202011,41670,경기도,여주시,30-34세,5048,2797,2251
202012,41670,경기도,여주시,30-34세,5097,2816,2281
202101,41670,경기도,여주시,30-34세,5077,2806,2271
202102,41670,경기도,여주시,30-34세,5100,2810,2290
202103,41670,경기도,여주시,30-34세,5118,2811,2307
202104,41670,경기도,여주시,30-34세,5122,2814,2308
202105,41670,경기도,여주시,30-34세,5132,2823,2309
202106,41670,경기도,여주시,30-34세,5141,2832,2309
202007,41670,경기도,여주시,35-39세,6644,3386,3258
202008,41670,경기도,여주시,35-39세,6608,3360,3248
202009,41670,경기도,여주시,35-39세,6550,3338,3212
202010,41670,경기도,여주시,35-39세,6504,3306,3198
202011,41670,경기도,여주시,35-39세,6442,3264,3178
202012,41670,경기도,여주시,35-39세,6442,3270,3172
202101,41670,경기도,여주시,35-39세,6419,3256,3163
202102,41670,경기도,여주시,35-39세,6354,3228,3126
202103,41670,경기도,여주시,35-39세,6280,3190,3090
202104,41670,경기도,여주시,35-39세,6249,3181,3068
202105,41670,경기도,여주시,35-39세,6214,3170,3044
202106,41670,경기도,여주시,35-39세,6167,3138,3029
202007,41670,경기도,여주시,40-44세,7343,3746,3597
202008,41670,경기도,여주시,40-44세,7338,3756,3582
202009,41670,경기도,여주시,40-44세,7359,3757,3602
202010,41670,경기도,여주시,40-44세,7390,3772,3618
202011,41670,경기도,여주시,40-44세,7435,3788,3647
202012,41670,경기도,여주시,40-44세,7438,3795,3643
202101,41670,경기도,여주시,40-44세,7452,3798,3654
202102,41670,경기도,여주시,40-44세,7446,3804,3642
202103,41670,경기도,여주시,40-44세,7415,3805,3610
202104,41670,경기도,여주시,40-44세,7382,3775,3607
202105,41670,경기도,여주시,40-44세,7393,3767,3626
202106,41670,경기도,여주시,40-44세,7402,3792,3610
202007,41670,경기도,여주시,45-49세,8724,4567,4157
202008,41670,경기도,여주시,45-49세,8689,4557,4132
202009,41670,경기도,여주시,45-49세,8647,4520,4127
202010,41670,경기도,여주시,45-49세,8632,4527,4105
202011,41670,경기도,여주시,45-49세,8586,4500,4086
202012,41670,경기도,여주시,45-49세,8595,4472,4123
202101,41670,경기도,여주시,45-49세,8581,4470,4111
202102,41670,경기도,여주시,45-49세,8553,4456,4097
202103,41670,경기도,여주시,45-49세,8479,4412,4067
202104,41670,경기도,여주시,45-49세,8473,4428,4045
202105,41670,경기도,여주시,45-49세,8433,4415,4018
202106,41670,경기도,여주시,45-49세,8414,4399,4015
202007,41670,경기도,여주시,50-54세,9670,5104,4566
202008,41670,경기도,여주시,50-54세,9635,5087,4548
202009,41670,경기도,여주시,50-54세,9641,5104,4537
202010,41670,경기도,여주시,50-54세,9651,5087,4564
202011,41670,경기도,여주시,50-54세,9668,5088,4580
202012,41670,경기도,여주시,50-54세,9665,5092,4573
202101,41670,경기도,여주시,50-54세,9686,5074,4612
202102,41670,경기도,여주시,50-54세,9719,5080,4639
202103,41670,경기도,여주시,50-54세,9689,5068,4621
202104,41670,경기도,여주시,50-54세,9718,5079,4639
202105,41670,경기도,여주시,50-54세,9749,5097,4652
202106,41670,경기도,여주시,50-54세,9808,5114,4694
202007,41670,경기도,여주시,55-59세,10422,5460,4962
202008,41670,경기도,여주시,55-59세,10456,5478,4978
202009,41670,경기도,여주시,55-59세,10460,5468,4992
202010,41670,경기도,여주시,55-59세,10441,5470,4971
202011,41670,경기도,여주시,55-59세,10434,5454,4980
202012,41670,경기도,여주시,55-59세,10452,5468,4984
202101,41670,경기도,여주시,55-59세,10446,5495,4951
202102,41670,경기도,여주시,55-59세,10440,5483,4957
202103,41670,경기도,여주시,55-59세,10390,5450,4940
202104,41670,경기도,여주시,55-59세,10345,5436,4909
202105,41670,경기도,여주시,55-59세,10300,5429,4871
202106,41670,경기도,여주시,55-59세,10210,5384,4826
202007,41670,경기도,여주시,60-64세,10191,5197,4994
202008,41670,경기도,여주시,60-64세,10279,5246,5033
202009,41670,경기도,여주시,60-64세,10340,5279,5061
202010,41670,경기도,여주시,60-64세,10398,5303,5095
202011,41670,경기도,여주시,60-64세,10471,5355,5116
202012,41670,경기도,여주시,60-64세,10550,5397,5153
202101,41670,경기도,여주시,60-64세,10590,5409,5181
202102,41670,경기도,여주시,60-64세,10656,5449,5207
202103,41670,경기도,여주시,60-64세,10736,5507,5229
202104,41670,경기도,여주시,60-64세,10812,5540,5272
202105,41670,경기도,여주시,60-64세,10906,5576,5330
202106,41670,경기도,여주시,60-64세,11010,5637,5373
202007,41670,경기도,여주시,65-69세,7733,3910,3823
202008,41670,경기도,여주시,65-69세,7790,3938,3852
202009,41670,경기도,여주시,65-69세,7871,3983,3888
202010,41670,경기도,여주시,65-69세,7940,4025,3915
202011,41670,경기도,여주시,65-69세,7979,4045,3934
202012,41670,경기도,여주시,65-69세,8072,4082,3990
202101,41670,경기도,여주시,65-69세,8164,4122,4042
202102,41670,경기도,여주시,65-69세,8241,4171,4070
202103,41670,경기도,여주시,65-69세,8340,4211,4129
202104,41670,경기도,여주시,65-69세,8421,4260,4161
202105,41670,경기도,여주시,65-69세,8476,4286,4190
202106,41670,경기도,여주시,65-69세,8551,4324,4227
202007,41670,경기도,여주시,70-74세,5299,2652,2647
202008,41670,경기도,여주시,70-74세,5296,2645,2651
202009,41670,경기도,여주시,70-74세,5317,2661,2656
202010,41670,경기도,여주시,70-74세,5350,2677,2673
202011,41670,경기도,여주시,70-74세,5398,2700,2698
202012,41670,경기도,여주시,70-74세,5432,2726,2706
202101,41670,경기도,여주시,70-74세,5487,2763,2724
202102,41670,경기도,여주시,70-74세,5526,2786,2740
202103,41670,경기도,여주시,70-74세,5497,2788,2709
202104,41670,경기도,여주시,70-74세,5501,2781,2720
202105,41670,경기도,여주시,70-74세,5509,2781,2728
202106,41670,경기도,여주시,70-74세,5518,2786,2732
202007,41670,경기도,여주시,75-79세,4911,2155,2756
202008,41670,경기도,여주시,75-79세,4888,2160,2728
202009,41670,경기도,여주시,75-79세,4859,2155,2704
202010,41670,경기도,여주시,75-79세,4843,2141,2702
202011,41670,경기도,여주시,75-79세,4810,2131,2679
202012,41670,경기도,여주시,75-79세,4782,2119,2663
202101,41670,경기도,여주시,75-79세,4765,2111,2654
202102,41670,경기도,여주시,75-79세,4742,2091,2651
202103,41670,경기도,여주시,75-79세,4723,2098,2625
202104,41670,경기도,여주시,75-79세,4712,2104,2608
202105,41670,경기도,여주시,75-79세,4690,2103,2587
202106,41670,경기도,여주시,75-79세,4694,2106,2588
202007,41670,경기도,여주시,80-84세,3421,1350,2071
202008,41670,경기도,여주시,80-84세,3446,1361,2085
202009,41670,경기도,여주시,80-84세,3463,1358,2105
202010,41670,경기도,여주시,80-84세,3462,1362,2100
202011,41670,경기도,여주시,80-84세,3451,1362,2089
202012,41670,경기도,여주시,80-84세,3461,1375,2086
202101,41670,경기도,여주시,80-84세,3473,1383,2090
202102,41670,경기도,여주시,80-84세,3493,1401,2092
202103,41670,경기도,여주시,80-84세,3496,1395,2101
202104,41670,경기도,여주시,80-84세,3532,1419,2113
202105,41670,경기도,여주시,80-84세,3550,1430,2120
202106,41670,경기도,여주시,80-84세,3571,1449,2122
202007,41670,경기도,여주시,85-89세,1761,578,1183
202008,41670,경기도,여주시,85-89세,1768,579,1189
202009,41670,경기도,여주시,85-89세,1784,587,1197
202010,41670,경기도,여주시,85-89세,1807,589,1218
202011,41670,경기도,여주시,85-89세,1829,592,1237
202012,41670,경기도,여주시,85-89세,1848,595,1253
202101,41670,경기도,여주시,85-89세,1860,590,1270
202102,41670,경기도,여주시,85-89세,1888,596,1292
202103,41670,경기도,여주시,85-89세,1887,596,1291
202104,41670,경기도,여주시,85-89세,1894,597,1297
202105,41670,경기도,여주시,85-89세,1911,598,1313
202106,41670,경기도,여주시,85-89세,1916,600,1316
202007,41670,경기도,여주시,90-94세,616,139,477
202008,41670,경기도,여주시,90-94세,637,145,492
202009,41670,경기도,여주시,90-94세,651,154,497
202010,41670,경기도,여주시,90-94세,665,157,508
202011,41670,경기도,여주시,90-94세,668,156,512
202012,41670,경기도,여주시,90-94세,664,158,506
202101,41670,경기도,여주시,90-94세,672,165,507
202102,41670,경기도,여주시,90-94세,683,169,514
202103,41670,경기도,여주시,90-94세,681,169,512
202104,41670,경기도,여주시,90-94세,691,172,519
202105,41670,경기도,여주시,90-94세,687,171,516
202106,41670,경기도,여주시,90-94세,694,172,522
202007,41670,경기도,여주시,95-99세,162,28,134
202008,41670,경기도,여주시,95-99세,157,26,131
202009,41670,경기도,여주시,95-99세,162,28,134
202010,41670,경기도,여주시,95-99세,161,28,133
202011,41670,경기도,여주시,95-99세,161,28,133
202012,41670,경기도,여주시,95-99세,164,30,134
202101,41670,경기도,여주시,95-99세,168,31,137
202102,41670,경기도,여주시,95-99세,171,30,141
202103,41670,경기도,여주시,95-99세,169,24,145
202104,41670,경기도,여주시,95-99세,165,23,142
202105,41670,경기도,여주시,95-99세,167,25,142
202106,41670,경기도,여주시,95-99세,167,26,141
202007,41670,경기도,여주시,100+,47,16,31
202008,41670,경기도,여주시,100+,49,16,33
202009,41670,경기도,여주시,100+,50,16,34
202010,41670,경기도,여주시,100+,52,16,36
202011,41670,경기도,여주시,100+,51,16,35
202012,41670,경기도,여주시,100+,52,16,36
202101,41670,경기도,여주시,100+,55,16,39
202102,41670,경기도,여주시,100+,56,17,39
202103,41670,경기도,여주시,100+,27,7,20
202104,41670,경기도,여주시,100+,28,7,21
202105,41670,경기도,여주시,100+,29,7,22
202106,41670,경기도,여주시,100+,29,7,22
202007,41800,경기도,연천군,0-4세,1350,700,650
202008,41800,경기도,연천군,0-4세,1339,690,649
202009,41800,경기도,연천군,0-4세,1328,681,647
202010,41800,경기도,연천군,0-4세,1293,666,627
202011,41800,경기도,연천군,0-4세,1282,658,624
202012,41800,경기도,연천군,0-4세,1253,645,608
202101,41800,경기도,연천군,0-4세,1232,633,599
202102,41800,경기도,연천군,0-4세,1228,634,594
202103,41800,경기도,연천군,0-4세,1213,619,594
202104,41800,경기도,연천군,0-4세,1216,620,596
202105,41800,경기도,연천군,0-4세,1201,611,590
202106,41800,경기도,연천군,0-4세,1183,601,582
202007,41800,경기도,연천군,5-9세,1483,750,733
202008,41800,경기도,연천군,5-9세,1480,751,729
202009,41800,경기도,연천군,5-9세,1483,753,730
202010,41800,경기도,연천군,5-9세,1481,747,734
202011,41800,경기도,연천군,5-9세,1470,738,732
202012,41800,경기도,연천군,5-9세,1477,749,728
202101,41800,경기도,연천군,5-9세,1470,747,723
202102,41800,경기도,연천군,5-9세,1451,739,712
202103,41800,경기도,연천군,5-9세,1442,730,712
202104,41800,경기도,연천군,5-9세,1432,728,704
202105,41800,경기도,연천군,5-9세,1442,727,715
202106,41800,경기도,연천군,5-9세,1439,723,716
202007,41800,경기도,연천군,10-14세,1468,772,696
202008,41800,경기도,연천군,10-14세,1473,782,691
202009,41800,경기도,연천군,10-14세,1466,775,691
202010,41800,경기도,연천군,10-14세,1474,774,700
202011,41800,경기도,연천군,10-14세,1468,765,703
202012,41800,경기도,연천군,10-14세,1482,765,717
202101,41800,경기도,연천군,10-14세,1492,765,727
202102,41800,경기도,연천군,10-14세,1497,768,729
202103,41800,경기도,연천군,10-14세,1502,766,736
202104,41800,경기도,연천군,10-14세,1516,772,744
202105,41800,경기도,연천군,10-14세,1521,777,744
202106,41800,경기도,연천군,10-14세,1508,773,735
202007,41800,경기도,연천군,15-19세,1740,943,797
202008,41800,경기도,연천군,15-19세,1731,932,799
202009,41800,경기도,연천군,15-19세,1722,925,797
202010,41800,경기도,연천군,15-19세,1721,927,794
202011,41800,경기도,연천군,15-19세,1723,933,790
202012,41800,경기도,연천군,15-19세,1711,927,784
202101,41800,경기도,연천군,15-19세,1687,914,773
202102,41800,경기도,연천군,15-19세,1660,900,760
202103,41800,경기도,연천군,15-19세,1621,889,732
202104,41800,경기도,연천군,15-19세,1603,881,722
202105,41800,경기도,연천군,15-19세,1598,869,729
202106,41800,경기도,연천군,15-19세,1598,867,731
202007,41800,경기도,연천군,20-24세,2471,1529,942
202008,41800,경기도,연천군,20-24세,2446,1508,938
202009,41800,경기도,연천군,20-24세,2472,1525,947
202010,41800,경기도,연천군,20-24세,2470,1522,948
202011,41800,경기도,연천군,20-24세,2476,1526,950
202012,41800,경기도,연천군,20-24세,2471,1523,948
202101,41800,경기도,연천군,20-24세,2440,1502,938
202102,41800,경기도,연천군,20-24세,2426,1493,933
202103,41800,경기도,연천군,20-24세,2416,1482,934
202104,41800,경기도,연천군,20-24세,2394,1466,928
202105,41800,경기도,연천군,20-24세,2387,1472,915
202106,41800,경기도,연천군,20-24세,2381,1468,913
202007,41800,경기도,연천군,25-29세,2918,1885,1033
202008,41800,경기도,연천군,25-29세,2917,1881,1036
202009,41800,경기도,연천군,25-29세,2918,1886,1032
202010,41800,경기도,연천군,25-29세,2916,1895,1021
202011,41800,경기도,연천군,25-29세,2899,1893,1006
202012,41800,경기도,연천군,25-29세,2893,1880,1013
202101,41800,경기도,연천군,25-29세,2894,1889,1005
202102,41800,경기도,연천군,25-29세,2895,1889,1006
202103,41800,경기도,연천군,25-29세,2909,1895,1014
202104,41800,경기도,연천군,25-29세,2902,1896,1006
202105,41800,경기도,연천군,25-29세,2901,1900,1001
202106,41800,경기도,연천군,25-29세,2887,1880,1007
202007,41800,경기도,연천군,30-34세,2099,1250,849
202008,41800,경기도,연천군,30-34세,2098,1254,844
202009,41800,경기도,연천군,30-34세,2102,1251,851
202010,41800,경기도,연천군,30-34세,2107,1257,850
202011,41800,경기도,연천군,30-34세,2128,1266,862
202012,41800,경기도,연천군,30-34세,2130,1267,863
202101,41800,경기도,연천군,30-34세,2135,1273,862
202102,41800,경기도,연천군,30-34세,2127,1270,857
202103,41800,경기도,연천군,30-34세,2108,1260,848
202104,41800,경기도,연천군,30-34세,2107,1253,854
202105,41800,경기도,연천군,30-34세,2112,1260,852
202106,41800,경기도,연천군,30-34세,2133,1272,861
202007,41800,경기도,연천군,35-39세,2175,1177,998
202008,41800,경기도,연천군,35-39세,2159,1169,990
202009,41800,경기도,연천군,35-39세,2133,1160,973
202010,41800,경기도,연천군,35-39세,2133,1156,977
202011,41800,경기도,연천군,35-39세,2114,1150,964
202012,41800,경기도,연천군,35-39세,2129,1161,968
202101,41800,경기도,연천군,35-39세,2108,1139,969
202102,41800,경기도,연천군,35-39세,2098,1128,970
202103,41800,경기도,연천군,35-39세,2068,1125,943
202104,41800,경기도,연천군,35-39세,2049,1104,945
202105,41800,경기도,연천군,35-39세,2034,1097,937
202106,41800,경기도,연천군,35-39세,2028,1095,933
202007,41800,경기도,연천군,40-44세,2172,1143,1029
202008,41800,경기도,연천군,40-44세,2181,1143,1038
202009,41800,경기도,연천군,40-44세,2195,1149,1046
202010,41800,경기도,연천군,40-44세,2192,1149,1043
202011,41800,경기도,연천군,40-44세,2202,1159,1043
202012,41800,경기도,연천군,40-44세,2191,1153,1038
202101,41800,경기도,연천군,40-44세,2191,1159,1032
202102,41800,경기도,연천군,40-44세,2183,1160,1023
202103,41800,경기도,연천군,40-44세,2153,1140,1013
202104,41800,경기도,연천군,40-44세,2173,1154,1019
202105,41800,경기도,연천군,40-44세,2181,1157,1024
202106,41800,경기도,연천군,40-44세,2182,1164,1018
202007,41800,경기도,연천군,45-49세,2848,1601,1247
202008,41800,경기도,연천군,45-49세,2836,1600,1236
202009,41800,경기도,연천군,45-49세,2832,1600,1232
202010,41800,경기도,연천군,45-49세,2814,1590,1224
202011,41800,경기도,연천군,45-49세,2783,1567,1216
202012,41800,경기도,연천군,45-49세,2787,1569,1218
202101,41800,경기도,연천군,45-49세,2763,1554,1209
202102,41800,경기도,연천군,45-49세,2749,1546,1203
202103,41800,경기도,연천군,45-49세,2710,1529,1181
202104,41800,경기도,연천군,45-49세,2697,1510,1187
202105,41800,경기도,연천군,45-49세,2660,1484,1176
202106,41800,경기도,연천군,45-49세,2637,1473,1164
202007,41800,경기도,연천군,50-54세,3227,1732,1495
202008,41800,경기도,연천군,50-54세,3209,1719,1490
202009,41800,경기도,연천군,50-54세,3197,1710,1487
202010,41800,경기도,연천군,50-54세,3200,1709,1491
202011,41800,경기도,연천군,50-54세,3203,1719,1484
202012,41800,경기도,연천군,50-54세,3187,1712,1475
202101,41800,경기도,연천군,50-54세,3187,1709,1478
202102,41800,경기도,연천군,50-54세,3171,1700,1471
202103,41800,경기도,연천군,50-54세,3122,1677,1445
202104,41800,경기도,연천군,50-54세,3144,1686,1458
202105,41800,경기도,연천군,50-54세,3156,1694,1462
202106,41800,경기도,연천군,50-54세,3162,1697,1465
202007,41800,경기도,연천군,55-59세,4004,2152,1852
202008,41800,경기도,연천군,55-59세,3991,2139,1852
202009,41800,경기도,연천군,55-59세,3989,2137,1852
202010,41800,경기도,연천군,55-59세,3979,2141,1838
202011,41800,경기도,연천군,55-59세,3960,2125,1835
202012,41800,경기도,연천군,55-59세,3945,2125,1820
202101,41800,경기도,연천군,55-59세,3919,2110,1809
202102,41800,경기도,연천군,55-59세,3897,2093,1804
202103,41800,경기도,연천군,55-59세,3876,2085,1791
202104,41800,경기도,연천군,55-59세,3860,2079,1781
202105,41800,경기도,연천군,55-59세,3843,2076,1767
202106,41800,경기도,연천군,55-59세,3812,2068,1744
202007,41800,경기도,연천군,60-64세,4281,2227,2054
202008,41800,경기도,연천군,60-64세,4313,2243,2070
202009,41800,경기도,연천군,60-64세,4345,2258,2087
202010,41800,경기도,연천군,60-64세,4343,2247,2096
202011,41800,경기도,연천군,60-64세,4363,2261,2102
202012,41800,경기도,연천군,60-64세,4370,2266,2104
202101,41800,경기도,연천군,60-64세,4372,2264,2108
202102,41800,경기도,연천군,60-64세,4403,2281,2122
202103,41800,경기도,연천군,60-64세,4404,2283,2121
202104,41800,경기도,연천군,60-64세,4432,2287,2145
202105,41800,경기도,연천군,60-64세,4456,2302,2154
202106,41800,경기도,연천군,60-64세,4473,2317,2156
202007,41800,경기도,연천군,65-69세,3060,1554,1506
202008,41800,경기도,연천군,65-69세,3093,1577,1516
202009,41800,경기도,연천군,65-69세,3103,1580,1523
202010,41800,경기도,연천군,65-69세,3128,1599,1529
202011,41800,경기도,연천군,65-69세,3144,1608,1536
202012,41800,경기도,연천군,65-69세,3177,1620,1557
202101,41800,경기도,연천군,65-69세,3224,1654,1570
202102,41800,경기도,연천군,65-69세,3247,1672,1575
202103,41800,경기도,연천군,65-69세,3253,1690,1563
202104,41800,경기도,연천군,65-69세,3275,1704,1571
202105,41800,경기도,연천군,65-69세,3312,1715,1597
202106,41800,경기도,연천군,65-69세,3348,1732,1616
202007,41800,경기도,연천군,70-74세,2662,1263,1399
202008,41800,경기도,연천군,70-74세,2660,1260,1400
202009,41800,경기도,연천군,70-74세,2673,1261,1412
202010,41800,경기도,연천군,70-74세,2682,1263,1419
202011,41800,경기도,연천군,70-74세,2679,1261,1418
202012,41800,경기도,연천군,70-74세,2662,1261,1401
202101,41800,경기도,연천군,70-74세,2657,1252,1405
202102,41800,경기도,연천군,70-74세,2665,1258,1407
202103,41800,경기도,연천군,70-74세,2666,1273,1393
202104,41800,경기도,연천군,70-74세,2661,1265,1396
202105,41800,경기도,연천군,70-74세,2639,1255,1384
202106,41800,경기도,연천군,70-74세,2638,1255,1383
202007,41800,경기도,연천군,75-79세,2402,1034,1368
202008,41800,경기도,연천군,75-79세,2394,1031,1363
202009,41800,경기도,연천군,75-79세,2379,1032,1347
202010,41800,경기도,연천군,75-79세,2385,1040,1345
202011,41800,경기도,연천군,75-79세,2374,1033,1341
202012,41800,경기도,연천군,75-79세,2383,1032,1351
202101,41800,경기도,연천군,75-79세,2385,1031,1354
202102,41800,경기도,연천군,75-79세,2369,1025,1344
202103,41800,경기도,연천군,75-79세,2345,1008,1337
202104,41800,경기도,연천군,75-79세,2341,1012,1329
202105,41800,경기도,연천군,75-79세,2325,999,1326
202106,41800,경기도,연천군,75-79세,2318,997,1321
202007,41800,경기도,연천군,80-84세,1879,686,1193
202008,41800,경기도,연천군,80-84세,1887,695,1192
202009,41800,경기도,연천군,80-84세,1899,697,1202
202010,41800,경기도,연천군,80-84세,1888,689,1199
202011,41800,경기도,연천군,80-84세,1898,690,1208
202012,41800,경기도,연천군,80-84세,1898,693,1205
202101,41800,경기도,연천군,80-84세,1902,698,1204
202102,41800,경기도,연천군,80-84세,1916,702,1214
202103,41800,경기도,연천군,80-84세,1902,691,1211
202104,41800,경기도,연천군,80-84세,1914,697,1217
202105,41800,경기도,연천군,80-84세,1930,705,1225
202106,41800,경기도,연천군,80-84세,1930,705,1225
202007,41800,경기도,연천군,85-89세,875,307,568
202008,41800,경기도,연천군,85-89세,885,309,576
202009,41800,경기도,연천군,85-89세,905,317,588
202010,41800,경기도,연천군,85-89세,919,323,596
202011,41800,경기도,연천군,85-89세,921,325,596
202012,41800,경기도,연천군,85-89세,923,326,597
202101,41800,경기도,연천군,85-89세,931,327,604
202102,41800,경기도,연천군,85-89세,928,321,607
202103,41800,경기도,연천군,85-89세,926,316,610
202104,41800,경기도,연천군,85-89세,931,318,613
202105,41800,경기도,연천군,85-89세,940,326,614
202106,41800,경기도,연천군,85-89세,947,329,618
202007,41800,경기도,연천군,90-94세,321,89,232
202008,41800,경기도,연천군,90-94세,323,90,233
202009,41800,경기도,연천군,90-94세,321,91,230
202010,41800,경기도,연천군,90-94세,321,87,234
202011,41800,경기도,연천군,90-94세,316,84,232
202012,41800,경기도,연천군,90-94세,317,85,232
202101,41800,경기도,연천군,90-94세,316,84,232
202102,41800,경기도,연천군,90-94세,324,87,237
202103,41800,경기도,연천군,90-94세,323,90,233
202104,41800,경기도,연천군,90-94세,326,91,235
202105,41800,경기도,연천군,90-94세,324,91,233
202106,41800,경기도,연천군,90-94세,329,93,236
202007,41800,경기도,연천군,95-99세,84,25,59
202008,41800,경기도,연천군,95-99세,81,25,56
202009,41800,경기도,연천군,95-99세,83,24,59
202010,41800,경기도,연천군,95-99세,82,23,59
202011,41800,경기도,연천군,95-99세,83,24,59
202012,41800,경기도,연천군,95-99세,83,23,60
202101,41800,경기도,연천군,95-99세,87,23,64
202102,41800,경기도,연천군,95-99세,88,24,64
202103,41800,경기도,연천군,95-99세,81,22,59
202104,41800,경기도,연천군,95-99세,83,21,62
202105,41800,경기도,연천군,95-99세,85,21,64
202106,41800,경기도,연천군,95-99세,85,20,65
202007,41800,경기도,연천군,100+,47,15,32
202008,41800,경기도,연천군,100+,46,15,31
202009,41800,경기도,연천군,100+,45,15,30
202010,41800,경기도,연천군,100+,46,16,30
202011,41800,경기도,연천군,100+,45,16,29
202012,41800,경기도,연천군,100+,47,17,30
202101,41800,경기도,연천군,100+,46,17,29
202102,41800,경기도,연천군,100+,46,17,29
202103,41800,경기도,연천군,100+,23,7,16
202104,41800,경기도,연천군,100+,24,8,16
202105,41800,경기도,연천군,100+,24,8,16
202106,41800,경기도,연천군,100+,24,8,16
202007,41820,경기도,가평군,0-4세,1540,761,779
202008,41820,경기도,가평군,0-4세,1523,749,774
202009,41820,경기도,가평군,0-4세,1497,737,760
202010,41820,경기도,가평군,0-4세,1471,733,738
202011,41820,경기도,가평군,0-4세,1462,732,730
202012,41820,경기도,가평군,0-4세,1444,731,713
202101,41820,경기도,가평군,0-4세,1439,726,713
202102,41820,경기도,가평군,0-4세,1414,717,697
202103,41820,경기도,가평군,0-4세,1398,712,686
202104,41820,경기도,가평군,0-4세,1390,712,678
202105,41820,경기도,가평군,0-4세,1375,701,674
202106,41820,경기도,가평군,0-4세,1365,688,677
202007,41820,경기도,가평군,5-9세,1954,967,987
202008,41820,경기도,가평군,5-9세,1944,966,978
202009,41820,경기도,가평군,5-9세,1931,965,966
202010,41820,경기도,가평군,5-9세,1919,947,972
202011,41820,경기도,가평군,5-9세,1914,940,974
202012,41820,경기도,가평군,5-9세,1900,932,968
202101,41820,경기도,가평군,5-9세,1895,932,963
202102,41820,경기도,가평군,5-9세,1884,930,954
202103,41820,경기도,가평군,5-9세,1893,939,954
202104,41820,경기도,가평군,5-9세,1892,936,956
202105,41820,경기도,가평군,5-9세,1897,937,960
202106,41820,경기도,가평군,5-9세,1902,951,951
202007,41820,경기도,가평군,10-14세,2156,1129,1027
202008,41820,경기도,가평군,10-14세,2154,1131,1023
202009,41820,경기도,가평군,10-14세,2147,1123,1024
202010,41820,경기도,가평군,10-14세,2160,1129,1031
202011,41820,경기도,가평군,10-14세,2158,1126,1032
202012,41820,경기도,가평군,10-14세,2150,1117,1033
202101,41820,경기도,가평군,10-14세,2149,1115,1034
202102,41820,경기도,가평군,10-14세,2144,1098,1046
202103,41820,경기도,가평군,10-14세,2154,1096,1058
202104,41820,경기도,가평군,10-14세,2160,1096,1064
202105,41820,경기도,가평군,10-14세,2159,1099,1060
202106,41820,경기도,가평군,10-14세,2169,1095,1074
202007,41820,경기도,가평군,15-19세,2602,1390,1212
202008,41820,경기도,가평군,15-19세,2600,1389,1211
202009,41820,경기도,가평군,15-19세,2574,1370,1204
202010,41820,경기도,가평군,15-19세,2555,1363,1192
202011,41820,경기도,가평군,15-19세,2535,1357,1178
202012,41820,경기도,가평군,15-19세,2484,1349,1135
202101,41820,경기도,가평군,15-19세,2429,1319,1110
202102,41820,경기도,가평군,15-19세,2397,1304,1093
202103,41820,경기도,가평군,15-19세,2368,1289,1079
202104,41820,경기도,가평군,15-19세,2401,1307,1094
202105,41820,경기도,가평군,15-19세,2423,1301,1122
202106,41820,경기도,가평군,15-19세,2399,1290,1109
202007,41820,경기도,가평군,20-24세,3105,1748,1357
202008,41820,경기도,가평군,20-24세,3102,1751,1351
202009,41820,경기도,가평군,20-24세,3104,1753,1351
202010,41820,경기도,가평군,20-24세,3114,1752,1362
202011,41820,경기도,가평군,20-24세,3141,1762,1379
202012,41820,경기도,가평군,20-24세,3132,1755,1377
202101,41820,경기도,가평군,20-24세,3142,1758,1384
202102,41820,경기도,가평군,20-24세,3138,1752,1386
202103,41820,경기도,가평군,20-24세,3139,1745,1394
202104,41820,경기도,가평군,20-24세,3122,1730,1392
202105,41820,경기도,가평군,20-24세,3117,1732,1385
202106,41820,경기도,가평군,20-24세,3131,1748,1383
202007,41820,경기도,가평군,25-29세,3118,1809,1309
202008,41820,경기도,가평군,25-29세,3129,1826,1303
202009,41820,경기도,가평군,25-29세,3130,1827,1303
202010,41820,경기도,가평군,25-29세,3092,1807,1285
202011,41820,경기도,가평군,25-29세,3074,1800,1274
202012,41820,경기도,가평군,25-29세,3080,1820,1260
202101,41820,경기도,가평군,25-29세,3111,1841,1270
202102,41820,경기도,가평군,25-29세,3096,1841,1255
202103,41820,경기도,가평군,25-29세,3081,1846,1235
202104,41820,경기도,가평군,25-29세,3091,1846,1245
202105,41820,경기도,가평군,25-29세,3102,1854,1248
202106,41820,경기도,가평군,25-29세,3091,1848,1243
202007,41820,경기도,가평군,30-34세,2694,1484,1210
202008,41820,경기도,가평군,30-34세,2683,1479,1204
202009,41820,경기도,가평군,30-34세,2665,1470,1195
202010,41820,경기도,가평군,30-34세,2667,1480,1187
202011,41820,경기도,가평군,30-34세,2700,1498,1202
202012,41820,경기도,가평군,30-34세,2689,1491,1198
202101,41820,경기도,가평군,30-34세,2673,1483,1190
202102,41820,경기도,가평군,30-34세,2664,1474,1190
202103,41820,경기도,가평군,30-34세,2652,1466,1186
202104,41820,경기도,가평군,30-34세,2656,1470,1186
202105,41820,경기도,가평군,30-34세,2676,1475,1201
202106,41820,경기도,가평군,30-34세,2676,1476,1200
202007,41820,경기도,가평군,35-39세,3170,1685,1485
202008,41820,경기도,가평군,35-39세,3139,1664,1475
202009,41820,경기도,가평군,35-39세,3134,1671,1463
202010,41820,경기도,가평군,35-39세,3096,1645,1451
202011,41820,경기도,가평군,35-39세,3071,1632,1439
202012,41820,경기도,가평군,35-39세,3053,1623,1430
202101,41820,경기도,가평군,35-39세,3036,1616,1420
202102,41820,경기도,가평군,35-39세,3010,1609,1401
202103,41820,경기도,가평군,35-39세,2976,1593,1383
202104,41820,경기도,가평군,35-39세,2946,1574,1372
202105,41820,경기도,가평군,35-39세,2920,1565,1355
202106,41820,경기도,가평군,35-39세,2918,1558,1360
202007,41820,경기도,가평군,40-44세,3523,1852,1671
202008,41820,경기도,가평군,40-44세,3514,1840,1674
202009,41820,경기도,가평군,40-44세,3527,1845,1682
202010,41820,경기도,가평군,40-44세,3541,1851,1690
202011,41820,경기도,가평군,40-44세,3531,1849,1682
202012,41820,경기도,가평군,40-44세,3503,1833,1670
202101,41820,경기도,가평군,40-44세,3517,1845,1672
202102,41820,경기도,가평군,40-44세,3506,1838,1668
202103,41820,경기도,가평군,40-44세,3489,1828,1661
202104,41820,경기도,가평군,40-44세,3515,1844,1671
202105,41820,경기도,가평군,40-44세,3538,1861,1677
202106,41820,경기도,가평군,40-44세,3549,1869,1680
202007,41820,경기도,가평군,45-49세,4484,2446,2038
202008,41820,경기도,가평군,45-49세,4460,2431,2029
202009,41820,경기도,가평군,45-49세,4419,2405,2014
202010,41820,경기도,가평군,45-49세,4401,2412,1989
202011,41820,경기도,가평군,45-49세,4397,2418,1979
202012,41820,경기도,가평군,45-49세,4407,2424,1983
202101,41820,경기도,가평군,45-49세,4379,2400,1979
202102,41820,경기도,가평군,45-49세,4387,2403,1984
202103,41820,경기도,가평군,45-49세,4324,2377,1947
202104,41820,경기도,가평군,45-49세,4333,2380,1953
202105,41820,경기도,가평군,45-49세,4321,2371,1950
202106,41820,경기도,가평군,45-49세,4303,2364,1939
202007,41820,경기도,가평군,50-54세,5233,2816,2417
202008,41820,경기도,가평군,50-54세,5221,2795,2426
202009,41820,경기도,가평군,50-54세,5230,2809,2421
202010,41820,경기도,가평군,50-54세,5215,2788,2427
202011,41820,경기도,가평군,50-54세,5217,2785,2432
202012,41820,경기도,가평군,50-54세,5198,2772,2426
202101,41820,경기도,가평군,50-54세,5227,2787,2440
202102,41820,경기도,가평군,50-54세,5228,2777,2451
202103,41820,경기도,가평군,50-54세,5191,2779,2412
202104,41820,경기도,가평군,50-54세,5172,2775,2397
202105,41820,경기도,가평군,50-54세,5174,2762,2412
202106,41820,경기도,가평군,50-54세,5174,2762,2412
202007,41820,경기도,가평군,55-59세,6233,3280,2953
202008,41820,경기도,가평군,55-59세,6233,3290,2943
202009,41820,경기도,가평군,55-59세,6212,3274,2938
202010,41820,경기도,가평군,55-59세,6209,3286,2923
202011,41820,경기도,가평군,55-59세,6180,3271,2909
202012,41820,경기도,가평군,55-59세,6166,3251,2915
202101,41820,경기도,가평군,55-59세,6125,3223,2902
202102,41820,경기도,가평군,55-59세,6077,3193,2884
202103,41820,경기도,가평군,55-59세,6043,3182,2861
202104,41820,경기도,가평군,55-59세,6041,3179,2862
202105,41820,경기도,가평군,55-59세,5989,3162,2827
202106,41820,경기도,가평군,55-59세,5947,3148,2799
202007,41820,경기도,가평군,60-64세,6781,3514,3267
202008,41820,경기도,가평군,60-64세,6803,3530,3273
202009,41820,경기도,가평군,60-64세,6822,3542,3280
202010,41820,경기도,가평군,60-64세,6838,3545,3293
202011,41820,경기도,가평군,60-64세,6843,3552,3291
202012,41820,경기도,가평군,60-64세,6847,3555,3292
202101,41820,경기도,가평군,60-64세,6867,3568,3299
202102,41820,경기도,가평군,60-64세,6889,3590,3299
202103,41820,경기도,가평군,60-64세,6878,3579,3299
202104,41820,경기도,가평군,60-64세,6946,3606,3340
202105,41820,경기도,가평군,60-64세,7027,3649,3378
202106,41820,경기도,가평군,60-64세,7062,3667,3395
202007,41820,경기도,가평군,65-69세,5040,2591,2449
202008,41820,경기도,가평군,65-69세,5073,2609,2464
202009,41820,경기도,가평군,65-69세,5123,2628,2495
202010,41820,경기도,가평군,65-69세,5151,2645,2506
202011,41820,경기도,가평군,65-69세,5210,2668,2542
202012,41820,경기도,가평군,65-69세,5261,2696,2565
202101,41820,경기도,가평군,65-69세,5312,2723,2589
202102,41820,경기도,가평군,65-69세,5366,2752,2614
202103,41820,경기도,가평군,65-69세,5406,2774,2632
202104,41820,경기도,가평군,65-69세,5464,2808,2656
202105,41820,경기도,가평군,65-69세,5511,2824,2687
202106,41820,경기도,가평군,65-69세,5569,2855,2714
202007,41820,경기도,가평군,70-74세,3546,1734,1812
202008,41820,경기도,가평군,70-74세,3529,1715,1814
202009,41820,경기도,가평군,70-74세,3545,1729,1816
202010,41820,경기도,가평군,70-74세,3549,1732,1817
202011,41820,경기도,가평군,70-74세,3568,1749,1819
202012,41820,경기도,가평군,70-74세,3576,1757,1819
202101,41820,경기도,가평군,70-74세,3601,1773,1828
202102,41820,경기도,가평군,70-74세,3614,1781,1833
202103,41820,경기도,가평군,70-74세,3598,1776,1822
202104,41820,경기도,가평군,70-74세,3584,1774,1810
202105,41820,경기도,가평군,70-74세,3596,1769,1827
202106,41820,경기도,가평군,70-74세,3586,1758,1828
202007,41820,경기도,가평군,75-79세,3312,1505,1807
202008,41820,경기도,가평군,75-79세,3331,1518,1813
202009,41820,경기도,가평군,75-79세,3309,1507,1802
202010,41820,경기도,가평군,75-79세,3299,1494,1805
202011,41820,경기도,가평군,75-79세,3284,1490,1794
202012,41820,경기도,가평군,75-79세,3257,1469,1788
202101,41820,경기도,가평군,75-79세,3229,1468,1761
202102,41820,경기도,가평군,75-79세,3227,1469,1758
202103,41820,경기도,가평군,75-79세,3212,1458,1754
202104,41820,경기도,가평군,75-79세,3207,1448,1759
202105,41820,경기도,가평군,75-79세,3223,1465,1758
202106,41820,경기도,가평군,75-79세,3220,1476,1744
202007,41820,경기도,가평군,80-84세,2379,987,1392
202008,41820,경기도,가평군,80-84세,2387,990,1397
202009,41820,경기도,가평군,80-84세,2389,987,1402
202010,41820,경기도,가평군,80-84세,2404,996,1408
202011,41820,경기도,가평군,80-84세,2400,995,1405
202012,41820,경기도,가평군,80-84세,2394,1004,1390
202101,41820,경기도,가평군,80-84세,2416,1009,1407
202102,41820,경기도,가평군,80-84세,2422,1014,1408
202103,41820,경기도,가평군,80-84세,2400,1007,1393
202104,41820,경기도,가평군,80-84세,2414,1016,1398
202105,41820,경기도,가평군,80-84세,2420,1019,1401
202106,41820,경기도,가평군,80-84세,2434,1014,1420
202007,41820,경기도,가평군,85-89세,1199,392,807
202008,41820,경기도,가평군,85-89세,1209,392,817
202009,41820,경기도,가평군,85-89세,1221,400,821
202010,41820,경기도,가평군,85-89세,1225,404,821
202011,41820,경기도,가평군,85-89세,1235,407,828
202012,41820,경기도,가평군,85-89세,1257,413,844
202101,41820,경기도,가평군,85-89세,1270,421,849
202102,41820,경기도,가평군,85-89세,1289,420,869
202103,41820,경기도,가평군,85-89세,1296,414,882
202104,41820,경기도,가평군,85-89세,1312,424,888
202105,41820,경기도,가평군,85-89세,1322,425,897
202106,41820,경기도,가평군,85-89세,1319,429,890
202007,41820,경기도,가평군,90-94세,403,104,299
202008,41820,경기도,가평군,90-94세,409,110,299
202009,41820,경기도,가평군,90-94세,410,111,299
202010,41820,경기도,가평군,90-94세,409,110,299
202011,41820,경기도,가평군,90-94세,411,110,301
202012,41820,경기도,가평군,90-94세,413,112,301
202101,41820,경기도,가평군,90-94세,416,110,306
202102,41820,경기도,가평군,90-94세,420,113,307
202103,41820,경기도,가평군,90-94세,403,109,294
202104,41820,경기도,가평군,90-94세,408,112,296
202105,41820,경기도,가평군,90-94세,401,109,292
202106,41820,경기도,가평군,90-94세,401,105,296
202007,41820,경기도,가평군,95-99세,114,34,80
202008,41820,경기도,가평군,95-99세,115,34,81
202009,41820,경기도,가평군,95-99세,113,33,80
202010,41820,경기도,가평군,95-99세,112,30,82
202011,41820,경기도,가평군,95-99세,115,32,83
202012,41820,경기도,가평군,95-99세,116,32,84
202101,41820,경기도,가평군,95-99세,115,31,84
202102,41820,경기도,가평군,95-99세,115,32,83
202103,41820,경기도,가평군,95-99세,115,29,86
202104,41820,경기도,가평군,95-99세,116,29,87
202105,41820,경기도,가평군,95-99세,117,31,86
202106,41820,경기도,가평군,95-99세,113,31,82
202007,41820,경기도,가평군,100+,46,19,27
202008,41820,경기도,가평군,100+,47,19,28
202009,41820,경기도,가평군,100+,49,19,30
202010,41820,경기도,가평군,100+,49,19,30
202011,41820,경기도,가평군,100+,49,19,30
202012,41820,경기도,가평군,100+,50,20,30
202101,41820,경기도,가평군,100+,51,21,30
202102,41820,경기도,가평군,100+,52,21,31
202103,41820,경기도,가평군,100+,33,11,22
202104,41820,경기도,가평군,100+,36,14,22
202105,41820,경기도,가평군,100+,36,14,22
202106,41820,경기도,가평군,100+,36,14,22
202007,41830,경기도,양평군,0-4세,3003,1512,1491
202008,41830,경기도,양평군,0-4세,2984,1510,1474
202009,41830,경기도,양평군,0-4세,2999,1525,1474
202010,41830,경기도,양평군,0-4세,2989,1519,1470
202011,41830,경기도,양평군,0-4세,2955,1503,1452
202012,41830,경기도,양평군,0-4세,2943,1507,1436
202101,41830,경기도,양평군,0-4세,2918,1497,1421
202102,41830,경기도,양평군,0-4세,2921,1503,1418
202103,41830,경기도,양평군,0-4세,2922,1497,1425
202104,41830,경기도,양평군,0-4세,2894,1498,1396
202105,41830,경기도,양평군,0-4세,2878,1495,1383
202106,41830,경기도,양평군,0-4세,2859,1480,1379
202007,41830,경기도,양평군,5-9세,4417,2288,2129
202008,41830,경기도,양평군,5-9세,4426,2294,2132
202009,41830,경기도,양평군,5-9세,4388,2267,2121
202010,41830,경기도,양평군,5-9세,4378,2263,2115
202011,41830,경기도,양평군,5-9세,4365,2246,2119
202012,41830,경기도,양평군,5-9세,4355,2225,2130
202101,41830,경기도,양평군,5-9세,4345,2212,2133
202102,41830,경기도,양평군,5-9세,4322,2194,2128
202103,41830,경기도,양평군,5-9세,4313,2194,2119
202104,41830,경기도,양평군,5-9세,4324,2191,2133
202105,41830,경기도,양평군,5-9세,4306,2173,2133
202106,41830,경기도,양평군,5-9세,4319,2181,2138
202007,41830,경기도,양평군,10-14세,4843,2486,2357
202008,41830,경기도,양평군,10-14세,4823,2468,2355
202009,41830,경기도,양평군,10-14세,4852,2493,2359
202010,41830,경기도,양평군,10-14세,4887,2502,2385
202011,41830,경기도,양평군,10-14세,4907,2510,2397
202012,41830,경기도,양평군,10-14세,4912,2513,2399
202101,41830,경기도,양평군,10-14세,4960,2541,2419
202102,41830,경기도,양평군,10-14세,5001,2563,2438
202103,41830,경기도,양평군,10-14세,4986,2555,2431
202104,41830,경기도,양평군,10-14세,4977,2561,2416
202105,41830,경기도,양평군,10-14세,4986,2569,2417
202106,41830,경기도,양평군,10-14세,5001,2573,2428
202007,41830,경기도,양평군,15-19세,4883,2668,2215
202008,41830,경기도,양평군,15-19세,5104,2837,2267
202009,41830,경기도,양평군,15-19세,5047,2796,2251
202010,41830,경기도,양평군,15-19세,4973,2735,2238
202011,41830,경기도,양평군,15-19세,4941,2713,2228
202012,41830,경기도,양평군,15-19세,4796,2590,2206
202101,41830,경기도,양평군,15-19세,4767,2572,2195
202102,41830,경기도,양평군,15-19세,4724,2561,2163
202103,41830,경기도,양평군,15-19세,4703,2553,2150
202104,41830,경기도,양평군,15-19세,4700,2551,2149
202105,41830,경기도,양평군,15-19세,4771,2604,2167
202106,41830,경기도,양평군,15-19세,4782,2630,2152
202007,41830,경기도,양평군,20-24세,5329,2906,2423
202008,41830,경기도,양평군,20-24세,5361,2930,2431
202009,41830,경기도,양평군,20-24세,5336,2922,2414
202010,41830,경기도,양평군,20-24세,5317,2908,2409
202011,41830,경기도,양평군,20-24세,5327,2916,2411
202012,41830,경기도,양평군,20-24세,5263,2882,2381
202101,41830,경기도,양평군,20-24세,5234,2864,2370
202102,41830,경기도,양평군,20-24세,5255,2866,2389
202103,41830,경기도,양평군,20-24세,5189,2841,2348
202104,41830,경기도,양평군,20-24세,5202,2851,2351
202105,41830,경기도,양평군,20-24세,5229,2865,2364
202106,41830,경기도,양평군,20-24세,5236,2880,2356
202007,41830,경기도,양평군,25-29세,5189,2906,2283
202008,41830,경기도,양평군,25-29세,5212,2915,2297
202009,41830,경기도,양평군,25-29세,5217,2913,2304
202010,41830,경기도,양평군,25-29세,5225,2911,2314
202011,41830,경기도,양평군,25-29세,5265,2938,2327
202012,41830,경기도,양평군,25-29세,5334,2985,2349
202101,41830,경기도,양평군,25-29세,5334,2994,2340
202102,41830,경기도,양평군,25-29세,5323,3001,2322
202103,41830,경기도,양평군,25-29세,5388,3037,2351
202104,41830,경기도,양평군,25-29세,5388,3030,2358
202105,41830,경기도,양평군,25-29세,5374,3019,2355
202106,41830,경기도,양평군,25-29세,5381,3027,2354
202007,41830,경기도,양평군,30-34세,4657,2411,2246
202008,41830,경기도,양평군,30-34세,4632,2402,2230
202009,41830,경기도,양평군,30-34세,4640,2411,2229
202010,41830,경기도,양평군,30-34세,4640,2414,2226
202011,41830,경기도,양평군,30-34세,4590,2392,2198
202012,41830,경기도,양평군,30-34세,4589,2375,2214
202101,41830,경기도,양평군,30-34세,4591,2387,2204
202102,41830,경기도,양평군,30-34세,4625,2410,2215
202103,41830,경기도,양평군,30-34세,4611,2399,2212
202104,41830,경기도,양평군,30-34세,4608,2392,2216
202105,41830,경기도,양평군,30-34세,4609,2393,2216
202106,41830,경기도,양평군,30-34세,4627,2407,2220
202007,41830,경기도,양평군,35-39세,6285,3128,3157
202008,41830,경기도,양평군,35-39세,6252,3112,3140
202009,41830,경기도,양평군,35-39세,6220,3085,3135
202010,41830,경기도,양평군,35-39세,6197,3082,3115
202011,41830,경기도,양평군,35-39세,6211,3076,3135
202012,41830,경기도,양평군,35-39세,6186,3056,3130
202101,41830,경기도,양평군,35-39세,6191,3055,3136
202102,41830,경기도,양평군,35-39세,6186,3055,3131
202103,41830,경기도,양평군,35-39세,6148,3039,3109
202104,41830,경기도,양평군,35-39세,6177,3050,3127
202105,41830,경기도,양평군,35-39세,6173,3062,3111
202106,41830,경기도,양평군,35-39세,6140,3047,3093
202007,41830,경기도,양평군,40-44세,7311,3657,3654
202008,41830,경기도,양평군,40-44세,7336,3661,3675
202009,41830,경기도,양평군,40-44세,7359,3658,3701
202010,41830,경기도,양평군,40-44세,7359,3639,3720
202011,41830,경기도,양평군,40-44세,7362,3638,3724
202012,41830,경기도,양평군,40-44세,7335,3622,3713
202101,41830,경기도,양평군,40-44세,7312,3597,3715
202102,41830,경기도,양평군,40-44세,7390,3637,3753
202103,41830,경기도,양평군,40-44세,7360,3629,3731
202104,41830,경기도,양평군,40-44세,7342,3614,3728
202105,41830,경기도,양평군,40-44세,7371,3616,3755
202106,41830,경기도,양평군,40-44세,7424,3636,3788
202007,41830,경기도,양평군,45-49세,9041,4723,4318
202008,41830,경기도,양평군,45-49세,9030,4701,4329
202009,41830,경기도,양평군,45-49세,8964,4678,4286
202010,41830,경기도,양평군,45-49세,8956,4669,4287
202011,41830,경기도,양평군,45-49세,8953,4674,4279
202012,41830,경기도,양평군,45-49세,8977,4680,4297
202101,41830,경기도,양평군,45-49세,8992,4675,4317
202102,41830,경기도,양평군,45-49세,8956,4639,4317
202103,41830,경기도,양평군,45-49세,8927,4639,4288
202104,41830,경기도,양평군,45-49세,8942,4646,4296
202105,41830,경기도,양평군,45-49세,8891,4633,4258
202106,41830,경기도,양평군,45-49세,8859,4624,4235
202007,41830,경기도,양평군,50-54세,9444,4920,4524
202008,41830,경기도,양평군,50-54세,9457,4927,4530
202009,41830,경기도,양평군,50-54세,9479,4930,4549
202010,41830,경기도,양평군,50-54세,9505,4950,4555
202011,41830,경기도,양평군,50-54세,9506,4945,4561
202012,41830,경기도,양평군,50-54세,9493,4943,4550
202101,41830,경기도,양평군,50-54세,9496,4942,4554
202102,41830,경기도,양평군,50-54세,9549,4992,4557
202103,41830,경기도,양평군,50-54세,9527,4967,4560
202104,41830,경기도,양평군,50-54세,9555,4983,4572
202105,41830,경기도,양평군,50-54세,9628,4993,4635
202106,41830,경기도,양평군,50-54세,9635,4985,4650
202007,41830,경기도,양평군,55-59세,11491,5806,5685
202008,41830,경기도,양평군,55-59세,11468,5805,5663
202009,41830,경기도,양평군,55-59세,11447,5796,5651
202010,41830,경기도,양평군,55-59세,11434,5792,5642
202011,41830,경기도,양평군,55-59세,11401,5775,5626
202012,41830,경기도,양평군,55-59세,11417,5791,5626
202101,41830,경기도,양평군,55-59세,11323,5740,5583
202102,41830,경기도,양평군,55-59세,11267,5713,5554
202103,41830,경기도,양평군,55-59세,11201,5691,5510
202104,41830,경기도,양평군,55-59세,11173,5691,5482
202105,41830,경기도,양평군,55-59세,11136,5687,5449
202106,41830,경기도,양평군,55-59세,11012,5607,5405
202007,41830,경기도,양평군,60-64세,12277,6132,6145
202008,41830,경기도,양평군,60-64세,12359,6160,6199
202009,41830,경기도,양평군,60-64세,12365,6170,6195
202010,41830,경기도,양평군,60-64세,12472,6230,6242
202011,41830,경기도,양평군,60-64세,12601,6307,6294
202012,41830,경기도,양평군,60-64세,12674,6350,6324
202101,41830,경기도,양평군,60-64세,12776,6409,6367
202102,41830,경기도,양평군,60-64세,12851,6449,6402
202103,41830,경기도,양평군,60-64세,12940,6485,6455
202104,41830,경기도,양평군,60-64세,13018,6524,6494
202105,41830,경기도,양평군,60-64세,13113,6574,6539
202106,41830,경기도,양평군,60-64세,13263,6667,6596
202007,41830,경기도,양평군,65-69세,9730,4752,4978
202008,41830,경기도,양평군,65-69세,9808,4801,5007
202009,41830,경기도,양평군,65-69세,9913,4868,5045
202010,41830,경기도,양평군,65-69세,9981,4899,5082
202011,41830,경기도,양평군,65-69세,10035,4933,5102
202012,41830,경기도,양평군,65-69세,10130,4990,5140
202101,41830,경기도,양평군,65-69세,10233,5041,5192
202102,41830,경기도,양평군,65-69세,10377,5101,5276
202103,41830,경기도,양평군,65-69세,10459,5161,5298
202104,41830,경기도,양평군,65-69세,10560,5221,5339
202105,41830,경기도,양평군,65-69세,10657,5271,5386
202106,41830,경기도,양평군,65-69세,10729,5297,5432
202007,41830,경기도,양평군,70-74세,6999,3554,3445
202008,41830,경기도,양평군,70-74세,7028,3583,3445
202009,41830,경기도,양평군,70-74세,7070,3588,3482
202010,41830,경기도,양평군,70-74세,7112,3617,3495
202011,41830,경기도,양평군,70-74세,7130,3614,3516
202012,41830,경기도,양평군,70-74세,7170,3626,3544
202101,41830,경기도,양평군,70-74세,7268,3675,3593
202102,41830,경기도,양평군,70-74세,7279,3678,3601
202103,41830,경기도,양평군,70-74세,7280,3681,3599
202104,41830,경기도,양평군,70-74세,7296,3680,3616
202105,41830,경기도,양평군,70-74세,7285,3658,3627
202106,41830,경기도,양평군,70-74세,7272,3644,3628
202007,41830,경기도,양평군,75-79세,5909,2790,3119
202008,41830,경기도,양평군,75-79세,5921,2789,3132
202009,41830,경기도,양평군,75-79세,5917,2783,3134
202010,41830,경기도,양평군,75-79세,5933,2785,3148
202011,41830,경기도,양평군,75-79세,5925,2777,3148
202012,41830,경기도,양평군,75-79세,5892,2766,3126
202101,41830,경기도,양평군,75-79세,5882,2777,3105
202102,41830,경기도,양평군,75-79세,5874,2773,3101
202103,41830,경기도,양평군,75-79세,5849,2767,3082
202104,41830,경기도,양평군,75-79세,5859,2779,3080
202105,41830,경기도,양평군,75-79세,5895,2815,3080
202106,41830,경기도,양평군,75-79세,5899,2829,3070
202007,41830,경기도,양평군,80-84세,4020,1652,2368
202008,41830,경기도,양평군,80-84세,4026,1662,2364
202009,41830,경기도,양평군,80-84세,4031,1685,2346
202010,41830,경기도,양평군,80-84세,4030,1684,2346
202011,41830,경기도,양평군,80-84세,4063,1701,2362
202012,41830,경기도,양평군,80-84세,4064,1704,2360
202101,41830,경기도,양평군,80-84세,4088,1707,2381
202102,41830,경기도,양평군,80-84세,4125,1738,2387
202103,41830,경기도,양평군,80-84세,4124,1738,2386
202104,41830,경기도,양평군,80-84세,4137,1742,2395
202105,41830,경기도,양평군,80-84세,4136,1739,2397
202106,41830,경기도,양평군,80-84세,4176,1759,2417
202007,41830,경기도,양평군,85-89세,2096,665,1431
202008,41830,경기도,양평군,85-89세,2121,675,1446
202009,41830,경기도,양평군,85-89세,2152,680,1472
202010,41830,경기도,양평군,85-89세,2162,685,1477
202011,41830,경기도,양평군,85-89세,2168,691,1477
202012,41830,경기도,양평군,85-89세,2204,709,1495
202101,41830,경기도,양평군,85-89세,2230,722,1508
202102,41830,경기도,양평군,85-89세,2264,726,1538
202103,41830,경기도,양평군,85-89세,2289,739,1550
202104,41830,경기도,양평군,85-89세,2307,734,1573
202105,41830,경기도,양평군,85-89세,2333,737,1596
202106,41830,경기도,양평군,85-89세,2338,739,1599
202007,41830,경기도,양평군,90-94세,754,175,579
202008,41830,경기도,양평군,90-94세,770,181,589
202009,41830,경기도,양평군,90-94세,782,183,599
202010,41830,경기도,양평군,90-94세,800,190,610
202011,41830,경기도,양평군,90-94세,811,191,620
202012,41830,경기도,양평군,90-94세,813,190,623
202101,41830,경기도,양평군,90-94세,815,193,622
202102,41830,경기도,양평군,90-94세,813,193,620
202103,41830,경기도,양평군,90-94세,819,193,626
202104,41830,경기도,양평군,90-94세,817,193,624
202105,41830,경기도,양평군,90-94세,826,195,631
202106,41830,경기도,양평군,90-94세,829,197,632
202007,41830,경기도,양평군,95-99세,187,47,140
202008,41830,경기도,양평군,95-99세,186,47,139
202009,41830,경기도,양평군,95-99세,187,47,140
202010,41830,경기도,양평군,95-99세,193,45,148
202011,41830,경기도,양평군,95-99세,195,46,149
202012,41830,경기도,양평군,95-99세,199,46,153
202101,41830,경기도,양평군,95-99세,201,44,157
202102,41830,경기도,양평군,95-99세,200,39,161
202103,41830,경기도,양평군,95-99세,184,38,146
202104,41830,경기도,양평군,95-99세,187,40,147
202105,41830,경기도,양평군,95-99세,186,39,147
202106,41830,경기도,양평군,95-99세,187,40,147
202007,41830,경기도,양평군,100+,66,14,52
202008,41830,경기도,양평군,100+,68,15,53
202009,41830,경기도,양평군,100+,68,15,53
202010,41830,경기도,양평군,100+,66,14,52
202011,41830,경기도,양평군,100+,67,14,53
202012,41830,경기도,양평군,100+,64,13,51
202101,41830,경기도,양평군,100+,66,14,52
202102,41830,경기도,양평군,100+,69,15,54
202103,41830,경기도,양평군,100+,41,10,31
202104,41830,경기도,양평군,100+,42,10,32
202105,41830,경기도,양평군,100+,43,10,33
202106,41830,경기도,양평군,100+,44,10,34
202007,42110,강원도,춘천시,0-4세,9357,4768,4589
202008,42110,강원도,춘천시,0-4세,9335,4751,4584
202009,42110,강원도,춘천시,0-4세,9311,4751,4560
202010,42110,강원도,춘천시,0-4세,9265,4725,4540
202011,42110,강원도,춘천시,0-4세,9219,4695,4524
202012,42110,강원도,춘천시,0-4세,9201,4686,4515
202101,42110,강원도,춘천시,0-4세,9136,4668,4468
202102,42110,강원도,춘천시,0-4세,9109,4648,4461
202103,42110,강원도,춘천시,0-4세,9027,4603,4424
202104,42110,강원도,춘천시,0-4세,8955,4581,4374
202105,42110,강원도,춘천시,0-4세,8910,4550,4360
202106,42110,강원도,춘천시,0-4세,8875,4530,4345
202007,42110,강원도,춘천시,5-9세,12522,6443,6079
202008,42110,강원도,춘천시,5-9세,12492,6446,6046
202009,42110,강원도,춘천시,5-9세,12500,6447,6053
202010,42110,강원도,춘천시,5-9세,12524,6456,6068
202011,42110,강원도,춘천시,5-9세,12481,6437,6044
202012,42110,강원도,춘천시,5-9세,12468,6430,6038
202101,42110,강원도,춘천시,5-9세,12376,6373,6003
202102,42110,강원도,춘천시,5-9세,12387,6387,6000
202103,42110,강원도,춘천시,5-9세,12390,6387,6003
202104,42110,강원도,춘천시,5-9세,12362,6369,5993
202105,42110,강원도,춘천시,5-9세,12279,6332,5947
202106,42110,강원도,춘천시,5-9세,12234,6326,5908
202007,42110,강원도,춘천시,10-14세,12732,6595,6137
202008,42110,강원도,춘천시,10-14세,12756,6590,6166
202009,42110,강원도,춘천시,10-14세,12748,6563,6185
202010,42110,강원도,춘천시,10-14세,12782,6574,6208
202011,42110,강원도,춘천시,10-14세,12812,6608,6204
202012,42110,강원도,춘천시,10-14세,12820,6629,6191
202101,42110,강원도,춘천시,10-14세,12935,6697,6238
202102,42110,강원도,춘천시,10-14세,12983,6727,6256
202103,42110,강원도,춘천시,10-14세,12961,6724,6237
202104,42110,강원도,춘천시,10-14세,12990,6738,6252
202105,42110,강원도,춘천시,10-14세,13048,6757,6291
202106,42110,강원도,춘천시,10-14세,13053,6768,6285
202007,42110,강원도,춘천시,15-19세,14468,7560,6908
202008,42110,강원도,춘천시,15-19세,14383,7519,6864
202009,42110,강원도,춘천시,15-19세,14325,7510,6815
202010,42110,강원도,춘천시,15-19세,14246,7472,6774
202011,42110,강원도,춘천시,15-19세,14186,7432,6754
202012,42110,강원도,춘천시,15-19세,14117,7358,6759
202101,42110,강원도,춘천시,15-19세,14023,7301,6722
202102,42110,강원도,춘천시,15-19세,13991,7277,6714
202103,42110,강원도,춘천시,15-19세,13842,7193,6649
202104,42110,강원도,춘천시,15-19세,13753,7146,6607
202105,42110,강원도,춘천시,15-19세,13637,7105,6532
202106,42110,강원도,춘천시,15-19세,13571,7076,6495
202007,42110,강원도,춘천시,20-24세,19161,10100,9061
202008,42110,강원도,춘천시,20-24세,19208,10117,9091
202009,42110,강원도,춘천시,20-24세,19167,10091,9076
202010,42110,강원도,춘천시,20-24세,19114,10082,9032
202011,42110,강원도,춘천시,20-24세,19085,10061,9024
202012,42110,강원도,춘천시,20-24세,19080,10088,8992
202101,42110,강원도,춘천시,20-24세,18946,10033,8913
202102,42110,강원도,춘천시,20-24세,19023,10099,8924
202103,42110,강원도,춘천시,20-24세,18961,10065,8896
202104,42110,강원도,춘천시,20-24세,18907,10035,8872
202105,42110,강원도,춘천시,20-24세,18898,10005,8893
202106,42110,강원도,춘천시,20-24세,18898,9993,8905
202007,42110,강원도,춘천시,25-29세,17830,9615,8215
202008,42110,강원도,춘천시,25-29세,17895,9656,8239
202009,42110,강원도,춘천시,25-29세,17980,9707,8273
202010,42110,강원도,춘천시,25-29세,18049,9710,8339
202011,42110,강원도,춘천시,25-29세,18184,9778,8406
202012,42110,강원도,춘천시,25-29세,18265,9842,8423
202101,42110,강원도,춘천시,25-29세,18273,9841,8432
202102,42110,강원도,춘천시,25-29세,18268,9804,8464
202103,42110,강원도,춘천시,25-29세,18323,9837,8486
202104,42110,강원도,춘천시,25-29세,18332,9850,8482
202105,42110,강원도,춘천시,25-29세,18370,9883,8487
202106,42110,강원도,춘천시,25-29세,18411,9911,8500
202007,42110,강원도,춘천시,30-34세,15629,8055,7574
202008,42110,강원도,춘천시,30-34세,15667,8069,7598
202009,42110,강원도,춘천시,30-34세,15675,8089,7586
202010,42110,강원도,춘천시,30-34세,15734,8152,7582
202011,42110,강원도,춘천시,30-34세,15715,8148,7567
202012,42110,강원도,춘천시,30-34세,15729,8151,7578
202101,42110,강원도,춘천시,30-34세,15718,8142,7576
202102,42110,강원도,춘천시,30-34세,15705,8155,7550
202103,42110,강원도,춘천시,30-34세,15760,8189,7571
202104,42110,강원도,춘천시,30-34세,15838,8204,7634
202105,42110,강원도,춘천시,30-34세,15899,8252,7647
202106,42110,강원도,춘천시,30-34세,15897,8252,7645
202007,42110,강원도,춘천시,35-39세,18790,9414,9376
202008,42110,강원도,춘천시,35-39세,18749,9418,9331
202009,42110,강원도,춘천시,35-39세,18681,9374,9307
202010,42110,강원도,춘천시,35-39세,18577,9331,9246
202011,42110,강원도,춘천시,35-39세,18524,9318,9206
202012,42110,강원도,춘천시,35-39세,18525,9336,9189
202101,42110,강원도,춘천시,35-39세,18446,9295,9151
202102,42110,강원도,춘천시,35-39세,18439,9283,9156
202103,42110,강원도,춘천시,35-39세,18310,9217,9093
202104,42110,강원도,춘천시,35-39세,18168,9148,9020
202105,42110,강원도,춘천시,35-39세,18091,9100,8991
202106,42110,강원도,춘천시,35-39세,18047,9104,8943
202007,42110,강원도,춘천시,40-44세,19366,9543,9823
202008,42110,강원도,춘천시,40-44세,19429,9580,9849
202009,42110,강원도,춘천시,40-44세,19485,9607,9878
202010,42110,강원도,춘천시,40-44세,19615,9664,9951
202011,42110,강원도,춘천시,40-44세,19705,9699,10006
202012,42110,강원도,춘천시,40-44세,19710,9719,9991
202101,42110,강원도,춘천시,40-44세,19730,9758,9972
202102,42110,강원도,춘천시,40-44세,19779,9782,9997
202103,42110,강원도,춘천시,40-44세,19710,9751,9959
202104,42110,강원도,춘천시,40-44세,19764,9796,9968
202105,42110,강원도,춘천시,40-44세,19817,9814,10003
202106,42110,강원도,춘천시,40-44세,19885,9844,10041
202007,42110,강원도,춘천시,45-49세,23177,11560,11617
202008,42110,강원도,춘천시,45-49세,23075,11483,11592
202009,42110,강원도,춘천시,45-49세,23002,11443,11559
202010,42110,강원도,춘천시,45-49세,22874,11353,11521
202011,42110,강원도,춘천시,45-49세,22795,11305,11490
202012,42110,강원도,춘천시,45-49세,22766,11273,11493
202101,42110,강원도,춘천시,45-49세,22703,11201,11502
202102,42110,강원도,춘천시,45-49세,22617,11150,11467
202103,42110,강원도,춘천시,45-49세,22429,11073,11356
202104,42110,강원도,춘천시,45-49세,22355,11036,11319
202105,42110,강원도,춘천시,45-49세,22253,10982,11271
202106,42110,강원도,춘천시,45-49세,22121,10923,11198
202007,42110,강원도,춘천시,50-54세,23632,11954,11678
202008,42110,강원도,춘천시,50-54세,23724,12018,11706
202009,42110,강원도,춘천시,50-54세,23734,12022,11712
202010,42110,강원도,춘천시,50-54세,23788,12041,11747
202011,42110,강원도,춘천시,50-54세,23818,12057,11761
202012,42110,강원도,춘천시,50-54세,23704,11994,11710
202101,42110,강원도,춘천시,50-54세,23791,12039,11752
202102,42110,강원도,춘천시,50-54세,23855,12071,11784
202103,42110,강원도,춘천시,50-54세,23784,12041,11743
202104,42110,강원도,춘천시,50-54세,23839,12083,11756
202105,42110,강원도,춘천시,50-54세,23993,12173,11820
202106,42110,강원도,춘천시,50-54세,24052,12186,11866
202007,42110,강원도,춘천시,55-59세,23393,11599,11794
202008,42110,강원도,춘천시,55-59세,23359,11574,11785
202009,42110,강원도,춘천시,55-59세,23345,11587,11758
202010,42110,강원도,춘천시,55-59세,23370,11618,11752
202011,42110,강원도,춘천시,55-59세,23353,11618,11735
202012,42110,강원도,춘천시,55-59세,23320,11602,11718
202101,42110,강원도,춘천시,55-59세,23149,11534,11615
202102,42110,강원도,춘천시,55-59세,23087,11514,11573
202103,42110,강원도,춘천시,55-59세,22953,11442,11511
202104,42110,강원도,춘천시,55-59세,22846,11382,11464
202105,42110,강원도,춘천시,55-59세,22683,11285,11398
202106,42110,강원도,춘천시,55-59세,22457,11197,11260
202007,42110,강원도,춘천시,60-64세,22106,10745,11361
202008,42110,강원도,춘천시,60-64세,22229,10804,11425
202009,42110,강원도,춘천시,60-64세,22263,10808,11455
202010,42110,강원도,춘천시,60-64세,22299,10804,11495
202011,42110,강원도,춘천시,60-64세,22355,10818,11537
202012,42110,강원도,춘천시,60-64세,22493,10890,11603
202101,42110,강원도,춘천시,60-64세,22664,10967,11697
202102,42110,강원도,춘천시,60-64세,22836,11038,11798
202103,42110,강원도,춘천시,60-64세,22869,11058,11811
202104,42110,강원도,춘천시,60-64세,22987,11110,11877
202105,42110,강원도,춘천시,60-64세,23158,11188,11970
202106,42110,강원도,춘천시,60-64세,23414,11317,12097
202007,42110,강원도,춘천시,65-69세,14939,7183,7756
202008,42110,강원도,춘천시,65-69세,15081,7261,7820
202009,42110,강원도,춘천시,65-69세,15229,7341,7888
202010,42110,강원도,춘천시,65-69세,15421,7452,7969
202011,42110,강원도,춘천시,65-69세,15570,7525,8045
202012,42110,강원도,춘천시,65-69세,15734,7594,8140
202101,42110,강원도,춘천시,65-69세,15878,7674,8204
202102,42110,강원도,춘천시,65-69세,16033,7759,8274
202103,42110,강원도,춘천시,65-69세,16208,7883,8325
202104,42110,강원도,춘천시,65-69세,16422,7987,8435
202105,42110,강원도,춘천시,65-69세,16615,8089,8526
202106,42110,강원도,춘천시,65-69세,16758,8141,8617
202007,42110,강원도,춘천시,70-74세,10524,4740,5784
202008,42110,강원도,춘천시,70-74세,10493,4718,5775
202009,42110,강원도,춘천시,70-74세,10510,4736,5774
202010,42110,강원도,춘천시,70-74세,10522,4735,5787
202011,42110,강원도,춘천시,70-74세,10554,4752,5802
202012,42110,강원도,춘천시,70-74세,10590,4786,5804
202101,42110,강원도,춘천시,70-74세,10619,4790,5829
202102,42110,강원도,춘천시,70-74세,10646,4806,5840
202103,42110,강원도,춘천시,70-74세,10555,4763,5792
202104,42110,강원도,춘천시,70-74세,10532,4755,5777
202105,42110,강원도,춘천시,70-74세,10479,4713,5766
202106,42110,강원도,춘천시,70-74세,10436,4705,5731
202007,42110,강원도,춘천시,75-79세,10532,4434,6098
202008,42110,강원도,춘천시,75-79세,10534,4450,6084
202009,42110,강원도,춘천시,75-79세,10524,4446,6078
202010,42110,강원도,춘천시,75-79세,10496,4448,6048
202011,42110,강원도,춘천시,75-79세,10464,4434,6030
202012,42110,강원도,춘천시,75-79세,10431,4428,6003
202101,42110,강원도,춘천시,75-79세,10388,4408,5980
202102,42110,강원도,춘천시,75-79세,10343,4411,5932
202103,42110,강원도,춘천시,75-79세,10319,4414,5905
202104,42110,강원도,춘천시,75-79세,10308,4401,5907
202105,42110,강원도,춘천시,75-79세,10301,4424,5877
202106,42110,강원도,춘천시,75-79세,10270,4396,5874
202007,42110,강원도,춘천시,80-84세,7743,2974,4769
202008,42110,강원도,춘천시,80-84세,7779,2993,4786
202009,42110,강원도,춘천시,80-84세,7797,3002,4795
202010,42110,강원도,춘천시,80-84세,7863,3029,4834
202011,42110,강원도,춘천시,80-84세,7878,3037,4841
202012,42110,강원도,춘천시,80-84세,7914,3034,4880
202101,42110,강원도,춘천시,80-84세,7961,3067,4894
202102,42110,강원도,춘천시,80-84세,8013,3073,4940
202103,42110,강원도,춘천시,80-84세,7972,3063,4909
202104,42110,강원도,춘천시,80-84세,7980,3063,4917
202105,42110,강원도,춘천시,80-84세,8038,3079,4959
202106,42110,강원도,춘천시,80-84세,8089,3112,4977
202007,42110,강원도,춘천시,85-89세,3636,1124,2512
202008,42110,강원도,춘천시,85-89세,3666,1134,2532
202009,42110,강원도,춘천시,85-89세,3714,1143,2571
202010,42110,강원도,춘천시,85-89세,3759,1160,2599
202011,42110,강원도,춘천시,85-89세,3813,1187,2626
202012,42110,강원도,춘천시,85-89세,3861,1217,2644
202101,42110,강원도,춘천시,85-89세,3901,1226,2675
202102,42110,강원도,춘천시,85-89세,3962,1244,2718
202103,42110,강원도,춘천시,85-89세,3995,1237,2758
202104,42110,강원도,춘천시,85-89세,4027,1243,2784
202105,42110,강원도,춘천시,85-89세,4048,1241,2807
202106,42110,강원도,춘천시,85-89세,4085,1243,2842
202007,42110,강원도,춘천시,90-94세,1485,334,1151
202008,42110,강원도,춘천시,90-94세,1495,339,1156
202009,42110,강원도,춘천시,90-94세,1509,351,1158
202010,42110,강원도,춘천시,90-94세,1511,349,1162
202011,42110,강원도,춘천시,90-94세,1520,354,1166
202012,42110,강원도,춘천시,90-94세,1527,356,1171
202101,42110,강원도,춘천시,90-94세,1535,354,1181
202102,42110,강원도,춘천시,90-94세,1538,360,1178
202103,42110,강원도,춘천시,90-94세,1524,355,1169
202104,42110,강원도,춘천시,90-94세,1525,358,1167
202105,42110,강원도,춘천시,90-94세,1533,364,1169
202106,42110,강원도,춘천시,90-94세,1528,359,1169
202007,42110,강원도,춘천시,95-99세,385,115,270
202008,42110,강원도,춘천시,95-99세,394,120,274
202009,42110,강원도,춘천시,95-99세,400,120,280
202010,42110,강원도,춘천시,95-99세,396,119,277
202011,42110,강원도,춘천시,95-99세,398,118,280
202012,42110,강원도,춘천시,95-99세,391,114,277
202101,42110,강원도,춘천시,95-99세,401,116,285
202102,42110,강원도,춘천시,95-99세,407,118,289
202103,42110,강원도,춘천시,95-99세,375,108,267
202104,42110,강원도,춘천시,95-99세,374,109,265
202105,42110,강원도,춘천시,95-99세,367,106,261
202106,42110,강원도,춘천시,95-99세,364,103,261
202007,42110,강원도,춘천시,100+,109,46,63
202008,42110,강원도,춘천시,100+,111,46,65
202009,42110,강원도,춘천시,100+,113,46,67
202010,42110,강원도,춘천시,100+,115,46,69
202011,42110,강원도,춘천시,100+,115,47,68
202012,42110,강원도,춘천시,100+,119,49,70
202101,42110,강원도,춘천시,100+,120,50,70
202102,42110,강원도,춘천시,100+,120,50,70
202103,42110,강원도,춘천시,100+,61,17,44
202104,42110,강원도,춘천시,100+,62,18,44
202105,42110,강원도,춘천시,100+,65,19,46
202106,42110,강원도,춘천시,100+,66,19,47
202007,42130,강원도,원주시,0-4세,12359,6382,5977
202008,42130,강원도,원주시,0-4세,12298,6337,5961
202009,42130,강원도,원주시,0-4세,12259,6313,5946
202010,42130,강원도,원주시,0-4세,12196,6272,5924
202011,42130,강원도,원주시,0-4세,12175,6284,5891
202012,42130,강원도,원주시,0-4세,12153,6282,5871
202101,42130,강원도,원주시,0-4세,12123,6247,5876
202102,42130,강원도,원주시,0-4세,12070,6219,5851
202103,42130,강원도,원주시,0-4세,12049,6220,5829
202104,42130,강원도,원주시,0-4세,11984,6156,5828
202105,42130,강원도,원주시,0-4세,11931,6134,5797
202106,42130,강원도,원주시,0-4세,11887,6110,5777
202007,42130,강원도,원주시,5-9세,16328,8252,8076
202008,42130,강원도,원주시,5-9세,16285,8239,8046
202009,42130,강원도,원주시,5-9세,16226,8206,8020
202010,42130,강원도,원주시,5-9세,16181,8179,8002
202011,42130,강원도,원주시,5-9세,16164,8153,8011
202012,42130,강원도,원주시,5-9세,16149,8142,8007
202101,42130,강원도,원주시,5-9세,16113,8137,7976
202102,42130,강원도,원주시,5-9세,16080,8114,7966
202103,42130,강원도,원주시,5-9세,16024,8080,7944
202104,42130,강원도,원주시,5-9세,15931,8061,7870
202105,42130,강원도,원주시,5-9세,15912,8061,7851
202106,42130,강원도,원주시,5-9세,15874,8045,7829
202007,42130,강원도,원주시,10-14세,17473,8998,8475
202008,42130,강원도,원주시,10-14세,17514,9037,8477
202009,42130,강원도,원주시,10-14세,17521,9014,8507
202010,42130,강원도,원주시,10-14세,17555,9029,8526
202011,42130,강원도,원주시,10-14세,17611,9038,8573
202012,42130,강원도,원주시,10-14세,17637,9063,8574
202101,42130,강원도,원주시,10-14세,17668,9064,8604
202102,42130,강원도,원주시,10-14세,17725,9093,8632
202103,42130,강원도,원주시,10-14세,17745,9111,8634
202104,42130,강원도,원주시,10-14세,17790,9122,8668
202105,42130,강원도,원주시,10-14세,17786,9100,8686
202106,42130,강원도,원주시,10-14세,17816,9125,8691
202007,42130,강원도,원주시,15-19세,18729,9794,8935
202008,42130,강원도,원주시,15-19세,18643,9727,8916
202009,42130,강원도,원주시,15-19세,18561,9708,8853
202010,42130,강원도,원주시,15-19세,18470,9646,8824
202011,42130,강원도,원주시,15-19세,18359,9592,8767
202012,42130,강원도,원주시,15-19세,18281,9565,8716
202101,42130,강원도,원주시,15-19세,18184,9486,8698
202102,42130,강원도,원주시,15-19세,18099,9433,8666
202103,42130,강원도,원주시,15-19세,17901,9328,8573
202104,42130,강원도,원주시,15-19세,17763,9258,8505
202105,42130,강원도,원주시,15-19세,17713,9240,8473
202106,42130,강원도,원주시,15-19세,17657,9198,8459
202007,42130,강원도,원주시,20-24세,23022,12279,10743
202008,42130,강원도,원주시,20-24세,22950,12217,10733
202009,42130,강원도,원주시,20-24세,22940,12226,10714
202010,42130,강원도,원주시,20-24세,22947,12221,10726
202011,42130,강원도,원주시,20-24세,22927,12238,10689
202012,42130,강원도,원주시,20-24세,22934,12227,10707
202101,42130,강원도,원주시,20-24세,22891,12211,10680
202102,42130,강원도,원주시,20-24세,22746,12150,10596
202103,42130,강원도,원주시,20-24세,22607,12082,10525
202104,42130,강원도,원주시,20-24세,22553,12057,10496
202105,42130,강원도,원주시,20-24세,22436,11997,10439
202106,42130,강원도,원주시,20-24세,22333,11929,10404
202007,42130,강원도,원주시,25-29세,22179,11728,10451
202008,42130,강원도,원주시,25-29세,22262,11775,10487
202009,42130,강원도,원주시,25-29세,22305,11779,10526
202010,42130,강원도,원주시,25-29세,22407,11879,10528
202011,42130,강원도,원주시,25-29세,22464,11948,10516
202012,42130,강원도,원주시,25-29세,22642,12054,10588
202101,42130,강원도,원주시,25-29세,22730,12085,10645
202102,42130,강원도,원주시,25-29세,22683,12005,10678
202103,42130,강원도,원주시,25-29세,22658,11981,10677
202104,42130,강원도,원주시,25-29세,22716,12041,10675
202105,42130,강원도,원주시,25-29세,22751,12089,10662
202106,42130,강원도,원주시,25-29세,22751,12077,10674
202007,42130,강원도,원주시,30-34세,20482,10520,9962
202008,42130,강원도,원주시,30-34세,20496,10543,9953
202009,42130,강원도,원주시,30-34세,20532,10538,9994
202010,42130,강원도,원주시,30-34세,20535,10525,10010
202011,42130,강원도,원주시,30-34세,20596,10553,10043
202012,42130,강원도,원주시,30-34세,20654,10600,10054
202101,42130,강원도,원주시,30-34세,20619,10553,10066
202102,42130,강원도,원주시,30-34세,20670,10590,10080
202103,42130,강원도,원주시,30-34세,20783,10636,10147
202104,42130,강원도,원주시,30-34세,20776,10638,10138
202105,42130,강원도,원주시,30-34세,20780,10613,10167
202106,42130,강원도,원주시,30-34세,20840,10661,10179
202007,42130,강원도,원주시,35-39세,24939,12517,12422
202008,42130,강원도,원주시,35-39세,24898,12508,12390
202009,42130,강원도,원주시,35-39세,24785,12501,12284
202010,42130,강원도,원주시,35-39세,24684,12476,12208
202011,42130,강원도,원주시,35-39세,24638,12429,12209
202012,42130,강원도,원주시,35-39세,24669,12437,12232
202101,42130,강원도,원주시,35-39세,24615,12404,12211
202102,42130,강원도,원주시,35-39세,24583,12401,12182
202103,42130,강원도,원주시,35-39세,24471,12367,12104
202104,42130,강원도,원주시,35-39세,24345,12262,12083
202105,42130,강원도,원주시,35-39세,24229,12209,12020
202106,42130,강원도,원주시,35-39세,24183,12190,11993
202007,42130,강원도,원주시,40-44세,26553,13058,13495
202008,42130,강원도,원주시,40-44세,26538,13038,13500
202009,42130,강원도,원주시,40-44세,26611,13031,13580
202010,42130,강원도,원주시,40-44세,26697,13065,13632
202011,42130,강원도,원주시,40-44세,26775,13141,13634
202012,42130,강원도,원주시,40-44세,26743,13189,13554
202101,42130,강원도,원주시,40-44세,26736,13197,13539
202102,42130,강원도,원주시,40-44세,26801,13210,13591
202103,42130,강원도,원주시,40-44세,26696,13202,13494
202104,42130,강원도,원주시,40-44세,26658,13190,13468
202105,42130,강원도,원주시,40-44세,26736,13229,13507
202106,42130,강원도,원주시,40-44세,26843,13266,13577
202007,42130,강원도,원주시,45-49세,30937,15341,15596
202008,42130,강원도,원주시,45-49세,30871,15286,15585
202009,42130,강원도,원주시,45-49세,30753,15211,15542
202010,42130,강원도,원주시,45-49세,30618,15121,15497
202011,42130,강원도,원주시,45-49세,30542,15089,15453
202012,42130,강원도,원주시,45-49세,30472,15030,15442
202101,42130,강원도,원주시,45-49세,30424,14978,15446
202102,42130,강원도,원주시,45-49세,30292,14916,15376
202103,42130,강원도,원주시,45-49세,30177,14823,15354
202104,42130,강원도,원주시,45-49세,30177,14814,15363
202105,42130,강원도,원주시,45-49세,30017,14703,15314
202106,42130,강원도,원주시,45-49세,29897,14674,15223
202007,42130,강원도,원주시,50-54세,30991,15632,15359
202008,42130,강원도,원주시,50-54세,31045,15660,15385
202009,42130,강원도,원주시,50-54세,31124,15718,15406
202010,42130,강원도,원주시,50-54세,31228,15742,15486
202011,42130,강원도,원주시,50-54세,31292,15766,15526
202012,42130,강원도,원주시,50-54세,31252,15739,15513
202101,42130,강원도,원주시,50-54세,31399,15798,15601
202102,42130,강원도,원주시,50-54세,31478,15803,15675
202103,42130,강원도,원주시,50-54세,31352,15748,15604
202104,42130,강원도,원주시,50-54세,31385,15767,15618
202105,42130,강원도,원주시,50-54세,31590,15916,15674
202106,42130,강원도,원주시,50-54세,31650,15925,15725
202007,42130,강원도,원주시,55-59세,29450,14762,14688
202008,42130,강원도,원주시,55-59세,29460,14765,14695
202009,42130,강원도,원주시,55-59세,29490,14773,14717
202010,42130,강원도,원주시,55-59세,29539,14826,14713
202011,42130,강원도,원주시,55-59세,29483,14782,14701
202012,42130,강원도,원주시,55-59세,29577,14821,14756
202101,42130,강원도,원주시,55-59세,29433,14774,14659
202102,42130,강원도,원주시,55-59세,29395,14761,14634
202103,42130,강원도,원주시,55-59세,29371,14790,14581
202104,42130,강원도,원주시,55-59세,29343,14785,14558
202105,42130,강원도,원주시,55-59세,29265,14739,14526
202106,42130,강원도,원주시,55-59세,29060,14612,14448
202007,42130,강원도,원주시,60-64세,27145,13525,13620
202008,42130,강원도,원주시,60-64세,27305,13593,13712
202009,42130,강원도,원주시,60-64세,27420,13657,13763
202010,42130,강원도,원주시,60-64세,27556,13686,13870
202011,42130,강원도,원주시,60-64세,27746,13795,13951
202012,42130,강원도,원주시,60-64세,27823,13849,13974
202101,42130,강원도,원주시,60-64세,27980,13911,14069
202102,42130,강원도,원주시,60-64세,28227,14019,14208
202103,42130,강원도,원주시,60-64세,28396,14070,14326
202104,42130,강원도,원주시,60-64세,28610,14170,14440
202105,42130,강원도,원주시,60-64세,28810,14282,14528
202106,42130,강원도,원주시,60-64세,29150,14458,14692
202007,42130,강원도,원주시,65-69세,16870,8246,8624
202008,42130,강원도,원주시,65-69세,17012,8329,8683
202009,42130,강원도,원주시,65-69세,17201,8404,8797
202010,42130,강원도,원주시,65-69세,17397,8525,8872
202011,42130,강원도,원주시,65-69세,17574,8619,8955
202012,42130,강원도,원주시,65-69세,17770,8712,9058
202101,42130,강원도,원주시,65-69세,17971,8809,9162
202102,42130,강원도,원주시,65-69세,18166,8923,9243
202103,42130,강원도,원주시,65-69세,18409,9067,9342
202104,42130,강원도,원주시,65-69세,18643,9197,9446
202105,42130,강원도,원주시,65-69세,18868,9330,9538
202106,42130,강원도,원주시,65-69세,19019,9419,9600
202007,42130,강원도,원주시,70-74세,11022,5083,5939
202008,42130,강원도,원주시,70-74세,11053,5094,5959
202009,42130,강원도,원주시,70-74세,11073,5107,5966
202010,42130,강원도,원주시,70-74세,11123,5130,5993
202011,42130,강원도,원주시,70-74세,11137,5123,6014
202012,42130,강원도,원주시,70-74세,11201,5157,6044
202101,42130,강원도,원주시,70-74세,11297,5204,6093
202102,42130,강원도,원주시,70-74세,11368,5258,6110
202103,42130,강원도,원주시,70-74세,11337,5248,6089
202104,42130,강원도,원주시,70-74세,11343,5247,6096
202105,42130,강원도,원주시,70-74세,11330,5236,6094
202106,42130,강원도,원주시,70-74세,11323,5225,6098
202007,42130,강원도,원주시,75-79세,10616,4449,6167
202008,42130,강원도,원주시,75-79세,10625,4476,6149
202009,42130,강원도,원주시,75-79세,10585,4466,6119
202010,42130,강원도,원주시,75-79세,10557,4469,6088
202011,42130,강원도,원주시,75-79세,10532,4471,6061
202012,42130,강원도,원주시,75-79세,10435,4429,6006
202101,42130,강원도,원주시,75-79세,10384,4416,5968
202102,42130,강원도,원주시,75-79세,10308,4370,5938
202103,42130,강원도,원주시,75-79세,10227,4337,5890
202104,42130,강원도,원주시,75-79세,10180,4337,5843
202105,42130,강원도,원주시,75-79세,10192,4334,5858
202106,42130,강원도,원주시,75-79세,10159,4334,5825
202007,42130,강원도,원주시,80-84세,7967,3006,4961
202008,42130,강원도,원주시,80-84세,7987,3007,4980
202009,42130,강원도,원주시,80-84세,8017,3024,4993
202010,42130,강원도,원주시,80-84세,8047,3031,5016
202011,42130,강원도,원주시,80-84세,8070,3055,5015
202012,42130,강원도,원주시,80-84세,8122,3082,5040
202101,42130,강원도,원주시,80-84세,8172,3102,5070
202102,42130,강원도,원주시,80-84세,8247,3135,5112
202103,42130,강원도,원주시,80-84세,8265,3143,5122
202104,42130,강원도,원주시,80-84세,8324,3169,5155
202105,42130,강원도,원주시,80-84세,8343,3180,5163
202106,42130,강원도,원주시,80-84세,8419,3199,5220
202007,42130,강원도,원주시,85-89세,3798,1080,2718
202008,42130,강원도,원주시,85-89세,3842,1096,2746
202009,42130,강원도,원주시,85-89세,3882,1107,2775
202010,42130,강원도,원주시,85-89세,3911,1114,2797
202011,42130,강원도,원주시,85-89세,3923,1112,2811
202012,42130,강원도,원주시,85-89세,3940,1122,2818
202101,42130,강원도,원주시,85-89세,3977,1131,2846
202102,42130,강원도,원주시,85-89세,4018,1146,2872
202103,42130,강원도,원주시,85-89세,4063,1155,2908
202104,42130,강원도,원주시,85-89세,4084,1163,2921
202105,42130,강원도,원주시,85-89세,4137,1187,2950
202106,42130,강원도,원주시,85-89세,4157,1206,2951
202007,42130,강원도,원주시,90-94세,1436,306,1130
202008,42130,강원도,원주시,90-94세,1444,305,1139
202009,42130,강원도,원주시,90-94세,1465,309,1156
202010,42130,강원도,원주시,90-94세,1459,305,1154
202011,42130,강원도,원주시,90-94세,1468,307,1161
202012,42130,강원도,원주시,90-94세,1472,312,1160
202101,42130,강원도,원주시,90-94세,1489,322,1167
202102,42130,강원도,원주시,90-94세,1507,327,1180
202103,42130,강원도,원주시,90-94세,1492,321,1171
202104,42130,강원도,원주시,90-94세,1507,321,1186
202105,42130,강원도,원주시,90-94세,1508,319,1189
202106,42130,강원도,원주시,90-94세,1530,328,1202
202007,42130,강원도,원주시,95-99세,324,95,229
202008,42130,강원도,원주시,95-99세,328,94,234
202009,42130,강원도,원주시,95-99세,332,99,233
202010,42130,강원도,원주시,95-99세,335,99,236
202011,42130,강원도,원주시,95-99세,340,101,239
202012,42130,강원도,원주시,95-99세,338,98,240
202101,42130,강원도,원주시,95-99세,349,103,246
202102,42130,강원도,원주시,95-99세,358,103,255
202103,42130,강원도,원주시,95-99세,351,95,256
202104,42130,강원도,원주시,95-99세,363,97,266
202105,42130,강원도,원주시,95-99세,372,100,272
202106,42130,강원도,원주시,95-99세,365,98,267
202007,42130,강원도,원주시,100+,106,24,82
202008,42130,강원도,원주시,100+,108,26,82
202009,42130,강원도,원주시,100+,107,26,81
202010,42130,강원도,원주시,100+,111,27,84
202011,42130,강원도,원주시,100+,112,28,84
202012,42130,강원도,원주시,100+,112,29,83
202101,42130,강원도,원주시,100+,110,30,80
202102,42130,강원도,원주시,100+,112,31,81
202103,42130,강원도,원주시,100+,63,12,51
202104,42130,강원도,원주시,100+,61,11,50
202105,42130,강원도,원주시,100+,62,11,51
202106,42130,강원도,원주시,100+,65,10,55
202007,42150,강원도,강릉시,0-4세,5773,3001,2772
202008,42150,강원도,강릉시,0-4세,5737,2982,2755
202009,42150,강원도,강릉시,0-4세,5714,2971,2743
202010,42150,강원도,강릉시,0-4세,5674,2947,2727
202011,42150,강원도,강릉시,0-4세,5645,2941,2704
202012,42150,강원도,강릉시,0-4세,5626,2941,2685
202101,42150,강원도,강릉시,0-4세,5596,2921,2675
202102,42150,강원도,강릉시,0-4세,5560,2903,2657
202103,42150,강원도,강릉시,0-4세,5521,2880,2641
202104,42150,강원도,강릉시,0-4세,5470,2843,2627
202105,42150,강원도,강릉시,0-4세,5457,2836,2621
202106,42150,강원도,강릉시,0-4세,5426,2822,2604
202007,42150,강원도,강릉시,5-9세,7987,4095,3892
202008,42150,강원도,강릉시,5-9세,7973,4086,3887
202009,42150,강원도,강릉시,5-9세,7933,4069,3864
202010,42150,강원도,강릉시,5-9세,7894,4041,3853
202011,42150,강원도,강릉시,5-9세,7882,4035,3847
202012,42150,강원도,강릉시,5-9세,7862,4025,3837
202101,42150,강원도,강릉시,5-9세,7832,4008,3824
202102,42150,강원도,강릉시,5-9세,7809,4001,3808
202103,42150,강원도,강릉시,5-9세,7788,4006,3782
202104,42150,강원도,강릉시,5-9세,7765,3992,3773
202105,42150,강원도,강릉시,5-9세,7745,3978,3767
202106,42150,강원도,강릉시,5-9세,7705,3959,3746
202007,42150,강원도,강릉시,10-14세,8797,4630,4167
202008,42150,강원도,강릉시,10-14세,8779,4632,4147
202009,42150,강원도,강릉시,10-14세,8779,4623,4156
202010,42150,강원도,강릉시,10-14세,8781,4621,4160
202011,42150,강원도,강릉시,10-14세,8780,4618,4162
202012,42150,강원도,강릉시,10-14세,8802,4617,4185
202101,42150,강원도,강릉시,10-14세,8792,4611,4181
202102,42150,강원도,강릉시,10-14세,8798,4611,4187
202103,42150,강원도,강릉시,10-14세,8789,4600,4189
202104,42150,강원도,강릉시,10-14세,8811,4612,4199
202105,42150,강원도,강릉시,10-14세,8788,4584,4204
202106,42150,강원도,강릉시,10-14세,8797,4590,4207
202007,42150,강원도,강릉시,15-19세,10586,5568,5018
202008,42150,강원도,강릉시,15-19세,10502,5507,4995
202009,42150,강원도,강릉시,15-19세,10463,5496,4967
202010,42150,강원도,강릉시,15-19세,10387,5459,4928
202011,42150,강원도,강릉시,15-19세,10296,5401,4895
202012,42150,강원도,강릉시,15-19세,10172,5341,4831
202101,42150,강원도,강릉시,15-19세,10133,5315,4818
202102,42150,강원도,강릉시,15-19세,10055,5281,4774
202103,42150,강원도,강릉시,15-19세,9964,5223,4741
202104,42150,강원도,강릉시,15-19세,9888,5174,4714
202105,42150,강원도,강릉시,15-19세,9854,5178,4676
202106,42150,강원도,강릉시,15-19세,9809,5168,4641
202007,42150,강원도,강릉시,20-24세,13611,7304,6307
202008,42150,강원도,강릉시,20-24세,13576,7299,6277
202009,42150,강원도,강릉시,20-24세,13531,7289,6242
202010,42150,강원도,강릉시,20-24세,13484,7269,6215
202011,42150,강원도,강릉시,20-24세,13504,7286,6218
202012,42150,강원도,강릉시,20-24세,13470,7280,6190
202101,42150,강원도,강릉시,20-24세,13383,7231,6152
202102,42150,강원도,강릉시,20-24세,13300,7228,6072
202103,42150,강원도,강릉시,20-24세,13221,7179,6042
202104,42150,강원도,강릉시,20-24세,13254,7194,6060
202105,42150,강원도,강릉시,20-24세,13232,7154,6078
202106,42150,강원도,강릉시,20-24세,13198,7161,6037
202007,42150,강원도,강릉시,25-29세,11437,6397,5040
202008,42150,강원도,강릉시,25-29세,11493,6420,5073
202009,42150,강원도,강릉시,25-29세,11522,6423,5099
202010,42150,강원도,강릉시,25-29세,11594,6456,5138
202011,42150,강원도,강릉시,25-29세,11647,6491,5156
202012,42150,강원도,강릉시,25-29세,11731,6525,5206
202101,42150,강원도,강릉시,25-29세,11730,6505,5225
202102,42150,강원도,강릉시,25-29세,11668,6463,5205
202103,42150,강원도,강릉시,25-29세,11708,6472,5236
202104,42150,강원도,강릉시,25-29세,11666,6452,5214
202105,42150,강원도,강릉시,25-29세,11661,6461,5200
202106,42150,강원도,강릉시,25-29세,11733,6477,5256
202007,42150,강원도,강릉시,30-34세,9481,5189,4292
202008,42150,강원도,강릉시,30-34세,9458,5174,4284
202009,42150,강원도,강릉시,30-34세,9452,5168,4284
202010,42150,강원도,강릉시,30-34세,9443,5164,4279
202011,42150,강원도,강릉시,30-34세,9476,5190,4286
202012,42150,강원도,강릉시,30-34세,9524,5227,4297
202101,42150,강원도,강릉시,30-34세,9562,5248,4314
202102,42150,강원도,강릉시,30-34세,9505,5194,4311
202103,42150,강원도,강릉시,30-34세,9516,5209,4307
202104,42150,강원도,강릉시,30-34세,9528,5197,4331
202105,42150,강원도,강릉시,30-34세,9521,5208,4313
202106,42150,강원도,강릉시,30-34세,9578,5243,4335
202007,42150,강원도,강릉시,35-39세,12396,6282,6114
202008,42150,강원도,강릉시,35-39세,12357,6271,6086
202009,42150,강원도,강릉시,35-39세,12289,6250,6039
202010,42150,강원도,강릉시,35-39세,12236,6217,6019
202011,42150,강원도,강릉시,35-39세,12189,6200,5989
202012,42150,강원도,강릉시,35-39세,12167,6181,5986
202101,42150,강원도,강릉시,35-39세,12098,6136,5962
202102,42150,강원도,강릉시,35-39세,12003,6091,5912
202103,42150,강원도,강릉시,35-39세,11908,6059,5849
202104,42150,강원도,강릉시,35-39세,11896,6048,5848
202105,42150,강원도,강릉시,35-39세,11844,6050,5794
202106,42150,강원도,강릉시,35-39세,11790,6030,5760
202007,42150,강원도,강릉시,40-44세,14464,7241,7223
202008,42150,강원도,강릉시,40-44세,14449,7244,7205
202009,42150,강원도,강릉시,40-44세,14498,7252,7246
202010,42150,강원도,강릉시,40-44세,14533,7278,7255
202011,42150,강원도,강릉시,40-44세,14569,7282,7287
202012,42150,강원도,강릉시,40-44세,14520,7261,7259
202101,42150,강원도,강릉시,40-44세,14480,7264,7216
202102,42150,강원도,강릉시,40-44세,14493,7283,7210
202103,42150,강원도,강릉시,40-44세,14407,7262,7145
202104,42150,강원도,강릉시,40-44세,14374,7267,7107
202105,42150,강원도,강릉시,40-44세,14369,7260,7109
202106,42150,강원도,강릉시,40-44세,14421,7274,7147
202007,42150,강원도,강릉시,45-49세,18066,9363,8703
202008,42150,강원도,강릉시,45-49세,17951,9273,8678
202009,42150,강원도,강릉시,45-49세,17873,9245,8628
202010,42150,강원도,강릉시,45-49세,17802,9193,8609
202011,42150,강원도,강릉시,45-49세,17785,9185,8600
202012,42150,강원도,강릉시,45-49세,17837,9212,8625
202101,42150,강원도,강릉시,45-49세,17850,9208,8642
202102,42150,강원도,강릉시,45-49세,17767,9175,8592
202103,42150,강원도,강릉시,45-49세,17748,9106,8642
202104,42150,강원도,강릉시,45-49세,17734,9094,8640
202105,42150,강원도,강릉시,45-49세,17660,9053,8607
202106,42150,강원도,강릉시,45-49세,17550,8997,8553
202007,42150,강원도,강릉시,50-54세,18241,9297,8944
202008,42150,강원도,강릉시,50-54세,18342,9382,8960
202009,42150,강원도,강릉시,50-54세,18420,9423,8997
202010,42150,강원도,강릉시,50-54세,18437,9422,9015
202011,42150,강원도,강릉시,50-54세,18426,9413,9013
202012,42150,강원도,강릉시,50-54세,18393,9395,8998
202101,42150,강원도,강릉시,50-54세,18530,9456,9074
202102,42150,강원도,강릉시,50-54세,18574,9447,9127
202103,42150,강원도,강릉시,50-54세,18441,9399,9042
202104,42150,강원도,강릉시,50-54세,18436,9395,9041
202105,42150,강원도,강릉시,50-54세,18473,9434,9039
202106,42150,강원도,강릉시,50-54세,18530,9467,9063
202007,42150,강원도,강릉시,55-59세,18458,9071,9387
202008,42150,강원도,강릉시,55-59세,18440,9067,9373
202009,42150,강원도,강릉시,55-59세,18418,9051,9367
202010,42150,강원도,강릉시,55-59세,18335,9010,9325
202011,42150,강원도,강릉시,55-59세,18277,8997,9280
202012,42150,강원도,강릉시,55-59세,18259,8992,9267
202101,42150,강원도,강릉시,55-59세,18094,8939,9155
202102,42150,강원도,강릉시,55-59세,18035,8938,9097
202103,42150,강원도,강릉시,55-59세,18025,8970,9055
202104,42150,강원도,강릉시,55-59세,18007,8992,9015
202105,42150,강원도,강릉시,55-59세,17947,8962,8985
202106,42150,강원도,강릉시,55-59세,17857,8917,8940
202007,42150,강원도,강릉시,60-64세,19071,9268,9803
202008,42150,강원도,강릉시,60-64세,19129,9268,9861
202009,42150,강원도,강릉시,60-64세,19149,9283,9866
202010,42150,강원도,강릉시,60-64세,19288,9350,9938
202011,42150,강원도,강릉시,60-64세,19368,9387,9981
202012,42150,강원도,강릉시,60-64세,19474,9436,10038
202101,42150,강원도,강릉시,60-64세,19643,9499,10144
202102,42150,강원도,강릉시,60-64세,19773,9534,10239
202103,42150,강원도,강릉시,60-64세,19848,9575,10273
202104,42150,강원도,강릉시,60-64세,19936,9577,10359
202105,42150,강원도,강릉시,60-64세,19999,9622,10377
202106,42150,강원도,강릉시,60-64세,20145,9687,10458
202007,42150,강원도,강릉시,65-69세,13766,6498,7268
202008,42150,강원도,강릉시,65-69세,13841,6520,7321
202009,42150,강원도,강릉시,65-69세,13977,6578,7399
202010,42150,강원도,강릉시,65-69세,14067,6624,7443
202011,42150,강원도,강릉시,65-69세,14179,6678,7501
202012,42150,강원도,강릉시,65-69세,14232,6701,7531
202101,42150,강원도,강릉시,65-69세,14286,6720,7566
202102,42150,강원도,강릉시,65-69세,14406,6780,7626
202103,42150,강원도,강릉시,65-69세,14543,6844,7699
202104,42150,강원도,강릉시,65-69세,14636,6898,7738
202105,42150,강원도,강릉시,65-69세,14687,6933,7754
202106,42150,강원도,강릉시,65-69세,14769,6973,7796
202007,42150,강원도,강릉시,70-74세,10080,4673,5407
202008,42150,강원도,강릉시,70-74세,10100,4684,5416
202009,42150,강원도,강릉시,70-74세,10171,4723,5448
202010,42150,강원도,강릉시,70-74세,10249,4764,5485
202011,42150,강원도,강릉시,70-74세,10289,4775,5514
202012,42150,강원도,강릉시,70-74세,10378,4814,5564
202101,42150,강원도,강릉시,70-74세,10469,4866,5603
202102,42150,강원도,강릉시,70-74세,10494,4870,5624
202103,42150,강원도,강릉시,70-74세,10449,4857,5592
202104,42150,강원도,강릉시,70-74세,10476,4863,5613
202105,42150,강원도,강릉시,70-74세,10425,4836,5589
202106,42150,강원도,강릉시,70-74세,10416,4818,5598
202007,42150,강원도,강릉시,75-79세,9401,4019,5382
202008,42150,강원도,강릉시,75-79세,9408,4018,5390
202009,42150,강원도,강릉시,75-79세,9384,4000,5384
202010,42150,강원도,강릉시,75-79세,9316,3960,5356
202011,42150,강원도,강릉시,75-79세,9296,3947,5349
202012,42150,강원도,강릉시,75-79세,9208,3913,5295
202101,42150,강원도,강릉시,75-79세,9180,3895,5285
202102,42150,강원도,강릉시,75-79세,9154,3905,5249
202103,42150,강원도,강릉시,75-79세,9182,3928,5254
202104,42150,강원도,강릉시,75-79세,9139,3931,5208
202105,42150,강원도,강릉시,75-79세,9155,3943,5212
202106,42150,강원도,강릉시,75-79세,9157,3963,5194
202007,42150,강원도,강릉시,80-84세,6534,2522,4012
202008,42150,강원도,강릉시,80-84세,6539,2529,4010
202009,42150,강원도,강릉시,80-84세,6580,2554,4026
202010,42150,강원도,강릉시,80-84세,6632,2576,4056
202011,42150,강원도,강릉시,80-84세,6621,2564,4057
202012,42150,강원도,강릉시,80-84세,6660,2575,4085
202101,42150,강원도,강릉시,80-84세,6700,2598,4102
202102,42150,강원도,강릉시,80-84세,6729,2607,4122
202103,42150,강원도,강릉시,80-84세,6724,2596,4128
202104,42150,강원도,강릉시,80-84세,6722,2591,4131
202105,42150,강원도,강릉시,80-84세,6734,2599,4135
202106,42150,강원도,강릉시,80-84세,6773,2611,4162
202007,42150,강원도,강릉시,85-89세,3129,928,2201
202008,42150,강원도,강릉시,85-89세,3144,935,2209
202009,42150,강원도,강릉시,85-89세,3160,946,2214
202010,42150,강원도,강릉시,85-89세,3177,956,2221
202011,42150,강원도,강릉시,85-89세,3214,978,2236
202012,42150,강원도,강릉시,85-89세,3248,998,2250
202101,42150,강원도,강릉시,85-89세,3282,1014,2268
202102,42150,강원도,강릉시,85-89세,3321,1030,2291
202103,42150,강원도,강릉시,85-89세,3363,1053,2310
202104,42150,강원도,강릉시,85-89세,3396,1063,2333
202105,42150,강원도,강릉시,85-89세,3391,1058,2333
202106,42150,강원도,강릉시,85-89세,3393,1055,2338
202007,42150,강원도,강릉시,90-94세,1278,263,1015
202008,42150,강원도,강릉시,90-94세,1293,269,1024
202009,42150,강원도,강릉시,90-94세,1311,270,1041
202010,42150,강원도,강릉시,90-94세,1308,268,1040
202011,42150,강원도,강릉시,90-94세,1305,267,1038
202012,42150,강원도,강릉시,90-94세,1313,271,1042
202101,42150,강원도,강릉시,90-94세,1322,276,1046
202102,42150,강원도,강릉시,90-94세,1336,277,1059
202103,42150,강원도,강릉시,90-94세,1334,272,1062
202104,42150,강원도,강릉시,90-94세,1340,275,1065
202105,42150,강원도,강릉시,90-94세,1339,275,1064
202106,42150,강원도,강릉시,90-94세,1341,274,1067
202007,42150,강원도,강릉시,95-99세,316,63,253
202008,42150,강원도,강릉시,95-99세,318,64,254
202009,42150,강원도,강릉시,95-99세,325,63,262
202010,42150,강원도,강릉시,95-99세,325,62,263
202011,42150,강원도,강릉시,95-99세,332,63,269
202012,42150,강원도,강릉시,95-99세,336,60,276
202101,42150,강원도,강릉시,95-99세,340,59,281
202102,42150,강원도,강릉시,95-99세,342,55,287
202103,42150,강원도,강릉시,95-99세,343,52,291
202104,42150,강원도,강릉시,95-99세,339,49,290
202105,42150,강원도,강릉시,95-99세,340,51,289
202106,42150,강원도,강릉시,95-99세,338,52,286
202007,42150,강원도,강릉시,100+,106,27,79
202008,42150,강원도,강릉시,100+,106,27,79
202009,42150,강원도,강릉시,100+,106,27,79
202010,42150,강원도,강릉시,100+,108,27,81
202011,42150,강원도,강릉시,100+,109,28,81
202012,42150,강원도,강릉시,100+,109,29,80
202101,42150,강원도,강릉시,100+,110,30,80
202102,42150,강원도,강릉시,100+,109,31,78
202103,42150,강원도,강릉시,100+,87,22,65
202104,42150,강원도,강릉시,100+,77,20,57
202105,42150,강원도,강릉시,100+,60,12,48
202106,42150,강원도,강릉시,100+,58,12,46
202007,42170,강원도,동해시,0-4세,2757,1389,1368
202008,42170,강원도,동해시,0-4세,2754,1381,1373
202009,42170,강원도,동해시,0-4세,2749,1389,1360
202010,42170,강원도,동해시,0-4세,2724,1382,1342
202011,42170,강원도,동해시,0-4세,2685,1364,1321
202012,42170,강원도,동해시,0-4세,2660,1345,1315
202101,42170,강원도,동해시,0-4세,2649,1327,1322
202102,42170,강원도,동해시,0-4세,2622,1320,1302
202103,42170,강원도,동해시,0-4세,2590,1307,1283
202104,42170,강원도,동해시,0-4세,2567,1305,1262
202105,42170,강원도,동해시,0-4세,2554,1297,1257
202106,42170,강원도,동해시,0-4세,2521,1286,1235
202007,42170,강원도,동해시,5-9세,4001,2099,1902
202008,42170,강원도,동해시,5-9세,4004,2102,1902
202009,42170,강원도,동해시,5-9세,3996,2085,1911
202010,42170,강원도,동해시,5-9세,4003,2092,1911
202011,42170,강원도,동해시,5-9세,4008,2092,1916
202012,42170,강원도,동해시,5-9세,3965,2069,1896
202101,42170,강원도,동해시,5-9세,3927,2058,1869
202102,42170,강원도,동해시,5-9세,3921,2043,1878
202103,42170,강원도,동해시,5-9세,3921,2040,1881
202104,42170,강원도,동해시,5-9세,3927,2032,1895
202105,42170,강원도,동해시,5-9세,3915,2019,1896
202106,42170,강원도,동해시,5-9세,3921,2025,1896
202007,42170,강원도,동해시,10-14세,4182,2166,2016
202008,42170,강원도,동해시,10-14세,4183,2162,2021
202009,42170,강원도,동해시,10-14세,4174,2162,2012
202010,42170,강원도,동해시,10-14세,4167,2160,2007
202011,42170,강원도,동해시,10-14세,4172,2163,2009
202012,42170,강원도,동해시,10-14세,4185,2165,2020
202101,42170,강원도,동해시,10-14세,4166,2159,2007
202102,42170,강원도,동해시,10-14세,4147,2155,1992
202103,42170,강원도,동해시,10-14세,4130,2145,1985
202104,42170,강원도,동해시,10-14세,4124,2146,1978
202105,42170,강원도,동해시,10-14세,4143,2157,1986
202106,42170,강원도,동해시,10-14세,4165,2164,2001
202007,42170,강원도,동해시,15-19세,4682,2468,2214
202008,42170,강원도,동해시,15-19세,4656,2445,2211
202009,42170,강원도,동해시,15-19세,4644,2433,2211
202010,42170,강원도,동해시,15-19세,4649,2430,2219
202011,42170,강원도,동해시,15-19세,4617,2411,2206
202012,42170,강원도,동해시,15-19세,4632,2424,2208
202101,42170,강원도,동해시,15-19세,4594,2409,2185
202102,42170,강원도,동해시,15-19세,4591,2406,2185
202103,42170,강원도,동해시,15-19세,4550,2379,2171
202104,42170,강원도,동해시,15-19세,4513,2363,2150
202105,42170,강원도,동해시,15-19세,4479,2337,2142
202106,42170,강원도,동해시,15-19세,4448,2319,2129
202007,42170,강원도,동해시,20-24세,5154,3034,2120
202008,42170,강원도,동해시,20-24세,5158,3046,2112
202009,42170,강원도,동해시,20-24세,5159,3047,2112
202010,42170,강원도,동해시,20-24세,5153,3043,2110
202011,42170,강원도,동해시,20-24세,5138,3032,2106
202012,42170,강원도,동해시,20-24세,5136,3042,2094
202101,42170,강원도,동해시,20-24세,5133,3023,2110
202102,42170,강원도,동해시,20-24세,5088,2993,2095
202103,42170,강원도,동해시,20-24세,4997,2930,2067
202104,42170,강원도,동해시,20-24세,4992,2912,2080
202105,42170,강원도,동해시,20-24세,5015,2924,2091
202106,42170,강원도,동해시,20-24세,4985,2917,2068
202007,42170,강원도,동해시,25-29세,4172,2432,1740
202008,42170,강원도,동해시,25-29세,4195,2447,1748
202009,42170,강원도,동해시,25-29세,4201,2438,1763
202010,42170,강원도,동해시,25-29세,4226,2468,1758
202011,42170,강원도,동해시,25-29세,4241,2476,1765
202012,42170,강원도,동해시,25-29세,4283,2518,1765
202101,42170,강원도,동해시,25-29세,4274,2531,1743
202102,42170,강원도,동해시,25-29세,4274,2537,1737
202103,42170,강원도,동해시,25-29세,4268,2536,1732
202104,42170,강원도,동해시,25-29세,4292,2558,1734
202105,42170,강원도,동해시,25-29세,4309,2570,1739
202106,42170,강원도,동해시,25-29세,4339,2589,1750
202007,42170,강원도,동해시,30-34세,3807,2084,1723
202008,42170,강원도,동해시,30-34세,3786,2074,1712
202009,42170,강원도,동해시,30-34세,3790,2091,1699
202010,42170,강원도,동해시,30-34세,3780,2079,1701
202011,42170,강원도,동해시,30-34세,3748,2075,1673
202012,42170,강원도,동해시,30-34세,3731,2079,1652
202101,42170,강원도,동해시,30-34세,3721,2070,1651
202102,42170,강원도,동해시,30-34세,3684,2040,1644
202103,42170,강원도,동해시,30-34세,3668,2024,1644
202104,42170,강원도,동해시,30-34세,3669,2012,1657
202105,42170,강원도,동해시,30-34세,3683,2015,1668
202106,42170,강원도,동해시,30-34세,3694,2013,1681
202007,42170,강원도,동해시,35-39세,5620,2883,2737
202008,42170,강원도,동해시,35-39세,5591,2894,2697
202009,42170,강원도,동해시,35-39세,5560,2890,2670
202010,42170,강원도,동해시,35-39세,5525,2883,2642
202011,42170,강원도,동해시,35-39세,5511,2872,2639
202012,42170,강원도,동해시,35-39세,5502,2862,2640
202101,42170,강원도,동해시,35-39세,5422,2826,2596
202102,42170,강원도,동해시,35-39세,5380,2805,2575
202103,42170,강원도,동해시,35-39세,5327,2783,2544
202104,42170,강원도,동해시,35-39세,5247,2751,2496
202105,42170,강원도,동해시,35-39세,5215,2748,2467
202106,42170,강원도,동해시,35-39세,5181,2742,2439
202007,42170,강원도,동해시,40-44세,6584,3343,3241
202008,42170,강원도,동해시,40-44세,6599,3340,3259
202009,42170,강원도,동해시,40-44세,6628,3351,3277
202010,42170,강원도,동해시,40-44세,6610,3326,3284
202011,42170,강원도,동해시,40-44세,6611,3325,3286
202012,42170,강원도,동해시,40-44세,6582,3315,3267
202101,42170,강원도,동해시,40-44세,6558,3304,3254
202102,42170,강원도,동해시,40-44세,6549,3317,3232
202103,42170,강원도,동해시,40-44세,6498,3297,3201
202104,42170,강원도,동해시,40-44세,6515,3296,3219
202105,42170,강원도,동해시,40-44세,6535,3302,3233
202106,42170,강원도,동해시,40-44세,6566,3309,3257
202007,42170,강원도,동해시,45-49세,8128,4333,3795
202008,42170,강원도,동해시,45-49세,8101,4316,3785
202009,42170,강원도,동해시,45-49세,8071,4296,3775
202010,42170,강원도,동해시,45-49세,8043,4275,3768
202011,42170,강원도,동해시,45-49세,7999,4256,3743
202012,42170,강원도,동해시,45-49세,7987,4265,3722
202101,42170,강원도,동해시,45-49세,7932,4231,3701
202102,42170,강원도,동해시,45-49세,7919,4218,3701
202103,42170,강원도,동해시,45-49세,7897,4211,3686
202104,42170,강원도,동해시,45-49세,7881,4198,3683
202105,42170,강원도,동해시,45-49세,7830,4175,3655
202106,42170,강원도,동해시,45-49세,7794,4160,3634
202007,42170,강원도,동해시,50-54세,7951,4140,3811
202008,42170,강원도,동해시,50-54세,7974,4157,3817
202009,42170,강원도,동해시,50-54세,8001,4169,3832
202010,42170,강원도,동해시,50-54세,8052,4201,3851
202011,42170,강원도,동해시,50-54세,8111,4229,3882
202012,42170,강원도,동해시,50-54세,8107,4212,3895
202101,42170,강원도,동해시,50-54세,8152,4248,3904
202102,42170,강원도,동해시,50-54세,8177,4265,3912
202103,42170,강원도,동해시,50-54세,8121,4231,3890
202104,42170,강원도,동해시,50-54세,8119,4224,3895
202105,42170,강원도,동해시,50-54세,8165,4258,3907
202106,42170,강원도,동해시,50-54세,8190,4285,3905
202007,42170,강원도,동해시,55-59세,7666,3924,3742
202008,42170,강원도,동해시,55-59세,7650,3921,3729
202009,42170,강원도,동해시,55-59세,7611,3898,3713
202010,42170,강원도,동해시,55-59세,7589,3888,3701
202011,42170,강원도,동해시,55-59세,7537,3859,3678
202012,42170,강원도,동해시,55-59세,7531,3861,3670
202101,42170,강원도,동해시,55-59세,7479,3847,3632
202102,42170,강원도,동해시,55-59세,7422,3803,3619
202103,42170,강원도,동해시,55-59세,7417,3809,3608
202104,42170,강원도,동해시,55-59세,7454,3849,3605
202105,42170,강원도,동해시,55-59세,7424,3829,3595
202106,42170,강원도,동해시,55-59세,7393,3813,3580
202007,42170,강원도,동해시,60-64세,7828,3770,4058
202008,42170,강원도,동해시,60-64세,7861,3789,4072
202009,42170,강원도,동해시,60-64세,7886,3807,4079
202010,42170,강원도,동해시,60-64세,7911,3836,4075
202011,42170,강원도,동해시,60-64세,7957,3862,4095
202012,42170,강원도,동해시,60-64세,7999,3884,4115
202101,42170,강원도,동해시,60-64세,8041,3888,4153
202102,42170,강원도,동해시,60-64세,8106,3930,4176
202103,42170,강원도,동해시,60-64세,8104,3929,4175
202104,42170,강원도,동해시,60-64세,8084,3915,4169
202105,42170,강원도,동해시,60-64세,8135,3940,4195
202106,42170,강원도,동해시,60-64세,8181,3963,4218
202007,42170,강원도,동해시,65-69세,5677,2729,2948
202008,42170,강원도,동해시,65-69세,5743,2753,2990
202009,42170,강원도,동해시,65-69세,5784,2777,3007
202010,42170,강원도,동해시,65-69세,5848,2807,3041
202011,42170,강원도,동해시,65-69세,5874,2825,3049
202012,42170,강원도,동해시,65-69세,5906,2835,3071
202101,42170,강원도,동해시,65-69세,5934,2851,3083
202102,42170,강원도,동해시,65-69세,5980,2877,3103
202103,42170,강원도,동해시,65-69세,6042,2915,3127
202104,42170,강원도,동해시,65-69세,6098,2941,3157
202105,42170,강원도,동해시,65-69세,6154,2972,3182
202106,42170,강원도,동해시,65-69세,6181,2986,3195
202007,42170,강원도,동해시,70-74세,4165,1957,2208
202008,42170,강원도,동해시,70-74세,4170,1960,2210
202009,42170,강원도,동해시,70-74세,4194,1974,2220
202010,42170,강원도,동해시,70-74세,4205,1975,2230
202011,42170,강원도,동해시,70-74세,4222,1985,2237
202012,42170,강원도,동해시,70-74세,4271,2010,2261
202101,42170,강원도,동해시,70-74세,4291,2018,2273
202102,42170,강원도,동해시,70-74세,4291,2019,2272
202103,42170,강원도,동해시,70-74세,4237,2014,2223
202104,42170,강원도,동해시,70-74세,4233,2022,2211
202105,42170,강원도,동해시,70-74세,4248,2020,2228
202106,42170,강원도,동해시,70-74세,4245,2009,2236
202007,42170,강원도,동해시,75-79세,3900,1676,2224
202008,42170,강원도,동해시,75-79세,3899,1678,2221
202009,42170,강원도,동해시,75-79세,3889,1675,2214
202010,42170,강원도,동해시,75-79세,3880,1676,2204
202011,42170,강원도,동해시,75-79세,3844,1658,2186
202012,42170,강원도,동해시,75-79세,3811,1644,2167
202101,42170,강원도,동해시,75-79세,3806,1645,2161
202102,42170,강원도,동해시,75-79세,3785,1634,2151
202103,42170,강원도,동해시,75-79세,3789,1624,2165
202104,42170,강원도,동해시,75-79세,3756,1605,2151
202105,42170,강원도,동해시,75-79세,3727,1595,2132
202106,42170,강원도,동해시,75-79세,3714,1586,2128
202007,42170,강원도,동해시,80-84세,2457,960,1497
202008,42170,강원도,동해시,80-84세,2455,958,1497
202009,42170,강원도,동해시,80-84세,2466,959,1507
202010,42170,강원도,동해시,80-84세,2476,957,1519
202011,42170,강원도,동해시,80-84세,2502,975,1527
202012,42170,강원도,동해시,80-84세,2510,982,1528
202101,42170,강원도,동해시,80-84세,2539,996,1543
202102,42170,강원도,동해시,80-84세,2548,1002,1546
202103,42170,강원도,동해시,80-84세,2553,1002,1551
202104,42170,강원도,동해시,80-84세,2560,999,1561
202105,42170,강원도,동해시,80-84세,2590,1015,1575
202106,42170,강원도,동해시,80-84세,2620,1038,1582
202007,42170,강원도,동해시,85-89세,1213,346,867
202008,42170,강원도,동해시,85-89세,1227,350,877
202009,42170,강원도,동해시,85-89세,1217,346,871
202010,42170,강원도,동해시,85-89세,1226,349,877
202011,42170,강원도,동해시,85-89세,1220,349,871
202012,42170,강원도,동해시,85-89세,1240,359,881
202101,42170,강원도,동해시,85-89세,1232,363,869
202102,42170,강원도,동해시,85-89세,1269,374,895
202103,42170,강원도,동해시,85-89세,1283,379,904
202104,42170,강원도,동해시,85-89세,1303,394,909
202105,42170,강원도,동해시,85-89세,1307,395,912
202106,42170,강원도,동해시,85-89세,1310,396,914
202007,42170,강원도,동해시,90-94세,390,82,308
202008,42170,강원도,동해시,90-94세,397,83,314
202009,42170,강원도,동해시,90-94세,408,87,321
202010,42170,강원도,동해시,90-94세,408,87,321
202011,42170,강원도,동해시,90-94세,410,88,322
202012,42170,강원도,동해시,90-94세,406,87,319
202101,42170,강원도,동해시,90-94세,415,86,329
202102,42170,강원도,동해시,90-94세,415,84,331
202103,42170,강원도,동해시,90-94세,408,86,322
202104,42170,강원도,동해시,90-94세,413,85,328
202105,42170,강원도,동해시,90-94세,420,86,334
202106,42170,강원도,동해시,90-94세,430,89,341
202007,42170,강원도,동해시,95-99세,117,23,94
202008,42170,강원도,동해시,95-99세,115,22,93
202009,42170,강원도,동해시,95-99세,117,23,94
202010,42170,강원도,동해시,95-99세,121,24,97
202011,42170,강원도,동해시,95-99세,123,25,98
202012,42170,강원도,동해시,95-99세,118,24,94
202101,42170,강원도,동해시,95-99세,117,24,93
202102,42170,강원도,동해시,95-99세,118,23,95
202103,42170,강원도,동해시,95-99세,110,16,94
202104,42170,강원도,동해시,95-99세,110,13,97
202105,42170,강원도,동해시,95-99세,108,11,97
202106,42170,강원도,동해시,95-99세,109,11,98
202007,42170,강원도,동해시,100+,30,9,21
202008,42170,강원도,동해시,100+,30,9,21
202009,42170,강원도,동해시,100+,30,9,21
202010,42170,강원도,동해시,100+,30,9,21
202011,42170,강원도,동해시,100+,30,9,21
202012,42170,강원도,동해시,100+,31,9,22
202101,42170,강원도,동해시,100+,34,10,24
202102,42170,강원도,동해시,100+,34,10,24
202103,42170,강원도,동해시,100+,12,3,9
202104,42170,강원도,동해시,100+,11,2,9
202105,42170,강원도,동해시,100+,12,2,10
202106,42170,강원도,동해시,100+,12,2,10
202007,42190,강원도,태백시,0-4세,1049,559,490
202008,42190,강원도,태백시,0-4세,1025,545,480
202009,42190,강원도,태백시,0-4세,1014,545,469
202010,42190,강원도,태백시,0-4세,1005,536,469
202011,42190,강원도,태백시,0-4세,990,529,461
202012,42190,강원도,태백시,0-4세,980,519,461
202101,42190,강원도,태백시,0-4세,966,515,451
202102,42190,강원도,태백시,0-4세,945,502,443
202103,42190,강원도,태백시,0-4세,941,500,441
202104,42190,강원도,태백시,0-4세,927,499,428
202105,42190,강원도,태백시,0-4세,918,497,421
202106,42190,강원도,태백시,0-4세,905,497,408
202007,42190,강원도,태백시,5-9세,1653,840,813
202008,42190,강원도,태백시,5-9세,1649,842,807
202009,42190,강원도,태백시,5-9세,1636,829,807
202010,42190,강원도,태백시,5-9세,1625,823,802
202011,42190,강원도,태백시,5-9세,1605,813,792
202012,42190,강원도,태백시,5-9세,1594,819,775
202101,42190,강원도,태백시,5-9세,1571,807,764
202102,42190,강원도,태백시,5-9세,1559,810,749
202103,42190,강원도,태백시,5-9세,1554,808,746
202104,42190,강원도,태백시,5-9세,1540,806,734
202105,42190,강원도,태백시,5-9세,1524,794,730
202106,42190,강원도,태백시,5-9세,1507,780,727
202007,42190,강원도,태백시,10-14세,1814,918,896
202008,42190,강원도,태백시,10-14세,1804,910,894
202009,42190,강원도,태백시,10-14세,1803,913,890
202010,42190,강원도,태백시,10-14세,1816,923,893
202011,42190,강원도,태백시,10-14세,1821,929,892
202012,42190,강원도,태백시,10-14세,1836,930,906
202101,42190,강원도,태백시,10-14세,1837,931,906
202102,42190,강원도,태백시,10-14세,1820,917,903
202103,42190,강원도,태백시,10-14세,1816,913,903
202104,42190,강원도,태백시,10-14세,1813,907,906
202105,42190,강원도,태백시,10-14세,1823,913,910
202106,42190,강원도,태백시,10-14세,1833,922,911
202007,42190,강원도,태백시,15-19세,2071,1100,971
202008,42190,강원도,태백시,15-19세,2060,1101,959
202009,42190,강원도,태백시,15-19세,2077,1117,960
202010,42190,강원도,태백시,15-19세,2053,1103,950
202011,42190,강원도,태백시,15-19세,2035,1092,943
202012,42190,강원도,태백시,15-19세,1995,1064,931
202101,42190,강원도,태백시,15-19세,1969,1045,924
202102,42190,강원도,태백시,15-19세,1933,1019,914
202103,42190,강원도,태백시,15-19세,1948,1046,902
202104,42190,강원도,태백시,15-19세,1941,1039,902
202105,42190,강원도,태백시,15-19세,1923,1030,893
202106,42190,강원도,태백시,15-19세,1903,1023,880
202007,42190,강원도,태백시,20-24세,2177,1261,916
202008,42190,강원도,태백시,20-24세,2167,1255,912
202009,42190,강원도,태백시,20-24세,2164,1248,916
202010,42190,강원도,태백시,20-24세,2158,1243,915
202011,42190,강원도,태백시,20-24세,2145,1238,907
202012,42190,강원도,태백시,20-24세,2131,1237,894
202101,42190,강원도,태백시,20-24세,2110,1223,887
202102,42190,강원도,태백시,20-24세,2095,1224,871
202103,42190,강원도,태백시,20-24세,2062,1205,857
202104,42190,강원도,태백시,20-24세,2039,1193,846
202105,42190,강원도,태백시,20-24세,2014,1188,826
202106,42190,강원도,태백시,20-24세,2009,1187,822
202007,42190,강원도,태백시,25-29세,1514,857,657
202008,42190,강원도,태백시,25-29세,1510,856,654
202009,42190,강원도,태백시,25-29세,1501,855,646
202010,42190,강원도,태백시,25-29세,1530,865,665
202011,42190,강원도,태백시,25-29세,1541,875,666
202012,42190,강원도,태백시,25-29세,1548,877,671
202101,42190,강원도,태백시,25-29세,1543,870,673
202102,42190,강원도,태백시,25-29세,1547,866,681
202103,42190,강원도,태백시,25-29세,1559,880,679
202104,42190,강원도,태백시,25-29세,1557,879,678
202105,42190,강원도,태백시,25-29세,1559,889,670
202106,42190,강원도,태백시,25-29세,1552,879,673
202007,42190,강원도,태백시,30-34세,1545,836,709
202008,42190,강원도,태백시,30-34세,1539,835,704
202009,42190,강원도,태백시,30-34세,1536,838,698
202010,42190,강원도,태백시,30-34세,1521,829,692
202011,42190,강원도,태백시,30-34세,1501,817,684
202012,42190,강원도,태백시,30-34세,1491,811,680
202101,42190,강원도,태백시,30-34세,1485,805,680
202102,42190,강원도,태백시,30-34세,1444,791,653
202103,42190,강원도,태백시,30-34세,1431,779,652
202104,42190,강원도,태백시,30-34세,1430,771,659
202105,42190,강원도,태백시,30-34세,1424,762,662
202106,42190,강원도,태백시,30-34세,1422,767,655
202007,42190,강원도,태백시,35-39세,2387,1220,1167
202008,42190,강원도,태백시,35-39세,2356,1203,1153
202009,42190,강원도,태백시,35-39세,2328,1190,1138
202010,42190,강원도,태백시,35-39세,2316,1189,1127
202011,42190,강원도,태백시,35-39세,2295,1179,1116
202012,42190,강원도,태백시,35-39세,2288,1177,1111
202101,42190,강원도,태백시,35-39세,2258,1166,1092
202102,42190,강원도,태백시,35-39세,2215,1153,1062
202103,42190,강원도,태백시,35-39세,2198,1144,1054
202104,42190,강원도,태백시,35-39세,2178,1146,1032
202105,42190,강원도,태백시,35-39세,2128,1118,1010
202106,42190,강원도,태백시,35-39세,2095,1098,997
202007,42190,강원도,태백시,40-44세,3059,1593,1466
202008,42190,강원도,태백시,40-44세,3050,1584,1466
202009,42190,강원도,태백시,40-44세,3044,1579,1465
202010,42190,강원도,태백시,40-44세,3050,1585,1465
202011,42190,강원도,태백시,40-44세,3047,1585,1462
202012,42190,강원도,태백시,40-44세,3009,1555,1454
202101,42190,강원도,태백시,40-44세,2966,1531,1435
202102,42190,강원도,태백시,40-44세,2944,1512,1432
202103,42190,강원도,태백시,40-44세,2919,1497,1422
202104,42190,강원도,태백시,40-44세,2912,1483,1429
202105,42190,강원도,태백시,40-44세,2879,1469,1410
202106,42190,강원도,태백시,40-44세,2871,1469,1402
202007,42190,강원도,태백시,45-49세,3475,1883,1592
202008,42190,강원도,태백시,45-49세,3456,1874,1582
202009,42190,강원도,태백시,45-49세,3454,1880,1574
202010,42190,강원도,태백시,45-49세,3418,1860,1558
202011,42190,강원도,태백시,45-49세,3413,1862,1551
202012,42190,강원도,태백시,45-49세,3425,1877,1548
202101,42190,강원도,태백시,45-49세,3425,1877,1548
202102,42190,강원도,태백시,45-49세,3421,1874,1547
202103,42190,강원도,태백시,45-49세,3406,1861,1545
202104,42190,강원도,태백시,45-49세,3403,1863,1540
202105,42190,강원도,태백시,45-49세,3336,1836,1500
202106,42190,강원도,태백시,45-49세,3293,1811,1482
202007,42190,강원도,태백시,50-54세,3765,2069,1696
202008,42190,강원도,태백시,50-54세,3747,2067,1680
202009,42190,강원도,태백시,50-54세,3732,2054,1678
202010,42190,강원도,태백시,50-54세,3737,2056,1681
202011,42190,강원도,태백시,50-54세,3728,2053,1675
202012,42190,강원도,태백시,50-54세,3708,2045,1663
202101,42190,강원도,태백시,50-54세,3713,2046,1667
202102,42190,강원도,태백시,50-54세,3690,2033,1657
202103,42190,강원도,태백시,50-54세,3638,1991,1647
202104,42190,강원도,태백시,50-54세,3635,1987,1648
202105,42190,강원도,태백시,50-54세,3616,1986,1630
202106,42190,강원도,태백시,50-54세,3601,1976,1625
202007,42190,강원도,태백시,55-59세,3726,1942,1784
202008,42190,강원도,태백시,55-59세,3712,1932,1780
202009,42190,강원도,태백시,55-59세,3702,1922,1780
202010,42190,강원도,태백시,55-59세,3687,1909,1778
202011,42190,강원도,태백시,55-59세,3674,1897,1777
202012,42190,강원도,태백시,55-59세,3668,1895,1773
202101,42190,강원도,태백시,55-59세,3632,1870,1762
202102,42190,강원도,태백시,55-59세,3609,1860,1749
202103,42190,강원도,태백시,55-59세,3608,1889,1719
202104,42190,강원도,태백시,55-59세,3572,1876,1696
202105,42190,강원도,태백시,55-59세,3518,1851,1667
202106,42190,강원도,태백시,55-59세,3484,1836,1648
202007,42190,강원도,태백시,60-64세,4249,2145,2104
202008,42190,강원도,태백시,60-64세,4253,2151,2102
202009,42190,강원도,태백시,60-64세,4246,2156,2090
202010,42190,강원도,태백시,60-64세,4267,2173,2094
202011,42190,강원도,태백시,60-64세,4273,2180,2093
202012,42190,강원도,태백시,60-64세,4286,2176,2110
202101,42190,강원도,태백시,60-64세,4292,2184,2108
202102,42190,강원도,태백시,60-64세,4314,2190,2124
202103,42190,강원도,태백시,60-64세,4298,2178,2120
202104,42190,강원도,태백시,60-64세,4337,2194,2143
202105,42190,강원도,태백시,60-64세,4291,2170,2121
202106,42190,강원도,태백시,60-64세,4283,2160,2123
202007,42190,강원도,태백시,65-69세,3353,1580,1773
202008,42190,강원도,태백시,65-69세,3369,1591,1778
202009,42190,강원도,태백시,65-69세,3390,1605,1785
202010,42190,강원도,태백시,65-69세,3398,1610,1788
202011,42190,강원도,태백시,65-69세,3401,1611,1790
202012,42190,강원도,태백시,65-69세,3396,1610,1786
202101,42190,강원도,태백시,65-69세,3425,1624,1801
202102,42190,강원도,태백시,65-69세,3442,1640,1802
202103,42190,강원도,태백시,65-69세,3503,1668,1835
202104,42190,강원도,태백시,65-69세,3509,1671,1838
202105,42190,강원도,태백시,65-69세,3463,1656,1807
202106,42190,강원도,태백시,65-69세,3441,1650,1791
202007,42190,강원도,태백시,70-74세,2601,1165,1436
202008,42190,강원도,태백시,70-74세,2613,1172,1441
202009,42190,강원도,태백시,70-74세,2629,1167,1462
202010,42190,강원도,태백시,70-74세,2650,1177,1473
202011,42190,강원도,태백시,70-74세,2661,1184,1477
202012,42190,강원도,태백시,70-74세,2689,1200,1489
202101,42190,강원도,태백시,70-74세,2697,1203,1494
202102,42190,강원도,태백시,70-74세,2689,1201,1488
202103,42190,강원도,태백시,70-74세,2678,1193,1485
202104,42190,강원도,태백시,70-74세,2691,1203,1488
202105,42190,강원도,태백시,70-74세,2663,1188,1475
202106,42190,강원도,태백시,70-74세,2638,1167,1471
202007,42190,강원도,태백시,75-79세,2284,1022,1262
202008,42190,강원도,태백시,75-79세,2295,1022,1273
202009,42190,강원도,태백시,75-79세,2287,1022,1265
202010,42190,강원도,태백시,75-79세,2252,1010,1242
202011,42190,강원도,태백시,75-79세,2246,1011,1235
202012,42190,강원도,태백시,75-79세,2235,1009,1226
202101,42190,강원도,태백시,75-79세,2231,1008,1223
202102,42190,강원도,태백시,75-79세,2230,998,1232
202103,42190,강원도,태백시,75-79세,2208,981,1227
202104,42190,강원도,태백시,75-79세,2196,972,1224
202105,42190,강원도,태백시,75-79세,2172,953,1219
202106,42190,강원도,태백시,75-79세,2160,950,1210
202007,42190,강원도,태백시,80-84세,1465,556,909
202008,42190,강원도,태백시,80-84세,1448,543,905
202009,42190,강원도,태백시,80-84세,1471,555,916
202010,42190,강원도,태백시,80-84세,1485,560,925
202011,42190,강원도,태백시,80-84세,1491,565,926
202012,42190,강원도,태백시,80-84세,1502,570,932
202101,42190,강원도,태백시,80-84세,1518,579,939
202102,42190,강원도,태백시,80-84세,1523,586,937
202103,42190,강원도,태백시,80-84세,1550,600,950
202104,42190,강원도,태백시,80-84세,1558,611,947
202105,42190,강원도,태백시,80-84세,1549,602,947
202106,42190,강원도,태백시,80-84세,1530,590,940
202007,42190,강원도,태백시,85-89세,585,175,410
202008,42190,강원도,태백시,85-89세,598,183,415
202009,42190,강원도,태백시,85-89세,590,180,410
202010,42190,강원도,태백시,85-89세,593,175,418
202011,42190,강원도,태백시,85-89세,589,174,415
202012,42190,강원도,태백시,85-89세,591,178,413
202101,42190,강원도,태백시,85-89세,600,182,418
202102,42190,강원도,태백시,85-89세,611,188,423
202103,42190,강원도,태백시,85-89세,618,190,428
202104,42190,강원도,태백시,85-89세,633,195,438
202105,42190,강원도,태백시,85-89세,620,188,432
202106,42190,강원도,태백시,85-89세,614,182,432
202007,42190,강원도,태백시,90-94세,202,45,157
202008,42190,강원도,태백시,90-94세,202,44,158
202009,42190,강원도,태백시,90-94세,205,46,159
202010,42190,강원도,태백시,90-94세,213,51,162
202011,42190,강원도,태백시,90-94세,216,51,165
202012,42190,강원도,태백시,90-94세,220,51,169
202101,42190,강원도,태백시,90-94세,219,50,169
202102,42190,강원도,태백시,90-94세,218,50,168
202103,42190,강원도,태백시,90-94세,221,50,171
202104,42190,강원도,태백시,90-94세,218,50,168
202105,42190,강원도,태백시,90-94세,211,47,164
202106,42190,강원도,태백시,90-94세,201,45,156
202007,42190,강원도,태백시,95-99세,62,12,50
202008,42190,강원도,태백시,95-99세,65,13,52
202009,42190,강원도,태백시,95-99세,65,14,51
202010,42190,강원도,태백시,95-99세,63,14,49
202011,42190,강원도,태백시,95-99세,64,14,50
202012,42190,강원도,태백시,95-99세,62,13,49
202101,42190,강원도,태백시,95-99세,63,14,49
202102,42190,강원도,태백시,95-99세,67,15,52
202103,42190,강원도,태백시,95-99세,70,16,54
202104,42190,강원도,태백시,95-99세,70,15,55
202105,42190,강원도,태백시,95-99세,64,13,51
202106,42190,강원도,태백시,95-99세,55,8,47
202007,42190,강원도,태백시,100+,62,26,36
202008,42190,강원도,태백시,100+,62,26,36
202009,42190,강원도,태백시,100+,63,26,37
202010,42190,강원도,태백시,100+,64,26,38
202011,42190,강원도,태백시,100+,64,26,38
202012,42190,강원도,태백시,100+,65,27,38
202101,42190,강원도,태백시,100+,66,27,39
202102,42190,강원도,태백시,100+,65,27,38
202103,42190,강원도,태백시,100+,23,9,14
202104,42190,강원도,태백시,100+,24,10,14
202105,42190,강원도,태백시,100+,23,10,13
202106,42190,강원도,태백시,100+,22,9,13
202007,42210,강원도,속초시,0-4세,2523,1307,1216
202008,42210,강원도,속초시,0-4세,2516,1306,1210
202009,42210,강원도,속초시,0-4세,2502,1307,1195
202010,42210,강원도,속초시,0-4세,2489,1303,1186
202011,42210,강원도,속초시,0-4세,2493,1304,1189
202012,42210,강원도,속초시,0-4세,2448,1280,1168
202101,42210,강원도,속초시,0-4세,2421,1267,1154
202102,42210,강원도,속초시,0-4세,2388,1250,1138
202103,42210,강원도,속초시,0-4세,2380,1249,1131
202104,42210,강원도,속초시,0-4세,2386,1248,1138
202105,42210,강원도,속초시,0-4세,2359,1229,1130
202106,42210,강원도,속초시,0-4세,2342,1230,1112
202007,42210,강원도,속초시,5-9세,3382,1678,1704
202008,42210,강원도,속초시,5-9세,3387,1670,1717
202009,42210,강원도,속초시,5-9세,3383,1666,1717
202010,42210,강원도,속초시,5-9세,3393,1675,1718
202011,42210,강원도,속초시,5-9세,3407,1691,1716
202012,42210,강원도,속초시,5-9세,3411,1701,1710
202101,42210,강원도,속초시,5-9세,3399,1696,1703
202102,42210,강원도,속초시,5-9세,3396,1690,1706
202103,42210,강원도,속초시,5-9세,3401,1694,1707
202104,42210,강원도,속초시,5-9세,3396,1690,1706
202105,42210,강원도,속초시,5-9세,3400,1702,1698
202106,42210,강원도,속초시,5-9세,3411,1706,1705
202007,42210,강원도,속초시,10-14세,3422,1742,1680
202008,42210,강원도,속초시,10-14세,3435,1753,1682
202009,42210,강원도,속초시,10-14세,3460,1765,1695
202010,42210,강원도,속초시,10-14세,3459,1770,1689
202011,42210,강원도,속초시,10-14세,3475,1772,1703
202012,42210,강원도,속초시,10-14세,3477,1776,1701
202101,42210,강원도,속초시,10-14세,3514,1812,1702
202102,42210,강원도,속초시,10-14세,3489,1798,1691
202103,42210,강원도,속초시,10-14세,3481,1786,1695
202104,42210,강원도,속초시,10-14세,3500,1794,1706
202105,42210,강원도,속초시,10-14세,3495,1795,1700
202106,42210,강원도,속초시,10-14세,3491,1795,1696
202007,42210,강원도,속초시,15-19세,4140,2165,1975
202008,42210,강원도,속초시,15-19세,4099,2142,1957
202009,42210,강원도,속초시,15-19세,4069,2130,1939
202010,42210,강원도,속초시,15-19세,4052,2115,1937
202011,42210,강원도,속초시,15-19세,4012,2096,1916
202012,42210,강원도,속초시,15-19세,4001,2087,1914
202101,42210,강원도,속초시,15-19세,3946,2047,1899
202102,42210,강원도,속초시,15-19세,3912,2037,1875
202103,42210,강원도,속초시,15-19세,3852,2014,1838
202104,42210,강원도,속초시,15-19세,3824,1999,1825
202105,42210,강원도,속초시,15-19세,3805,1997,1808
202106,42210,강원도,속초시,15-19세,3768,1971,1797
202007,42210,강원도,속초시,20-24세,4690,2600,2090
202008,42210,강원도,속초시,20-24세,4693,2600,2093
202009,42210,강원도,속초시,20-24세,4696,2606,2090
202010,42210,강원도,속초시,20-24세,4700,2609,2091
202011,42210,강원도,속초시,20-24세,4706,2615,2091
202012,42210,강원도,속초시,20-24세,4686,2614,2072
202101,42210,강원도,속초시,20-24세,4643,2583,2060
202102,42210,강원도,속초시,20-24세,4609,2555,2054
202103,42210,강원도,속초시,20-24세,4556,2528,2028
202104,42210,강원도,속초시,20-24세,4546,2530,2016
202105,42210,강원도,속초시,20-24세,4515,2503,2012
202106,42210,강원도,속초시,20-24세,4517,2517,2000
202007,42210,강원도,속초시,25-29세,4256,2433,1823
202008,42210,강원도,속초시,25-29세,4278,2459,1819
202009,42210,강원도,속초시,25-29세,4287,2479,1808
202010,42210,강원도,속초시,25-29세,4313,2481,1832
202011,42210,강원도,속초시,25-29세,4320,2477,1843
202012,42210,강원도,속초시,25-29세,4332,2480,1852
202101,42210,강원도,속초시,25-29세,4338,2480,1858
202102,42210,강원도,속초시,25-29세,4343,2479,1864
202103,42210,강원도,속초시,25-29세,4371,2499,1872
202104,42210,강원도,속초시,25-29세,4362,2471,1891
202105,42210,강원도,속초시,25-29세,4361,2477,1884
202106,42210,강원도,속초시,25-29세,4368,2468,1900
202007,42210,강원도,속초시,30-34세,4050,2216,1834
202008,42210,강원도,속초시,30-34세,4080,2242,1838
202009,42210,강원도,속초시,30-34세,4099,2254,1845
202010,42210,강원도,속초시,30-34세,4090,2255,1835
202011,42210,강원도,속초시,30-34세,4075,2251,1824
202012,42210,강원도,속초시,30-34세,4094,2265,1829
202101,42210,강원도,속초시,30-34세,4104,2274,1830
202102,42210,강원도,속초시,30-34세,4097,2287,1810
202103,42210,강원도,속초시,30-34세,4071,2264,1807
202104,42210,강원도,속초시,30-34세,4080,2277,1803
202105,42210,강원도,속초시,30-34세,4102,2295,1807
202106,42210,강원도,속초시,30-34세,4123,2326,1797
202007,42210,강원도,속초시,35-39세,5211,2736,2475
202008,42210,강원도,속초시,35-39세,5198,2718,2480
202009,42210,강원도,속초시,35-39세,5167,2704,2463
202010,42210,강원도,속초시,35-39세,5129,2698,2431
202011,42210,강원도,속초시,35-39세,5133,2689,2444
202012,42210,강원도,속초시,35-39세,5105,2663,2442
202101,42210,강원도,속초시,35-39세,5062,2624,2438
202102,42210,강원도,속초시,35-39세,5044,2605,2439
202103,42210,강원도,속초시,35-39세,5014,2601,2413
202104,42210,강원도,속초시,35-39세,5002,2590,2412
202105,42210,강원도,속초시,35-39세,4975,2565,2410
202106,42210,강원도,속초시,35-39세,4960,2557,2403
202007,42210,강원도,속초시,40-44세,5571,2767,2804
202008,42210,강원도,속초시,40-44세,5582,2784,2798
202009,42210,강원도,속초시,40-44세,5604,2794,2810
202010,42210,강원도,속초시,40-44세,5629,2802,2827
202011,42210,강원도,속초시,40-44세,5643,2810,2833
202012,42210,강원도,속초시,40-44세,5638,2827,2811
202101,42210,강원도,속초시,40-44세,5643,2829,2814
202102,42210,강원도,속초시,40-44세,5647,2849,2798
202103,42210,강원도,속초시,40-44세,5609,2826,2783
202104,42210,강원도,속초시,40-44세,5636,2843,2793
202105,42210,강원도,속초시,40-44세,5648,2850,2798
202106,42210,강원도,속초시,40-44세,5662,2851,2811
202007,42210,강원도,속초시,45-49세,6958,3469,3489
202008,42210,강원도,속초시,45-49세,6950,3441,3509
202009,42210,강원도,속초시,45-49세,6896,3404,3492
202010,42210,강원도,속초시,45-49세,6865,3376,3489
202011,42210,강원도,속초시,45-49세,6842,3370,3472
202012,42210,강원도,속초시,45-49세,6844,3384,3460
202101,42210,강원도,속초시,45-49세,6820,3387,3433
202102,42210,강원도,속초시,45-49세,6783,3361,3422
202103,42210,강원도,속초시,45-49세,6715,3340,3375
202104,42210,강원도,속초시,45-49세,6690,3342,3348
202105,42210,강원도,속초시,45-49세,6621,3316,3305
202106,42210,강원도,속초시,45-49세,6591,3302,3289
202007,42210,강원도,속초시,50-54세,7557,3765,3792
202008,42210,강원도,속초시,50-54세,7567,3787,3780
202009,42210,강원도,속초시,50-54세,7606,3801,3805
202010,42210,강원도,속초시,50-54세,7631,3827,3804
202011,42210,강원도,속초시,50-54세,7641,3816,3825
202012,42210,강원도,속초시,50-54세,7632,3793,3839
202101,42210,강원도,속초시,50-54세,7661,3788,3873
202102,42210,강원도,속초시,50-54세,7662,3781,3881
202103,42210,강원도,속초시,50-54세,7627,3769,3858
202104,42210,강원도,속초시,50-54세,7648,3768,3880
202105,42210,강원도,속초시,50-54세,7683,3783,3900
202106,42210,강원도,속초시,50-54세,7672,3773,3899
202007,42210,강원도,속초시,55-59세,7599,3703,3896
202008,42210,강원도,속초시,55-59세,7571,3679,3892
202009,42210,강원도,속초시,55-59세,7585,3697,3888
202010,42210,강원도,속초시,55-59세,7574,3691,3883
202011,42210,강원도,속초시,55-59세,7556,3696,3860
202012,42210,강원도,속초시,55-59세,7544,3699,3845
202101,42210,강원도,속초시,55-59세,7473,3667,3806
202102,42210,강원도,속초시,55-59세,7429,3669,3760
202103,42210,강원도,속초시,55-59세,7384,3658,3726
202104,42210,강원도,속초시,55-59세,7358,3644,3714
202105,42210,강원도,속초시,55-59세,7313,3632,3681
202106,42210,강원도,속초시,55-59세,7254,3603,3651
202007,42210,강원도,속초시,60-64세,7353,3573,3780
202008,42210,강원도,속초시,60-64세,7392,3604,3788
202009,42210,강원도,속초시,60-64세,7427,3628,3799
202010,42210,강원도,속초시,60-64세,7481,3660,3821
202011,42210,강원도,속초시,60-64세,7535,3669,3866
202012,42210,강원도,속초시,60-64세,7579,3682,3897
202101,42210,강원도,속초시,60-64세,7689,3738,3951
202102,42210,강원도,속초시,60-64세,7732,3745,3987
202103,42210,강원도,속초시,60-64세,7750,3737,4013
202104,42210,강원도,속초시,60-64세,7811,3774,4037
202105,42210,강원도,속초시,60-64세,7838,3770,4068
202106,42210,강원도,속초시,60-64세,7910,3793,4117
202007,42210,강원도,속초시,65-69세,4968,2386,2582
202008,42210,강원도,속초시,65-69세,5048,2412,2636
202009,42210,강원도,속초시,65-69세,5102,2434,2668
202010,42210,강원도,속초시,65-69세,5131,2448,2683
202011,42210,강원도,속초시,65-69세,5172,2482,2690
202012,42210,강원도,속초시,65-69세,5219,2506,2713
202101,42210,강원도,속초시,65-69세,5247,2519,2728
202102,42210,강원도,속초시,65-69세,5277,2524,2753
202103,42210,강원도,속초시,65-69세,5345,2572,2773
202104,42210,강원도,속초시,65-69세,5379,2592,2787
202105,42210,강원도,속초시,65-69세,5433,2631,2802
202106,42210,강원도,속초시,65-69세,5481,2673,2808
202007,42210,강원도,속초시,70-74세,3594,1626,1968
202008,42210,강원도,속초시,70-74세,3587,1632,1955
202009,42210,강원도,속초시,70-74세,3597,1636,1961
202010,42210,강원도,속초시,70-74세,3616,1647,1969
202011,42210,강원도,속초시,70-74세,3628,1655,1973
202012,42210,강원도,속초시,70-74세,3653,1672,1981
202101,42210,강원도,속초시,70-74세,3678,1680,1998
202102,42210,강원도,속초시,70-74세,3694,1688,2006
202103,42210,강원도,속초시,70-74세,3673,1664,2009
202104,42210,강원도,속초시,70-74세,3680,1663,2017
202105,42210,강원도,속초시,70-74세,3673,1654,2019
202106,42210,강원도,속초시,70-74세,3665,1641,2024
202007,42210,강원도,속초시,75-79세,3167,1305,1862
202008,42210,강원도,속초시,75-79세,3179,1310,1869
202009,42210,강원도,속초시,75-79세,3175,1315,1860
202010,42210,강원도,속초시,75-79세,3168,1313,1855
202011,42210,강원도,속초시,75-79세,3166,1310,1856
202012,42210,강원도,속초시,75-79세,3151,1305,1846
202101,42210,강원도,속초시,75-79세,3131,1299,1832
202102,42210,강원도,속초시,75-79세,3113,1290,1823
202103,42210,강원도,속초시,75-79세,3107,1290,1817
202104,42210,강원도,속초시,75-79세,3103,1292,1811
202105,42210,강원도,속초시,75-79세,3109,1293,1816
202106,42210,강원도,속초시,75-79세,3118,1302,1816
202007,42210,강원도,속초시,80-84세,2194,828,1366
202008,42210,강원도,속초시,80-84세,2190,826,1364
202009,42210,강원도,속초시,80-84세,2198,823,1375
202010,42210,강원도,속초시,80-84세,2203,820,1383
202011,42210,강원도,속초시,80-84세,2202,818,1384
202012,42210,강원도,속초시,80-84세,2212,820,1392
202101,42210,강원도,속초시,80-84세,2230,830,1400
202102,42210,강원도,속초시,80-84세,2250,843,1407
202103,42210,강원도,속초시,80-84세,2241,845,1396
202104,42210,강원도,속초시,80-84세,2242,844,1398
202105,42210,강원도,속초시,80-84세,2237,845,1392
202106,42210,강원도,속초시,80-84세,2239,847,1392
202007,42210,강원도,속초시,85-89세,945,230,715
202008,42210,강원도,속초시,85-89세,957,237,720
202009,42210,강원도,속초시,85-89세,959,247,712
202010,42210,강원도,속초시,85-89세,973,260,713
202011,42210,강원도,속초시,85-89세,985,271,714
202012,42210,강원도,속초시,85-89세,990,271,719
202101,42210,강원도,속초시,85-89세,999,280,719
202102,42210,강원도,속초시,85-89세,1014,286,728
202103,42210,강원도,속초시,85-89세,1014,277,737
202104,42210,강원도,속초시,85-89세,1035,289,746
202105,42210,강원도,속초시,85-89세,1051,295,756
202106,42210,강원도,속초시,85-89세,1062,299,763
202007,42210,강원도,속초시,90-94세,492,98,394
202008,42210,강원도,속초시,90-94세,496,98,398
202009,42210,강원도,속초시,90-94세,505,97,408
202010,42210,강원도,속초시,90-94세,499,96,403
202011,42210,강원도,속초시,90-94세,499,98,401
202012,42210,강원도,속초시,90-94세,502,100,402
202101,42210,강원도,속초시,90-94세,507,99,408
202102,42210,강원도,속초시,90-94세,500,95,405
202103,42210,강원도,속초시,90-94세,496,92,404
202104,42210,강원도,속초시,90-94세,500,92,408
202105,42210,강원도,속초시,90-94세,498,88,410
202106,42210,강원도,속초시,90-94세,492,88,404
202007,42210,강원도,속초시,95-99세,105,28,77
202008,42210,강원도,속초시,95-99세,104,29,75
202009,42210,강원도,속초시,95-99세,107,28,79
202010,42210,강원도,속초시,95-99세,111,28,83
202011,42210,강원도,속초시,95-99세,114,28,86
202012,42210,강원도,속초시,95-99세,115,27,88
202101,42210,강원도,속초시,95-99세,116,28,88
202102,42210,강원도,속초시,95-99세,119,29,90
202103,42210,강원도,속초시,95-99세,108,25,83
202104,42210,강원도,속초시,95-99세,105,23,82
202105,42210,강원도,속초시,95-99세,105,24,81
202106,42210,강원도,속초시,95-99세,107,23,84
202007,42210,강원도,속초시,100+,34,13,21
202008,42210,강원도,속초시,100+,34,13,21
202009,42210,강원도,속초시,100+,33,13,20
202010,42210,강원도,속초시,100+,32,13,19
202011,42210,강원도,속초시,100+,32,13,19
202012,42210,강원도,속초시,100+,32,13,19
202101,42210,강원도,속초시,100+,31,13,18
202102,42210,강원도,속초시,100+,33,13,20
202103,42210,강원도,속초시,100+,18,6,12
202104,42210,강원도,속초시,100+,19,6,13
202105,42210,강원도,속초시,100+,20,6,14
202106,42210,강원도,속초시,100+,21,7,14
202007,42230,강원도,삼척시,0-4세,1728,863,865
202008,42230,강원도,삼척시,0-4세,1714,855,859
202009,42230,강원도,삼척시,0-4세,1714,852,862
202010,42230,강원도,삼척시,0-4세,1708,853,855
202011,42230,강원도,삼척시,0-4세,1708,850,858
202012,42230,강원도,삼척시,0-4세,1720,856,864
202101,42230,강원도,삼척시,0-4세,1706,843,863
202102,42230,강원도,삼척시,0-4세,1694,837,857
202103,42230,강원도,삼척시,0-4세,1676,829,847
202104,42230,강원도,삼척시,0-4세,1653,819,834
202105,42230,강원도,삼척시,0-4세,1645,827,818
202106,42230,강원도,삼척시,0-4세,1629,812,817
202007,42230,강원도,삼척시,5-9세,2228,1146,1082
202008,42230,강원도,삼척시,5-9세,2215,1139,1076
202009,42230,강원도,삼척시,5-9세,2191,1135,1056
202010,42230,강원도,삼척시,5-9세,2170,1131,1039
202011,42230,강원도,삼척시,5-9세,2157,1119,1038
202012,42230,강원도,삼척시,5-9세,2141,1106,1035
202101,42230,강원도,삼척시,5-9세,2120,1098,1022
202102,42230,강원도,삼척시,5-9세,2102,1091,1011
202103,42230,강원도,삼척시,5-9세,2096,1085,1011
202104,42230,강원도,삼척시,5-9세,2074,1073,1001
202105,42230,강원도,삼척시,5-9세,2057,1058,999
202106,42230,강원도,삼척시,5-9세,2052,1060,992
202007,42230,강원도,삼척시,10-14세,2311,1217,1094
202008,42230,강원도,삼척시,10-14세,2304,1211,1093
202009,42230,강원도,삼척시,10-14세,2322,1213,1109
202010,42230,강원도,삼척시,10-14세,2329,1210,1119
202011,42230,강원도,삼척시,10-14세,2338,1219,1119
202012,42230,강원도,삼척시,10-14세,2334,1223,1111
202101,42230,강원도,삼척시,10-14세,2307,1211,1096
202102,42230,강원도,삼척시,10-14세,2303,1202,1101
202103,42230,강원도,삼척시,10-14세,2305,1199,1106
202104,42230,강원도,삼척시,10-14세,2308,1202,1106
202105,42230,강원도,삼척시,10-14세,2308,1196,1112
202106,42230,강원도,삼척시,10-14세,2302,1193,1109
202007,42230,강원도,삼척시,15-19세,2903,1507,1396
202008,42230,강원도,삼척시,15-19세,2961,1525,1436
202009,42230,강원도,삼척시,15-19세,2941,1520,1421
202010,42230,강원도,삼척시,15-19세,2904,1502,1402
202011,42230,강원도,삼척시,15-19세,2855,1473,1382
202012,42230,강원도,삼척시,15-19세,2800,1442,1358
202101,42230,강원도,삼척시,15-19세,2763,1415,1348
202102,42230,강원도,삼척시,15-19세,2736,1399,1337
202103,42230,강원도,삼척시,15-19세,2739,1409,1330
202104,42230,강원도,삼척시,15-19세,2811,1415,1396
202105,42230,강원도,삼척시,15-19세,2781,1408,1373
202106,42230,강원도,삼척시,15-19세,2755,1397,1358
202007,42230,강원도,삼척시,20-24세,4551,2529,2022
202008,42230,강원도,삼척시,20-24세,4579,2523,2056
202009,42230,강원도,삼척시,20-24세,4560,2505,2055
202010,42230,강원도,삼척시,20-24세,4556,2495,2061
202011,42230,강원도,삼척시,20-24세,4535,2468,2067
202012,42230,강원도,삼척시,20-24세,4433,2407,2026
202101,42230,강원도,삼척시,20-24세,4302,2337,1965
202102,42230,강원도,삼척시,20-24세,4196,2275,1921
202103,42230,강원도,삼척시,20-24세,4227,2297,1930
202104,42230,강원도,삼척시,20-24세,4235,2306,1929
202105,42230,강원도,삼척시,20-24세,4234,2311,1923
202106,42230,강원도,삼척시,20-24세,4208,2286,1922
202007,42230,강원도,삼척시,25-29세,2839,1636,1203
202008,42230,강원도,삼척시,25-29세,2818,1627,1191
202009,42230,강원도,삼척시,25-29세,2823,1638,1185
202010,42230,강원도,삼척시,25-29세,2831,1645,1186
202011,42230,강원도,삼척시,25-29세,2809,1632,1177
202012,42230,강원도,삼척시,25-29세,2803,1635,1168
202101,42230,강원도,삼척시,25-29세,2787,1628,1159
202102,42230,강원도,삼척시,25-29세,2760,1609,1151
202103,42230,강원도,삼척시,25-29세,2748,1586,1162
202104,42230,강원도,삼척시,25-29세,2739,1589,1150
202105,42230,강원도,삼척시,25-29세,2742,1585,1157
202106,42230,강원도,삼척시,25-29세,2735,1590,1145
202007,42230,강원도,삼척시,30-34세,2554,1384,1170
202008,42230,강원도,삼척시,30-34세,2567,1396,1171
202009,42230,강원도,삼척시,30-34세,2547,1385,1162
202010,42230,강원도,삼척시,30-34세,2528,1387,1141
202011,42230,강원도,삼척시,30-34세,2521,1381,1140
202012,42230,강원도,삼척시,30-34세,2511,1376,1135
202101,42230,강원도,삼척시,30-34세,2480,1356,1124
202102,42230,강원도,삼척시,30-34세,2420,1320,1100
202103,42230,강원도,삼척시,30-34세,2421,1321,1100
202104,42230,강원도,삼척시,30-34세,2398,1312,1086
202105,42230,강원도,삼척시,30-34세,2383,1307,1076
202106,42230,강원도,삼척시,30-34세,2372,1295,1077
202007,42230,강원도,삼척시,35-39세,3414,1838,1576
202008,42230,강원도,삼척시,35-39세,3373,1820,1553
202009,42230,강원도,삼척시,35-39세,3340,1809,1531
202010,42230,강원도,삼척시,35-39세,3310,1794,1516
202011,42230,강원도,삼척시,35-39세,3280,1767,1513
202012,42230,강원도,삼척시,35-39세,3284,1767,1517
202101,42230,강원도,삼척시,35-39세,3254,1743,1511
202102,42230,강원도,삼척시,35-39세,3225,1728,1497
202103,42230,강원도,삼척시,35-39세,3169,1697,1472
202104,42230,강원도,삼척시,35-39세,3136,1673,1463
202105,42230,강원도,삼척시,35-39세,3094,1660,1434
202106,42230,강원도,삼척시,35-39세,3060,1636,1424
202007,42230,강원도,삼척시,40-44세,3960,2108,1852
202008,42230,강원도,삼척시,40-44세,3949,2097,1852
202009,42230,강원도,삼척시,40-44세,3957,2097,1860
202010,42230,강원도,삼척시,40-44세,3970,2100,1870
202011,42230,강원도,삼척시,40-44세,3973,2109,1864
202012,42230,강원도,삼척시,40-44세,3923,2086,1837
202101,42230,강원도,삼척시,40-44세,3900,2079,1821
202102,42230,강원도,삼척시,40-44세,3894,2067,1827
202103,42230,강원도,삼척시,40-44세,3866,2063,1803
202104,42230,강원도,삼척시,40-44세,3858,2060,1798
202105,42230,강원도,삼척시,40-44세,3850,2047,1803
202106,42230,강원도,삼척시,40-44세,3856,2045,1811
202007,42230,강원도,삼척시,45-49세,5102,2917,2185
202008,42230,강원도,삼척시,45-49세,5084,2896,2188
202009,42230,강원도,삼척시,45-49세,5066,2882,2184
202010,42230,강원도,삼척시,45-49세,5011,2851,2160
202011,42230,강원도,삼척시,45-49세,4977,2828,2149
202012,42230,강원도,삼척시,45-49세,5000,2824,2176
202101,42230,강원도,삼척시,45-49세,4984,2809,2175
202102,42230,강원도,삼척시,45-49세,4950,2796,2154
202103,42230,강원도,삼척시,45-49세,4926,2779,2147
202104,42230,강원도,삼척시,45-49세,4897,2757,2140
202105,42230,강원도,삼척시,45-49세,4816,2714,2102
202106,42230,강원도,삼척시,45-49세,4781,2700,2081
202007,42230,강원도,삼척시,50-54세,5499,3009,2490
202008,42230,강원도,삼척시,50-54세,5497,3019,2478
202009,42230,강원도,삼척시,50-54세,5486,3023,2463
202010,42230,강원도,삼척시,50-54세,5495,3039,2456
202011,42230,강원도,삼척시,50-54세,5503,3043,2460
202012,42230,강원도,삼척시,50-54세,5485,3056,2429
202101,42230,강원도,삼척시,50-54세,5500,3057,2443
202102,42230,강원도,삼척시,50-54세,5490,3048,2442
202103,42230,강원도,삼척시,50-54세,5414,3030,2384
202104,42230,강원도,삼척시,50-54세,5415,3039,2376
202105,42230,강원도,삼척시,50-54세,5433,3046,2387
202106,42230,강원도,삼척시,50-54세,5436,3031,2405
202007,42230,강원도,삼척시,55-59세,5975,3085,2890
202008,42230,강원도,삼척시,55-59세,5949,3069,2880
202009,42230,강원도,삼척시,55-59세,5920,3065,2855
202010,42230,강원도,삼척시,55-59세,5895,3048,2847
202011,42230,강원도,삼척시,55-59세,5862,3044,2818
202012,42230,강원도,삼척시,55-59세,5846,3025,2821
202101,42230,강원도,삼척시,55-59세,5800,3010,2790
202102,42230,강원도,삼척시,55-59세,5783,3006,2777
202103,42230,강원도,삼척시,55-59세,5731,2992,2739
202104,42230,강원도,삼척시,55-59세,5693,2979,2714
202105,42230,강원도,삼척시,55-59세,5649,2965,2684
202106,42230,강원도,삼척시,55-59세,5603,2944,2659
202007,42230,강원도,삼척시,60-64세,6231,3132,3099
202008,42230,강원도,삼척시,60-64세,6252,3147,3105
202009,42230,강원도,삼척시,60-64세,6288,3157,3131
202010,42230,강원도,삼척시,60-64세,6330,3183,3147
202011,42230,강원도,삼척시,60-64세,6357,3198,3159
202012,42230,강원도,삼척시,60-64세,6391,3204,3187
202101,42230,강원도,삼척시,60-64세,6422,3217,3205
202102,42230,강원도,삼척시,60-64세,6447,3240,3207
202103,42230,강원도,삼척시,60-64세,6490,3275,3215
202104,42230,강원도,삼척시,60-64세,6481,3268,3213
202105,42230,강원도,삼척시,60-64세,6509,3293,3216
202106,42230,강원도,삼척시,60-64세,6552,3317,3235
202007,42230,강원도,삼척시,65-69세,4639,2296,2343
202008,42230,강원도,삼척시,65-69세,4690,2324,2366
202009,42230,강원도,삼척시,65-69세,4711,2333,2378
202010,42230,강원도,삼척시,65-69세,4733,2348,2385
202011,42230,강원도,삼척시,65-69세,4752,2351,2401
202012,42230,강원도,삼척시,65-69세,4776,2373,2403
202101,42230,강원도,삼척시,65-69세,4807,2391,2416
202102,42230,강원도,삼척시,65-69세,4830,2401,2429
202103,42230,강원도,삼척시,65-69세,4840,2409,2431
202104,42230,강원도,삼척시,65-69세,4912,2446,2466
202105,42230,강원도,삼척시,65-69세,4943,2466,2477
202106,42230,강원도,삼척시,65-69세,4982,2487,2495
202007,42230,강원도,삼척시,70-74세,3706,1789,1917
202008,42230,강원도,삼척시,70-74세,3696,1784,1912
202009,42230,강원도,삼척시,70-74세,3710,1792,1918
202010,42230,강원도,삼척시,70-74세,3739,1801,1938
202011,42230,강원도,삼척시,70-74세,3768,1816,1952
202012,42230,강원도,삼척시,70-74세,3796,1826,1970
202101,42230,강원도,삼척시,70-74세,3806,1833,1973
202102,42230,강원도,삼척시,70-74세,3810,1829,1981
202103,42230,강원도,삼척시,70-74세,3758,1806,1952
202104,42230,강원도,삼척시,70-74세,3730,1788,1942
202105,42230,강원도,삼척시,70-74세,3730,1782,1948
202106,42230,강원도,삼척시,70-74세,3714,1776,1938
202007,42230,강원도,삼척시,75-79세,3539,1396,2143
202008,42230,강원도,삼척시,75-79세,3537,1400,2137
202009,42230,강원도,삼척시,75-79세,3511,1389,2122
202010,42230,강원도,삼척시,75-79세,3481,1377,2104
202011,42230,강원도,삼척시,75-79세,3437,1363,2074
202012,42230,강원도,삼척시,75-79세,3391,1353,2038
202101,42230,강원도,삼척시,75-79세,3366,1344,2022
202102,42230,강원도,삼척시,75-79세,3375,1351,2024
202103,42230,강원도,삼척시,75-79세,3357,1341,2016
202104,42230,강원도,삼척시,75-79세,3370,1342,2028
202105,42230,강원도,삼척시,75-79세,3354,1341,2013
202106,42230,강원도,삼척시,75-79세,3354,1344,2010
202007,42230,강원도,삼척시,80-84세,2538,919,1619
202008,42230,강원도,삼척시,80-84세,2541,921,1620
202009,42230,강원도,삼척시,80-84세,2551,929,1622
202010,42230,강원도,삼척시,80-84세,2561,925,1636
202011,42230,강원도,삼척시,80-84세,2562,918,1644
202012,42230,강원도,삼척시,80-84세,2576,918,1658
202101,42230,강원도,삼척시,80-84세,2590,926,1664
202102,42230,강원도,삼척시,80-84세,2586,921,1665
202103,42230,강원도,삼척시,80-84세,2566,909,1657
202104,42230,강원도,삼척시,80-84세,2557,912,1645
202105,42230,강원도,삼척시,80-84세,2566,914,1652
202106,42230,강원도,삼척시,80-84세,2576,906,1670
202007,42230,강원도,삼척시,85-89세,1361,396,965
202008,42230,강원도,삼척시,85-89세,1359,396,963
202009,42230,강원도,삼척시,85-89세,1371,399,972
202010,42230,강원도,삼척시,85-89세,1364,397,967
202011,42230,강원도,삼척시,85-89세,1384,403,981
202012,42230,강원도,삼척시,85-89세,1400,410,990
202101,42230,강원도,삼척시,85-89세,1415,417,998
202102,42230,강원도,삼척시,85-89세,1438,425,1013
202103,42230,강원도,삼척시,85-89세,1456,429,1027
202104,42230,강원도,삼척시,85-89세,1463,439,1024
202105,42230,강원도,삼척시,85-89세,1470,439,1031
202106,42230,강원도,삼척시,85-89세,1469,438,1031
202007,42230,강원도,삼척시,90-94세,467,89,378
202008,42230,강원도,삼척시,90-94세,470,89,381
202009,42230,강원도,삼척시,90-94세,472,90,382
202010,42230,강원도,삼척시,90-94세,476,92,384
202011,42230,강원도,삼척시,90-94세,477,93,384
202012,42230,강원도,삼척시,90-94세,477,94,383
202101,42230,강원도,삼척시,90-94세,479,92,387
202102,42230,강원도,삼척시,90-94세,478,94,384
202103,42230,강원도,삼척시,90-94세,480,91,389
202104,42230,강원도,삼척시,90-94세,490,94,396
202105,42230,강원도,삼척시,90-94세,493,98,395
202106,42230,강원도,삼척시,90-94세,503,105,398
202007,42230,강원도,삼척시,95-99세,103,19,84
202008,42230,강원도,삼척시,95-99세,103,18,85
202009,42230,강원도,삼척시,95-99세,108,20,88
202010,42230,강원도,삼척시,95-99세,103,18,85
202011,42230,강원도,삼척시,95-99세,104,19,85
202012,42230,강원도,삼척시,95-99세,105,18,87
202101,42230,강원도,삼척시,95-99세,104,18,86
202102,42230,강원도,삼척시,95-99세,110,19,91
202103,42230,강원도,삼척시,95-99세,99,14,85
202104,42230,강원도,삼척시,95-99세,105,14,91
202105,42230,강원도,삼척시,95-99세,105,14,91
202106,42230,강원도,삼척시,95-99세,108,14,94
202007,42230,강원도,삼척시,100+,50,12,38
202008,42230,강원도,삼척시,100+,50,12,38
202009,42230,강원도,삼척시,100+,50,12,38
202010,42230,강원도,삼척시,100+,50,12,38
202011,42230,강원도,삼척시,100+,50,12,38
202012,42230,강원도,삼척시,100+,51,12,39
202101,42230,강원도,삼척시,100+,54,12,42
202102,42230,강원도,삼척시,100+,53,12,41
202103,42230,강원도,삼척시,100+,29,5,24
202104,42230,강원도,삼척시,100+,30,5,25
202105,42230,강원도,삼척시,100+,26,4,22
202106,42230,강원도,삼척시,100+,26,4,22
202007,42720,강원도,홍천군,0-4세,1714,871,843
202008,42720,강원도,홍천군,0-4세,1696,859,837
202009,42720,강원도,홍천군,0-4세,1679,849,830
202010,42720,강원도,홍천군,0-4세,1654,833,821
202011,42720,강원도,홍천군,0-4세,1662,847,815
202012,42720,강원도,홍천군,0-4세,1669,845,824
202101,42720,강원도,홍천군,0-4세,1646,834,812
202102,42720,강원도,홍천군,0-4세,1643,837,806
202103,42720,강원도,홍천군,0-4세,1620,826,794
202104,42720,강원도,홍천군,0-4세,1602,815,787
202105,42720,강원도,홍천군,0-4세,1598,820,778
202106,42720,강원도,홍천군,0-4세,1585,811,774
202007,42720,강원도,홍천군,5-9세,2152,1073,1079
202008,42720,강원도,홍천군,5-9세,2150,1080,1070
202009,42720,강원도,홍천군,5-9세,2140,1077,1063
202010,42720,강원도,홍천군,5-9세,2139,1067,1072
202011,42720,강원도,홍천군,5-9세,2130,1062,1068
202012,42720,강원도,홍천군,5-9세,2131,1066,1065
202101,42720,강원도,홍천군,5-9세,2125,1064,1061
202102,42720,강원도,홍천군,5-9세,2130,1057,1073
202103,42720,강원도,홍천군,5-9세,2109,1048,1061
202104,42720,강원도,홍천군,5-9세,2128,1071,1057
202105,42720,강원도,홍천군,5-9세,2120,1069,1051
202106,42720,강원도,홍천군,5-9세,2106,1067,1039
202007,42720,강원도,홍천군,10-14세,2410,1225,1185
202008,42720,강원도,홍천군,10-14세,2385,1208,1177
202009,42720,강원도,홍천군,10-14세,2380,1205,1175
202010,42720,강원도,홍천군,10-14세,2372,1207,1165
202011,42720,강원도,홍천군,10-14세,2364,1199,1165
202012,42720,강원도,홍천군,10-14세,2371,1211,1160
202101,42720,강원도,홍천군,10-14세,2367,1215,1152
202102,42720,강원도,홍천군,10-14세,2342,1207,1135
202103,42720,강원도,홍천군,10-14세,2357,1211,1146
202104,42720,강원도,홍천군,10-14세,2352,1207,1145
202105,42720,강원도,홍천군,10-14세,2351,1204,1147
202106,42720,강원도,홍천군,10-14세,2372,1207,1165
202007,42720,강원도,홍천군,15-19세,2882,1520,1362
202008,42720,강원도,홍천군,15-19세,2866,1511,1355
202009,42720,강원도,홍천군,15-19세,2868,1512,1356
202010,42720,강원도,홍천군,15-19세,2874,1520,1354
202011,42720,강원도,홍천군,15-19세,2848,1496,1352
202012,42720,강원도,홍천군,15-19세,2809,1462,1347
202101,42720,강원도,홍천군,15-19세,2764,1433,1331
202102,42720,강원도,홍천군,15-19세,2729,1416,1313
202103,42720,강원도,홍천군,15-19세,2753,1402,1351
202104,42720,강원도,홍천군,15-19세,2729,1390,1339
202105,42720,강원도,홍천군,15-19세,2697,1369,1328
202106,42720,강원도,홍천군,15-19세,2682,1367,1315
202007,42720,강원도,홍천군,20-24세,3660,2159,1501
202008,42720,강원도,홍천군,20-24세,3620,2134,1486
202009,42720,강원도,홍천군,20-24세,3590,2110,1480
202010,42720,강원도,홍천군,20-24세,3558,2095,1463
202011,42720,강원도,홍천군,20-24세,3561,2108,1453
202012,42720,강원도,홍천군,20-24세,3552,2107,1445
202101,42720,강원도,홍천군,20-24세,3529,2099,1430
202102,42720,강원도,홍천군,20-24세,3505,2078,1427
202103,42720,강원도,홍천군,20-24세,3470,2055,1415
202104,42720,강원도,홍천군,20-24세,3441,2037,1404
202105,42720,강원도,홍천군,20-24세,3409,2019,1390
202106,42720,강원도,홍천군,20-24세,3390,1999,1391
202007,42720,강원도,홍천군,25-29세,3313,2076,1237
202008,42720,강원도,홍천군,25-29세,3319,2073,1246
202009,42720,강원도,홍천군,25-29세,3326,2079,1247
202010,42720,강원도,홍천군,25-29세,3337,2079,1258
202011,42720,강원도,홍천군,25-29세,3339,2078,1261
202012,42720,강원도,홍천군,25-29세,3323,2078,1245
202101,42720,강원도,홍천군,25-29세,3329,2072,1257
202102,42720,강원도,홍천군,25-29세,3324,2074,1250
202103,42720,강원도,홍천군,25-29세,3294,2049,1245
202104,42720,강원도,홍천군,25-29세,3287,2047,1240
202105,42720,강원도,홍천군,25-29세,3275,2046,1229
202106,42720,강원도,홍천군,25-29세,3262,2034,1228
202007,42720,강원도,홍천군,30-34세,2849,1607,1242
202008,42720,강원도,홍천군,30-34세,2839,1606,1233
202009,42720,강원도,홍천군,30-34세,2829,1596,1233
202010,42720,강원도,홍천군,30-34세,2845,1608,1237
202011,42720,강원도,홍천군,30-34세,2834,1598,1236
202012,42720,강원도,홍천군,30-34세,2858,1609,1249
202101,42720,강원도,홍천군,30-34세,2836,1599,1237
202102,42720,강원도,홍천군,30-34세,2820,1600,1220
202103,42720,강원도,홍천군,30-34세,2806,1594,1212
202104,42720,강원도,홍천군,30-34세,2804,1582,1222
202105,42720,강원도,홍천군,30-34세,2773,1560,1213
202106,42720,강원도,홍천군,30-34세,2780,1561,1219
202007,42720,강원도,홍천군,35-39세,3350,1768,1582
202008,42720,강원도,홍천군,35-39세,3334,1766,1568
202009,42720,강원도,홍천군,35-39세,3333,1765,1568
202010,42720,강원도,홍천군,35-39세,3296,1752,1544
202011,42720,강원도,홍천군,35-39세,3284,1758,1526
202012,42720,강원도,홍천군,35-39세,3281,1758,1523
202101,42720,강원도,홍천군,35-39세,3227,1728,1499
202102,42720,강원도,홍천군,35-39세,3224,1723,1501
202103,42720,강원도,홍천군,35-39세,3175,1685,1490
202104,42720,강원도,홍천군,35-39세,3141,1666,1475
202105,42720,강원도,홍천군,35-39세,3130,1662,1468
202106,42720,강원도,홍천군,35-39세,3098,1647,1451
202007,42720,강원도,홍천군,40-44세,3689,1953,1736
202008,42720,강원도,홍천군,40-44세,3700,1952,1748
202009,42720,강원도,홍천군,40-44세,3703,1956,1747
202010,42720,강원도,홍천군,40-44세,3715,1956,1759
202011,42720,강원도,홍천군,40-44세,3716,1955,1761
202012,42720,강원도,홍천군,40-44세,3702,1954,1748
202101,42720,강원도,홍천군,40-44세,3688,1940,1748
202102,42720,강원도,홍천군,40-44세,3666,1936,1730
202103,42720,강원도,홍천군,40-44세,3629,1918,1711
202104,42720,강원도,홍천군,40-44세,3607,1912,1695
202105,42720,강원도,홍천군,40-44세,3606,1907,1699
202106,42720,강원도,홍천군,40-44세,3626,1911,1715
202007,42720,강원도,홍천군,45-49세,4659,2540,2119
202008,42720,강원도,홍천군,45-49세,4624,2520,2104
202009,42720,강원도,홍천군,45-49세,4593,2498,2095
202010,42720,강원도,홍천군,45-49세,4584,2496,2088
202011,42720,강원도,홍천군,45-49세,4583,2490,2093
202012,42720,강원도,홍천군,45-49세,4595,2503,2092
202101,42720,강원도,홍천군,45-49세,4586,2504,2082
202102,42720,강원도,홍천군,45-49세,4553,2464,2089
202103,42720,강원도,홍천군,45-49세,4501,2435,2066
202104,42720,강원도,홍천군,45-49세,4501,2434,2067
202105,42720,강원도,홍천군,45-49세,4471,2419,2052
202106,42720,강원도,홍천군,45-49세,4448,2411,2037
202007,42720,강원도,홍천군,50-54세,5733,3038,2695
202008,42720,강원도,홍천군,50-54세,5739,3038,2701
202009,42720,강원도,홍천군,50-54세,5747,3050,2697
202010,42720,강원도,홍천군,50-54세,5755,3049,2706
202011,42720,강원도,홍천군,50-54세,5735,3034,2701
202012,42720,강원도,홍천군,50-54세,5678,2992,2686
202101,42720,강원도,홍천군,50-54세,5695,2995,2700
202102,42720,강원도,홍천군,50-54세,5709,3009,2700
202103,42720,강원도,홍천군,50-54세,5610,2955,2655
202104,42720,강원도,홍천군,50-54세,5592,2957,2635
202105,42720,강원도,홍천군,50-54세,5598,2969,2629
202106,42720,강원도,홍천군,50-54세,5610,2971,2639
202007,42720,강원도,홍천군,55-59세,7179,3770,3409
202008,42720,강원도,홍천군,55-59세,7156,3761,3395
202009,42720,강원도,홍천군,55-59세,7134,3758,3376
202010,42720,강원도,홍천군,55-59세,7094,3736,3358
202011,42720,강원도,홍천군,55-59세,7080,3726,3354
202012,42720,강원도,홍천군,55-59세,7076,3719,3357
202101,42720,강원도,홍천군,55-59세,7000,3677,3323
202102,42720,강원도,홍천군,55-59세,6921,3624,3297
202103,42720,강원도,홍천군,55-59세,6862,3618,3244
202104,42720,강원도,홍천군,55-59세,6800,3588,3212
202105,42720,강원도,홍천군,55-59세,6745,3555,3190
202106,42720,강원도,홍천군,55-59세,6665,3515,3150
202007,42720,강원도,홍천군,60-64세,7853,4043,3810
202008,42720,강원도,홍천군,60-64세,7877,4048,3829
202009,42720,강원도,홍천군,60-64세,7903,4047,3856
202010,42720,강원도,홍천군,60-64세,7946,4068,3878
202011,42720,강원도,홍천군,60-64세,8006,4114,3892
202012,42720,강원도,홍천군,60-64세,8064,4148,3916
202101,42720,강원도,홍천군,60-64세,8100,4174,3926
202102,42720,강원도,홍천군,60-64세,8151,4210,3941
202103,42720,강원도,홍천군,60-64세,8206,4229,3977
202104,42720,강원도,홍천군,60-64세,8247,4249,3998
202105,42720,강원도,홍천군,60-64세,8313,4278,4035
202106,42720,강원도,홍천군,60-64세,8395,4336,4059
202007,42720,강원도,홍천군,65-69세,5508,2876,2632
202008,42720,강원도,홍천군,65-69세,5560,2907,2653
202009,42720,강원도,홍천군,65-69세,5631,2959,2672
202010,42720,강원도,홍천군,65-69세,5663,2987,2676
202011,42720,강원도,홍천군,65-69세,5699,3007,2692
202012,42720,강원도,홍천군,65-69세,5756,3033,2723
202101,42720,강원도,홍천군,65-69세,5832,3090,2742
202102,42720,강원도,홍천군,65-69세,5898,3126,2772
202103,42720,강원도,홍천군,65-69세,5996,3182,2814
202104,42720,강원도,홍천군,65-69세,6080,3225,2855
202105,42720,강원도,홍천군,65-69세,6134,3267,2867
202106,42720,강원도,홍천군,65-69세,6211,3302,2909
202007,42720,강원도,홍천군,70-74세,3798,1931,1867
202008,42720,강원도,홍천군,70-74세,3804,1923,1881
202009,42720,강원도,홍천군,70-74세,3794,1908,1886
202010,42720,강원도,홍천군,70-74세,3790,1897,1893
202011,42720,강원도,홍천군,70-74세,3795,1904,1891
202012,42720,강원도,홍천군,70-74세,3817,1916,1901
202101,42720,강원도,홍천군,70-74세,3827,1916,1911
202102,42720,강원도,홍천군,70-74세,3826,1916,1910
202103,42720,강원도,홍천군,70-74세,3802,1912,1890
202104,42720,강원도,홍천군,70-74세,3793,1919,1874
202105,42720,강원도,홍천군,70-74세,3792,1917,1875
202106,42720,강원도,홍천군,70-74세,3772,1909,1863
202007,42720,강원도,홍천군,75-79세,3530,1532,1998
202008,42720,강원도,홍천군,75-79세,3513,1530,1983
202009,42720,강원도,홍천군,75-79세,3515,1541,1974
202010,42720,강원도,홍천군,75-79세,3516,1542,1974
202011,42720,강원도,홍천군,75-79세,3505,1527,1978
202012,42720,강원도,홍천군,75-79세,3493,1525,1968
202101,42720,강원도,홍천군,75-79세,3503,1533,1970
202102,42720,강원도,홍천군,75-79세,3474,1523,1951
202103,42720,강원도,홍천군,75-79세,3452,1516,1936
202104,42720,강원도,홍천군,75-79세,3454,1513,1941
202105,42720,강원도,홍천군,75-79세,3449,1514,1935
202106,42720,강원도,홍천군,75-79세,3432,1511,1921
202007,42720,강원도,홍천군,80-84세,2911,1135,1776
202008,42720,강원도,홍천군,80-84세,2925,1144,1781
202009,42720,강원도,홍천군,80-84세,2930,1138,1792
202010,42720,강원도,홍천군,80-84세,2931,1149,1782
202011,42720,강원도,홍천군,80-84세,2939,1163,1776
202012,42720,강원도,홍천군,80-84세,2941,1157,1784
202101,42720,강원도,홍천군,80-84세,2946,1168,1778
202102,42720,강원도,홍천군,80-84세,2961,1174,1787
202103,42720,강원도,홍천군,80-84세,2949,1165,1784
202104,42720,강원도,홍천군,80-84세,2954,1177,1777
202105,42720,강원도,홍천군,80-84세,2962,1177,1785
202106,42720,강원도,홍천군,80-84세,3004,1194,1810
202007,42720,강원도,홍천군,85-89세,1389,372,1017
202008,42720,강원도,홍천군,85-89세,1396,374,1022
202009,42720,강원도,홍천군,85-89세,1400,378,1022
202010,42720,강원도,홍천군,85-89세,1422,385,1037
202011,42720,강원도,홍천군,85-89세,1431,388,1043
202012,42720,강원도,홍천군,85-89세,1446,402,1044
202101,42720,강원도,홍천군,85-89세,1456,408,1048
202102,42720,강원도,홍천군,85-89세,1468,415,1053
202103,42720,강원도,홍천군,85-89세,1483,420,1063
202104,42720,강원도,홍천군,85-89세,1490,419,1071
202105,42720,강원도,홍천군,85-89세,1500,431,1069
202106,42720,강원도,홍천군,85-89세,1503,430,1073
202007,42720,강원도,홍천군,90-94세,496,131,365
202008,42720,강원도,홍천군,90-94세,503,129,374
202009,42720,강원도,홍천군,90-94세,509,132,377
202010,42720,강원도,홍천군,90-94세,509,132,377
202011,42720,강원도,홍천군,90-94세,514,131,383
202012,42720,강원도,홍천군,90-94세,514,127,387
202101,42720,강원도,홍천군,90-94세,517,121,396
202102,42720,강원도,홍천군,90-94세,527,120,407
202103,42720,강원도,홍천군,90-94세,527,116,411
202104,42720,강원도,홍천군,90-94세,526,119,407
202105,42720,강원도,홍천군,90-94세,525,116,409
202106,42720,강원도,홍천군,90-94세,532,121,411
202007,42720,강원도,홍천군,95-99세,115,40,75
202008,42720,강원도,홍천군,95-99세,119,41,78
202009,42720,강원도,홍천군,95-99세,119,40,79
202010,42720,강원도,홍천군,95-99세,120,42,78
202011,42720,강원도,홍천군,95-99세,123,44,79
202012,42720,강원도,홍천군,95-99세,123,44,79
202101,42720,강원도,홍천군,95-99세,127,48,79
202102,42720,강원도,홍천군,95-99세,125,47,78
202103,42720,강원도,홍천군,95-99세,116,41,75
202104,42720,강원도,홍천군,95-99세,119,39,80
202105,42720,강원도,홍천군,95-99세,116,36,80
202106,42720,강원도,홍천군,95-99세,114,34,80
202007,42720,강원도,홍천군,100+,42,9,33
202008,42720,강원도,홍천군,100+,42,9,33
202009,42720,강원도,홍천군,100+,41,7,34
202010,42720,강원도,홍천군,100+,43,8,35
202011,42720,강원도,홍천군,100+,44,8,36
202012,42720,강원도,홍천군,100+,43,7,36
202101,42720,강원도,홍천군,100+,42,7,35
202102,42720,강원도,홍천군,100+,45,8,37
202103,42720,강원도,홍천군,100+,34,4,30
202104,42720,강원도,홍천군,100+,34,4,30
202105,42720,강원도,홍천군,100+,33,4,29
202106,42720,강원도,홍천군,100+,32,4,28
202007,42730,강원도,횡성군,0-4세,967,523,444
202008,42730,강원도,횡성군,0-4세,958,523,435
202009,42730,강원도,횡성군,0-4세,946,509,437
202010,42730,강원도,횡성군,0-4세,935,504,431
202011,42730,강원도,횡성군,0-4세,927,503,424
202012,42730,강원도,횡성군,0-4세,928,504,424
202101,42730,강원도,횡성군,0-4세,932,507,425
202102,42730,강원도,횡성군,0-4세,928,504,424
202103,42730,강원도,횡성군,0-4세,903,493,410
202104,42730,강원도,횡성군,0-4세,910,497,413
202105,42730,강원도,횡성군,0-4세,910,490,420
202106,42730,강원도,횡성군,0-4세,916,494,422
202007,42730,강원도,횡성군,5-9세,1256,642,614
202008,42730,강원도,횡성군,5-9세,1257,644,613
202009,42730,강원도,횡성군,5-9세,1262,649,613
202010,42730,강원도,횡성군,5-9세,1247,641,606
202011,42730,강원도,횡성군,5-9세,1231,633,598
202012,42730,강원도,횡성군,5-9세,1231,630,601
202101,42730,강원도,횡성군,5-9세,1220,625,595
202102,42730,강원도,횡성군,5-9세,1223,633,590
202103,42730,강원도,횡성군,5-9세,1222,635,587
202104,42730,강원도,횡성군,5-9세,1225,635,590
202105,42730,강원도,횡성군,5-9세,1219,635,584
202106,42730,강원도,횡성군,5-9세,1207,627,580
202007,42730,강원도,횡성군,10-14세,1485,760,725
202008,42730,강원도,횡성군,10-14세,1478,761,717
202009,42730,강원도,횡성군,10-14세,1472,758,714
202010,42730,강원도,횡성군,10-14세,1486,758,728
202011,42730,강원도,횡성군,10-14세,1481,757,724
202012,42730,강원도,횡성군,10-14세,1479,754,725
202101,42730,강원도,횡성군,10-14세,1478,754,724
202102,42730,강원도,횡성군,10-14세,1472,751,721
202103,42730,강원도,횡성군,10-14세,1481,756,725
202104,42730,강원도,횡성군,10-14세,1490,763,727
202105,42730,강원도,횡성군,10-14세,1485,763,722
202106,42730,강원도,횡성군,10-14세,1490,771,719
202007,42730,강원도,횡성군,15-19세,2157,1143,1014
202008,42730,강원도,횡성군,15-19세,2136,1125,1011
202009,42730,강원도,횡성군,15-19세,2125,1115,1010
202010,42730,강원도,횡성군,15-19세,2129,1129,1000
202011,42730,강원도,횡성군,15-19세,2109,1127,982
202012,42730,강원도,횡성군,15-19세,2021,1079,942
202101,42730,강원도,횡성군,15-19세,1969,1052,917
202102,42730,강원도,횡성군,15-19세,1958,1042,916
202103,42730,강원도,횡성군,15-19세,2090,1110,980
202104,42730,강원도,횡성군,15-19세,2064,1097,967
202105,42730,강원도,횡성군,15-19세,2080,1099,981
202106,42730,강원도,횡성군,15-19세,2080,1096,984
202007,42730,강원도,횡성군,20-24세,2122,1188,934
202008,42730,강원도,횡성군,20-24세,2114,1182,932
202009,42730,강원도,횡성군,20-24세,2106,1186,920
202010,42730,강원도,횡성군,20-24세,2100,1178,922
202011,42730,강원도,횡성군,20-24세,2103,1170,933
202012,42730,강원도,횡성군,20-24세,2076,1157,919
202101,42730,강원도,횡성군,20-24세,2056,1150,906
202102,42730,강원도,횡성군,20-24세,2046,1145,901
202103,42730,강원도,횡성군,20-24세,2033,1144,889
202104,42730,강원도,횡성군,20-24세,2034,1138,896
202105,42730,강원도,횡성군,20-24세,2036,1151,885
202106,42730,강원도,횡성군,20-24세,2028,1149,879
202007,42730,강원도,횡성군,25-29세,1741,1001,740
202008,42730,강원도,횡성군,25-29세,1742,999,743
202009,42730,강원도,횡성군,25-29세,1752,1007,745
202010,42730,강원도,횡성군,25-29세,1735,995,740
202011,42730,강원도,횡성군,25-29세,1755,1011,744
202012,42730,강원도,횡성군,25-29세,1775,1031,744
202101,42730,강원도,횡성군,25-29세,1760,1019,741
202102,42730,강원도,횡성군,25-29세,1756,1012,744
202103,42730,강원도,횡성군,25-29세,1755,1017,738
202104,42730,강원도,횡성군,25-29세,1763,1019,744
202105,42730,강원도,횡성군,25-29세,1754,1021,733
202106,42730,강원도,횡성군,25-29세,1763,1023,740
202007,42730,강원도,횡성군,30-34세,1542,819,723
202008,42730,강원도,횡성군,30-34세,1523,808,715
202009,42730,강원도,횡성군,30-34세,1511,802,709
202010,42730,강원도,횡성군,30-34세,1507,802,705
202011,42730,강원도,횡성군,30-34세,1503,796,707
202012,42730,강원도,횡성군,30-34세,1505,800,705
202101,42730,강원도,횡성군,30-34세,1514,805,709
202102,42730,강원도,횡성군,30-34세,1517,802,715
202103,42730,강원도,횡성군,30-34세,1493,782,711
202104,42730,강원도,횡성군,30-34세,1502,794,708
202105,42730,강원도,횡성군,30-34세,1491,794,697
202106,42730,강원도,횡성군,30-34세,1484,797,687
202007,42730,강원도,횡성군,35-39세,1971,1037,934
202008,42730,강원도,횡성군,35-39세,1963,1035,928
202009,42730,강원도,횡성군,35-39세,1963,1031,932
202010,42730,강원도,횡성군,35-39세,1950,1025,925
202011,42730,강원도,횡성군,35-39세,1951,1019,932
202012,42730,강원도,횡성군,35-39세,1934,1007,927
202101,42730,강원도,횡성군,35-39세,1916,998,918
202102,42730,강원도,횡성군,35-39세,1899,985,914
202103,42730,강원도,횡성군,35-39세,1882,979,903
202104,42730,강원도,횡성군,35-39세,1888,979,909
202105,42730,강원도,횡성군,35-39세,1876,961,915
202106,42730,강원도,횡성군,35-39세,1865,954,911
202007,42730,강원도,횡성군,40-44세,2198,1220,978
202008,42730,강원도,횡성군,40-44세,2191,1217,974
202009,42730,강원도,횡성군,40-44세,2214,1235,979
202010,42730,강원도,횡성군,40-44세,2210,1235,975
202011,42730,강원도,횡성군,40-44세,2207,1239,968
202012,42730,강원도,횡성군,40-44세,2206,1240,966
202101,42730,강원도,횡성군,40-44세,2218,1243,975
202102,42730,강원도,횡성군,40-44세,2211,1241,970
202103,42730,강원도,횡성군,40-44세,2203,1237,966
202104,42730,강원도,횡성군,40-44세,2207,1235,972
202105,42730,강원도,횡성군,40-44세,2216,1237,979
202106,42730,강원도,횡성군,40-44세,2232,1247,985
202007,42730,강원도,횡성군,45-49세,2935,1634,1301
202008,42730,강원도,횡성군,45-49세,2933,1625,1308
202009,42730,강원도,횡성군,45-49세,2923,1622,1301
202010,42730,강원도,횡성군,45-49세,2934,1622,1312
202011,42730,강원도,횡성군,45-49세,2914,1613,1301
202012,42730,강원도,횡성군,45-49세,2913,1612,1301
202101,42730,강원도,횡성군,45-49세,2893,1595,1298
202102,42730,강원도,횡성군,45-49세,2883,1593,1290
202103,42730,강원도,횡성군,45-49세,2849,1576,1273
202104,42730,강원도,횡성군,45-49세,2832,1569,1263
202105,42730,강원도,횡성군,45-49세,2807,1569,1238
202106,42730,강원도,횡성군,45-49세,2782,1556,1226
202007,42730,강원도,횡성군,50-54세,3931,2101,1830
202008,42730,강원도,횡성군,50-54세,3925,2110,1815
202009,42730,강원도,횡성군,50-54세,3931,2105,1826
202010,42730,강원도,횡성군,50-54세,3909,2104,1805
202011,42730,강원도,횡성군,50-54세,3910,2106,1804
202012,42730,강원도,횡성군,50-54세,3886,2077,1809
202101,42730,강원도,횡성군,50-54세,3891,2085,1806
202102,42730,강원도,횡성군,50-54세,3893,2090,1803
202103,42730,강원도,횡성군,50-54세,3862,2065,1797
202104,42730,강원도,횡성군,50-54세,3865,2071,1794
202105,42730,강원도,횡성군,50-54세,3893,2073,1820
202106,42730,강원도,횡성군,50-54세,3896,2074,1822
202007,42730,강원도,횡성군,55-59세,4906,2580,2326
202008,42730,강원도,횡성군,55-59세,4923,2568,2355
202009,42730,강원도,횡성군,55-59세,4909,2565,2344
202010,42730,강원도,횡성군,55-59세,4890,2557,2333
202011,42730,강원도,횡성군,55-59세,4853,2543,2310
202012,42730,강원도,횡성군,55-59세,4853,2547,2306
202101,42730,강원도,횡성군,55-59세,4823,2549,2274
202102,42730,강원도,횡성군,55-59세,4800,2533,2267
202103,42730,강원도,횡성군,55-59세,4772,2530,2242
202104,42730,강원도,횡성군,55-59세,4732,2502,2230
202105,42730,강원도,횡성군,55-59세,4710,2486,2224
202106,42730,강원도,횡성군,55-59세,4662,2464,2198
202007,42730,강원도,횡성군,60-64세,5818,3000,2818
202008,42730,강원도,횡성군,60-64세,5827,3011,2816
202009,42730,강원도,횡성군,60-64세,5848,3028,2820
202010,42730,강원도,횡성군,60-64세,5898,3046,2852
202011,42730,강원도,횡성군,60-64세,5960,3076,2884
202012,42730,강원도,횡성군,60-64세,5964,3093,2871
202101,42730,강원도,횡성군,60-64세,5990,3101,2889
202102,42730,강원도,횡성군,60-64세,5988,3103,2885
202103,42730,강원도,횡성군,60-64세,5998,3113,2885
202104,42730,강원도,횡성군,60-64세,6027,3126,2901
202105,42730,강원도,횡성군,60-64세,6042,3139,2903
202106,42730,강원도,횡성군,60-64세,6092,3161,2931
202007,42730,강원도,횡성군,65-69세,4060,2141,1919
202008,42730,강원도,횡성군,65-69세,4109,2173,1936
202009,42730,강원도,횡성군,65-69세,4164,2201,1963
202010,42730,강원도,횡성군,65-69세,4216,2237,1979
202011,42730,강원도,횡성군,65-69세,4252,2252,2000
202012,42730,강원도,횡성군,65-69세,4309,2262,2047
202101,42730,강원도,횡성군,65-69세,4357,2281,2076
202102,42730,강원도,횡성군,65-69세,4411,2301,2110
202103,42730,강원도,횡성군,65-69세,4452,2335,2117
202104,42730,강원도,횡성군,65-69세,4539,2390,2149
202105,42730,강원도,횡성군,65-69세,4611,2437,2174
202106,42730,강원도,횡성군,65-69세,4657,2457,2200
202007,42730,강원도,횡성군,70-74세,2852,1455,1397
202008,42730,강원도,횡성군,70-74세,2849,1456,1393
202009,42730,강원도,횡성군,70-74세,2853,1453,1400
202010,42730,강원도,횡성군,70-74세,2849,1448,1401
202011,42730,강원도,횡성군,70-74세,2834,1443,1391
202012,42730,강원도,횡성군,70-74세,2846,1457,1389
202101,42730,강원도,횡성군,70-74세,2851,1463,1388
202102,42730,강원도,횡성군,70-74세,2878,1480,1398
202103,42730,강원도,횡성군,70-74세,2862,1470,1392
202104,42730,강원도,횡성군,70-74세,2874,1481,1393
202105,42730,강원도,횡성군,70-74세,2875,1475,1400
202106,42730,강원도,횡성군,70-74세,2867,1482,1385
202007,42730,강원도,횡성군,75-79세,2785,1260,1525
202008,42730,강원도,횡성군,75-79세,2794,1263,1531
202009,42730,강원도,횡성군,75-79세,2789,1269,1520
202010,42730,강원도,횡성군,75-79세,2767,1257,1510
202011,42730,강원도,횡성군,75-79세,2767,1256,1511
202012,42730,강원도,횡성군,75-79세,2746,1239,1507
202101,42730,강원도,횡성군,75-79세,2737,1243,1494
202102,42730,강원도,횡성군,75-79세,2704,1234,1470
202103,42730,강원도,횡성군,75-79세,2681,1223,1458
202104,42730,강원도,횡성군,75-79세,2665,1214,1451
202105,42730,강원도,횡성군,75-79세,2659,1215,1444
202106,42730,강원도,횡성군,75-79세,2629,1197,1432
202007,42730,강원도,횡성군,80-84세,2142,885,1257
202008,42730,강원도,횡성군,80-84세,2141,890,1251
202009,42730,강원도,횡성군,80-84세,2151,892,1259
202010,42730,강원도,횡성군,80-84세,2177,904,1273
202011,42730,강원도,횡성군,80-84세,2200,912,1288
202012,42730,강원도,횡성군,80-84세,2216,924,1292
202101,42730,강원도,횡성군,80-84세,2223,924,1299
202102,42730,강원도,횡성군,80-84세,2253,936,1317
202103,42730,강원도,횡성군,80-84세,2226,921,1305
202104,42730,강원도,횡성군,80-84세,2233,918,1315
202105,42730,강원도,횡성군,80-84세,2248,927,1321
202106,42730,강원도,횡성군,80-84세,2273,929,1344
202007,42730,강원도,횡성군,85-89세,992,259,733
202008,42730,강원도,횡성군,85-89세,998,257,741
202009,42730,강원도,횡성군,85-89세,1015,261,754
202010,42730,강원도,횡성군,85-89세,1020,268,752
202011,42730,강원도,횡성군,85-89세,1020,266,754
202012,42730,강원도,횡성군,85-89세,1026,276,750
202101,42730,강원도,횡성군,85-89세,1048,284,764
202102,42730,강원도,횡성군,85-89세,1067,293,774
202103,42730,강원도,횡성군,85-89세,1093,306,787
202104,42730,강원도,횡성군,85-89세,1112,314,798
202105,42730,강원도,횡성군,85-89세,1114,318,796
202106,42730,강원도,횡성군,85-89세,1124,327,797
202007,42730,강원도,횡성군,90-94세,406,93,313
202008,42730,강원도,횡성군,90-94세,408,96,312
202009,42730,강원도,횡성군,90-94세,408,95,313
202010,42730,강원도,횡성군,90-94세,421,98,323
202011,42730,강원도,횡성군,90-94세,417,96,321
202012,42730,강원도,횡성군,90-94세,419,94,325
202101,42730,강원도,횡성군,90-94세,427,95,332
202102,42730,강원도,횡성군,90-94세,421,95,326
202103,42730,강원도,횡성군,90-94세,420,91,329
202104,42730,강원도,횡성군,90-94세,419,91,328
202105,42730,강원도,횡성군,90-94세,430,91,339
202106,42730,강원도,횡성군,90-94세,433,94,339
202007,42730,강원도,횡성군,95-99세,104,27,77
202008,42730,강원도,횡성군,95-99세,107,29,78
202009,42730,강원도,횡성군,95-99세,107,29,78
202010,42730,강원도,횡성군,95-99세,102,29,73
202011,42730,강원도,횡성군,95-99세,107,30,77
202012,42730,강원도,횡성군,95-99세,104,29,75
202101,42730,강원도,횡성군,95-99세,102,29,73
202102,42730,강원도,횡성군,95-99세,102,27,75
202103,42730,강원도,횡성군,95-99세,96,25,71
202104,42730,강원도,횡성군,95-99세,102,24,78
202105,42730,강원도,횡성군,95-99세,106,25,81
202106,42730,강원도,횡성군,95-99세,106,24,82
202007,42730,강원도,횡성군,100+,32,11,21
202008,42730,강원도,횡성군,100+,33,11,22
202009,42730,강원도,횡성군,100+,33,11,22
202010,42730,강원도,횡성군,100+,32,10,22
202011,42730,강원도,횡성군,100+,32,10,22
202012,42730,강원도,횡성군,100+,35,10,25
202101,42730,강원도,횡성군,100+,36,10,26
202102,42730,강원도,횡성군,100+,37,10,27
202103,42730,강원도,횡성군,100+,26,4,22
202104,42730,강원도,횡성군,100+,27,4,23
202105,42730,강원도,횡성군,100+,27,4,23
202106,42730,강원도,횡성군,100+,28,4,24
202007,42750,강원도,영월군,0-4세,710,380,330
202008,42750,강원도,영월군,0-4세,695,372,323
202009,42750,강원도,영월군,0-4세,691,373,318
202010,42750,강원도,영월군,0-4세,687,372,315
202011,42750,강원도,영월군,0-4세,683,361,322
202012,42750,강원도,영월군,0-4세,685,357,328
202101,42750,강원도,영월군,0-4세,688,361,327
202102,42750,강원도,영월군,0-4세,681,360,321
202103,42750,강원도,영월군,0-4세,673,347,326
202104,42750,강원도,영월군,0-4세,670,343,327
202105,42750,강원도,영월군,0-4세,660,341,319
202106,42750,강원도,영월군,0-4세,657,336,321
202007,42750,강원도,영월군,5-9세,1004,533,471
202008,42750,강원도,영월군,5-9세,1011,536,475
202009,42750,강원도,영월군,5-9세,1012,533,479
202010,42750,강원도,영월군,5-9세,1014,535,479
202011,42750,강원도,영월군,5-9세,1003,538,465
202012,42750,강원도,영월군,5-9세,992,532,460
202101,42750,강원도,영월군,5-9세,983,531,452
202102,42750,강원도,영월군,5-9세,972,521,451
202103,42750,강원도,영월군,5-9세,968,517,451
202104,42750,강원도,영월군,5-9세,962,515,447
202105,42750,강원도,영월군,5-9세,960,513,447
202106,42750,강원도,영월군,5-9세,952,508,444
202007,42750,강원도,영월군,10-14세,1168,615,553
202008,42750,강원도,영월군,10-14세,1175,618,557
202009,42750,강원도,영월군,10-14세,1171,611,560
202010,42750,강원도,영월군,10-14세,1163,606,557
202011,42750,강원도,영월군,10-14세,1162,607,555
202012,42750,강원도,영월군,10-14세,1157,610,547
202101,42750,강원도,영월군,10-14세,1148,602,546
202102,42750,강원도,영월군,10-14세,1145,603,542
202103,42750,강원도,영월군,10-14세,1141,607,534
202104,42750,강원도,영월군,10-14세,1139,602,537
202105,42750,강원도,영월군,10-14세,1144,603,541
202106,42750,강원도,영월군,10-14세,1150,611,539
202007,42750,강원도,영월군,15-19세,1827,993,834
202008,42750,강원도,영월군,15-19세,1796,981,815
202009,42750,강원도,영월군,15-19세,1765,966,799
202010,42750,강원도,영월군,15-19세,1759,957,802
202011,42750,강원도,영월군,15-19세,1746,942,804
202012,42750,강원도,영월군,15-19세,1712,926,786
202101,42750,강원도,영월군,15-19세,1672,911,761
202102,42750,강원도,영월군,15-19세,1663,916,747
202103,42750,강원도,영월군,15-19세,1793,989,804
202104,42750,강원도,영월군,15-19세,1776,982,794
202105,42750,강원도,영월군,15-19세,1749,970,779
202106,42750,강원도,영월군,15-19세,1731,951,780
202007,42750,강원도,영월군,20-24세,1926,1067,859
202008,42750,강원도,영월군,20-24세,1924,1070,854
202009,42750,강원도,영월군,20-24세,1922,1069,853
202010,42750,강원도,영월군,20-24세,1933,1078,855
202011,42750,강원도,영월군,20-24세,1953,1088,865
202012,42750,강원도,영월군,20-24세,1940,1085,855
202101,42750,강원도,영월군,20-24세,1921,1076,845
202102,42750,강원도,영월군,20-24세,1878,1046,832
202103,42750,강원도,영월군,20-24세,1857,1047,810
202104,42750,강원도,영월군,20-24세,1844,1044,800
202105,42750,강원도,영월군,20-24세,1855,1050,805
202106,42750,강원도,영월군,20-24세,1854,1052,802
202007,42750,강원도,영월군,25-29세,1378,829,549
202008,42750,강원도,영월군,25-29세,1378,830,548
202009,42750,강원도,영월군,25-29세,1362,817,545
202010,42750,강원도,영월군,25-29세,1379,832,547
202011,42750,강원도,영월군,25-29세,1369,828,541
202012,42750,강원도,영월군,25-29세,1371,833,538
202101,42750,강원도,영월군,25-29세,1351,815,536
202102,42750,강원도,영월군,25-29세,1325,802,523
202103,42750,강원도,영월군,25-29세,1326,808,518
202104,42750,강원도,영월군,25-29세,1309,793,516
202105,42750,강원도,영월군,25-29세,1285,780,505
202106,42750,강원도,영월군,25-29세,1277,770,507
202007,42750,강원도,영월군,30-34세,1235,688,547
202008,42750,강원도,영월군,30-34세,1227,683,544
202009,42750,강원도,영월군,30-34세,1222,686,536
202010,42750,강원도,영월군,30-34세,1188,662,526
202011,42750,강원도,영월군,30-34세,1187,659,528
202012,42750,강원도,영월군,30-34세,1199,666,533
202101,42750,강원도,영월군,30-34세,1199,669,530
202102,42750,강원도,영월군,30-34세,1187,657,530
202103,42750,강원도,영월군,30-34세,1185,655,530
202104,42750,강원도,영월군,30-34세,1186,653,533
202105,42750,강원도,영월군,30-34세,1180,649,531
202106,42750,강원도,영월군,30-34세,1175,650,525
202007,42750,강원도,영월군,35-39세,1624,876,748
202008,42750,강원도,영월군,35-39세,1623,876,747
202009,42750,강원도,영월군,35-39세,1614,871,743
202010,42750,강원도,영월군,35-39세,1602,869,733
202011,42750,강원도,영월군,35-39세,1594,859,735
202012,42750,강원도,영월군,35-39세,1581,852,729
202101,42750,강원도,영월군,35-39세,1572,844,728
202102,42750,강원도,영월군,35-39세,1555,836,719
202103,42750,강원도,영월군,35-39세,1540,826,714
202104,42750,강원도,영월군,35-39세,1538,824,714
202105,42750,강원도,영월군,35-39세,1523,818,705
202106,42750,강원도,영월군,35-39세,1523,818,705
202007,42750,강원도,영월군,40-44세,1938,1057,881
202008,42750,강원도,영월군,40-44세,1940,1058,882
202009,42750,강원도,영월군,40-44세,1934,1048,886
202010,42750,강원도,영월군,40-44세,1948,1051,897
202011,42750,강원도,영월군,40-44세,1944,1057,887
202012,42750,강원도,영월군,40-44세,1945,1064,881
202101,42750,강원도,영월군,40-44세,1927,1049,878
202102,42750,강원도,영월군,40-44세,1912,1042,870
202103,42750,강원도,영월군,40-44세,1895,1032,863
202104,42750,강원도,영월군,40-44세,1889,1026,863
202105,42750,강원도,영월군,40-44세,1857,1002,855
202106,42750,강원도,영월군,40-44세,1849,995,854
202007,42750,강원도,영월군,45-49세,2784,1550,1234
202008,42750,강원도,영월군,45-49세,2742,1520,1222
202009,42750,강원도,영월군,45-49세,2720,1508,1212
202010,42750,강원도,영월군,45-49세,2711,1504,1207
202011,42750,강원도,영월군,45-49세,2691,1484,1207
202012,42750,강원도,영월군,45-49세,2669,1471,1198
202101,42750,강원도,영월군,45-49세,2644,1453,1191
202102,42750,강원도,영월군,45-49세,2639,1449,1190
202103,42750,강원도,영월군,45-49세,2615,1436,1179
202104,42750,강원도,영월군,45-49세,2614,1433,1181
202105,42750,강원도,영월군,45-49세,2553,1397,1156
202106,42750,강원도,영월군,45-49세,2540,1386,1154
202007,42750,강원도,영월군,50-54세,3421,1916,1505
202008,42750,강원도,영월군,50-54세,3433,1930,1503
202009,42750,강원도,영월군,50-54세,3428,1928,1500
202010,42750,강원도,영월군,50-54세,3428,1929,1499
202011,42750,강원도,영월군,50-54세,3443,1938,1505
202012,42750,강원도,영월군,50-54세,3429,1928,1501
202101,42750,강원도,영월군,50-54세,3437,1936,1501
202102,42750,강원도,영월군,50-54세,3390,1911,1479
202103,42750,강원도,영월군,50-54세,3346,1877,1469
202104,42750,강원도,영월군,50-54세,3335,1873,1462
202105,42750,강원도,영월군,50-54세,3331,1877,1454
202106,42750,강원도,영월군,50-54세,3325,1875,1450
202007,42750,강원도,영월군,55-59세,4015,2174,1841
202008,42750,강원도,영월군,55-59세,3991,2163,1828
202009,42750,강원도,영월군,55-59세,3978,2167,1811
202010,42750,강원도,영월군,55-59세,3958,2162,1796
202011,42750,강원도,영월군,55-59세,3954,2153,1801
202012,42750,강원도,영월군,55-59세,3935,2143,1792
202101,42750,강원도,영월군,55-59세,3889,2124,1765
202102,42750,강원도,영월군,55-59세,3886,2127,1759
202103,42750,강원도,영월군,55-59세,3905,2149,1756
202104,42750,강원도,영월군,55-59세,3882,2137,1745
202105,42750,강원도,영월군,55-59세,3829,2113,1716
202106,42750,강원도,영월군,55-59세,3809,2100,1709
202007,42750,강원도,영월군,60-64세,4443,2348,2095
202008,42750,강원도,영월군,60-64세,4477,2356,2121
202009,42750,강원도,영월군,60-64세,4500,2370,2130
202010,42750,강원도,영월군,60-64세,4504,2366,2138
202011,42750,강원도,영월군,60-64세,4513,2387,2126
202012,42750,강원도,영월군,60-64세,4549,2405,2144
202101,42750,강원도,영월군,60-64세,4583,2411,2172
202102,42750,강원도,영월군,60-64세,4597,2414,2183
202103,42750,강원도,영월군,60-64세,4604,2414,2190
202104,42750,강원도,영월군,60-64세,4608,2415,2193
202105,42750,강원도,영월군,60-64세,4598,2425,2173
202106,42750,강원도,영월군,60-64세,4620,2448,2172
202007,42750,강원도,영월군,65-69세,3440,1755,1685
202008,42750,강원도,영월군,65-69세,3454,1763,1691
202009,42750,강원도,영월군,65-69세,3462,1769,1693
202010,42750,강원도,영월군,65-69세,3492,1793,1699
202011,42750,강원도,영월군,65-69세,3526,1807,1719
202012,42750,강원도,영월군,65-69세,3542,1819,1723
202101,42750,강원도,영월군,65-69세,3552,1828,1724
202102,42750,강원도,영월군,65-69세,3576,1848,1728
202103,42750,강원도,영월군,65-69세,3618,1872,1746
202104,42750,강원도,영월군,65-69세,3662,1901,1761
202105,42750,강원도,영월군,65-69세,3642,1911,1731
202106,42750,강원도,영월군,65-69세,3667,1923,1744
202007,42750,강원도,영월군,70-74세,2406,1161,1245
202008,42750,강원도,영월군,70-74세,2406,1155,1251
202009,42750,강원도,영월군,70-74세,2422,1158,1264
202010,42750,강원도,영월군,70-74세,2438,1168,1270
202011,42750,강원도,영월군,70-74세,2437,1169,1268
202012,42750,강원도,영월군,70-74세,2453,1181,1272
202101,42750,강원도,영월군,70-74세,2486,1203,1283
202102,42750,강원도,영월군,70-74세,2487,1198,1289
202103,42750,강원도,영월군,70-74세,2476,1196,1280
202104,42750,강원도,영월군,70-74세,2479,1190,1289
202105,42750,강원도,영월군,70-74세,2462,1188,1274
202106,42750,강원도,영월군,70-74세,2456,1186,1270
202007,42750,강원도,영월군,75-79세,2486,1065,1421
202008,42750,강원도,영월군,75-79세,2479,1063,1416
202009,42750,강원도,영월군,75-79세,2452,1049,1403
202010,42750,강원도,영월군,75-79세,2436,1043,1393
202011,42750,강원도,영월군,75-79세,2417,1036,1381
202012,42750,강원도,영월군,75-79세,2381,1010,1371
202101,42750,강원도,영월군,75-79세,2372,1009,1363
202102,42750,강원도,영월군,75-79세,2352,1009,1343
202103,42750,강원도,영월군,75-79세,2354,1010,1344
202104,42750,강원도,영월군,75-79세,2343,1007,1336
202105,42750,강원도,영월군,75-79세,2319,997,1322
202106,42750,강원도,영월군,75-79세,2305,989,1316
202007,42750,강원도,영월군,80-84세,1791,699,1092
202008,42750,강원도,영월군,80-84세,1795,703,1092
202009,42750,강원도,영월군,80-84세,1820,721,1099
202010,42750,강원도,영월군,80-84세,1838,726,1112
202011,42750,강원도,영월군,80-84세,1842,730,1112
202012,42750,강원도,영월군,80-84세,1854,740,1114
202101,42750,강원도,영월군,80-84세,1865,741,1124
202102,42750,강원도,영월군,80-84세,1887,741,1146
202103,42750,강원도,영월군,80-84세,1888,742,1146
202104,42750,강원도,영월군,80-84세,1903,752,1151
202105,42750,강원도,영월군,80-84세,1900,749,1151
202106,42750,강원도,영월군,80-84세,1902,749,1153
202007,42750,강원도,영월군,85-89세,824,232,592
202008,42750,강원도,영월군,85-89세,829,237,592
202009,42750,강원도,영월군,85-89세,823,234,589
202010,42750,강원도,영월군,85-89세,829,239,590
202011,42750,강원도,영월군,85-89세,843,243,600
202012,42750,강원도,영월군,85-89세,861,249,612
202101,42750,강원도,영월군,85-89세,870,257,613
202102,42750,강원도,영월군,85-89세,877,264,613
202103,42750,강원도,영월군,85-89세,889,259,630
202104,42750,강원도,영월군,85-89세,894,259,635
202105,42750,강원도,영월군,85-89세,887,256,631
202106,42750,강원도,영월군,85-89세,894,259,635
202007,42750,강원도,영월군,90-94세,276,69,207
202008,42750,강원도,영월군,90-94세,274,68,206
202009,42750,강원도,영월군,90-94세,275,67,208
202010,42750,강원도,영월군,90-94세,280,66,214
202011,42750,강원도,영월군,90-94세,277,67,210
202012,42750,강원도,영월군,90-94세,282,71,211
202101,42750,강원도,영월군,90-94세,278,70,208
202102,42750,강원도,영월군,90-94세,281,74,207
202103,42750,강원도,영월군,90-94세,280,76,204
202104,42750,강원도,영월군,90-94세,282,75,207
202105,42750,강원도,영월군,90-94세,273,73,200
202106,42750,강원도,영월군,90-94세,280,74,206
202007,42750,강원도,영월군,95-99세,72,27,45
202008,42750,강원도,영월군,95-99세,73,26,47
202009,42750,강원도,영월군,95-99세,72,26,46
202010,42750,강원도,영월군,95-99세,73,28,45
202011,42750,강원도,영월군,95-99세,74,28,46
202012,42750,강원도,영월군,95-99세,73,28,45
202101,42750,강원도,영월군,95-99세,76,29,47
202102,42750,강원도,영월군,95-99세,77,28,49
202103,42750,강원도,영월군,95-99세,78,26,52
202104,42750,강원도,영월군,95-99세,77,26,51
202105,42750,강원도,영월군,95-99세,70,23,47
202106,42750,강원도,영월군,95-99세,70,23,47
202007,42750,강원도,영월군,100+,50,14,36
202008,42750,강원도,영월군,100+,51,15,36
202009,42750,강원도,영월군,100+,53,16,37
202010,42750,강원도,영월군,100+,52,16,36
202011,42750,강원도,영월군,100+,52,16,36
202012,42750,강원도,영월군,100+,52,16,36
202101,42750,강원도,영월군,100+,52,16,36
202102,42750,강원도,영월군,100+,51,17,34
202103,42750,강원도,영월군,100+,27,10,17
202104,42750,강원도,영월군,100+,25,9,16
202105,42750,강원도,영월군,100+,22,8,14
202106,42750,강원도,영월군,100+,21,8,13
202007,42760,강원도,평창군,0-4세,798,391,407
202008,42760,강원도,평창군,0-4세,793,387,406
202009,42760,강원도,평창군,0-4세,790,388,402
202010,42760,강원도,평창군,0-4세,781,381,400
202011,42760,강원도,평창군,0-4세,763,374,389
202012,42760,강원도,평창군,0-4세,750,368,382
202101,42760,강원도,평창군,0-4세,741,358,383
202102,42760,강원도,평창군,0-4세,734,362,372
202103,42760,강원도,평창군,0-4세,730,359,371
202104,42760,강원도,평창군,0-4세,727,355,372
202105,42760,강원도,평창군,0-4세,722,349,373
202106,42760,강원도,평창군,0-4세,711,348,363
202007,42760,강원도,평창군,5-9세,1147,572,575
202008,42760,강원도,평창군,5-9세,1137,572,565
202009,42760,강원도,평창군,5-9세,1128,567,561
202010,42760,강원도,평창군,5-9세,1127,566,561
202011,42760,강원도,평창군,5-9세,1122,560,562
202012,42760,강원도,평창군,5-9세,1118,552,566
202101,42760,강원도,평창군,5-9세,1111,548,563
202102,42760,강원도,평창군,5-9세,1107,549,558
202103,42760,강원도,평창군,5-9세,1106,554,552
202104,42760,강원도,평창군,5-9세,1099,551,548
202105,42760,강원도,평창군,5-9세,1085,550,535
202106,42760,강원도,평창군,5-9세,1088,548,540
202007,42760,강원도,평창군,10-14세,1352,714,638
202008,42760,강원도,평창군,10-14세,1363,716,647
202009,42760,강원도,평창군,10-14세,1359,718,641
202010,42760,강원도,평창군,10-14세,1367,721,646
202011,42760,강원도,평창군,10-14세,1362,719,643
202012,42760,강원도,평창군,10-14세,1361,723,638
202101,42760,강원도,평창군,10-14세,1346,713,633
202102,42760,강원도,평창군,10-14세,1337,703,634
202103,42760,강원도,평창군,10-14세,1328,696,632
202104,42760,강원도,평창군,10-14세,1331,694,637
202105,42760,강원도,평창군,10-14세,1332,694,638
202106,42760,강원도,평창군,10-14세,1325,691,634
202007,42760,강원도,평창군,15-19세,1604,850,754
202008,42760,강원도,평창군,15-19세,1607,851,756
202009,42760,강원도,평창군,15-19세,1589,841,748
202010,42760,강원도,평창군,15-19세,1568,830,738
202011,42760,강원도,평창군,15-19세,1565,825,740
202012,42760,강원도,평창군,15-19세,1546,814,732
202101,42760,강원도,평창군,15-19세,1533,808,725
202102,42760,강원도,평창군,15-19세,1526,804,722
202103,42760,강원도,평창군,15-19세,1497,793,704
202104,42760,강원도,평창군,15-19세,1479,784,695
202105,42760,강원도,평창군,15-19세,1478,779,699
202106,42760,강원도,평창군,15-19세,1475,775,700
202007,42760,강원도,평창군,20-24세,1869,1071,798
202008,42760,강원도,평창군,20-24세,1866,1072,794
202009,42760,강원도,평창군,20-24세,1856,1059,797
202010,42760,강원도,평창군,20-24세,1858,1064,794
202011,42760,강원도,평창군,20-24세,1852,1066,786
202012,42760,강원도,평창군,20-24세,1861,1069,792
202101,42760,강원도,평창군,20-24세,1847,1069,778
202102,42760,강원도,평창군,20-24세,1818,1062,756
202103,42760,강원도,평창군,20-24세,1810,1062,748
202104,42760,강원도,평창군,20-24세,1812,1060,752
202105,42760,강원도,평창군,20-24세,1803,1058,745
202106,42760,강원도,평창군,20-24세,1793,1056,737
202007,42760,강원도,평창군,25-29세,1516,886,630
202008,42760,강원도,평창군,25-29세,1511,884,627
202009,42760,강원도,평창군,25-29세,1519,887,632
202010,42760,강원도,평창군,25-29세,1530,893,637
202011,42760,강원도,평창군,25-29세,1553,908,645
202012,42760,강원도,평창군,25-29세,1554,923,631
202101,42760,강원도,평창군,25-29세,1543,928,615
202102,42760,강원도,평창군,25-29세,1535,925,610
202103,42760,강원도,평창군,25-29세,1536,925,611
202104,42760,강원도,평창군,25-29세,1525,922,603
202105,42760,강원도,평창군,25-29세,1512,908,604
202106,42760,강원도,평창군,25-29세,1497,894,603
202007,42760,강원도,평창군,30-34세,1386,756,630
202008,42760,강원도,평창군,30-34세,1386,753,633
202009,42760,강원도,평창군,30-34세,1373,748,625
202010,42760,강원도,평창군,30-34세,1357,740,617
202011,42760,강원도,평창군,30-34세,1346,738,608
202012,42760,강원도,평창군,30-34세,1367,746,621
202101,42760,강원도,평창군,30-34세,1362,747,615
202102,42760,강원도,평창군,30-34세,1348,743,605
202103,42760,강원도,평창군,30-34세,1340,736,604
202104,42760,강원도,평창군,30-34세,1330,733,597
202105,42760,강원도,평창군,30-34세,1329,730,599
202106,42760,강원도,평창군,30-34세,1330,737,593
202007,42760,강원도,평창군,35-39세,1831,988,843
202008,42760,강원도,평창군,35-39세,1803,971,832
202009,42760,강원도,평창군,35-39세,1779,960,819
202010,42760,강원도,평창군,35-39세,1769,955,814
202011,42760,강원도,평창군,35-39세,1757,940,817
202012,42760,강원도,평창군,35-39세,1731,918,813
202101,42760,강원도,평창군,35-39세,1714,905,809
202102,42760,강원도,평창군,35-39세,1704,909,795
202103,42760,강원도,평창군,35-39세,1663,889,774
202104,42760,강원도,평창군,35-39세,1644,871,773
202105,42760,강원도,평창군,35-39세,1627,862,765
202106,42760,강원도,평창군,35-39세,1606,850,756
202007,42760,강원도,평창군,40-44세,2274,1240,1034
202008,42760,강원도,평창군,40-44세,2281,1235,1046
202009,42760,강원도,평창군,40-44세,2295,1239,1056
202010,42760,강원도,평창군,40-44세,2299,1238,1061
202011,42760,강원도,평창군,40-44세,2271,1225,1046
202012,42760,강원도,평창군,40-44세,2276,1237,1039
202101,42760,강원도,평창군,40-44세,2253,1223,1030
202102,42760,강원도,평창군,40-44세,2240,1205,1035
202103,42760,강원도,평창군,40-44세,2214,1184,1030
202104,42760,강원도,평창군,40-44세,2221,1192,1029
202105,42760,강원도,평창군,40-44세,2219,1188,1031
202106,42760,강원도,평창군,40-44세,2238,1202,1036
202007,42760,강원도,평창군,45-49세,3122,1712,1410
202008,42760,강원도,평창군,45-49세,3111,1709,1402
202009,42760,강원도,평창군,45-49세,3086,1701,1385
202010,42760,강원도,평창군,45-49세,3078,1694,1384
202011,42760,강원도,평창군,45-49세,3090,1695,1395
202012,42760,강원도,평창군,45-49세,3065,1673,1392
202101,42760,강원도,평창군,45-49세,3059,1677,1382
202102,42760,강원도,평창군,45-49세,3051,1678,1373
202103,42760,강원도,평창군,45-49세,3004,1659,1345
202104,42760,강원도,평창군,45-49세,3001,1660,1341
202105,42760,강원도,평창군,45-49세,2956,1636,1320
202106,42760,강원도,평창군,45-49세,2937,1623,1314
202007,42760,강원도,평창군,50-54세,3759,2055,1704
202008,42760,강원도,평창군,50-54세,3758,2052,1706
202009,42760,강원도,평창군,50-54세,3752,2041,1711
202010,42760,강원도,평창군,50-54세,3734,2028,1706
202011,42760,강원도,평창군,50-54세,3726,2033,1693
202012,42760,강원도,평창군,50-54세,3727,2032,1695
202101,42760,강원도,평창군,50-54세,3730,2028,1702
202102,42760,강원도,평창군,50-54세,3733,2033,1700
202103,42760,강원도,평창군,50-54세,3650,1983,1667
202104,42760,강원도,평창군,50-54세,3636,1986,1650
202105,42760,강원도,평창군,50-54세,3676,2007,1669
202106,42760,강원도,평창군,50-54세,3671,2009,1662
202007,42760,강원도,평창군,55-59세,4391,2288,2103
202008,42760,강원도,평창군,55-59세,4398,2303,2095
202009,42760,강원도,평창군,55-59세,4390,2297,2093
202010,42760,강원도,평창군,55-59세,4382,2298,2084
202011,42760,강원도,평창군,55-59세,4354,2279,2075
202012,42760,강원도,평창군,55-59세,4353,2291,2062
202101,42760,강원도,평창군,55-59세,4289,2252,2037
202102,42760,강원도,평창군,55-59세,4252,2239,2013
202103,42760,강원도,평창군,55-59세,4243,2245,1998
202104,42760,강원도,평창군,55-59세,4233,2240,1993
202105,42760,강원도,평창군,55-59세,4220,2242,1978
202106,42760,강원도,평창군,55-59세,4159,2201,1958
202007,42760,강원도,평창군,60-64세,5016,2631,2385
202008,42760,강원도,평창군,60-64세,5040,2642,2398
202009,42760,강원도,평창군,60-64세,5066,2655,2411
202010,42760,강원도,평창군,60-64세,5097,2672,2425
202011,42760,강원도,평창군,60-64세,5121,2690,2431
202012,42760,강원도,평창군,60-64세,5141,2695,2446
202101,42760,강원도,평창군,60-64세,5186,2714,2472
202102,42760,강원도,평창군,60-64세,5201,2727,2474
202103,42760,강원도,평창군,60-64세,5193,2731,2462
202104,42760,강원도,평창군,60-64세,5200,2729,2471
202105,42760,강원도,평창군,60-64세,5229,2736,2493
202106,42760,강원도,평창군,60-64세,5277,2772,2505
202007,42760,강원도,평창군,65-69세,3606,1832,1774
202008,42760,강원도,평창군,65-69세,3633,1851,1782
202009,42760,강원도,평창군,65-69세,3657,1866,1791
202010,42760,강원도,평창군,65-69세,3681,1883,1798
202011,42760,강원도,평창군,65-69세,3700,1893,1807
202012,42760,강원도,평창군,65-69세,3735,1908,1827
202101,42760,강원도,평창군,65-69세,3743,1921,1822
202102,42760,강원도,평창군,65-69세,3778,1939,1839
202103,42760,강원도,평창군,65-69세,3821,1973,1848
202104,42760,강원도,평창군,65-69세,3859,2002,1857
202105,42760,강원도,평창군,65-69세,3880,2016,1864
202106,42760,강원도,평창군,65-69세,3909,2031,1878
202007,42760,강원도,평창군,70-74세,2598,1248,1350
202008,42760,강원도,평창군,70-74세,2598,1252,1346
202009,42760,강원도,평창군,70-74세,2588,1247,1341
202010,42760,강원도,평창군,70-74세,2592,1254,1338
202011,42760,강원도,평창군,70-74세,2602,1260,1342
202012,42760,강원도,평창군,70-74세,2607,1265,1342
202101,42760,강원도,평창군,70-74세,2628,1270,1358
202102,42760,강원도,평창군,70-74세,2634,1264,1370
202103,42760,강원도,평창군,70-74세,2624,1265,1359
202104,42760,강원도,평창군,70-74세,2624,1256,1368
202105,42760,강원도,평창군,70-74세,2639,1267,1372
202106,42760,강원도,평창군,70-74세,2633,1272,1361
202007,42760,강원도,평창군,75-79세,2448,1087,1361
202008,42760,강원도,평창군,75-79세,2440,1072,1368
202009,42760,강원도,평창군,75-79세,2432,1069,1363
202010,42760,강원도,평창군,75-79세,2413,1061,1352
202011,42760,강원도,평창군,75-79세,2399,1060,1339
202012,42760,강원도,평창군,75-79세,2381,1062,1319
202101,42760,강원도,평창군,75-79세,2385,1068,1317
202102,42760,강원도,평창군,75-79세,2360,1055,1305
202103,42760,강원도,평창군,75-79세,2314,1034,1280
202104,42760,강원도,평창군,75-79세,2305,1033,1272
202105,42760,강원도,평창군,75-79세,2280,1023,1257
202106,42760,강원도,평창군,75-79세,2267,1016,1251
202007,42760,강원도,평창군,80-84세,1852,730,1122
202008,42760,강원도,평창군,80-84세,1876,750,1126
202009,42760,강원도,평창군,80-84세,1887,750,1137
202010,42760,강원도,평창군,80-84세,1899,753,1146
202011,42760,강원도,평창군,80-84세,1893,745,1148
202012,42760,강원도,평창군,80-84세,1904,743,1161
202101,42760,강원도,평창군,80-84세,1896,739,1157
202102,42760,강원도,평창군,80-84세,1916,759,1157
202103,42760,강원도,평창군,80-84세,1917,758,1159
202104,42760,강원도,평창군,80-84세,1937,768,1169
202105,42760,강원도,평창군,80-84세,1945,772,1173
202106,42760,강원도,평창군,80-84세,1958,776,1182
202007,42760,강원도,평창군,85-89세,749,193,556
202008,42760,강원도,평창군,85-89세,750,193,557
202009,42760,강원도,평창군,85-89세,758,202,556
202010,42760,강원도,평창군,85-89세,770,207,563
202011,42760,강원도,평창군,85-89세,784,211,573
202012,42760,강원도,평창군,85-89세,797,216,581
202101,42760,강원도,평창군,85-89세,810,224,586
202102,42760,강원도,평창군,85-89세,823,227,596
202103,42760,강원도,평창군,85-89세,836,229,607
202104,42760,강원도,평창군,85-89세,841,229,612
202105,42760,강원도,평창군,85-89세,850,232,618
202106,42760,강원도,평창군,85-89세,848,235,613
202007,42760,강원도,평창군,90-94세,258,49,209
202008,42760,강원도,평창군,90-94세,259,49,210
202009,42760,강원도,평창군,90-94세,271,50,221
202010,42760,강원도,평창군,90-94세,276,51,225
202011,42760,강원도,평창군,90-94세,276,51,225
202012,42760,강원도,평창군,90-94세,278,52,226
202101,42760,강원도,평창군,90-94세,284,52,232
202102,42760,강원도,평창군,90-94세,288,54,234
202103,42760,강원도,평창군,90-94세,289,54,235
202104,42760,강원도,평창군,90-94세,289,52,237
202105,42760,강원도,평창군,90-94세,287,53,234
202106,42760,강원도,평창군,90-94세,291,53,238
202007,42760,강원도,평창군,95-99세,91,26,65
202008,42760,강원도,평창군,95-99세,91,25,66
202009,42760,강원도,평창군,95-99세,89,25,64
202010,42760,강원도,평창군,95-99세,88,24,64
202011,42760,강원도,평창군,95-99세,88,23,65
202012,42760,강원도,평창군,95-99세,87,23,64
202101,42760,강원도,평창군,95-99세,86,22,64
202102,42760,강원도,평창군,95-99세,89,22,67
202103,42760,강원도,평창군,95-99세,81,18,63
202104,42760,강원도,평창군,95-99세,78,18,60
202105,42760,강원도,평창군,95-99세,77,18,59
202106,42760,강원도,평창군,95-99세,78,18,60
202007,42760,강원도,평창군,100+,42,12,30
202008,42760,강원도,평창군,100+,41,11,30
202009,42760,강원도,평창군,100+,42,11,31
202010,42760,강원도,평창군,100+,42,11,31
202011,42760,강원도,평창군,100+,41,11,30
202012,42760,강원도,평창군,100+,42,11,31
202101,42760,강원도,평창군,100+,41,10,31
202102,42760,강원도,평창군,100+,40,10,30
202103,42760,강원도,평창군,100+,16,4,12
202104,42760,강원도,평창군,100+,17,4,13
202105,42760,강원도,평창군,100+,18,4,14
202106,42760,강원도,평창군,100+,18,4,14
202007,42770,강원도,정선군,0-4세,710,361,349
202008,42770,강원도,정선군,0-4세,700,359,341
202009,42770,강원도,정선군,0-4세,699,361,338
202010,42770,강원도,정선군,0-4세,702,365,337
202011,42770,강원도,정선군,0-4세,706,363,343
202012,42770,강원도,정선군,0-4세,704,359,345
202101,42770,강원도,정선군,0-4세,701,355,346
202102,42770,강원도,정선군,0-4세,694,351,343
202103,42770,강원도,정선군,0-4세,688,344,344
202104,42770,강원도,정선군,0-4세,699,344,355
202105,42770,강원도,정선군,0-4세,694,340,354
202106,42770,강원도,정선군,0-4세,694,340,354
202007,42770,강원도,정선군,5-9세,1064,557,507
202008,42770,강원도,정선군,5-9세,1061,551,510
202009,42770,강원도,정선군,5-9세,1054,542,512
202010,42770,강원도,정선군,5-9세,1043,539,504
202011,42770,강원도,정선군,5-9세,1040,539,501
202012,42770,강원도,정선군,5-9세,1032,534,498
202101,42770,강원도,정선군,5-9세,1011,524,487
202102,42770,강원도,정선군,5-9세,1020,528,492
202103,42770,강원도,정선군,5-9세,1019,534,485
202104,42770,강원도,정선군,5-9세,1006,529,477
202105,42770,강원도,정선군,5-9세,1006,535,471
202106,42770,강원도,정선군,5-9세,1006,536,470
202007,42770,강원도,정선군,10-14세,1231,626,605
202008,42770,강원도,정선군,10-14세,1225,628,597
202009,42770,강원도,정선군,10-14세,1225,631,594
202010,42770,강원도,정선군,10-14세,1232,632,600
202011,42770,강원도,정선군,10-14세,1230,636,594
202012,42770,강원도,정선군,10-14세,1224,632,592
202101,42770,강원도,정선군,10-14세,1229,638,591
202102,42770,강원도,정선군,10-14세,1225,631,594
202103,42770,강원도,정선군,10-14세,1227,632,595
202104,42770,강원도,정선군,10-14세,1216,623,593
202105,42770,강원도,정선군,10-14세,1217,621,596
202106,42770,강원도,정선군,10-14세,1212,619,593
202007,42770,강원도,정선군,15-19세,1374,720,654
202008,42770,강원도,정선군,15-19세,1375,717,658
202009,42770,강원도,정선군,15-19세,1351,702,649
202010,42770,강원도,정선군,15-19세,1334,691,643
202011,42770,강원도,정선군,15-19세,1329,688,641
202012,42770,강원도,정선군,15-19세,1320,690,630
202101,42770,강원도,정선군,15-19세,1312,679,633
202102,42770,강원도,정선군,15-19세,1301,679,622
202103,42770,강원도,정선군,15-19세,1274,666,608
202104,42770,강원도,정선군,15-19세,1267,664,603
202105,42770,강원도,정선군,15-19세,1252,654,598
202106,42770,강원도,정선군,15-19세,1245,651,594
202007,42770,강원도,정선군,20-24세,1615,896,719
202008,42770,강원도,정선군,20-24세,1596,888,708
202009,42770,강원도,정선군,20-24세,1593,881,712
202010,42770,강원도,정선군,20-24세,1595,883,712
202011,42770,강원도,정선군,20-24세,1584,878,706
202012,42770,강원도,정선군,20-24세,1575,872,703
202101,42770,강원도,정선군,20-24세,1552,865,687
202102,42770,강원도,정선군,20-24세,1547,859,688
202103,42770,강원도,정선군,20-24세,1521,854,667
202104,42770,강원도,정선군,20-24세,1509,847,662
202105,42770,강원도,정선군,20-24세,1509,844,665
202106,42770,강원도,정선군,20-24세,1510,845,665
202007,42770,강원도,정선군,25-29세,1242,719,523
202008,42770,강원도,정선군,25-29세,1244,718,526
202009,42770,강원도,정선군,25-29세,1253,732,521
202010,42770,강원도,정선군,25-29세,1249,732,517
202011,42770,강원도,정선군,25-29세,1253,738,515
202012,42770,강원도,정선군,25-29세,1245,736,509
202101,42770,강원도,정선군,25-29세,1240,734,506
202102,42770,강원도,정선군,25-29세,1218,723,495
202103,42770,강원도,정선군,25-29세,1202,711,491
202104,42770,강원도,정선군,25-29세,1208,718,490
202105,42770,강원도,정선군,25-29세,1195,719,476
202106,42770,강원도,정선군,25-29세,1190,722,468
202007,42770,강원도,정선군,30-34세,1376,783,593
202008,42770,강원도,정선군,30-34세,1374,781,593
202009,42770,강원도,정선군,30-34세,1352,763,589
202010,42770,강원도,정선군,30-34세,1360,761,599
202011,42770,강원도,정선군,30-34세,1359,760,599
202012,42770,강원도,정선군,30-34세,1332,749,583
202101,42770,강원도,정선군,30-34세,1322,743,579
202102,42770,강원도,정선군,30-34세,1304,733,571
202103,42770,강원도,정선군,30-34세,1291,726,565
202104,42770,강원도,정선군,30-34세,1278,717,561
202105,42770,강원도,정선군,30-34세,1276,716,560
202106,42770,강원도,정선군,30-34세,1271,705,566
202007,42770,강원도,정선군,35-39세,1827,1034,793
202008,42770,강원도,정선군,35-39세,1804,1024,780
202009,42770,강원도,정선군,35-39세,1796,1022,774
202010,42770,강원도,정선군,35-39세,1766,996,770
202011,42770,강원도,정선군,35-39세,1745,981,764
202012,42770,강원도,정선군,35-39세,1746,975,771
202101,42770,강원도,정선군,35-39세,1737,969,768
202102,42770,강원도,정선군,35-39세,1724,963,761
202103,42770,강원도,정선군,35-39세,1679,937,742
202104,42770,강원도,정선군,35-39세,1666,927,739
202105,42770,강원도,정선군,35-39세,1659,920,739
202106,42770,강원도,정선군,35-39세,1636,909,727
202007,42770,강원도,정선군,40-44세,2206,1234,972
202008,42770,강원도,정선군,40-44세,2213,1242,971
202009,42770,강원도,정선군,40-44세,2222,1245,977
202010,42770,강원도,정선군,40-44세,2224,1255,969
202011,42770,강원도,정선군,40-44세,2223,1255,968
202012,42770,강원도,정선군,40-44세,2213,1250,963
202101,42770,강원도,정선군,40-44세,2185,1238,947
202102,42770,강원도,정선군,40-44세,2164,1225,939
202103,42770,강원도,정선군,40-44세,2114,1206,908
202104,42770,강원도,정선군,40-44세,2097,1202,895
202105,42770,강원도,정선군,40-44세,2097,1195,902
202106,42770,강원도,정선군,40-44세,2100,1191,909
202007,42770,강원도,정선군,45-49세,2779,1660,1119
202008,42770,강원도,정선군,45-49세,2770,1645,1125
202009,42770,강원도,정선군,45-49세,2768,1642,1126
202010,42770,강원도,정선군,45-49세,2768,1647,1121
202011,42770,강원도,정선군,45-49세,2759,1643,1116
202012,42770,강원도,정선군,45-49세,2765,1651,1114
202101,42770,강원도,정선군,45-49세,2748,1629,1119
202102,42770,강원도,정선군,45-49세,2743,1626,1117
202103,42770,강원도,정선군,45-49세,2688,1588,1100
202104,42770,강원도,정선군,45-49세,2680,1581,1099
202105,42770,강원도,정선군,45-49세,2654,1562,1092
202106,42770,강원도,정선군,45-49세,2644,1561,1083
202007,42770,강원도,정선군,50-54세,3315,1871,1444
202008,42770,강원도,정선군,50-54세,3321,1881,1440
202009,42770,강원도,정선군,50-54세,3309,1882,1427
202010,42770,강원도,정선군,50-54세,3319,1884,1435
202011,42770,강원도,정선군,50-54세,3317,1879,1438
202012,42770,강원도,정선군,50-54세,3291,1866,1425
202101,42770,강원도,정선군,50-54세,3313,1884,1429
202102,42770,강원도,정선군,50-54세,3309,1877,1432
202103,42770,강원도,정선군,50-54세,3242,1857,1385
202104,42770,강원도,정선군,50-54세,3233,1861,1372
202105,42770,강원도,정선군,50-54세,3257,1881,1376
202106,42770,강원도,정선군,50-54세,3254,1870,1384
202007,42770,강원도,정선군,55-59세,3801,2008,1793
202008,42770,강원도,정선군,55-59세,3796,2013,1783
202009,42770,강원도,정선군,55-59세,3765,1996,1769
202010,42770,강원도,정선군,55-59세,3727,1981,1746
202011,42770,강원도,정선군,55-59세,3711,1968,1743
202012,42770,강원도,정선군,55-59세,3695,1960,1735
202101,42770,강원도,정선군,55-59세,3662,1944,1718
202102,42770,강원도,정선군,55-59세,3635,1943,1692
202103,42770,강원도,정선군,55-59세,3578,1916,1662
202104,42770,강원도,정선군,55-59세,3557,1901,1656
202105,42770,강원도,정선군,55-59세,3551,1903,1648
202106,42770,강원도,정선군,55-59세,3513,1885,1628
202007,42770,강원도,정선군,60-64세,4300,2290,2010
202008,42770,강원도,정선군,60-64세,4307,2297,2010
202009,42770,강원도,정선군,60-64세,4321,2297,2024
202010,42770,강원도,정선군,60-64세,4360,2318,2042
202011,42770,강원도,정선군,60-64세,4389,2339,2050
202012,42770,강원도,정선군,60-64세,4411,2352,2059
202101,42770,강원도,정선군,60-64세,4415,2356,2059
202102,42770,강원도,정선군,60-64세,4433,2345,2088
202103,42770,강원도,정선군,60-64세,4380,2332,2048
202104,42770,강원도,정선군,60-64세,4383,2326,2057
202105,42770,강원도,정선군,60-64세,4409,2334,2075
202106,42770,강원도,정선군,60-64세,4454,2354,2100
202007,42770,강원도,정선군,65-69세,3076,1577,1499
202008,42770,강원도,정선군,65-69세,3095,1589,1506
202009,42770,강원도,정선군,65-69세,3116,1607,1509
202010,42770,강원도,정선군,65-69세,3116,1612,1504
202011,42770,강원도,정선군,65-69세,3137,1623,1514
202012,42770,강원도,정선군,65-69세,3164,1639,1525
202101,42770,강원도,정선군,65-69세,3181,1639,1542
202102,42770,강원도,정선군,65-69세,3197,1659,1538
202103,42770,강원도,정선군,65-69세,3179,1654,1525
202104,42770,강원도,정선군,65-69세,3203,1675,1528
202105,42770,강원도,정선군,65-69세,3220,1697,1523
202106,42770,강원도,정선군,65-69세,3240,1711,1529
202007,42770,강원도,정선군,70-74세,2273,1079,1194
202008,42770,강원도,정선군,70-74세,2289,1087,1202
202009,42770,강원도,정선군,70-74세,2299,1085,1214
202010,42770,강원도,정선군,70-74세,2305,1085,1220
202011,42770,강원도,정선군,70-74세,2311,1086,1225
202012,42770,강원도,정선군,70-74세,2301,1080,1221
202101,42770,강원도,정선군,70-74세,2310,1093,1217
202102,42770,강원도,정선군,70-74세,2318,1092,1226
202103,42770,강원도,정선군,70-74세,2291,1075,1216
202104,42770,강원도,정선군,70-74세,2295,1084,1211
202105,42770,강원도,정선군,70-74세,2287,1074,1213
202106,42770,강원도,정선군,70-74세,2284,1077,1207
202007,42770,강원도,정선군,75-79세,2266,963,1303
202008,42770,강원도,정선군,75-79세,2273,970,1303
202009,42770,강원도,정선군,75-79세,2249,960,1289
202010,42770,강원도,정선군,75-79세,2236,952,1284
202011,42770,강원도,정선군,75-79세,2225,949,1276
202012,42770,강원도,정선군,75-79세,2219,948,1271
202101,42770,강원도,정선군,75-79세,2217,950,1267
202102,42770,강원도,정선군,75-79세,2212,942,1270
202103,42770,강원도,정선군,75-79세,2137,909,1228
202104,42770,강원도,정선군,75-79세,2138,904,1234
202105,42770,강원도,정선군,75-79세,2143,906,1237
202106,42770,강원도,정선군,75-79세,2122,897,1225
202007,42770,강원도,정선군,80-84세,1488,558,930
202008,42770,강원도,정선군,80-84세,1495,564,931
202009,42770,강원도,정선군,80-84세,1509,569,940
202010,42770,강원도,정선군,80-84세,1532,584,948
202011,42770,강원도,정선군,80-84세,1530,585,945
202012,42770,강원도,정선군,80-84세,1533,588,945
202101,42770,강원도,정선군,80-84세,1540,595,945
202102,42770,강원도,정선군,80-84세,1550,603,947
202103,42770,강원도,정선군,80-84세,1517,578,939
202104,42770,강원도,정선군,80-84세,1521,580,941
202105,42770,강원도,정선군,80-84세,1513,583,930
202106,42770,강원도,정선군,80-84세,1522,581,941
202007,42770,강원도,정선군,85-89세,669,186,483
202008,42770,강원도,정선군,85-89세,672,186,486
202009,42770,강원도,정선군,85-89세,675,188,487
202010,42770,강원도,정선군,85-89세,677,188,489
202011,42770,강원도,정선군,85-89세,688,191,497
202012,42770,강원도,정선군,85-89세,698,193,505
202101,42770,강원도,정선군,85-89세,704,191,513
202102,42770,강원도,정선군,85-89세,708,193,515
202103,42770,강원도,정선군,85-89세,702,192,510
202104,42770,강원도,정선군,85-89세,704,190,514
202105,42770,강원도,정선군,85-89세,714,193,521
202106,42770,강원도,정선군,85-89세,721,196,525
202007,42770,강원도,정선군,90-94세,248,49,199
202008,42770,강원도,정선군,90-94세,253,49,204
202009,42770,강원도,정선군,90-94세,254,48,206
202010,42770,강원도,정선군,90-94세,259,49,210
202011,42770,강원도,정선군,90-94세,255,49,206
202012,42770,강원도,정선군,90-94세,252,50,202
202101,42770,강원도,정선군,90-94세,254,51,203
202102,42770,강원도,정선군,90-94세,252,50,202
202103,42770,강원도,정선군,90-94세,232,39,193
202104,42770,강원도,정선군,90-94세,227,39,188
202105,42770,강원도,정선군,90-94세,232,41,191
202106,42770,강원도,정선군,90-94세,226,40,186
202007,42770,강원도,정선군,95-99세,92,27,65
202008,42770,강원도,정선군,95-99세,93,26,67
202009,42770,강원도,정선군,95-99세,96,29,67
202010,42770,강원도,정선군,95-99세,96,29,67
202011,42770,강원도,정선군,95-99세,96,29,67
202012,42770,강원도,정선군,95-99세,100,30,70
202101,42770,강원도,정선군,95-99세,101,30,71
202102,42770,강원도,정선군,95-99세,100,28,72
202103,42770,강원도,정선군,95-99세,81,19,62
202104,42770,강원도,정선군,95-99세,86,18,68
202105,42770,강원도,정선군,95-99세,88,17,71
202106,42770,강원도,정선군,95-99세,90,17,73
202007,42770,강원도,정선군,100+,49,20,29
202008,42770,강원도,정선군,100+,50,20,30
202009,42770,강원도,정선군,100+,50,20,30
202010,42770,강원도,정선군,100+,50,20,30
202011,42770,강원도,정선군,100+,50,20,30
202012,42770,강원도,정선군,100+,50,20,30
202101,42770,강원도,정선군,100+,49,20,29
202102,42770,강원도,정선군,100+,50,21,29
202103,42770,강원도,정선군,100+,17,7,10
202104,42770,강원도,정선군,100+,17,7,10
202105,42770,강원도,정선군,100+,18,8,10
202106,42770,강원도,정선군,100+,18,8,10
202007,42780,강원도,철원군,0-4세,1657,836,821
202008,42780,강원도,철원군,0-4세,1664,833,831
202009,42780,강원도,철원군,0-4세,1663,841,822
202010,42780,강원도,철원군,0-4세,1662,833,829
202011,42780,강원도,철원군,0-4세,1651,832,819
202012,42780,강원도,철원군,0-4세,1651,834,817
202101,42780,강원도,철원군,0-4세,1645,826,819
202102,42780,강원도,철원군,0-4세,1622,813,809
202103,42780,강원도,철원군,0-4세,1610,804,806
202104,42780,강원도,철원군,0-4세,1612,805,807
202105,42780,강원도,철원군,0-4세,1589,799,790
202106,42780,강원도,철원군,0-4세,1575,786,789
202007,42780,강원도,철원군,5-9세,1717,877,840
202008,42780,강원도,철원군,5-9세,1709,878,831
202009,42780,강원도,철원군,5-9세,1704,871,833
202010,42780,강원도,철원군,5-9세,1695,862,833
202011,42780,강원도,철원군,5-9세,1695,859,836
202012,42780,강원도,철원군,5-9세,1714,872,842
202101,42780,강원도,철원군,5-9세,1707,864,843
202102,42780,강원도,철원군,5-9세,1708,861,847
202103,42780,강원도,철원군,5-9세,1705,865,840
202104,42780,강원도,철원군,5-9세,1699,860,839
202105,42780,강원도,철원군,5-9세,1702,855,847
202106,42780,강원도,철원군,5-9세,1688,851,837
202007,42780,강원도,철원군,10-14세,1804,947,857
202008,42780,강원도,철원군,10-14세,1804,943,861
202009,42780,강원도,철원군,10-14세,1804,944,860
202010,42780,강원도,철원군,10-14세,1800,950,850
202011,42780,강원도,철원군,10-14세,1788,938,850
202012,42780,강원도,철원군,10-14세,1783,937,846
202101,42780,강원도,철원군,10-14세,1774,935,839
202102,42780,강원도,철원군,10-14세,1756,929,827
202103,42780,강원도,철원군,10-14세,1745,923,822
202104,42780,강원도,철원군,10-14세,1743,924,819
202105,42780,강원도,철원군,10-14세,1737,924,813
202106,42780,강원도,철원군,10-14세,1755,932,823
202007,42780,강원도,철원군,15-19세,2062,1062,1000
202008,42780,강원도,철원군,15-19세,2043,1050,993
202009,42780,강원도,철원군,15-19세,2039,1048,991
202010,42780,강원도,철원군,15-19세,2026,1040,986
202011,42780,강원도,철원군,15-19세,2030,1043,987
202012,42780,강원도,철원군,15-19세,2012,1028,984
202101,42780,강원도,철원군,15-19세,1985,1017,968
202102,42780,강원도,철원군,15-19세,1975,1010,965
202103,42780,강원도,철원군,15-19세,1963,1009,954
202104,42780,강원도,철원군,15-19세,1952,998,954
202105,42780,강원도,철원군,15-19세,1936,996,940
202106,42780,강원도,철원군,15-19세,1920,988,932
202007,42780,강원도,철원군,20-24세,2840,1825,1015
202008,42780,강원도,철원군,20-24세,2832,1812,1020
202009,42780,강원도,철원군,20-24세,2818,1800,1018
202010,42780,강원도,철원군,20-24세,2824,1800,1024
202011,42780,강원도,철원군,20-24세,2819,1795,1024
202012,42780,강원도,철원군,20-24세,2806,1778,1028
202101,42780,강원도,철원군,20-24세,2783,1762,1021
202102,42780,강원도,철원군,20-24세,2723,1730,993
202103,42780,강원도,철원군,20-24세,2657,1687,970
202104,42780,강원도,철원군,20-24세,2627,1665,962
202105,42780,강원도,철원군,20-24세,2613,1642,971
202106,42780,강원도,철원군,20-24세,2598,1626,972
202007,42780,강원도,철원군,25-29세,3050,2000,1050
202008,42780,강원도,철원군,25-29세,3029,1992,1037
202009,42780,강원도,철원군,25-29세,3010,1980,1030
202010,42780,강원도,철원군,25-29세,3027,2004,1023
202011,42780,강원도,철원군,25-29세,3028,2005,1023
202012,42780,강원도,철원군,25-29세,3040,2011,1029
202101,42780,강원도,철원군,25-29세,3026,2000,1026
202102,42780,강원도,철원군,25-29세,2962,1981,981
202103,42780,강원도,철원군,25-29세,2972,1979,993
202104,42780,강원도,철원군,25-29세,2969,1974,995
202105,42780,강원도,철원군,25-29세,2959,1971,988
202106,42780,강원도,철원군,25-29세,2931,1949,982
202007,42780,강원도,철원군,30-34세,2324,1344,980
202008,42780,강원도,철원군,30-34세,2319,1334,985
202009,42780,강원도,철원군,30-34세,2314,1336,978
202010,42780,강원도,철원군,30-34세,2283,1316,967
202011,42780,강원도,철원군,30-34세,2284,1314,970
202012,42780,강원도,철원군,30-34세,2281,1306,975
202101,42780,강원도,철원군,30-34세,2289,1315,974
202102,42780,강원도,철원군,30-34세,2323,1327,996
202103,42780,강원도,철원군,30-34세,2303,1318,985
202104,42780,강원도,철원군,30-34세,2311,1320,991
202105,42780,강원도,철원군,30-34세,2309,1321,988
202106,42780,강원도,철원군,30-34세,2301,1325,976
202007,42780,강원도,철원군,35-39세,2435,1267,1168
202008,42780,강원도,철원군,35-39세,2413,1258,1155
202009,42780,강원도,철원군,35-39세,2425,1268,1157
202010,42780,강원도,철원군,35-39세,2420,1275,1145
202011,42780,강원도,철원군,35-39세,2387,1260,1127
202012,42780,강원도,철원군,35-39세,2406,1277,1129
202101,42780,강원도,철원군,35-39세,2379,1266,1113
202102,42780,강원도,철원군,35-39세,2350,1252,1098
202103,42780,강원도,철원군,35-39세,2320,1229,1091
202104,42780,강원도,철원군,35-39세,2322,1236,1086
202105,42780,강원도,철원군,35-39세,2301,1228,1073
202106,42780,강원도,철원군,35-39세,2304,1223,1081
202007,42780,강원도,철원군,40-44세,2583,1353,1230
202008,42780,강원도,철원군,40-44세,2585,1354,1231
202009,42780,강원도,철원군,40-44세,2598,1364,1234
202010,42780,강원도,철원군,40-44세,2590,1356,1234
202011,42780,강원도,철원군,40-44세,2591,1346,1245
202012,42780,강원도,철원군,40-44세,2588,1335,1253
202101,42780,강원도,철원군,40-44세,2573,1335,1238
202102,42780,강원도,철원군,40-44세,2556,1331,1225
202103,42780,강원도,철원군,40-44세,2561,1333,1228
202104,42780,강원도,철원군,40-44세,2571,1337,1234
202105,42780,강원도,철원군,40-44세,2580,1341,1239
202106,42780,강원도,철원군,40-44세,2581,1341,1240
202007,42780,강원도,철원군,45-49세,3189,1750,1439
202008,42780,강원도,철원군,45-49세,3170,1742,1428
202009,42780,강원도,철원군,45-49세,3144,1718,1426
202010,42780,강원도,철원군,45-49세,3132,1713,1419
202011,42780,강원도,철원군,45-49세,3117,1709,1408
202012,42780,강원도,철원군,45-49세,3099,1701,1398
202101,42780,강원도,철원군,45-49세,3088,1697,1391
202102,42780,강원도,철원군,45-49세,3085,1690,1395
202103,42780,강원도,철원군,45-49세,3059,1680,1379
202104,42780,강원도,철원군,45-49세,3043,1668,1375
202105,42780,강원도,철원군,45-49세,3013,1649,1364
202106,42780,강원도,철원군,45-49세,2983,1638,1345
202007,42780,강원도,철원군,50-54세,3441,1827,1614
202008,42780,강원도,철원군,50-54세,3428,1823,1605
202009,42780,강원도,철원군,50-54세,3427,1828,1599
202010,42780,강원도,철원군,50-54세,3427,1826,1601
202011,42780,강원도,철원군,50-54세,3427,1829,1598
202012,42780,강원도,철원군,50-54세,3404,1823,1581
202101,42780,강원도,철원군,50-54세,3407,1822,1585
202102,42780,강원도,철원군,50-54세,3385,1812,1573
202103,42780,강원도,철원군,50-54세,3346,1795,1551
202104,42780,강원도,철원군,50-54세,3343,1796,1547
202105,42780,강원도,철원군,50-54세,3352,1806,1546
202106,42780,강원도,철원군,50-54세,3363,1801,1562
202007,42780,강원도,철원군,55-59세,3909,2084,1825
202008,42780,강원도,철원군,55-59세,3882,2062,1820
202009,42780,강원도,철원군,55-59세,3853,2045,1808
202010,42780,강원도,철원군,55-59세,3836,2037,1799
202011,42780,강원도,철원군,55-59세,3819,2033,1786
202012,42780,강원도,철원군,55-59세,3823,2034,1789
202101,42780,강원도,철원군,55-59세,3769,2004,1765
202102,42780,강원도,철원군,55-59세,3736,1986,1750
202103,42780,강원도,철원군,55-59세,3702,1954,1748
202104,42780,강원도,철원군,55-59세,3679,1931,1748
202105,42780,강원도,철원군,55-59세,3656,1941,1715
202106,42780,강원도,철원군,55-59세,3645,1933,1712
202007,42780,강원도,철원군,60-64세,3850,1930,1920
202008,42780,강원도,철원군,60-64세,3867,1943,1924
202009,42780,강원도,철원군,60-64세,3883,1958,1925
202010,42780,강원도,철원군,60-64세,3891,1967,1924
202011,42780,강원도,철원군,60-64세,3902,1971,1931
202012,42780,강원도,철원군,60-64세,3921,1982,1939
202101,42780,강원도,철원군,60-64세,3940,1991,1949
202102,42780,강원도,철원군,60-64세,3953,2010,1943
202103,42780,강원도,철원군,60-64세,3975,2039,1936
202104,42780,강원도,철원군,60-64세,4023,2078,1945
202105,42780,강원도,철원군,60-64세,4031,2081,1950
202106,42780,강원도,철원군,60-64세,4043,2090,1953
202007,42780,강원도,철원군,65-69세,2676,1225,1451
202008,42780,강원도,철원군,65-69세,2703,1244,1459
202009,42780,강원도,철원군,65-69세,2739,1262,1477
202010,42780,강원도,철원군,65-69세,2763,1284,1479
202011,42780,강원도,철원군,65-69세,2792,1304,1488
202012,42780,강원도,철원군,65-69세,2805,1308,1497
202101,42780,강원도,철원군,65-69세,2821,1316,1505
202102,42780,강원도,철원군,65-69세,2872,1339,1533
202103,42780,강원도,철원군,65-69세,2906,1348,1558
202104,42780,강원도,철원군,65-69세,2935,1361,1574
202105,42780,강원도,철원군,65-69세,2936,1364,1572
202106,42780,강원도,철원군,65-69세,2946,1371,1575
202007,42780,강원도,철원군,70-74세,2340,1108,1232
202008,42780,강원도,철원군,70-74세,2342,1104,1238
202009,42780,강원도,철원군,70-74세,2336,1102,1234
202010,42780,강원도,철원군,70-74세,2330,1089,1241
202011,42780,강원도,철원군,70-74세,2338,1093,1245
202012,42780,강원도,철원군,70-74세,2334,1095,1239
202101,42780,강원도,철원군,70-74세,2341,1103,1238
202102,42780,강원도,철원군,70-74세,2338,1103,1235
202103,42780,강원도,철원군,70-74세,2329,1104,1225
202104,42780,강원도,철원군,70-74세,2325,1099,1226
202105,42780,강원도,철원군,70-74세,2305,1085,1220
202106,42780,강원도,철원군,70-74세,2288,1073,1215
202007,42780,강원도,철원군,75-79세,2471,1035,1436
202008,42780,강원도,철원군,75-79세,2450,1029,1421
202009,42780,강원도,철원군,75-79세,2432,1019,1413
202010,42780,강원도,철원군,75-79세,2415,1013,1402
202011,42780,강원도,철원군,75-79세,2400,1002,1398
202012,42780,강원도,철원군,75-79세,2382,990,1392
202101,42780,강원도,철원군,75-79세,2364,982,1382
202102,42780,강원도,철원군,75-79세,2357,979,1378
202103,42780,강원도,철원군,75-79세,2354,979,1375
202104,42780,강원도,철원군,75-79세,2335,975,1360
202105,42780,강원도,철원군,75-79세,2318,973,1345
202106,42780,강원도,철원군,75-79세,2318,978,1340
202007,42780,강원도,철원군,80-84세,1574,597,977
202008,42780,강원도,철원군,80-84세,1589,601,988
202009,42780,강원도,철원군,80-84세,1599,603,996
202010,42780,강원도,철원군,80-84세,1612,610,1002
202011,42780,강원도,철원군,80-84세,1616,612,1004
202012,42780,강원도,철원군,80-84세,1621,615,1006
202101,42780,강원도,철원군,80-84세,1630,623,1007
202102,42780,강원도,철원군,80-84세,1635,625,1010
202103,42780,강원도,철원군,80-84세,1643,627,1016
202104,42780,강원도,철원군,80-84세,1648,631,1017
202105,42780,강원도,철원군,80-84세,1651,630,1021
202106,42780,강원도,철원군,80-84세,1671,638,1033
202007,42780,강원도,철원군,85-89세,606,192,414
202008,42780,강원도,철원군,85-89세,602,190,412
202009,42780,강원도,철원군,85-89세,607,191,416
202010,42780,강원도,철원군,85-89세,609,193,416
202011,42780,강원도,철원군,85-89세,615,197,418
202012,42780,강원도,철원군,85-89세,623,198,425
202101,42780,강원도,철원군,85-89세,633,201,432
202102,42780,강원도,철원군,85-89세,634,202,432
202103,42780,강원도,철원군,85-89세,640,201,439
202104,42780,강원도,철원군,85-89세,646,200,446
202105,42780,강원도,철원군,85-89세,647,202,445
202106,42780,강원도,철원군,85-89세,646,202,444
202007,42780,강원도,철원군,90-94세,295,62,233
202008,42780,강원도,철원군,90-94세,298,63,235
202009,42780,강원도,철원군,90-94세,299,64,235
202010,42780,강원도,철원군,90-94세,300,68,232
202011,42780,강원도,철원군,90-94세,299,69,230
202012,42780,강원도,철원군,90-94세,298,68,230
202101,42780,강원도,철원군,90-94세,301,68,233
202102,42780,강원도,철원군,90-94세,299,67,232
202103,42780,강원도,철원군,90-94세,299,72,227
202104,42780,강원도,철원군,90-94세,298,73,225
202105,42780,강원도,철원군,90-94세,293,72,221
202106,42780,강원도,철원군,90-94세,293,72,221
202007,42780,강원도,철원군,95-99세,55,13,42
202008,42780,강원도,철원군,95-99세,58,13,45
202009,42780,강원도,철원군,95-99세,60,13,47
202010,42780,강원도,철원군,95-99세,62,13,49
202011,42780,강원도,철원군,95-99세,65,13,52
202012,42780,강원도,철원군,95-99세,63,13,50
202101,42780,강원도,철원군,95-99세,64,14,50
202102,42780,강원도,철원군,95-99세,67,14,53
202103,42780,강원도,철원군,95-99세,65,12,53
202104,42780,강원도,철원군,95-99세,69,12,57
202105,42780,강원도,철원군,95-99세,66,10,56
202106,42780,강원도,철원군,95-99세,66,10,56
202007,42780,강원도,철원군,100+,46,12,34
202008,42780,강원도,철원군,100+,46,12,34
202009,42780,강원도,철원군,100+,45,12,33
202010,42780,강원도,철원군,100+,45,12,33
202011,42780,강원도,철원군,100+,43,11,32
202012,42780,강원도,철원군,100+,45,11,34
202101,42780,강원도,철원군,100+,44,10,34
202102,42780,강원도,철원군,100+,44,10,34
202103,42780,강원도,철원군,100+,17,5,12
202104,42780,강원도,철원군,100+,19,5,14
202105,42780,강원도,철원군,100+,17,5,12
202106,42780,강원도,철원군,100+,17,5,12
202007,42790,강원도,화천군,0-4세,899,446,453
202008,42790,강원도,화천군,0-4세,894,443,451
202009,42790,강원도,화천군,0-4세,883,438,445
202010,42790,강원도,화천군,0-4세,882,435,447
202011,42790,강원도,화천군,0-4세,871,428,443
202012,42790,강원도,화천군,0-4세,858,420,438
202101,42790,강원도,화천군,0-4세,862,426,436
202102,42790,강원도,화천군,0-4세,879,439,440
202103,42790,강원도,화천군,0-4세,870,432,438
202104,42790,강원도,화천군,0-4세,856,428,428
202105,42790,강원도,화천군,0-4세,842,426,416
202106,42790,강원도,화천군,0-4세,849,425,424
202007,42790,강원도,화천군,5-9세,947,481,466
202008,42790,강원도,화천군,5-9세,958,485,473
202009,42790,강원도,화천군,5-9세,955,484,471
202010,42790,강원도,화천군,5-9세,934,478,456
202011,42790,강원도,화천군,5-9세,933,475,458
202012,42790,강원도,화천군,5-9세,933,479,454
202101,42790,강원도,화천군,5-9세,922,471,451
202102,42790,강원도,화천군,5-9세,912,469,443
202103,42790,강원도,화천군,5-9세,906,466,440
202104,42790,강원도,화천군,5-9세,912,463,449
202105,42790,강원도,화천군,5-9세,913,466,447
202106,42790,강원도,화천군,5-9세,904,463,441
202007,42790,강원도,화천군,10-14세,839,407,432
202008,42790,강원도,화천군,10-14세,843,411,432
202009,42790,강원도,화천군,10-14세,862,419,443
202010,42790,강원도,화천군,10-14세,858,419,439
202011,42790,강원도,화천군,10-14세,845,414,431
202012,42790,강원도,화천군,10-14세,842,408,434
202101,42790,강원도,화천군,10-14세,823,401,422
202102,42790,강원도,화천군,10-14세,822,399,423
202103,42790,강원도,화천군,10-14세,823,396,427
202104,42790,강원도,화천군,10-14세,824,396,428
202105,42790,강원도,화천군,10-14세,823,395,428
202106,42790,강원도,화천군,10-14세,833,404,429
202007,42790,강원도,화천군,15-19세,973,518,455
202008,42790,강원도,화천군,15-19세,970,515,455
202009,42790,강원도,화천군,15-19세,956,502,454
202010,42790,강원도,화천군,15-19세,952,498,454
202011,42790,강원도,화천군,15-19세,960,499,461
202012,42790,강원도,화천군,15-19세,955,497,458
202101,42790,강원도,화천군,15-19세,946,500,446
202102,42790,강원도,화천군,15-19세,926,487,439
202103,42790,강원도,화천군,15-19세,919,483,436
202104,42790,강원도,화천군,15-19세,914,480,434
202105,42790,강원도,화천군,15-19세,908,473,435
202106,42790,강원도,화천군,15-19세,905,469,436
202007,42790,강원도,화천군,20-24세,1745,1191,554
202008,42790,강원도,화천군,20-24세,1761,1210,551
202009,42790,강원도,화천군,20-24세,1761,1208,553
202010,42790,강원도,화천군,20-24세,1800,1239,561
202011,42790,강원도,화천군,20-24세,1789,1238,551
202012,42790,강원도,화천군,20-24세,1790,1236,554
202101,42790,강원도,화천군,20-24세,1782,1231,551
202102,42790,강원도,화천군,20-24세,1768,1220,548
202103,42790,강원도,화천군,20-24세,1745,1197,548
202104,42790,강원도,화천군,20-24세,1725,1182,543
202105,42790,강원도,화천군,20-24세,1696,1160,536
202106,42790,강원도,화천군,20-24세,1706,1165,541
202007,42790,강원도,화천군,25-29세,2104,1486,618
202008,42790,강원도,화천군,25-29세,2093,1474,619
202009,42790,강원도,화천군,25-29세,2113,1483,630
202010,42790,강원도,화천군,25-29세,2125,1501,624
202011,42790,강원도,화천군,25-29세,2127,1507,620
202012,42790,강원도,화천군,25-29세,2116,1498,618
202101,42790,강원도,화천군,25-29세,2076,1472,604
202102,42790,강원도,화천군,25-29세,2054,1458,596
202103,42790,강원도,화천군,25-29세,2036,1448,588
202104,42790,강원도,화천군,25-29세,2030,1443,587
202105,42790,강원도,화천군,25-29세,2020,1430,590
202106,42790,강원도,화천군,25-29세,2029,1436,593
202007,42790,강원도,화천군,30-34세,1517,940,577
202008,42790,강원도,화천군,30-34세,1527,947,580
202009,42790,강원도,화천군,30-34세,1535,953,582
202010,42790,강원도,화천군,30-34세,1550,966,584
202011,42790,강원도,화천군,30-34세,1543,962,581
202012,42790,강원도,화천군,30-34세,1525,953,572
202101,42790,강원도,화천군,30-34세,1519,958,561
202102,42790,강원도,화천군,30-34세,1516,964,552
202103,42790,강원도,화천군,30-34세,1525,975,550
202104,42790,강원도,화천군,30-34세,1501,959,542
202105,42790,강원도,화천군,30-34세,1516,966,550
202106,42790,강원도,화천군,30-34세,1503,954,549
202007,42790,강원도,화천군,35-39세,1330,722,608
202008,42790,강원도,화천군,35-39세,1333,723,610
202009,42790,강원도,화천군,35-39세,1339,726,613
202010,42790,강원도,화천군,35-39세,1320,716,604
202011,42790,강원도,화천군,35-39세,1312,710,602
202012,42790,강원도,화천군,35-39세,1321,714,607
202101,42790,강원도,화천군,35-39세,1325,708,617
202102,42790,강원도,화천군,35-39세,1319,704,615
202103,42790,강원도,화천군,35-39세,1302,697,605
202104,42790,강원도,화천군,35-39세,1319,706,613
202105,42790,강원도,화천군,35-39세,1288,689,599
202106,42790,강원도,화천군,35-39세,1290,696,594
202007,42790,강원도,화천군,40-44세,1265,711,554
202008,42790,강원도,화천군,40-44세,1259,707,552
202009,42790,강원도,화천군,40-44세,1271,709,562
202010,42790,강원도,화천군,40-44세,1270,711,559
202011,42790,강원도,화천군,40-44세,1257,704,553
202012,42790,강원도,화천군,40-44세,1251,702,549
202101,42790,강원도,화천군,40-44세,1230,690,540
202102,42790,강원도,화천군,40-44세,1222,677,545
202103,42790,강원도,화천군,40-44세,1202,669,533
202104,42790,강원도,화천군,40-44세,1190,667,523
202105,42790,강원도,화천군,40-44세,1193,674,519
202106,42790,강원도,화천군,40-44세,1183,663,520
202007,42790,강원도,화천군,45-49세,1502,799,703
202008,42790,강원도,화천군,45-49세,1505,797,708
202009,42790,강원도,화천군,45-49세,1486,790,696
202010,42790,강원도,화천군,45-49세,1482,785,697
202011,42790,강원도,화천군,45-49세,1487,785,702
202012,42790,강원도,화천군,45-49세,1494,786,708
202101,42790,강원도,화천군,45-49세,1484,787,697
202102,42790,강원도,화천군,45-49세,1468,791,677
202103,42790,강원도,화천군,45-49세,1463,789,674
202104,42790,강원도,화천군,45-49세,1451,782,669
202105,42790,강원도,화천군,45-49세,1439,778,661
202106,42790,강원도,화천군,45-49세,1436,777,659
202007,42790,강원도,화천군,50-54세,1835,989,846
202008,42790,강원도,화천군,50-54세,1822,978,844
202009,42790,강원도,화천군,50-54세,1828,988,840
202010,42790,강원도,화천군,50-54세,1839,990,849
202011,42790,강원도,화천군,50-54세,1834,989,845
202012,42790,강원도,화천군,50-54세,1833,996,837
202101,42790,강원도,화천군,50-54세,1826,991,835
202102,42790,강원도,화천군,50-54세,1816,975,841
202103,42790,강원도,화천군,50-54세,1797,968,829
202104,42790,강원도,화천군,50-54세,1804,976,828
202105,42790,강원도,화천군,50-54세,1827,987,840
202106,42790,강원도,화천군,50-54세,1821,984,837
202007,42790,강원도,화천군,55-59세,2151,1163,988
202008,42790,강원도,화천군,55-59세,2156,1169,987
202009,42790,강원도,화천군,55-59세,2141,1155,986
202010,42790,강원도,화천군,55-59세,2130,1153,977
202011,42790,강원도,화천군,55-59세,2121,1151,970
202012,42790,강원도,화천군,55-59세,2081,1130,951
202101,42790,강원도,화천군,55-59세,2059,1117,942
202102,42790,강원도,화천군,55-59세,2047,1116,931
202103,42790,강원도,화천군,55-59세,2029,1111,918
202104,42790,강원도,화천군,55-59세,2018,1098,920
202105,42790,강원도,화천군,55-59세,1993,1083,910
202106,42790,강원도,화천군,55-59세,1981,1078,903
202007,42790,강원도,화천군,60-64세,2144,1157,987
202008,42790,강원도,화천군,60-64세,2152,1164,988
202009,42790,강원도,화천군,60-64세,2170,1172,998
202010,42790,강원도,화천군,60-64세,2181,1174,1007
202011,42790,강원도,화천군,60-64세,2196,1180,1016
202012,42790,강원도,화천군,60-64세,2249,1198,1051
202101,42790,강원도,화천군,60-64세,2262,1200,1062
202102,42790,강원도,화천군,60-64세,2269,1203,1066
202103,42790,강원도,화천군,60-64세,2278,1217,1061
202104,42790,강원도,화천군,60-64세,2289,1235,1054
202105,42790,강원도,화천군,60-64세,2316,1251,1065
202106,42790,강원도,화천군,60-64세,2338,1263,1075
202007,42790,강원도,화천군,65-69세,1511,802,709
202008,42790,강원도,화천군,65-69세,1531,808,723
202009,42790,강원도,화천군,65-69세,1544,817,727
202010,42790,강원도,화천군,65-69세,1561,825,736
202011,42790,강원도,화천군,65-69세,1574,831,743
202012,42790,강원도,화천군,65-69세,1588,841,747
202101,42790,강원도,화천군,65-69세,1600,859,741
202102,42790,강원도,화천군,65-69세,1611,865,746
202103,42790,강원도,화천군,65-69세,1626,873,753
202104,42790,강원도,화천군,65-69세,1644,878,766
202105,42790,강원도,화천군,65-69세,1665,894,771
202106,42790,강원도,화천군,65-69세,1680,909,771
202007,42790,강원도,화천군,70-74세,1167,529,638
202008,42790,강원도,화천군,70-74세,1172,531,641
202009,42790,강원도,화천군,70-74세,1169,534,635
202010,42790,강원도,화천군,70-74세,1152,529,623
202011,42790,강원도,화천군,70-74세,1155,531,624
202012,42790,강원도,화천군,70-74세,1148,528,620
202101,42790,강원도,화천군,70-74세,1136,518,618
202102,42790,강원도,화천군,70-74세,1137,520,617
202103,42790,강원도,화천군,70-74세,1117,510,607
202104,42790,강원도,화천군,70-74세,1103,501,602
202105,42790,강원도,화천군,70-74세,1091,496,595
202106,42790,강원도,화천군,70-74세,1081,492,589
202007,42790,강원도,화천군,75-79세,1284,546,738
202008,42790,강원도,화천군,75-79세,1278,544,734
202009,42790,강원도,화천군,75-79세,1280,542,738
202010,42790,강원도,화천군,75-79세,1274,539,735
202011,42790,강원도,화천군,75-79세,1268,543,725
202012,42790,강원도,화천군,75-79세,1267,546,721
202101,42790,강원도,화천군,75-79세,1254,540,714
202102,42790,강원도,화천군,75-79세,1245,542,703
202103,42790,강원도,화천군,75-79세,1245,542,703
202104,42790,강원도,화천군,75-79세,1234,543,691
202105,42790,강원도,화천군,75-79세,1211,532,679
202106,42790,강원도,화천군,75-79세,1207,532,675
202007,42790,강원도,화천군,80-84세,925,347,578
202008,42790,강원도,화천군,80-84세,927,345,582
202009,42790,강원도,화천군,80-84세,931,343,588
202010,42790,강원도,화천군,80-84세,950,347,603
202011,42790,강원도,화천군,80-84세,956,346,610
202012,42790,강원도,화천군,80-84세,964,349,615
202101,42790,강원도,화천군,80-84세,979,354,625
202102,42790,강원도,화천군,80-84세,988,355,633
202103,42790,강원도,화천군,80-84세,974,350,624
202104,42790,강원도,화천군,80-84세,985,354,631
202105,42790,강원도,화천군,80-84세,998,361,637
202106,42790,강원도,화천군,80-84세,1007,366,641
202007,42790,강원도,화천군,85-89세,393,126,267
202008,42790,강원도,화천군,85-89세,395,127,268
202009,42790,강원도,화천군,85-89세,398,132,266
202010,42790,강원도,화천군,85-89세,400,132,268
202011,42790,강원도,화천군,85-89세,398,127,271
202012,42790,강원도,화천군,85-89세,402,125,277
202101,42790,강원도,화천군,85-89세,403,124,279
202102,42790,강원도,화천군,85-89세,407,129,278
202103,42790,강원도,화천군,85-89세,413,134,279
202104,42790,강원도,화천군,85-89세,416,133,283
202105,42790,강원도,화천군,85-89세,425,134,291
202106,42790,강원도,화천군,85-89세,424,134,290
202007,42790,강원도,화천군,90-94세,164,36,128
202008,42790,강원도,화천군,90-94세,168,37,131
202009,42790,강원도,화천군,90-94세,173,37,136
202010,42790,강원도,화천군,90-94세,175,40,135
202011,42790,강원도,화천군,90-94세,178,42,136
202012,42790,강원도,화천군,90-94세,176,40,136
202101,42790,강원도,화천군,90-94세,181,39,142
202102,42790,강원도,화천군,90-94세,180,37,143
202103,42790,강원도,화천군,90-94세,179,34,145
202104,42790,강원도,화천군,90-94세,175,34,141
202105,42790,강원도,화천군,90-94세,176,37,139
202106,42790,강원도,화천군,90-94세,174,37,137
202007,42790,강원도,화천군,95-99세,43,18,25
202008,42790,강원도,화천군,95-99세,43,18,25
202009,42790,강원도,화천군,95-99세,45,19,26
202010,42790,강원도,화천군,95-99세,47,19,28
202011,42790,강원도,화천군,95-99세,49,19,30
202012,42790,강원도,화천군,95-99세,49,19,30
202101,42790,강원도,화천군,95-99세,47,19,28
202102,42790,강원도,화천군,95-99세,48,19,29
202103,42790,강원도,화천군,95-99세,45,17,28
202104,42790,강원도,화천군,95-99세,46,16,30
202105,42790,강원도,화천군,95-99세,47,16,31
202106,42790,강원도,화천군,95-99세,46,14,32
202007,42790,강원도,화천군,100+,15,7,8
202008,42790,강원도,화천군,100+,15,7,8
202009,42790,강원도,화천군,100+,15,7,8
202010,42790,강원도,화천군,100+,15,7,8
202011,42790,강원도,화천군,100+,15,7,8
202012,42790,강원도,화천군,100+,15,7,8
202101,42790,강원도,화천군,100+,16,7,9
202102,42790,강원도,화천군,100+,18,8,10
202103,42790,강원도,화천군,100+,12,5,7
202104,42790,강원도,화천군,100+,10,4,6
202105,42790,강원도,화천군,100+,10,4,6
202106,42790,강원도,화천군,100+,11,5,6
202007,42800,강원도,양구군,0-4세,861,423,438
202008,42800,강원도,양구군,0-4세,862,421,441
202009,42800,강원도,양구군,0-4세,871,426,445
202010,42800,강원도,양구군,0-4세,863,420,443
202011,42800,강원도,양구군,0-4세,858,413,445
202012,42800,강원도,양구군,0-4세,848,412,436
202101,42800,강원도,양구군,0-4세,834,408,426
202102,42800,강원도,양구군,0-4세,836,418,418
202103,42800,강원도,양구군,0-4세,831,411,420
202104,42800,강원도,양구군,0-4세,815,397,418
202105,42800,강원도,양구군,0-4세,826,405,421
202106,42800,강원도,양구군,0-4세,821,405,416
202007,42800,강원도,양구군,5-9세,916,478,438
202008,42800,강원도,양구군,5-9세,905,476,429
202009,42800,강원도,양구군,5-9세,896,475,421
202010,42800,강원도,양구군,5-9세,881,470,411
202011,42800,강원도,양구군,5-9세,861,458,403
202012,42800,강원도,양구군,5-9세,854,449,405
202101,42800,강원도,양구군,5-9세,851,442,409
202102,42800,강원도,양구군,5-9세,868,452,416
202103,42800,강원도,양구군,5-9세,871,452,419
202104,42800,강원도,양구군,5-9세,860,443,417
202105,42800,강원도,양구군,5-9세,861,444,417
202106,42800,강원도,양구군,5-9세,867,448,419
202007,42800,강원도,양구군,10-14세,831,432,399
202008,42800,강원도,양구군,10-14세,836,437,399
202009,42800,강원도,양구군,10-14세,840,434,406
202010,42800,강원도,양구군,10-14세,850,432,418
202011,42800,강원도,양구군,10-14세,852,439,413
202012,42800,강원도,양구군,10-14세,848,440,408
202101,42800,강원도,양구군,10-14세,847,438,409
202102,42800,강원도,양구군,10-14세,834,429,405
202103,42800,강원도,양구군,10-14세,831,427,404
202104,42800,강원도,양구군,10-14세,841,437,404
202105,42800,강원도,양구군,10-14세,845,441,404
202106,42800,강원도,양구군,10-14세,845,434,411
202007,42800,강원도,양구군,15-19세,1275,629,646
202008,42800,강원도,양구군,15-19세,1264,626,638
202009,42800,강원도,양구군,15-19세,1243,623,620
202010,42800,강원도,양구군,15-19세,1234,616,618
202011,42800,강원도,양구군,15-19세,1226,612,614
202012,42800,강원도,양구군,15-19세,1199,595,604
202101,42800,강원도,양구군,15-19세,1141,567,574
202102,42800,강원도,양구군,15-19세,1116,554,562
202103,42800,강원도,양구군,15-19세,1203,585,618
202104,42800,강원도,양구군,15-19세,1201,585,616
202105,42800,강원도,양구군,15-19세,1196,580,616
202106,42800,강원도,양구군,15-19세,1194,575,619
202007,42800,강원도,양구군,20-24세,1379,904,475
202008,42800,강원도,양구군,20-24세,1421,935,486
202009,42800,강원도,양구군,20-24세,1439,951,488
202010,42800,강원도,양구군,20-24세,1445,957,488
202011,42800,강원도,양구군,20-24세,1501,1004,497
202012,42800,강원도,양구군,20-24세,1510,1016,494
202101,42800,강원도,양구군,20-24세,1502,1010,492
202102,42800,강원도,양구군,20-24세,1486,996,490
202103,42800,강원도,양구군,20-24세,1456,975,481
202104,42800,강원도,양구군,20-24세,1423,945,478
202105,42800,강원도,양구군,20-24세,1390,918,472
202106,42800,강원도,양구군,20-24세,1363,901,462
202007,42800,강원도,양구군,25-29세,1671,1120,551
202008,42800,강원도,양구군,25-29세,1678,1125,553
202009,42800,강원도,양구군,25-29세,1672,1116,556
202010,42800,강원도,양구군,25-29세,1652,1108,544
202011,42800,강원도,양구군,25-29세,1666,1126,540
202012,42800,강원도,양구군,25-29세,1661,1116,545
202101,42800,강원도,양구군,25-29세,1640,1103,537
202102,42800,강원도,양구군,25-29세,1647,1109,538
202103,42800,강원도,양구군,25-29세,1644,1103,541
202104,42800,강원도,양구군,25-29세,1641,1107,534
202105,42800,강원도,양구군,25-29세,1629,1098,531
202106,42800,강원도,양구군,25-29세,1612,1076,536
202007,42800,강원도,양구군,30-34세,1276,743,533
202008,42800,강원도,양구군,30-34세,1290,758,532
202009,42800,강원도,양구군,30-34세,1281,751,530
202010,42800,강원도,양구군,30-34세,1292,756,536
202011,42800,강원도,양구군,30-34세,1289,761,528
202012,42800,강원도,양구군,30-34세,1279,758,521
202101,42800,강원도,양구군,30-34세,1266,746,520
202102,42800,강원도,양구군,30-34세,1273,748,525
202103,42800,강원도,양구군,30-34세,1276,756,520
202104,42800,강원도,양구군,30-34세,1256,737,519
202105,42800,강원도,양구군,30-34세,1271,742,529
202106,42800,강원도,양구군,30-34세,1268,742,526
202007,42800,강원도,양구군,35-39세,1325,695,630
202008,42800,강원도,양구군,35-39세,1307,686,621
202009,42800,강원도,양구군,35-39세,1307,685,622
202010,42800,강원도,양구군,35-39세,1284,672,612
202011,42800,강원도,양구군,35-39세,1277,667,610
202012,42800,강원도,양구군,35-39세,1268,657,611
202101,42800,강원도,양구군,35-39세,1258,656,602
202102,42800,강원도,양구군,35-39세,1267,666,601
202103,42800,강원도,양구군,35-39세,1266,666,600
202104,42800,강원도,양구군,35-39세,1254,658,596
202105,42800,강원도,양구군,35-39세,1249,658,591
202106,42800,강원도,양구군,35-39세,1247,659,588
202007,42800,강원도,양구군,40-44세,1164,614,550
202008,42800,강원도,양구군,40-44세,1161,611,550
202009,42800,강원도,양구군,40-44세,1167,611,556
202010,42800,강원도,양구군,40-44세,1179,624,555
202011,42800,강원도,양구군,40-44세,1183,627,556
202012,42800,강원도,양구군,40-44세,1175,623,552
202101,42800,강원도,양구군,40-44세,1169,621,548
202102,42800,강원도,양구군,40-44세,1155,611,544
202103,42800,강원도,양구군,40-44세,1157,606,551
202104,42800,강원도,양구군,40-44세,1160,613,547
202105,42800,강원도,양구군,40-44세,1166,616,550
202106,42800,강원도,양구군,40-44세,1172,615,557
202007,42800,강원도,양구군,45-49세,1405,786,619
202008,42800,강원도,양구군,45-49세,1406,786,620
202009,42800,강원도,양구군,45-49세,1389,781,608
202010,42800,강원도,양구군,45-49세,1383,770,613
202011,42800,강원도,양구군,45-49세,1387,773,614
202012,42800,강원도,양구군,45-49세,1381,773,608
202101,42800,강원도,양구군,45-49세,1375,767,608
202102,42800,강원도,양구군,45-49세,1363,753,610
202103,42800,강원도,양구군,45-49세,1347,743,604
202104,42800,강원도,양구군,45-49세,1342,734,608
202105,42800,강원도,양구군,45-49세,1326,723,603
202106,42800,강원도,양구군,45-49세,1314,714,600
202007,42800,강원도,양구군,50-54세,1582,843,739
202008,42800,강원도,양구군,50-54세,1590,844,746
202009,42800,강원도,양구군,50-54세,1596,845,751
202010,42800,강원도,양구군,50-54세,1586,848,738
202011,42800,강원도,양구군,50-54세,1596,853,743
202012,42800,강원도,양구군,50-54세,1591,853,738
202101,42800,강원도,양구군,50-54세,1588,856,732
202102,42800,강원도,양구군,50-54세,1580,860,720
202103,42800,강원도,양구군,50-54세,1575,853,722
202104,42800,강원도,양구군,50-54세,1577,854,723
202105,42800,강원도,양구군,50-54세,1572,853,719
202106,42800,강원도,양구군,50-54세,1572,855,717
202007,42800,강원도,양구군,55-59세,2017,1073,944
202008,42800,강원도,양구군,55-59세,1980,1049,931
202009,42800,강원도,양구군,55-59세,1972,1045,927
202010,42800,강원도,양구군,55-59세,1962,1038,924
202011,42800,강원도,양구군,55-59세,1961,1036,925
202012,42800,강원도,양구군,55-59세,1956,1034,922
202101,42800,강원도,양구군,55-59세,1948,1026,922
202102,42800,강원도,양구군,55-59세,1930,1016,914
202103,42800,강원도,양구군,55-59세,1921,1012,909
202104,42800,강원도,양구군,55-59세,1907,1006,901
202105,42800,강원도,양구군,55-59세,1890,998,892
202106,42800,강원도,양구군,55-59세,1854,983,871
202007,42800,강원도,양구군,60-64세,1956,1034,922
202008,42800,강원도,양구군,60-64세,1982,1052,930
202009,42800,강원도,양구군,60-64세,1991,1056,935
202010,42800,강원도,양구군,60-64세,2002,1064,938
202011,42800,강원도,양구군,60-64세,2005,1064,941
202012,42800,강원도,양구군,60-64세,2006,1060,946
202101,42800,강원도,양구군,60-64세,2014,1065,949
202102,42800,강원도,양구군,60-64세,2032,1071,961
202103,42800,강원도,양구군,60-64세,2030,1079,951
202104,42800,강원도,양구군,60-64세,2047,1088,959
202105,42800,강원도,양구군,60-64세,2067,1097,970
202106,42800,강원도,양구군,60-64세,2089,1111,978
202007,42800,강원도,양구군,65-69세,1315,696,619
202008,42800,강원도,양구군,65-69세,1330,708,622
202009,42800,강원도,양구군,65-69세,1331,710,621
202010,42800,강원도,양구군,65-69세,1333,708,625
202011,42800,강원도,양구군,65-69세,1352,723,629
202012,42800,강원도,양구군,65-69세,1359,728,631
202101,42800,강원도,양구군,65-69세,1372,734,638
202102,42800,강원도,양구군,65-69세,1381,740,641
202103,42800,강원도,양구군,65-69세,1417,756,661
202104,42800,강원도,양구군,65-69세,1448,778,670
202105,42800,강원도,양구군,65-69세,1454,783,671
202106,42800,강원도,양구군,65-69세,1463,785,678
202007,42800,강원도,양구군,70-74세,916,398,518
202008,42800,강원도,양구군,70-74세,917,396,521
202009,42800,강원도,양구군,70-74세,919,395,524
202010,42800,강원도,양구군,70-74세,930,404,526
202011,42800,강원도,양구군,70-74세,944,407,537
202012,42800,강원도,양구군,70-74세,942,408,534
202101,42800,강원도,양구군,70-74세,948,411,537
202102,42800,강원도,양구군,70-74세,943,413,530
202103,42800,강원도,양구군,70-74세,940,414,526
202104,42800,강원도,양구군,70-74세,928,408,520
202105,42800,강원도,양구군,70-74세,927,404,523
202106,42800,강원도,양구군,70-74세,926,403,523
202007,42800,강원도,양구군,75-79세,1135,490,645
202008,42800,강원도,양구군,75-79세,1120,485,635
202009,42800,강원도,양구군,75-79세,1118,486,632
202010,42800,강원도,양구군,75-79세,1104,479,625
202011,42800,강원도,양구군,75-79세,1089,472,617
202012,42800,강원도,양구군,75-79세,1078,465,613
202101,42800,강원도,양구군,75-79세,1079,463,616
202102,42800,강원도,양구군,75-79세,1075,459,616
202103,42800,강원도,양구군,75-79세,1062,456,606
202104,42800,강원도,양구군,75-79세,1066,455,611
202105,42800,강원도,양구군,75-79세,1064,459,605
202106,42800,강원도,양구군,75-79세,1048,453,595
202007,42800,강원도,양구군,80-84세,754,279,475
202008,42800,강원도,양구군,80-84세,755,280,475
202009,42800,강원도,양구군,80-84세,757,282,475
202010,42800,강원도,양구군,80-84세,769,285,484
202011,42800,강원도,양구군,80-84세,774,289,485
202012,42800,강원도,양구군,80-84세,790,298,492
202101,42800,강원도,양구군,80-84세,785,297,488
202102,42800,강원도,양구군,80-84세,786,301,485
202103,42800,강원도,양구군,80-84세,789,300,489
202104,42800,강원도,양구군,80-84세,788,302,486
202105,42800,강원도,양구군,80-84세,796,304,492
202106,42800,강원도,양구군,80-84세,806,308,498
202007,42800,강원도,양구군,85-89세,358,95,263
202008,42800,강원도,양구군,85-89세,367,98,269
202009,42800,강원도,양구군,85-89세,365,98,267
202010,42800,강원도,양구군,85-89세,364,98,266
202011,42800,강원도,양구군,85-89세,364,100,264
202012,42800,강원도,양구군,85-89세,370,100,270
202101,42800,강원도,양구군,85-89세,376,103,273
202102,42800,강원도,양구군,85-89세,379,104,275
202103,42800,강원도,양구군,85-89세,383,108,275
202104,42800,강원도,양구군,85-89세,384,110,274
202105,42800,강원도,양구군,85-89세,387,113,274
202106,42800,강원도,양구군,85-89세,387,109,278
202007,42800,강원도,양구군,90-94세,110,28,82
202008,42800,강원도,양구군,90-94세,109,28,81
202009,42800,강원도,양구군,90-94세,112,29,83
202010,42800,강원도,양구군,90-94세,115,28,87
202011,42800,강원도,양구군,90-94세,118,28,90
202012,42800,강원도,양구군,90-94세,117,29,88
202101,42800,강원도,양구군,90-94세,122,31,91
202102,42800,강원도,양구군,90-94세,126,33,93
202103,42800,강원도,양구군,90-94세,128,30,98
202104,42800,강원도,양구군,90-94세,130,29,101
202105,42800,강원도,양구군,90-94세,132,29,103
202106,42800,강원도,양구군,90-94세,132,30,102
202007,42800,강원도,양구군,95-99세,36,10,26
202008,42800,강원도,양구군,95-99세,35,9,26
202009,42800,강원도,양구군,95-99세,35,9,26
202010,42800,강원도,양구군,95-99세,34,10,24
202011,42800,강원도,양구군,95-99세,33,9,24
202012,42800,강원도,양구군,95-99세,31,9,22
202101,42800,강원도,양구군,95-99세,31,9,22
202102,42800,강원도,양구군,95-99세,31,9,22
202103,42800,강원도,양구군,95-99세,30,10,20
202104,42800,강원도,양구군,95-99세,31,9,22
202105,42800,강원도,양구군,95-99세,32,9,23
202106,42800,강원도,양구군,95-99세,33,9,24
202007,42800,강원도,양구군,100+,13,5,8
202008,42800,강원도,양구군,100+,14,6,8
202009,42800,강원도,양구군,100+,14,6,8
202010,42800,강원도,양구군,100+,14,6,8
202011,42800,강원도,양구군,100+,14,6,8
202012,42800,강원도,양구군,100+,15,6,9
202101,42800,강원도,양구군,100+,15,6,9
202102,42800,강원도,양구군,100+,15,6,9
202103,42800,강원도,양구군,100+,15,6,9
202104,42800,강원도,양구군,100+,15,6,9
202105,42800,강원도,양구군,100+,14,5,9
202106,42800,강원도,양구군,100+,14,5,9
202007,42810,강원도,인제군,0-4세,1243,633,610
202008,42810,강원도,인제군,0-4세,1236,627,609
202009,42810,강원도,인제군,0-4세,1240,623,617
202010,42810,강원도,인제군,0-4세,1231,620,611
202011,42810,강원도,인제군,0-4세,1229,618,611
202012,42810,강원도,인제군,0-4세,1222,616,606
202101,42810,강원도,인제군,0-4세,1214,609,605
202102,42810,강원도,인제군,0-4세,1200,604,596
202103,42810,강원도,인제군,0-4세,1183,596,587
202104,42810,강원도,인제군,0-4세,1162,581,581
202105,42810,강원도,인제군,0-4세,1173,586,587
202106,42810,강원도,인제군,0-4세,1173,590,583
202007,42810,강원도,인제군,5-9세,1296,678,618
202008,42810,강원도,인제군,5-9세,1293,671,622
202009,42810,강원도,인제군,5-9세,1281,667,614
202010,42810,강원도,인제군,5-9세,1271,653,618
202011,42810,강원도,인제군,5-9세,1283,660,623
202012,42810,강원도,인제군,5-9세,1277,657,620
202101,42810,강원도,인제군,5-9세,1273,649,624
202102,42810,강원도,인제군,5-9세,1271,652,619
202103,42810,강원도,인제군,5-9세,1272,650,622
202104,42810,강원도,인제군,5-9세,1267,647,620
202105,42810,강원도,인제군,5-9세,1275,655,620
202106,42810,강원도,인제군,5-9세,1291,664,627
202007,42810,강원도,인제군,10-14세,1129,565,564
202008,42810,강원도,인제군,10-14세,1136,570,566
202009,42810,강원도,인제군,10-14세,1145,577,568
202010,42810,강원도,인제군,10-14세,1166,592,574
202011,42810,강원도,인제군,10-14세,1179,597,582
202012,42810,강원도,인제군,10-14세,1174,600,574
202101,42810,강원도,인제군,10-14세,1154,594,560
202102,42810,강원도,인제군,10-14세,1147,587,560
202103,42810,강원도,인제군,10-14세,1146,595,551
202104,42810,강원도,인제군,10-14세,1145,597,548
202105,42810,강원도,인제군,10-14세,1129,587,542
202106,42810,강원도,인제군,10-14세,1143,597,546
202007,42810,강원도,인제군,15-19세,1175,626,549
202008,42810,강원도,인제군,15-19세,1163,618,545
202009,42810,강원도,인제군,15-19세,1148,612,536
202010,42810,강원도,인제군,15-19세,1144,609,535
202011,42810,강원도,인제군,15-19세,1136,612,524
202012,42810,강원도,인제군,15-19세,1140,609,531
202101,42810,강원도,인제군,15-19세,1150,624,526
202102,42810,강원도,인제군,15-19세,1145,610,535
202103,42810,강원도,인제군,15-19세,1132,600,532
202104,42810,강원도,인제군,15-19세,1123,598,525
202105,42810,강원도,인제군,15-19세,1115,590,525
202106,42810,강원도,인제군,15-19세,1117,591,526
202007,42810,강원도,인제군,20-24세,1841,1212,629
202008,42810,강원도,인제군,20-24세,1836,1211,625
202009,42810,강원도,인제군,20-24세,1824,1199,625
202010,42810,강원도,인제군,20-24세,1818,1190,628
202011,42810,강원도,인제군,20-24세,1812,1189,623
202012,42810,강원도,인제군,20-24세,1834,1208,626
202101,42810,강원도,인제군,20-24세,1873,1245,628
202102,42810,강원도,인제군,20-24세,1865,1241,624
202103,42810,강원도,인제군,20-24세,1852,1219,633
202104,42810,강원도,인제군,20-24세,1869,1225,644
202105,42810,강원도,인제군,20-24세,1907,1251,656
202106,42810,강원도,인제군,20-24세,1949,1296,653
202007,42810,강원도,인제군,25-29세,2226,1483,743
202008,42810,강원도,인제군,25-29세,2224,1478,746
202009,42810,강원도,인제군,25-29세,2204,1469,735
202010,42810,강원도,인제군,25-29세,2216,1473,743
202011,42810,강원도,인제군,25-29세,2204,1461,743
202012,42810,강원도,인제군,25-29세,2233,1484,749
202101,42810,강원도,인제군,25-29세,2248,1500,748
202102,42810,강원도,인제군,25-29세,2214,1476,738
202103,42810,강원도,인제군,25-29세,2211,1488,723
202104,42810,강원도,인제군,25-29세,2194,1481,713
202105,42810,강원도,인제군,25-29세,2217,1492,725
202106,42810,강원도,인제군,25-29세,2233,1504,729
202007,42810,강원도,인제군,30-34세,1867,1118,749
202008,42810,강원도,인제군,30-34세,1865,1115,750
202009,42810,강원도,인제군,30-34세,1861,1103,758
202010,42810,강원도,인제군,30-34세,1876,1112,764
202011,42810,강원도,인제군,30-34세,1898,1129,769
202012,42810,강원도,인제군,30-34세,1905,1132,773
202101,42810,강원도,인제군,30-34세,1923,1128,795
202102,42810,강원도,인제군,30-34세,1900,1119,781
202103,42810,강원도,인제군,30-34세,1889,1122,767
202104,42810,강원도,인제군,30-34세,1887,1122,765
202105,42810,강원도,인제군,30-34세,1910,1140,770
202106,42810,강원도,인제군,30-34세,1955,1163,792
202007,42810,강원도,인제군,35-39세,2003,1098,905
202008,42810,강원도,인제군,35-39세,2016,1104,912
202009,42810,강원도,인제군,35-39세,2012,1110,902
202010,42810,강원도,인제군,35-39세,1991,1095,896
202011,42810,강원도,인제군,35-39세,1992,1095,897
202012,42810,강원도,인제군,35-39세,1997,1097,900
202101,42810,강원도,인제군,35-39세,1947,1075,872
202102,42810,강원도,인제군,35-39세,1943,1081,862
202103,42810,강원도,인제군,35-39세,1930,1068,862
202104,42810,강원도,인제군,35-39세,1944,1083,861
202105,42810,강원도,인제군,35-39세,1953,1091,862
202106,42810,강원도,인제군,35-39세,1951,1091,860
202007,42810,강원도,인제군,40-44세,1895,1034,861
202008,42810,강원도,인제군,40-44세,1895,1035,860
202009,42810,강원도,인제군,40-44세,1906,1041,865
202010,42810,강원도,인제군,40-44세,1914,1042,872
202011,42810,강원도,인제군,40-44세,1911,1044,867
202012,42810,강원도,인제군,40-44세,1913,1034,879
202101,42810,강원도,인제군,40-44세,1920,1037,883
202102,42810,강원도,인제군,40-44세,1920,1026,894
202103,42810,강원도,인제군,40-44세,1896,1012,884
202104,42810,강원도,인제군,40-44세,1875,995,880
202105,42810,강원도,인제군,40-44세,1882,1001,881
202106,42810,강원도,인제군,40-44세,1907,1022,885
202007,42810,강원도,인제군,45-49세,2095,1185,910
202008,42810,강원도,인제군,45-49세,2105,1192,913
202009,42810,강원도,인제군,45-49세,2078,1175,903
202010,42810,강원도,인제군,45-49세,2071,1175,896
202011,42810,강원도,인제군,45-49세,2090,1189,901
202012,42810,강원도,인제군,45-49세,2085,1199,886
202101,42810,강원도,인제군,45-49세,2079,1196,883
202102,42810,강원도,인제군,45-49세,2071,1192,879
202103,42810,강원도,인제군,45-49세,2065,1188,877
202104,42810,강원도,인제군,45-49세,2058,1191,867
202105,42810,강원도,인제군,45-49세,2025,1166,859
202106,42810,강원도,인제군,45-49세,2011,1156,855
202007,42810,강원도,인제군,50-54세,2357,1297,1060
202008,42810,강원도,인제군,50-54세,2340,1285,1055
202009,42810,강원도,인제군,50-54세,2336,1285,1051
202010,42810,강원도,인제군,50-54세,2340,1294,1046
202011,42810,강원도,인제군,50-54세,2334,1291,1043
202012,42810,강원도,인제군,50-54세,2313,1276,1037
202101,42810,강원도,인제군,50-54세,2315,1271,1044
202102,42810,강원도,인제군,50-54세,2315,1269,1046
202103,42810,강원도,인제군,50-54세,2306,1283,1023
202104,42810,강원도,인제군,50-54세,2305,1284,1021
202105,42810,강원도,인제군,50-54세,2325,1305,1020
202106,42810,강원도,인제군,50-54세,2348,1318,1030
202007,42810,강원도,인제군,55-59세,2963,1527,1436
202008,42810,강원도,인제군,55-59세,2973,1536,1437
202009,42810,강원도,인제군,55-59세,2971,1533,1438
202010,42810,강원도,인제군,55-59세,2964,1514,1450
202011,42810,강원도,인제군,55-59세,2953,1511,1442
202012,42810,강원도,인제군,55-59세,2942,1502,1440
202101,42810,강원도,인제군,55-59세,2922,1495,1427
202102,42810,강원도,인제군,55-59세,2885,1488,1397
202103,42810,강원도,인제군,55-59세,2838,1469,1369
202104,42810,강원도,인제군,55-59세,2802,1441,1361
202105,42810,강원도,인제군,55-59세,2801,1435,1366
202106,42810,강원도,인제군,55-59세,2779,1427,1352
202007,42810,강원도,인제군,60-64세,3003,1651,1352
202008,42810,강원도,인제군,60-64세,3032,1660,1372
202009,42810,강원도,인제군,60-64세,3054,1682,1372
202010,42810,강원도,인제군,60-64세,3056,1679,1377
202011,42810,강원도,인제군,60-64세,3081,1692,1389
202012,42810,강원도,인제군,60-64세,3129,1716,1413
202101,42810,강원도,인제군,60-64세,3138,1723,1415
202102,42810,강원도,인제군,60-64세,3181,1737,1444
202103,42810,강원도,인제군,60-64세,3207,1755,1452
202104,42810,강원도,인제군,60-64세,3238,1769,1469
202105,42810,강원도,인제군,60-64세,3254,1769,1485
202106,42810,강원도,인제군,60-64세,3286,1785,1501
202007,42810,강원도,인제군,65-69세,1976,1036,940
202008,42810,강원도,인제군,65-69세,2003,1047,956
202009,42810,강원도,인제군,65-69세,2029,1053,976
202010,42810,강원도,인제군,65-69세,2058,1077,981
202011,42810,강원도,인제군,65-69세,2065,1079,986
202012,42810,강원도,인제군,65-69세,2076,1085,991
202101,42810,강원도,인제군,65-69세,2102,1092,1010
202102,42810,강원도,인제군,65-69세,2127,1103,1024
202103,42810,강원도,인제군,65-69세,2166,1130,1036
202104,42810,강원도,인제군,65-69세,2207,1158,1049
202105,42810,강원도,인제군,65-69세,2230,1175,1055
202106,42810,강원도,인제군,65-69세,2258,1190,1068
202007,42810,강원도,인제군,70-74세,1310,647,663
202008,42810,강원도,인제군,70-74세,1312,649,663
202009,42810,강원도,인제군,70-74세,1293,643,650
202010,42810,강원도,인제군,70-74세,1290,636,654
202011,42810,강원도,인제군,70-74세,1287,638,649
202012,42810,강원도,인제군,70-74세,1279,636,643
202101,42810,강원도,인제군,70-74세,1287,643,644
202102,42810,강원도,인제군,70-74세,1300,651,649
202103,42810,강원도,인제군,70-74세,1288,646,642
202104,42810,강원도,인제군,70-74세,1285,646,639
202105,42810,강원도,인제군,70-74세,1281,640,641
202106,42810,강원도,인제군,70-74세,1278,641,637
202007,42810,강원도,인제군,75-79세,1431,654,777
202008,42810,강원도,인제군,75-79세,1411,649,762
202009,42810,강원도,인제군,75-79세,1407,645,762
202010,42810,강원도,인제군,75-79세,1409,650,759
202011,42810,강원도,인제군,75-79세,1403,646,757
202012,42810,강원도,인제군,75-79세,1398,639,759
202101,42810,강원도,인제군,75-79세,1384,635,749
202102,42810,강원도,인제군,75-79세,1384,634,750
202103,42810,강원도,인제군,75-79세,1351,617,734
202104,42810,강원도,인제군,75-79세,1350,615,735
202105,42810,강원도,인제군,75-79세,1348,611,737
202106,42810,강원도,인제군,75-79세,1344,610,734
202007,42810,강원도,인제군,80-84세,1004,382,622
202008,42810,강원도,인제군,80-84세,1015,380,635
202009,42810,강원도,인제군,80-84세,1026,387,639
202010,42810,강원도,인제군,80-84세,1028,390,638
202011,42810,강원도,인제군,80-84세,1037,389,648
202012,42810,강원도,인제군,80-84세,1037,387,650
202101,42810,강원도,인제군,80-84세,1054,393,661
202102,42810,강원도,인제군,80-84세,1055,396,659
202103,42810,강원도,인제군,80-84세,1045,394,651
202104,42810,강원도,인제군,80-84세,1046,398,648
202105,42810,강원도,인제군,80-84세,1053,406,647
202106,42810,강원도,인제군,80-84세,1056,406,650
202007,42810,강원도,인제군,85-89세,454,123,331
202008,42810,강원도,인제군,85-89세,457,127,330
202009,42810,강원도,인제군,85-89세,463,131,332
202010,42810,강원도,인제군,85-89세,459,129,330
202011,42810,강원도,인제군,85-89세,462,133,329
202012,42810,강원도,인제군,85-89세,470,135,335
202101,42810,강원도,인제군,85-89세,463,135,328
202102,42810,강원도,인제군,85-89세,467,137,330
202103,42810,강원도,인제군,85-89세,487,146,341
202104,42810,강원도,인제군,85-89세,495,146,349
202105,42810,강원도,인제군,85-89세,497,147,350
202106,42810,강원도,인제군,85-89세,498,147,351
202007,42810,강원도,인제군,90-94세,190,46,144
202008,42810,강원도,인제군,90-94세,191,45,146
202009,42810,강원도,인제군,90-94세,193,45,148
202010,42810,강원도,인제군,90-94세,200,43,157
202011,42810,강원도,인제군,90-94세,196,43,153
202012,42810,강원도,인제군,90-94세,197,43,154
202101,42810,강원도,인제군,90-94세,200,42,158
202102,42810,강원도,인제군,90-94세,199,42,157
202103,42810,강원도,인제군,90-94세,191,39,152
202104,42810,강원도,인제군,90-94세,190,40,150
202105,42810,강원도,인제군,90-94세,192,39,153
202106,42810,강원도,인제군,90-94세,187,40,147
202007,42810,강원도,인제군,95-99세,54,22,32
202008,42810,강원도,인제군,95-99세,54,22,32
202009,42810,강원도,인제군,95-99세,54,22,32
202010,42810,강원도,인제군,95-99세,53,22,31
202011,42810,강원도,인제군,95-99세,56,22,34
202012,42810,강원도,인제군,95-99세,59,23,36
202101,42810,강원도,인제군,95-99세,59,24,35
202102,42810,강원도,인제군,95-99세,61,25,36
202103,42810,강원도,인제군,95-99세,59,25,34
202104,42810,강원도,인제군,95-99세,59,26,33
202105,42810,강원도,인제군,95-99세,59,26,33
202106,42810,강원도,인제군,95-99세,64,26,38
202007,42810,강원도,인제군,100+,14,5,9
202008,42810,강원도,인제군,100+,14,5,9
202009,42810,강원도,인제군,100+,13,5,8
202010,42810,강원도,인제군,100+,15,6,9
202011,42810,강원도,인제군,100+,15,6,9
202012,42810,강원도,인제군,100+,14,6,8
202101,42810,강원도,인제군,100+,15,6,9
202102,42810,강원도,인제군,100+,15,6,9
202103,42810,강원도,인제군,100+,7,4,3
202104,42810,강원도,인제군,100+,7,4,3
202105,42810,강원도,인제군,100+,7,4,3
202106,42810,강원도,인제군,100+,7,4,3
202007,42820,강원도,고성군,0-4세,573,283,290
202008,42820,강원도,고성군,0-4세,574,282,292
202009,42820,강원도,고성군,0-4세,562,274,288
202010,42820,강원도,고성군,0-4세,550,265,285
202011,42820,강원도,고성군,0-4세,555,268,287
202012,42820,강원도,고성군,0-4세,546,265,281
202101,42820,강원도,고성군,0-4세,542,264,278
202102,42820,강원도,고성군,0-4세,541,265,276
202103,42820,강원도,고성군,0-4세,531,260,271
202104,42820,강원도,고성군,0-4세,535,263,272
202105,42820,강원도,고성군,0-4세,541,266,275
202106,42820,강원도,고성군,0-4세,538,263,275
202007,42820,강원도,고성군,5-9세,725,386,339
202008,42820,강원도,고성군,5-9세,728,384,344
202009,42820,강원도,고성군,5-9세,731,382,349
202010,42820,강원도,고성군,5-9세,735,387,348
202011,42820,강원도,고성군,5-9세,735,387,348
202012,42820,강원도,고성군,5-9세,727,386,341
202101,42820,강원도,고성군,5-9세,729,386,343
202102,42820,강원도,고성군,5-9세,755,399,356
202103,42820,강원도,고성군,5-9세,758,399,359
202104,42820,강원도,고성군,5-9세,757,399,358
202105,42820,강원도,고성군,5-9세,763,399,364
202106,42820,강원도,고성군,5-9세,770,404,366
202007,42820,강원도,고성군,10-14세,721,380,341
202008,42820,강원도,고성군,10-14세,718,386,332
202009,42820,강원도,고성군,10-14세,719,393,326
202010,42820,강원도,고성군,10-14세,711,388,323
202011,42820,강원도,고성군,10-14세,711,394,317
202012,42820,강원도,고성군,10-14세,714,396,318
202101,42820,강원도,고성군,10-14세,700,387,313
202102,42820,강원도,고성군,10-14세,710,395,315
202103,42820,강원도,고성군,10-14세,710,395,315
202104,42820,강원도,고성군,10-14세,718,400,318
202105,42820,강원도,고성군,10-14세,721,400,321
202106,42820,강원도,고성군,10-14세,725,403,322
202007,42820,강원도,고성군,15-19세,929,501,428
202008,42820,강원도,고성군,15-19세,929,494,435
202009,42820,강원도,고성군,15-19세,922,488,434
202010,42820,강원도,고성군,15-19세,915,491,424
202011,42820,강원도,고성군,15-19세,917,490,427
202012,42820,강원도,고성군,15-19세,907,483,424
202101,42820,강원도,고성군,15-19세,901,484,417
202102,42820,강원도,고성군,15-19세,897,480,417
202103,42820,강원도,고성군,15-19세,893,481,412
202104,42820,강원도,고성군,15-19세,885,472,413
202105,42820,강원도,고성군,15-19세,879,471,408
202106,42820,강원도,고성군,15-19세,880,475,405
202007,42820,강원도,고성군,20-24세,1475,908,567
202008,42820,강원도,고성군,20-24세,1462,912,550
202009,42820,강원도,고성군,20-24세,1448,914,534
202010,42820,강원도,고성군,20-24세,1450,911,539
202011,42820,강원도,고성군,20-24세,1441,907,534
202012,42820,강원도,고성군,20-24세,1421,888,533
202101,42820,강원도,고성군,20-24세,1418,882,536
202102,42820,강원도,고성군,20-24세,1408,877,531
202103,42820,강원도,고성군,20-24세,1370,858,512
202104,42820,강원도,고성군,20-24세,1353,844,509
202105,42820,강원도,고성군,20-24세,1342,843,499
202106,42820,강원도,고성군,20-24세,1343,838,505
202007,42820,강원도,고성군,25-29세,1473,956,517
202008,42820,강원도,고성군,25-29세,1459,941,518
202009,42820,강원도,고성군,25-29세,1447,933,514
202010,42820,강원도,고성군,25-29세,1437,920,517
202011,42820,강원도,고성군,25-29세,1427,918,509
202012,42820,강원도,고성군,25-29세,1447,936,511
202101,42820,강원도,고성군,25-29세,1414,915,499
202102,42820,강원도,고성군,25-29세,1376,885,491
202103,42820,강원도,고성군,25-29세,1373,884,489
202104,42820,강원도,고성군,25-29세,1354,883,471
202105,42820,강원도,고성군,25-29세,1353,872,481
202106,42820,강원도,고성군,25-29세,1354,870,484
202007,42820,강원도,고성군,30-34세,1074,649,425
202008,42820,강원도,고성군,30-34세,1058,632,426
202009,42820,강원도,고성군,30-34세,1051,626,425
202010,42820,강원도,고성군,30-34세,1070,639,431
202011,42820,강원도,고성군,30-34세,1070,633,437
202012,42820,강원도,고성군,30-34세,1068,631,437
202101,42820,강원도,고성군,30-34세,1064,629,435
202102,42820,강원도,고성군,30-34세,1058,631,427
202103,42820,강원도,고성군,30-34세,1054,628,426
202104,42820,강원도,고성군,30-34세,1060,633,427
202105,42820,강원도,고성군,30-34세,1090,649,441
202106,42820,강원도,고성군,30-34세,1098,659,439
202007,42820,강원도,고성군,35-39세,1152,620,532
202008,42820,강원도,고성군,35-39세,1159,625,534
202009,42820,강원도,고성군,35-39세,1159,628,531
202010,42820,강원도,고성군,35-39세,1147,619,528
202011,42820,강원도,고성군,35-39세,1158,625,533
202012,42820,강원도,고성군,35-39세,1151,621,530
202101,42820,강원도,고성군,35-39세,1160,634,526
202102,42820,강원도,고성군,35-39세,1177,641,536
202103,42820,강원도,고성군,35-39세,1193,651,542
202104,42820,강원도,고성군,35-39세,1199,650,549
202105,42820,강원도,고성군,35-39세,1190,655,535
202106,42820,강원도,고성군,35-39세,1186,652,534
202007,42820,강원도,고성군,40-44세,1273,702,571
202008,42820,강원도,고성군,40-44세,1280,706,574
202009,42820,강원도,고성군,40-44세,1270,696,574
202010,42820,강원도,고성군,40-44세,1274,698,576
202011,42820,강원도,고성군,40-44세,1277,701,576
202012,42820,강원도,고성군,40-44세,1269,704,565
202101,42820,강원도,고성군,40-44세,1262,697,565
202102,42820,강원도,고성군,40-44세,1269,695,574
202103,42820,강원도,고성군,40-44세,1259,697,562
202104,42820,강원도,고성군,40-44세,1259,693,566
202105,42820,강원도,고성군,40-44세,1272,696,576
202106,42820,강원도,고성군,40-44세,1287,704,583
202007,42820,강원도,고성군,45-49세,1828,1039,789
202008,42820,강원도,고성군,45-49세,1817,1028,789
202009,42820,강원도,고성군,45-49세,1794,1015,779
202010,42820,강원도,고성군,45-49세,1790,1019,771
202011,42820,강원도,고성군,45-49세,1790,1019,771
202012,42820,강원도,고성군,45-49세,1794,1013,781
202101,42820,강원도,고성군,45-49세,1781,999,782
202102,42820,강원도,고성군,45-49세,1777,992,785
202103,42820,강원도,고성군,45-49세,1783,987,796
202104,42820,강원도,고성군,45-49세,1784,978,806
202105,42820,강원도,고성군,45-49세,1803,981,822
202106,42820,강원도,고성군,45-49세,1775,969,806
202007,42820,강원도,고성군,50-54세,2235,1252,983
202008,42820,강원도,고성군,50-54세,2227,1249,978
202009,42820,강원도,고성군,50-54세,2234,1252,982
202010,42820,강원도,고성군,50-54세,2225,1255,970
202011,42820,강원도,고성군,50-54세,2207,1247,960
202012,42820,강원도,고성군,50-54세,2199,1241,958
202101,42820,강원도,고성군,50-54세,2183,1235,948
202102,42820,강원도,고성군,50-54세,2174,1231,943
202103,42820,강원도,고성군,50-54세,2171,1230,941
202104,42820,강원도,고성군,50-54세,2183,1231,952
202105,42820,강원도,고성군,50-54세,2191,1237,954
202106,42820,강원도,고성군,50-54세,2220,1247,973
202007,42820,강원도,고성군,55-59세,2691,1388,1303
202008,42820,강원도,고성군,55-59세,2688,1397,1291
202009,42820,강원도,고성군,55-59세,2669,1389,1280
202010,42820,강원도,고성군,55-59세,2654,1376,1278
202011,42820,강원도,고성군,55-59세,2637,1371,1266
202012,42820,강원도,고성군,55-59세,2623,1363,1260
202101,42820,강원도,고성군,55-59세,2603,1349,1254
202102,42820,강원도,고성군,55-59세,2592,1353,1239
202103,42820,강원도,고성군,55-59세,2579,1343,1236
202104,42820,강원도,고성군,55-59세,2559,1334,1225
202105,42820,강원도,고성군,55-59세,2562,1343,1219
202106,42820,강원도,고성군,55-59세,2541,1332,1209
202007,42820,강원도,고성군,60-64세,2863,1511,1352
202008,42820,강원도,고성군,60-64세,2879,1510,1369
202009,42820,강원도,고성군,60-64세,2883,1510,1373
202010,42820,강원도,고성군,60-64세,2900,1519,1381
202011,42820,강원도,고성군,60-64세,2924,1526,1398
202012,42820,강원도,고성군,60-64세,2946,1536,1410
202101,42820,강원도,고성군,60-64세,2963,1544,1419
202102,42820,강원도,고성군,60-64세,2992,1554,1438
202103,42820,강원도,고성군,60-64세,3027,1572,1455
202104,42820,강원도,고성군,60-64세,3054,1583,1471
202105,42820,강원도,고성군,60-64세,3089,1595,1494
202106,42820,강원도,고성군,60-64세,3123,1609,1514
202007,42820,강원도,고성군,65-69세,2184,1078,1106
202008,42820,강원도,고성군,65-69세,2195,1091,1104
202009,42820,강원도,고성군,65-69세,2218,1100,1118
202010,42820,강원도,고성군,65-69세,2229,1105,1124
202011,42820,강원도,고성군,65-69세,2242,1114,1128
202012,42820,강원도,고성군,65-69세,2247,1119,1128
202101,42820,강원도,고성군,65-69세,2264,1130,1134
202102,42820,강원도,고성군,65-69세,2282,1138,1144
202103,42820,강원도,고성군,65-69세,2301,1149,1152
202104,42820,강원도,고성군,65-69세,2338,1173,1165
202105,42820,강원도,고성군,65-69세,2347,1174,1173
202106,42820,강원도,고성군,65-69세,2380,1192,1188
202007,42820,강원도,고성군,70-74세,1724,777,947
202008,42820,강원도,고성군,70-74세,1724,779,945
202009,42820,강원도,고성군,70-74세,1723,778,945
202010,42820,강원도,고성군,70-74세,1722,780,942
202011,42820,강원도,고성군,70-74세,1737,788,949
202012,42820,강원도,고성군,70-74세,1734,786,948
202101,42820,강원도,고성군,70-74세,1735,793,942
202102,42820,강원도,고성군,70-74세,1725,785,940
202103,42820,강원도,고성군,70-74세,1731,784,947
202104,42820,강원도,고성군,70-74세,1712,773,939
202105,42820,강원도,고성군,70-74세,1708,777,931
202106,42820,강원도,고성군,70-74세,1687,773,914
202007,42820,강원도,고성군,75-79세,1803,748,1055
202008,42820,강원도,고성군,75-79세,1804,741,1063
202009,42820,강원도,고성군,75-79세,1790,735,1055
202010,42820,강원도,고성군,75-79세,1783,721,1062
202011,42820,강원도,고성군,75-79세,1772,716,1056
202012,42820,강원도,고성군,75-79세,1765,715,1050
202101,42820,강원도,고성군,75-79세,1748,704,1044
202102,42820,강원도,고성군,75-79세,1743,707,1036
202103,42820,강원도,고성군,75-79세,1735,708,1027
202104,42820,강원도,고성군,75-79세,1737,708,1029
202105,42820,강원도,고성군,75-79세,1735,708,1027
202106,42820,강원도,고성군,75-79세,1744,707,1037
202007,42820,강원도,고성군,80-84세,1242,450,792
202008,42820,강원도,고성군,80-84세,1251,456,795
202009,42820,강원도,고성군,80-84세,1264,466,798
202010,42820,강원도,고성군,80-84세,1273,480,793
202011,42820,강원도,고성군,80-84세,1277,482,795
202012,42820,강원도,고성군,80-84세,1272,474,798
202101,42820,강원도,고성군,80-84세,1278,478,800
202102,42820,강원도,고성군,80-84세,1298,484,814
202103,42820,강원도,고성군,80-84세,1312,486,826
202104,42820,강원도,고성군,80-84세,1314,486,828
202105,42820,강원도,고성군,80-84세,1326,491,835
202106,42820,강원도,고성군,80-84세,1316,490,826
202007,42820,강원도,고성군,85-89세,556,154,402
202008,42820,강원도,고성군,85-89세,557,159,398
202009,42820,강원도,고성군,85-89세,554,158,396
202010,42820,강원도,고성군,85-89세,565,161,404
202011,42820,강원도,고성군,85-89세,566,158,408
202012,42820,강원도,고성군,85-89세,571,165,406
202101,42820,강원도,고성군,85-89세,583,171,412
202102,42820,강원도,고성군,85-89세,595,177,418
202103,42820,강원도,고성군,85-89세,601,179,422
202104,42820,강원도,고성군,85-89세,599,179,420
202105,42820,강원도,고성군,85-89세,601,177,424
202106,42820,강원도,고성군,85-89세,614,181,433
202007,42820,강원도,고성군,90-94세,267,61,206
202008,42820,강원도,고성군,90-94세,268,61,207
202009,42820,강원도,고성군,90-94세,269,59,210
202010,42820,강원도,고성군,90-94세,271,58,213
202011,42820,강원도,고성군,90-94세,273,60,213
202012,42820,강원도,고성군,90-94세,275,60,215
202101,42820,강원도,고성군,90-94세,276,59,217
202102,42820,강원도,고성군,90-94세,280,59,221
202103,42820,강원도,고성군,90-94세,275,58,217
202104,42820,강원도,고성군,90-94세,271,58,213
202105,42820,강원도,고성군,90-94세,267,59,208
202106,42820,강원도,고성군,90-94세,261,57,204
202007,42820,강원도,고성군,95-99세,64,16,48
202008,42820,강원도,고성군,95-99세,64,16,48
202009,42820,강원도,고성군,95-99세,64,16,48
202010,42820,강원도,고성군,95-99세,64,17,47
202011,42820,강원도,고성군,95-99세,65,17,48
202012,42820,강원도,고성군,95-99세,64,17,47
202101,42820,강원도,고성군,95-99세,66,19,47
202102,42820,강원도,고성군,95-99세,68,20,48
202103,42820,강원도,고성군,95-99세,69,18,51
202104,42820,강원도,고성군,95-99세,71,19,52
202105,42820,강원도,고성군,95-99세,69,18,51
202106,42820,강원도,고성군,95-99세,70,20,50
202007,42820,강원도,고성군,100+,15,3,12
202008,42820,강원도,고성군,100+,16,3,13
202009,42820,강원도,고성군,100+,16,3,13
202010,42820,강원도,고성군,100+,16,3,13
202011,42820,강원도,고성군,100+,17,3,14
202012,42820,강원도,고성군,100+,17,3,14
202101,42820,강원도,고성군,100+,17,3,14
202102,42820,강원도,고성군,100+,17,3,14
202103,42820,강원도,고성군,100+,18,3,15
202104,42820,강원도,고성군,100+,18,3,15
202105,42820,강원도,고성군,100+,15,3,12
202106,42820,강원도,고성군,100+,12,3,9
202007,42830,강원도,양양군,0-4세,575,291,284
202008,42830,강원도,양양군,0-4세,576,291,285
202009,42830,강원도,양양군,0-4세,570,285,285
202010,42830,강원도,양양군,0-4세,564,285,279
202011,42830,강원도,양양군,0-4세,566,286,280
202012,42830,강원도,양양군,0-4세,560,280,280
202101,42830,강원도,양양군,0-4세,555,274,281
202102,42830,강원도,양양군,0-4세,540,268,272
202103,42830,강원도,양양군,0-4세,534,265,269
202104,42830,강원도,양양군,0-4세,534,270,264
202105,42830,강원도,양양군,0-4세,535,273,262
202106,42830,강원도,양양군,0-4세,531,272,259
202007,42830,강원도,양양군,5-9세,795,413,382
202008,42830,강원도,양양군,5-9세,791,412,379
202009,42830,강원도,양양군,5-9세,795,413,382
202010,42830,강원도,양양군,5-9세,796,412,384
202011,42830,강원도,양양군,5-9세,785,406,379
202012,42830,강원도,양양군,5-9세,790,412,378
202101,42830,강원도,양양군,5-9세,803,415,388
202102,42830,강원도,양양군,5-9세,815,421,394
202103,42830,강원도,양양군,5-9세,800,411,389
202104,42830,강원도,양양군,5-9세,790,402,388
202105,42830,강원도,양양군,5-9세,787,401,386
202106,42830,강원도,양양군,5-9세,787,403,384
202007,42830,강원도,양양군,10-14세,840,429,411
202008,42830,강원도,양양군,10-14세,824,426,398
202009,42830,강원도,양양군,10-14세,831,428,403
202010,42830,강원도,양양군,10-14세,835,433,402
202011,42830,강원도,양양군,10-14세,829,432,397
202012,42830,강원도,양양군,10-14세,832,431,401
202101,42830,강원도,양양군,10-14세,833,441,392
202102,42830,강원도,양양군,10-14세,833,443,390
202103,42830,강원도,양양군,10-14세,851,454,397
202104,42830,강원도,양양군,10-14세,853,454,399
202105,42830,강원도,양양군,10-14세,864,459,405
202106,42830,강원도,양양군,10-14세,870,465,405
202007,42830,강원도,양양군,15-19세,1058,566,492
202008,42830,강원도,양양군,15-19세,1053,556,497
202009,42830,강원도,양양군,15-19세,1046,555,491
202010,42830,강원도,양양군,15-19세,1024,546,478
202011,42830,강원도,양양군,15-19세,1016,546,470
202012,42830,강원도,양양군,15-19세,1013,546,467
202101,42830,강원도,양양군,15-19세,985,530,455
202102,42830,강원도,양양군,15-19세,979,528,451
202103,42830,강원도,양양군,15-19세,964,520,444
202104,42830,강원도,양양군,15-19세,963,521,442
202105,42830,강원도,양양군,15-19세,953,515,438
202106,42830,강원도,양양군,15-19세,952,513,439
202007,42830,강원도,양양군,20-24세,1312,755,557
202008,42830,강원도,양양군,20-24세,1301,747,554
202009,42830,강원도,양양군,20-24세,1302,749,553
202010,42830,강원도,양양군,20-24세,1305,748,557
202011,42830,강원도,양양군,20-24세,1312,741,571
202012,42830,강원도,양양군,20-24세,1319,748,571
202101,42830,강원도,양양군,20-24세,1313,746,567
202102,42830,강원도,양양군,20-24세,1304,744,560
202103,42830,강원도,양양군,20-24세,1294,743,551
202104,42830,강원도,양양군,20-24세,1283,736,547
202105,42830,강원도,양양군,20-24세,1294,744,550
202106,42830,강원도,양양군,20-24세,1283,737,546
202007,42830,강원도,양양군,25-29세,1077,646,431
202008,42830,강원도,양양군,25-29세,1075,650,425
202009,42830,강원도,양양군,25-29세,1079,652,427
202010,42830,강원도,양양군,25-29세,1081,655,426
202011,42830,강원도,양양군,25-29세,1098,671,427
202012,42830,강원도,양양군,25-29세,1092,669,423
202101,42830,강원도,양양군,25-29세,1106,677,429
202102,42830,강원도,양양군,25-29세,1103,672,431
202103,42830,강원도,양양군,25-29세,1093,671,422
202104,42830,강원도,양양군,25-29세,1066,654,412
202105,42830,강원도,양양군,25-29세,1080,659,421
202106,42830,강원도,양양군,25-29세,1088,664,424
202007,42830,강원도,양양군,30-34세,1006,545,461
202008,42830,강원도,양양군,30-34세,999,543,456
202009,42830,강원도,양양군,30-34세,1008,549,459
202010,42830,강원도,양양군,30-34세,1000,546,454
202011,42830,강원도,양양군,30-34세,1010,554,456
202012,42830,강원도,양양군,30-34세,1025,571,454
202101,42830,강원도,양양군,30-34세,1021,563,458
202102,42830,강원도,양양군,30-34세,1012,553,459
202103,42830,강원도,양양군,30-34세,998,546,452
202104,42830,강원도,양양군,30-34세,1017,558,459
202105,42830,강원도,양양군,30-34세,1011,557,454
202106,42830,강원도,양양군,30-34세,996,551,445
202007,42830,강원도,양양군,35-39세,1376,740,636
202008,42830,강원도,양양군,35-39세,1374,740,634
202009,42830,강원도,양양군,35-39세,1372,737,635
202010,42830,강원도,양양군,35-39세,1361,731,630
202011,42830,강원도,양양군,35-39세,1331,715,616
202012,42830,강원도,양양군,35-39세,1315,694,621
202101,42830,강원도,양양군,35-39세,1315,693,622
202102,42830,강원도,양양군,35-39세,1308,704,604
202103,42830,강원도,양양군,35-39세,1317,708,609
202104,42830,강원도,양양군,35-39세,1311,714,597
202105,42830,강원도,양양군,35-39세,1302,706,596
202106,42830,강원도,양양군,35-39세,1286,700,586
202007,42830,강원도,양양군,40-44세,1575,864,711
202008,42830,강원도,양양군,40-44세,1572,864,708
202009,42830,강원도,양양군,40-44세,1599,880,719
202010,42830,강원도,양양군,40-44세,1610,883,727
202011,42830,강원도,양양군,40-44세,1614,888,726
202012,42830,강원도,양양군,40-44세,1603,888,715
202101,42830,강원도,양양군,40-44세,1608,886,722
202102,42830,강원도,양양군,40-44세,1615,883,732
202103,42830,강원도,양양군,40-44세,1620,877,743
202104,42830,강원도,양양군,40-44세,1587,854,733
202105,42830,강원도,양양군,40-44세,1576,844,732
202106,42830,강원도,양양군,40-44세,1589,847,742
202007,42830,강원도,양양군,45-49세,1972,1078,894
202008,42830,강원도,양양군,45-49세,1973,1073,900
202009,42830,강원도,양양군,45-49세,1964,1066,898
202010,42830,강원도,양양군,45-49세,1947,1057,890
202011,42830,강원도,양양군,45-49세,1925,1039,886
202012,42830,강원도,양양군,45-49세,1921,1046,875
202101,42830,강원도,양양군,45-49세,1914,1040,874
202102,42830,강원도,양양군,45-49세,1924,1048,876
202103,42830,강원도,양양군,45-49세,1917,1050,867
202104,42830,강원도,양양군,45-49세,1912,1048,864
202105,42830,강원도,양양군,45-49세,1916,1052,864
202106,42830,강원도,양양군,45-49세,1909,1055,854
202007,42830,강원도,양양군,50-54세,2369,1352,1017
202008,42830,강원도,양양군,50-54세,2367,1349,1018
202009,42830,강원도,양양군,50-54세,2367,1357,1010
202010,42830,강원도,양양군,50-54세,2388,1370,1018
202011,42830,강원도,양양군,50-54세,2388,1367,1021
202012,42830,강원도,양양군,50-54세,2381,1359,1022
202101,42830,강원도,양양군,50-54세,2367,1348,1019
202102,42830,강원도,양양군,50-54세,2360,1346,1014
202103,42830,강원도,양양군,50-54세,2344,1339,1005
202104,42830,강원도,양양군,50-54세,2348,1349,999
202105,42830,강원도,양양군,50-54세,2365,1347,1018
202106,42830,강원도,양양군,50-54세,2370,1350,1020
202007,42830,강원도,양양군,55-59세,2739,1404,1335
202008,42830,강원도,양양군,55-59세,2754,1409,1345
202009,42830,강원도,양양군,55-59세,2753,1398,1355
202010,42830,강원도,양양군,55-59세,2737,1384,1353
202011,42830,강원도,양양군,55-59세,2723,1371,1352
202012,42830,강원도,양양군,55-59세,2720,1366,1354
202101,42830,강원도,양양군,55-59세,2689,1359,1330
202102,42830,강원도,양양군,55-59세,2683,1357,1326
202103,42830,강원도,양양군,55-59세,2673,1354,1319
202104,42830,강원도,양양군,55-59세,2656,1338,1318
202105,42830,강원도,양양군,55-59세,2628,1326,1302
202106,42830,강원도,양양군,55-59세,2627,1328,1299
202007,42830,강원도,양양군,60-64세,2985,1499,1486
202008,42830,강원도,양양군,60-64세,2992,1512,1480
202009,42830,강원도,양양군,60-64세,2994,1514,1480
202010,42830,강원도,양양군,60-64세,3024,1532,1492
202011,42830,강원도,양양군,60-64세,3026,1542,1484
202012,42830,강원도,양양군,60-64세,3061,1567,1494
202101,42830,강원도,양양군,60-64세,3101,1594,1507
202102,42830,강원도,양양군,60-64세,3138,1609,1529
202103,42830,강원도,양양군,60-64세,3134,1605,1529
202104,42830,강원도,양양군,60-64세,3170,1629,1541
202105,42830,강원도,양양군,60-64세,3202,1651,1551
202106,42830,강원도,양양군,60-64세,3242,1673,1569
202007,42830,강원도,양양군,65-69세,2405,1181,1224
202008,42830,강원도,양양군,65-69세,2422,1180,1242
202009,42830,강원도,양양군,65-69세,2448,1198,1250
202010,42830,강원도,양양군,65-69세,2469,1207,1262
202011,42830,강원도,양양군,65-69세,2473,1206,1267
202012,42830,강원도,양양군,65-69세,2478,1208,1270
202101,42830,강원도,양양군,65-69세,2489,1209,1280
202102,42830,강원도,양양군,65-69세,2501,1220,1281
202103,42830,강원도,양양군,65-69세,2542,1238,1304
202104,42830,강원도,양양군,65-69세,2554,1253,1301
202105,42830,강원도,양양군,65-69세,2570,1260,1310
202106,42830,강원도,양양군,65-69세,2579,1268,1311
202007,42830,강원도,양양군,70-74세,1834,904,930
202008,42830,강원도,양양군,70-74세,1839,909,930
202009,42830,강원도,양양군,70-74세,1838,910,928
202010,42830,강원도,양양군,70-74세,1839,911,928
202011,42830,강원도,양양군,70-74세,1840,915,925
202012,42830,강원도,양양군,70-74세,1837,912,925
202101,42830,강원도,양양군,70-74세,1847,912,935
202102,42830,강원도,양양군,70-74세,1853,919,934
202103,42830,강원도,양양군,70-74세,1855,918,937
202104,42830,강원도,양양군,70-74세,1854,921,933
202105,42830,강원도,양양군,70-74세,1859,927,932
202106,42830,강원도,양양군,70-74세,1850,924,926
202007,42830,강원도,양양군,75-79세,1829,784,1045
202008,42830,강원도,양양군,75-79세,1833,783,1050
202009,42830,강원도,양양군,75-79세,1834,785,1049
202010,42830,강원도,양양군,75-79세,1828,784,1044
202011,42830,강원도,양양군,75-79세,1823,780,1043
202012,42830,강원도,양양군,75-79세,1811,781,1030
202101,42830,강원도,양양군,75-79세,1791,772,1019
202102,42830,강원도,양양군,75-79세,1763,762,1001
202103,42830,강원도,양양군,75-79세,1763,760,1003
202104,42830,강원도,양양군,75-79세,1774,767,1007
202105,42830,강원도,양양군,75-79세,1792,773,1019
202106,42830,강원도,양양군,75-79세,1791,771,1020
202007,42830,강원도,양양군,80-84세,1238,474,764
202008,42830,강원도,양양군,80-84세,1253,481,772
202009,42830,강원도,양양군,80-84세,1263,486,777
202010,42830,강원도,양양군,80-84세,1261,486,775
202011,42830,강원도,양양군,80-84세,1262,488,774
202012,42830,강원도,양양군,80-84세,1267,490,777
202101,42830,강원도,양양군,80-84세,1278,497,781
202102,42830,강원도,양양군,80-84세,1303,507,796
202103,42830,강원도,양양군,80-84세,1307,511,796
202104,42830,강원도,양양군,80-84세,1300,507,793
202105,42830,강원도,양양군,80-84세,1293,505,788
202106,42830,강원도,양양군,80-84세,1295,508,787
202007,42830,강원도,양양군,85-89세,548,171,377
202008,42830,강원도,양양군,85-89세,543,171,372
202009,42830,강원도,양양군,85-89세,552,176,376
202010,42830,강원도,양양군,85-89세,563,181,382
202011,42830,강원도,양양군,85-89세,569,183,386
202012,42830,강원도,양양군,85-89세,583,187,396
202101,42830,강원도,양양군,85-89세,592,189,403
202102,42830,강원도,양양군,85-89세,603,194,409
202103,42830,강원도,양양군,85-89세,608,194,414
202104,42830,강원도,양양군,85-89세,619,195,424
202105,42830,강원도,양양군,85-89세,637,203,434
202106,42830,강원도,양양군,85-89세,643,206,437
202007,42830,강원도,양양군,90-94세,246,51,195
202008,42830,강원도,양양군,90-94세,246,51,195
202009,42830,강원도,양양군,90-94세,240,49,191
202010,42830,강원도,양양군,90-94세,244,51,193
202011,42830,강원도,양양군,90-94세,248,52,196
202012,42830,강원도,양양군,90-94세,246,52,194
202101,42830,강원도,양양군,90-94세,247,51,196
202102,42830,강원도,양양군,90-94세,248,52,196
202103,42830,강원도,양양군,90-94세,254,55,199
202104,42830,강원도,양양군,90-94세,253,54,199
202105,42830,강원도,양양군,90-94세,254,54,200
202106,42830,강원도,양양군,90-94세,255,56,199
202007,42830,강원도,양양군,95-99세,64,11,53
202008,42830,강원도,양양군,95-99세,65,12,53
202009,42830,강원도,양양군,95-99세,69,12,57
202010,42830,강원도,양양군,95-99세,72,12,60
202011,42830,강원도,양양군,95-99세,71,11,60
202012,42830,강원도,양양군,95-99세,75,12,63
202101,42830,강원도,양양군,95-99세,76,13,63
202102,42830,강원도,양양군,95-99세,79,13,66
202103,42830,강원도,양양군,95-99세,74,13,61
202104,42830,강원도,양양군,95-99세,74,13,61
202105,42830,강원도,양양군,95-99세,75,12,63
202106,42830,강원도,양양군,95-99세,78,12,66
202007,42830,강원도,양양군,100+,16,1,15
202008,42830,강원도,양양군,100+,16,1,15
202009,42830,강원도,양양군,100+,16,1,15
202010,42830,강원도,양양군,100+,16,1,15
202011,42830,강원도,양양군,100+,17,1,16
202012,42830,강원도,양양군,100+,17,1,16
202101,42830,강원도,양양군,100+,16,1,15
202102,42830,강원도,양양군,100+,16,1,15
202103,42830,강원도,양양군,100+,14,1,13
202104,42830,강원도,양양군,100+,14,1,13
202105,42830,강원도,양양군,100+,13,1,12
202106,42830,강원도,양양군,100+,14,2,12
202007,43111,충청북도,청주시 상당구,0-4세,6527,3295,3232
202008,43111,충청북도,청주시 상당구,0-4세,6539,3298,3241
202009,43111,충청북도,청주시 상당구,0-4세,6597,3314,3283
202010,43111,충청북도,청주시 상당구,0-4세,6647,3335,3312
202011,43111,충청북도,청주시 상당구,0-4세,6648,3333,3315
202012,43111,충청북도,청주시 상당구,0-4세,6647,3332,3315
202101,43111,충청북도,청주시 상당구,0-4세,6684,3363,3321
202102,43111,충청북도,청주시 상당구,0-4세,6742,3390,3352
202103,43111,충청북도,청주시 상당구,0-4세,6740,3382,3358
202104,43111,충청북도,청주시 상당구,0-4세,6749,3403,3346
202105,43111,충청북도,청주시 상당구,0-4세,6730,3389,3341
202106,43111,충청북도,청주시 상당구,0-4세,6682,3357,3325
202007,43111,충청북도,청주시 상당구,5-9세,9238,4716,4522
202008,43111,충청북도,청주시 상당구,5-9세,9278,4708,4570
202009,43111,충청북도,청주시 상당구,5-9세,9295,4721,4574
202010,43111,충청북도,청주시 상당구,5-9세,9424,4785,4639
202011,43111,충청북도,청주시 상당구,5-9세,9427,4798,4629
202012,43111,충청북도,청주시 상당구,5-9세,9435,4822,4613
202101,43111,충청북도,청주시 상당구,5-9세,9498,4843,4655
202102,43111,충청북도,청주시 상당구,5-9세,9582,4875,4707
202103,43111,충청북도,청주시 상당구,5-9세,9564,4866,4698
202104,43111,충청북도,청주시 상당구,5-9세,9538,4843,4695
202105,43111,충청북도,청주시 상당구,5-9세,9533,4853,4680
202106,43111,충청북도,청주시 상당구,5-9세,9546,4857,4689
202007,43111,충청북도,청주시 상당구,10-14세,9019,4678,4341
202008,43111,충청북도,청주시 상당구,10-14세,9082,4725,4357
202009,43111,충청북도,청주시 상당구,10-14세,9203,4783,4420
202010,43111,충청북도,청주시 상당구,10-14세,9336,4848,4488
202011,43111,충청북도,청주시 상당구,10-14세,9421,4881,4540
202012,43111,충청북도,청주시 상당구,10-14세,9444,4898,4546
202101,43111,충청북도,청주시 상당구,10-14세,9497,4926,4571
202102,43111,충청북도,청주시 상당구,10-14세,9590,4961,4629
202103,43111,충청북도,청주시 상당구,10-14세,9672,5000,4672
202104,43111,충청북도,청주시 상당구,10-14세,9675,5002,4673
202105,43111,충청북도,청주시 상당구,10-14세,9692,4996,4696
202106,43111,충청북도,청주시 상당구,10-14세,9721,5013,4708
202007,43111,충청북도,청주시 상당구,15-19세,10467,5494,4973
202008,43111,충청북도,청주시 상당구,15-19세,10422,5475,4947
202009,43111,충청북도,청주시 상당구,15-19세,10373,5450,4923
202010,43111,충청북도,청주시 상당구,15-19세,10422,5464,4958
202011,43111,충청북도,청주시 상당구,15-19세,10372,5429,4943
202012,43111,충청북도,청주시 상당구,15-19세,10348,5408,4940
202101,43111,충청북도,청주시 상당구,15-19세,10353,5403,4950
202102,43111,충청북도,청주시 상당구,15-19세,10345,5394,4951
202103,43111,충청북도,청주시 상당구,15-19세,10222,5344,4878
202104,43111,충청북도,청주시 상당구,15-19세,10144,5287,4857
202105,43111,충청북도,청주시 상당구,15-19세,10079,5258,4821
202106,43111,충청북도,청주시 상당구,15-19세,10003,5230,4773
202007,43111,충청북도,청주시 상당구,20-24세,12502,6740,5762
202008,43111,충청북도,청주시 상당구,20-24세,12509,6740,5769
202009,43111,충청북도,청주시 상당구,20-24세,12520,6747,5773
202010,43111,충청북도,청주시 상당구,20-24세,12616,6811,5805
202011,43111,충청북도,청주시 상당구,20-24세,12603,6794,5809
202012,43111,충청북도,청주시 상당구,20-24세,12541,6764,5777
202101,43111,충청북도,청주시 상당구,20-24세,12578,6773,5805
202102,43111,충청북도,청주시 상당구,20-24세,12569,6763,5806
202103,43111,충청북도,청주시 상당구,20-24세,12541,6758,5783
202104,43111,충청북도,청주시 상당구,20-24세,12522,6752,5770
202105,43111,충청북도,청주시 상당구,20-24세,12525,6729,5796
202106,43111,충청북도,청주시 상당구,20-24세,12470,6695,5775
202007,43111,충청북도,청주시 상당구,25-29세,11388,6229,5159
202008,43111,충청북도,청주시 상당구,25-29세,11446,6263,5183
202009,43111,충청북도,청주시 상당구,25-29세,11591,6325,5266
202010,43111,충청북도,청주시 상당구,25-29세,11787,6441,5346
202011,43111,충청북도,청주시 상당구,25-29세,11904,6491,5413
202012,43111,충청북도,청주시 상당구,25-29세,11961,6502,5459
202101,43111,충청북도,청주시 상당구,25-29세,12108,6587,5521
202102,43111,충청북도,청주시 상당구,25-29세,12266,6667,5599
202103,43111,충청북도,청주시 상당구,25-29세,12338,6705,5633
202104,43111,충청북도,청주시 상당구,25-29세,12412,6729,5683
202105,43111,충청북도,청주시 상당구,25-29세,12420,6736,5684
202106,43111,충청북도,청주시 상당구,25-29세,12424,6734,5690
202007,43111,충청북도,청주시 상당구,30-34세,9562,4926,4636
202008,43111,충청북도,청주시 상당구,30-34세,9646,4988,4658
202009,43111,충청북도,청주시 상당구,30-34세,9747,5029,4718
202010,43111,충청북도,청주시 상당구,30-34세,9981,5160,4821
202011,43111,충청북도,청주시 상당구,30-34세,10053,5186,4867
202012,43111,충청북도,청주시 상당구,30-34세,10127,5221,4906
202101,43111,충청북도,청주시 상당구,30-34세,10228,5248,4980
202102,43111,충청북도,청주시 상당구,30-34세,10408,5381,5027
202103,43111,충청북도,청주시 상당구,30-34세,10484,5421,5063
202104,43111,충청북도,청주시 상당구,30-34세,10526,5467,5059
202105,43111,충청북도,청주시 상당구,30-34세,10550,5492,5058
202106,43111,충청북도,청주시 상당구,30-34세,10578,5520,5058
202007,43111,충청북도,청주시 상당구,35-39세,12551,6343,6208
202008,43111,충청북도,청주시 상당구,35-39세,12591,6354,6237
202009,43111,충청북도,청주시 상당구,35-39세,12621,6355,6266
202010,43111,충청북도,청주시 상당구,35-39세,12810,6445,6365
202011,43111,충청북도,청주시 상당구,35-39세,12807,6450,6357
202012,43111,충청북도,청주시 상당구,35-39세,12750,6403,6347
202101,43111,충청북도,청주시 상당구,35-39세,12863,6474,6389
202102,43111,충청북도,청주시 상당구,35-39세,13042,6562,6480
202103,43111,충청북도,청주시 상당구,35-39세,12988,6538,6450
202104,43111,충청북도,청주시 상당구,35-39세,12996,6550,6446
202105,43111,충청북도,청주시 상당구,35-39세,12985,6550,6435
202106,43111,충청북도,청주시 상당구,35-39세,12938,6508,6430
202007,43111,충청북도,청주시 상당구,40-44세,13640,6804,6836
202008,43111,충청북도,청주시 상당구,40-44세,13655,6801,6854
202009,43111,충청북도,청주시 상당구,40-44세,13823,6895,6928
202010,43111,충청북도,청주시 상당구,40-44세,13991,6991,7000
202011,43111,충청북도,청주시 상당구,40-44세,14059,7019,7040
202012,43111,충청북도,청주시 상당구,40-44세,14089,7061,7028
202101,43111,충청북도,청주시 상당구,40-44세,14200,7143,7057
202102,43111,충청북도,청주시 상당구,40-44세,14352,7212,7140
202103,43111,충청북도,청주시 상당구,40-44세,14375,7245,7130
202104,43111,충청북도,청주시 상당구,40-44세,14327,7198,7129
202105,43111,충청북도,청주시 상당구,40-44세,14393,7230,7163
202106,43111,충청북도,청주시 상당구,40-44세,14462,7267,7195
202007,43111,충청북도,청주시 상당구,45-49세,16143,7991,8152
202008,43111,충청북도,청주시 상당구,45-49세,16120,7979,8141
202009,43111,충청북도,청주시 상당구,45-49세,16108,7958,8150
202010,43111,충청북도,청주시 상당구,45-49세,16204,7983,8221
202011,43111,충청북도,청주시 상당구,45-49세,16192,7961,8231
202012,43111,충청북도,청주시 상당구,45-49세,16216,7962,8254
202101,43111,충청북도,청주시 상당구,45-49세,16303,7987,8316
202102,43111,충청북도,청주시 상당구,45-49세,16418,8060,8358
202103,43111,충청북도,청주시 상당구,45-49세,16400,8067,8333
202104,43111,충청북도,청주시 상당구,45-49세,16399,8066,8333
202105,43111,충청북도,청주시 상당구,45-49세,16247,8001,8246
202106,43111,충청북도,청주시 상당구,45-49세,16209,7959,8250
202007,43111,충청북도,청주시 상당구,50-54세,16563,8151,8412
202008,43111,충청북도,청주시 상당구,50-54세,16648,8185,8463
202009,43111,충청북도,청주시 상당구,50-54세,16731,8222,8509
202010,43111,충청북도,청주시 상당구,50-54세,16963,8328,8635
202011,43111,충청북도,청주시 상당구,50-54세,17034,8375,8659
202012,43111,충청북도,청주시 상당구,50-54세,16956,8352,8604
202101,43111,충청북도,청주시 상당구,50-54세,17118,8424,8694
202102,43111,충청북도,청주시 상당구,50-54세,17246,8457,8789
202103,43111,충청북도,청주시 상당구,50-54세,17206,8437,8769
202104,43111,충청북도,청주시 상당구,50-54세,17206,8441,8765
202105,43111,충청북도,청주시 상당구,50-54세,17323,8484,8839
202106,43111,충청북도,청주시 상당구,50-54세,17356,8504,8852
202007,43111,충청북도,청주시 상당구,55-59세,15675,7992,7683
202008,43111,충청북도,청주시 상당구,55-59세,15706,7986,7720
202009,43111,충청북도,청주시 상당구,55-59세,15803,8045,7758
202010,43111,충청북도,청주시 상당구,55-59세,15953,8107,7846
202011,43111,충청북도,청주시 상당구,55-59세,15946,8087,7859
202012,43111,충청북도,청주시 상당구,55-59세,16017,8112,7905
202101,43111,충청북도,청주시 상당구,55-59세,15991,8122,7869
202102,43111,충청북도,청주시 상당구,55-59세,16093,8176,7917
202103,43111,충청북도,청주시 상당구,55-59세,16061,8153,7908
202104,43111,충청북도,청주시 상당구,55-59세,16001,8116,7885
202105,43111,충청북도,청주시 상당구,55-59세,15944,8065,7879
202106,43111,충청북도,청주시 상당구,55-59세,15792,7998,7794
202007,43111,충청북도,청주시 상당구,60-64세,13484,6713,6771
202008,43111,충청북도,청주시 상당구,60-64세,13594,6779,6815
202009,43111,충청북도,청주시 상당구,60-64세,13751,6838,6913
202010,43111,충청북도,청주시 상당구,60-64세,13899,6903,6996
202011,43111,충청북도,청주시 상당구,60-64세,14041,6972,7069
202012,43111,충청북도,청주시 상당구,60-64세,14123,7009,7114
202101,43111,충청북도,청주시 상당구,60-64세,14372,7122,7250
202102,43111,충청북도,청주시 상당구,60-64세,14593,7234,7359
202103,43111,충청북도,청주시 상당구,60-64세,14785,7320,7465
202104,43111,충청북도,청주시 상당구,60-64세,14929,7386,7543
202105,43111,충청북도,청주시 상당구,60-64세,15063,7475,7588
202106,43111,충청북도,청주시 상당구,60-64세,15263,7578,7685
202007,43111,충청북도,청주시 상당구,65-69세,9246,4552,4694
202008,43111,충청북도,청주시 상당구,65-69세,9351,4601,4750
202009,43111,충청북도,청주시 상당구,65-69세,9438,4651,4787
202010,43111,충청북도,청주시 상당구,65-69세,9582,4727,4855
202011,43111,충청북도,청주시 상당구,65-69세,9654,4762,4892
202012,43111,충청북도,청주시 상당구,65-69세,9772,4822,4950
202101,43111,충청북도,청주시 상당구,65-69세,9873,4851,5022
202102,43111,충청북도,청주시 상당구,65-69세,9998,4899,5099
202103,43111,충청북도,청주시 상당구,65-69세,10170,4999,5171
202104,43111,충청북도,청주시 상당구,65-69세,10279,5067,5212
202105,43111,충청북도,청주시 상당구,65-69세,10341,5085,5256
202106,43111,충청북도,청주시 상당구,65-69세,10420,5112,5308
202007,43111,충청북도,청주시 상당구,70-74세,6410,2989,3421
202008,43111,충청북도,청주시 상당구,70-74세,6420,2997,3423
202009,43111,충청북도,청주시 상당구,70-74세,6495,3031,3464
202010,43111,충청북도,청주시 상당구,70-74세,6554,3057,3497
202011,43111,충청북도,청주시 상당구,70-74세,6630,3092,3538
202012,43111,충청북도,청주시 상당구,70-74세,6659,3096,3563
202101,43111,충청북도,청주시 상당구,70-74세,6731,3135,3596
202102,43111,충청북도,청주시 상당구,70-74세,6793,3173,3620
202103,43111,충청북도,청주시 상당구,70-74세,6774,3167,3607
202104,43111,충청북도,청주시 상당구,70-74세,6777,3170,3607
202105,43111,충청북도,청주시 상당구,70-74세,6807,3187,3620
202106,43111,충청북도,청주시 상당구,70-74세,6783,3185,3598
202007,43111,충청북도,청주시 상당구,75-79세,5745,2392,3353
202008,43111,충청북도,청주시 상당구,75-79세,5758,2391,3367
202009,43111,충청북도,청주시 상당구,75-79세,5726,2376,3350
202010,43111,충청북도,청주시 상당구,75-79세,5708,2365,3343
202011,43111,충청북도,청주시 상당구,75-79세,5677,2356,3321
202012,43111,충청북도,청주시 상당구,75-79세,5651,2343,3308
202101,43111,충청북도,청주시 상당구,75-79세,5643,2347,3296
202102,43111,충청북도,청주시 상당구,75-79세,5620,2336,3284
202103,43111,충청북도,청주시 상당구,75-79세,5614,2345,3269
202104,43111,충청북도,청주시 상당구,75-79세,5578,2336,3242
202105,43111,충청북도,청주시 상당구,75-79세,5574,2349,3225
202106,43111,충청북도,청주시 상당구,75-79세,5597,2354,3243
202007,43111,충청북도,청주시 상당구,80-84세,4064,1458,2606
202008,43111,충청북도,청주시 상당구,80-84세,4080,1466,2614
202009,43111,충청북도,청주시 상당구,80-84세,4074,1461,2613
202010,43111,충청북도,청주시 상당구,80-84세,4090,1476,2614
202011,43111,충청북도,청주시 상당구,80-84세,4115,1483,2632
202012,43111,충청북도,청주시 상당구,80-84세,4119,1497,2622
202101,43111,충청북도,청주시 상당구,80-84세,4118,1491,2627
202102,43111,충청북도,청주시 상당구,80-84세,4119,1490,2629
202103,43111,충청북도,청주시 상당구,80-84세,4119,1488,2631
202104,43111,충청북도,청주시 상당구,80-84세,4140,1500,2640
202105,43111,충청북도,청주시 상당구,80-84세,4162,1510,2652
202106,43111,충청북도,청주시 상당구,80-84세,4180,1518,2662
202007,43111,충청북도,청주시 상당구,85-89세,2025,585,1440
202008,43111,충청북도,청주시 상당구,85-89세,2040,588,1452
202009,43111,충청북도,청주시 상당구,85-89세,2067,608,1459
202010,43111,충청북도,청주시 상당구,85-89세,2092,615,1477
202011,43111,충청북도,청주시 상당구,85-89세,2099,620,1479
202012,43111,충청북도,청주시 상당구,85-89세,2132,633,1499
202101,43111,충청북도,청주시 상당구,85-89세,2148,635,1513
202102,43111,충청북도,청주시 상당구,85-89세,2191,650,1541
202103,43111,충청북도,청주시 상당구,85-89세,2223,658,1565
202104,43111,충청북도,청주시 상당구,85-89세,2240,664,1576
202105,43111,충청북도,청주시 상당구,85-89세,2274,674,1600
202106,43111,충청북도,청주시 상당구,85-89세,2285,674,1611
202007,43111,충청북도,청주시 상당구,90-94세,785,185,600
202008,43111,충청북도,청주시 상당구,90-94세,792,186,606
202009,43111,충청북도,청주시 상당구,90-94세,811,191,620
202010,43111,충청북도,청주시 상당구,90-94세,818,192,626
202011,43111,충청북도,청주시 상당구,90-94세,819,196,623
202012,43111,충청북도,청주시 상당구,90-94세,822,197,625
202101,43111,충청북도,청주시 상당구,90-94세,833,198,635
202102,43111,충청북도,청주시 상당구,90-94세,832,194,638
202103,43111,충청북도,청주시 상당구,90-94세,826,189,637
202104,43111,충청북도,청주시 상당구,90-94세,834,188,646
202105,43111,충청북도,청주시 상당구,90-94세,830,191,639
202106,43111,충청북도,청주시 상당구,90-94세,827,188,639
202007,43111,충청북도,청주시 상당구,95-99세,166,40,126
202008,43111,충청북도,청주시 상당구,95-99세,170,38,132
202009,43111,충청북도,청주시 상당구,95-99세,171,37,134
202010,43111,충청북도,청주시 상당구,95-99세,171,36,135
202011,43111,충청북도,청주시 상당구,95-99세,171,34,137
202012,43111,충청북도,청주시 상당구,95-99세,169,34,135
202101,43111,충청북도,청주시 상당구,95-99세,168,33,135
202102,43111,충청북도,청주시 상당구,95-99세,169,32,137
202103,43111,충청북도,청주시 상당구,95-99세,165,35,130
202104,43111,충청북도,청주시 상당구,95-99세,166,35,131
202105,43111,충청북도,청주시 상당구,95-99세,167,33,134
202106,43111,충청북도,청주시 상당구,95-99세,169,34,135
202007,43111,충청북도,청주시 상당구,100+,56,11,45
202008,43111,충청북도,청주시 상당구,100+,57,11,46
202009,43111,충청북도,청주시 상당구,100+,58,12,46
202010,43111,충청북도,청주시 상당구,100+,57,12,45
202011,43111,충청북도,청주시 상당구,100+,55,12,43
202012,43111,충청북도,청주시 상당구,100+,56,12,44
202101,43111,충청북도,청주시 상당구,100+,56,13,43
202102,43111,충청북도,청주시 상당구,100+,59,15,44
202103,43111,충청북도,청주시 상당구,100+,33,5,28
202104,43111,충청북도,청주시 상당구,100+,34,6,28
202105,43111,충청북도,청주시 상당구,100+,34,5,29
202106,43111,충청북도,청주시 상당구,100+,32,4,28
202007,43112,충청북도,청주시 서원구,0-4세,6027,3089,2938
202008,43112,충청북도,청주시 서원구,0-4세,5933,3050,2883
202009,43112,충청북도,청주시 서원구,0-4세,5874,3022,2852
202010,43112,충청북도,청주시 서원구,0-4세,5727,2946,2781
202011,43112,충청북도,청주시 서원구,0-4세,5657,2909,2748
202012,43112,충청북도,청주시 서원구,0-4세,5560,2860,2700
202101,43112,충청북도,청주시 서원구,0-4세,5463,2803,2660
202102,43112,충청북도,청주시 서원구,0-4세,5404,2789,2615
202103,43112,충청북도,청주시 서원구,0-4세,5308,2746,2562
202104,43112,충청북도,청주시 서원구,0-4세,5339,2763,2576
202105,43112,충청북도,청주시 서원구,0-4세,5342,2772,2570
202106,43112,충청북도,청주시 서원구,0-4세,5283,2740,2543
202007,43112,충청북도,청주시 서원구,5-9세,8663,4369,4294
202008,43112,충청북도,청주시 서원구,5-9세,8632,4362,4270
202009,43112,충청북도,청주시 서원구,5-9세,8524,4310,4214
202010,43112,충청북도,청주시 서원구,5-9세,8455,4274,4181
202011,43112,충청북도,청주시 서원구,5-9세,8364,4245,4119
202012,43112,충청북도,청주시 서원구,5-9세,8282,4209,4073
202101,43112,충청북도,청주시 서원구,5-9세,8142,4144,3998
202102,43112,충청북도,청주시 서원구,5-9세,8082,4090,3992
202103,43112,충청북도,청주시 서원구,5-9세,8055,4081,3974
202104,43112,충청북도,청주시 서원구,5-9세,8012,4056,3956
202105,43112,충청북도,청주시 서원구,5-9세,8009,4065,3944
202106,43112,충청북도,청주시 서원구,5-9세,7949,4031,3918
202007,43112,충청북도,청주시 서원구,10-14세,9748,5056,4692
202008,43112,충청북도,청주시 서원구,10-14세,9704,5025,4679
202009,43112,충청북도,청주시 서원구,10-14세,9698,5033,4665
202010,43112,충청북도,청주시 서원구,10-14세,9670,5018,4652
202011,43112,충청북도,청주시 서원구,10-14세,9663,4999,4664
202012,43112,충청북도,청주시 서원구,10-14세,9606,4950,4656
202101,43112,충청북도,청주시 서원구,10-14세,9591,4941,4650
202102,43112,충청북도,청주시 서원구,10-14세,9522,4892,4630
202103,43112,충청북도,청주시 서원구,10-14세,9507,4876,4631
202104,43112,충청북도,청주시 서원구,10-14세,9519,4895,4624
202105,43112,충청북도,청주시 서원구,10-14세,9486,4875,4611
202106,43112,충청북도,청주시 서원구,10-14세,9452,4849,4603
202007,43112,충청북도,청주시 서원구,15-19세,11262,5910,5352
202008,43112,충청북도,청주시 서원구,15-19세,11189,5874,5315
202009,43112,충청북도,청주시 서원구,15-19세,11096,5829,5267
202010,43112,충청북도,청주시 서원구,15-19세,10985,5768,5217
202011,43112,충청북도,청주시 서원구,15-19세,10879,5716,5163
202012,43112,충청북도,청주시 서원구,15-19세,10765,5675,5090
202101,43112,충청북도,청주시 서원구,15-19세,10662,5593,5069
202102,43112,충청북도,청주시 서원구,15-19세,10584,5551,5033
202103,43112,충청북도,청주시 서원구,15-19세,10452,5479,4973
202104,43112,충청북도,청주시 서원구,15-19세,10417,5455,4962
202105,43112,충청북도,청주시 서원구,15-19세,10388,5438,4950
202106,43112,충청북도,청주시 서원구,15-19세,10340,5423,4917
202007,43112,충청북도,청주시 서원구,20-24세,14863,7913,6950
202008,43112,충청북도,청주시 서원구,20-24세,14828,7892,6936
202009,43112,충청북도,청주시 서원구,20-24세,14745,7832,6913
202010,43112,충청북도,청주시 서원구,20-24세,14670,7787,6883
202011,43112,충청북도,청주시 서원구,20-24세,14640,7745,6895
202012,43112,충청북도,청주시 서원구,20-24세,14495,7661,6834
202101,43112,충청북도,청주시 서원구,20-24세,14488,7660,6828
202102,43112,충청북도,청주시 서원구,20-24세,14392,7587,6805
202103,43112,충청북도,청주시 서원구,20-24세,14346,7563,6783
202104,43112,충청북도,청주시 서원구,20-24세,14324,7524,6800
202105,43112,충청북도,청주시 서원구,20-24세,14299,7506,6793
202106,43112,충청북도,청주시 서원구,20-24세,14243,7462,6781
202007,43112,충청북도,청주시 서원구,25-29세,13880,7724,6156
202008,43112,충청북도,청주시 서원구,25-29세,13842,7673,6169
202009,43112,충청북도,청주시 서원구,25-29세,13834,7683,6151
202010,43112,충청북도,청주시 서원구,25-29세,13844,7681,6163
202011,43112,충청북도,청주시 서원구,25-29세,13827,7710,6117
202012,43112,충청북도,청주시 서원구,25-29세,13835,7717,6118
202101,43112,충청북도,청주시 서원구,25-29세,13742,7682,6060
202102,43112,충청북도,청주시 서원구,25-29세,13684,7658,6026
202103,43112,충청북도,청주시 서원구,25-29세,13725,7686,6039
202104,43112,충청북도,청주시 서원구,25-29세,13800,7749,6051
202105,43112,충청북도,청주시 서원구,25-29세,13867,7774,6093
202106,43112,충청북도,청주시 서원구,25-29세,13946,7851,6095
202007,43112,충청북도,청주시 서원구,30-34세,10714,5670,5044
202008,43112,충청북도,청주시 서원구,30-34세,10670,5648,5022
202009,43112,충청북도,청주시 서원구,30-34세,10630,5633,4997
202010,43112,충청북도,청주시 서원구,30-34세,10516,5564,4952
202011,43112,충청북도,청주시 서원구,30-34세,10449,5524,4925
202012,43112,충청북도,청주시 서원구,30-34세,10353,5466,4887
202101,43112,충청북도,청주시 서원구,30-34세,10315,5459,4856
202102,43112,충청북도,청주시 서원구,30-34세,10237,5414,4823
202103,43112,충청북도,청주시 서원구,30-34세,10225,5424,4801
202104,43112,충청북도,청주시 서원구,30-34세,10351,5490,4861
202105,43112,충청북도,청주시 서원구,30-34세,10417,5522,4895
202106,43112,충청북도,청주시 서원구,30-34세,10488,5558,4930
202007,43112,충청북도,청주시 서원구,35-39세,12977,6490,6487
202008,43112,충청북도,청주시 서원구,35-39세,12814,6412,6402
202009,43112,충청북도,청주시 서원구,35-39세,12698,6366,6332
202010,43112,충청북도,청주시 서원구,35-39세,12521,6282,6239
202011,43112,충청북도,청주시 서원구,35-39세,12419,6222,6197
202012,43112,충청북도,청주시 서원구,35-39세,12310,6199,6111
202101,43112,충청북도,청주시 서원구,35-39세,12190,6115,6075
202102,43112,충청북도,청주시 서원구,35-39세,11997,6026,5971
202103,43112,충청북도,청주시 서원구,35-39세,11846,5943,5903
202104,43112,충청북도,청주시 서원구,35-39세,11870,5971,5899
202105,43112,충청북도,청주시 서원구,35-39세,11834,5981,5853
202106,43112,충청북도,청주시 서원구,35-39세,11724,5940,5784
202007,43112,충청북도,청주시 서원구,40-44세,14201,7057,7144
202008,43112,충청북도,청주시 서원구,40-44세,14179,7055,7124
202009,43112,충청북도,청주시 서원구,40-44세,14154,7056,7098
202010,43112,충청북도,청주시 서원구,40-44세,14091,7011,7080
202011,43112,충청북도,청주시 서원구,40-44세,14046,6998,7048
202012,43112,충청북도,청주시 서원구,40-44세,13900,6915,6985
202101,43112,충청북도,청주시 서원구,40-44세,13823,6900,6923
202102,43112,충청북도,청주시 서원구,40-44세,13740,6852,6888
202103,43112,충청북도,청주시 서원구,40-44세,13630,6800,6830
202104,43112,충청북도,청주시 서원구,40-44세,13664,6815,6849
202105,43112,충청북도,청주시 서원구,40-44세,13736,6853,6883
202106,43112,충청북도,청주시 서원구,40-44세,13757,6842,6915
202007,43112,충청북도,청주시 서원구,45-49세,17469,8554,8915
202008,43112,충청북도,청주시 서원구,45-49세,17330,8477,8853
202009,43112,충청북도,청주시 서원구,45-49세,17159,8376,8783
202010,43112,충청북도,청주시 서원구,45-49세,17028,8326,8702
202011,43112,충청북도,청주시 서원구,45-49세,16891,8281,8610
202012,43112,충청북도,청주시 서원구,45-49세,16781,8246,8535
202101,43112,충청북도,청주시 서원구,45-49세,16697,8211,8486
202102,43112,충청북도,청주시 서원구,45-49세,16645,8172,8473
202103,43112,충청북도,청주시 서원구,45-49세,16571,8145,8426
202104,43112,충청북도,청주시 서원구,45-49세,16565,8153,8412
202105,43112,충청북도,청주시 서원구,45-49세,16475,8110,8365
202106,43112,충청북도,청주시 서원구,45-49세,16411,8079,8332
202007,43112,충청북도,청주시 서원구,50-54세,18107,8841,9266
202008,43112,충청북도,청주시 서원구,50-54세,18176,8852,9324
202009,43112,충청북도,청주시 서원구,50-54세,18160,8855,9305
202010,43112,충청북도,청주시 서원구,50-54세,18095,8821,9274
202011,43112,충청북도,청주시 서원구,50-54세,18070,8807,9263
202012,43112,충청북도,청주시 서원구,50-54세,17852,8690,9162
202101,43112,충청북도,청주시 서원구,50-54세,17903,8706,9197
202102,43112,충청북도,청주시 서원구,50-54세,17833,8665,9168
202103,43112,충청북도,청주시 서원구,50-54세,17772,8638,9134
202104,43112,충청북도,청주시 서원구,50-54세,17875,8685,9190
202105,43112,충청북도,청주시 서원구,50-54세,17963,8728,9235
202106,43112,충청북도,청주시 서원구,50-54세,17962,8738,9224
202007,43112,충청북도,청주시 서원구,55-59세,16793,8331,8462
202008,43112,충청북도,청주시 서원구,55-59세,16740,8325,8415
202009,43112,충청북도,청주시 서원구,55-59세,16639,8293,8346
202010,43112,충청북도,청주시 서원구,55-59세,16521,8232,8289
202011,43112,충청북도,청주시 서원구,55-59세,16417,8185,8232
202012,43112,충청북도,청주시 서원구,55-59세,16383,8168,8215
202101,43112,충청북도,청주시 서원구,55-59세,16217,8085,8132
202102,43112,충청북도,청주시 서원구,55-59세,16128,8050,8078
202103,43112,충청북도,청주시 서원구,55-59세,16024,7999,8025
202104,43112,충청북도,청주시 서원구,55-59세,15918,7934,7984
202105,43112,충청북도,청주시 서원구,55-59세,15846,7909,7937
202106,43112,충청북도,청주시 서원구,55-59세,15702,7837,7865
202007,43112,충청북도,청주시 서원구,60-64세,14848,7262,7586
202008,43112,충청북도,청주시 서원구,60-64세,14968,7314,7654
202009,43112,충청북도,청주시 서원구,60-64세,15024,7329,7695
202010,43112,충청북도,청주시 서원구,60-64세,15055,7334,7721
202011,43112,충청북도,청주시 서원구,60-64세,15118,7352,7766
202012,43112,충청북도,청주시 서원구,60-64세,15122,7338,7784
202101,43112,충청북도,청주시 서원구,60-64세,15217,7382,7835
202102,43112,충청북도,청주시 서원구,60-64세,15301,7445,7856
202103,43112,충청북도,청주시 서원구,60-64세,15452,7532,7920
202104,43112,충청북도,청주시 서원구,60-64세,15612,7628,7984
202105,43112,충청북도,청주시 서원구,60-64세,15755,7677,8078
202106,43112,충청북도,청주시 서원구,60-64세,15899,7746,8153
202007,43112,충청북도,청주시 서원구,65-69세,9721,4613,5108
202008,43112,충청북도,청주시 서원구,65-69세,9814,4679,5135
202009,43112,충청북도,청주시 서원구,65-69세,9869,4690,5179
202010,43112,충청북도,청주시 서원구,65-69세,9884,4698,5186
202011,43112,충청북도,청주시 서원구,65-69세,9947,4739,5208
202012,43112,충청북도,청주시 서원구,65-69세,10065,4778,5287
202101,43112,충청북도,청주시 서원구,65-69세,10195,4851,5344
202102,43112,충청북도,청주시 서원구,65-69세,10284,4889,5395
202103,43112,충청북도,청주시 서원구,65-69세,10383,4946,5437
202104,43112,충청북도,청주시 서원구,65-69세,10493,4984,5509
202105,43112,충청북도,청주시 서원구,65-69세,10568,5007,5561
202106,43112,충청북도,청주시 서원구,65-69세,10629,5046,5583
202007,43112,충청북도,청주시 서원구,70-74세,6719,3100,3619
202008,43112,충청북도,청주시 서원구,70-74세,6732,3101,3631
202009,43112,충청북도,청주시 서원구,70-74세,6779,3131,3648
202010,43112,충청북도,청주시 서원구,70-74세,6808,3134,3674
202011,43112,충청북도,청주시 서원구,70-74세,6847,3147,3700
202012,43112,충청북도,청주시 서원구,70-74세,6872,3164,3708
202101,43112,충청북도,청주시 서원구,70-74세,6943,3199,3744
202102,43112,충청북도,청주시 서원구,70-74세,6970,3205,3765
202103,43112,충청북도,청주시 서원구,70-74세,6947,3180,3767
202104,43112,충청북도,청주시 서원구,70-74세,6962,3186,3776
202105,43112,충청북도,청주시 서원구,70-74세,6978,3190,3788
202106,43112,충청북도,청주시 서원구,70-74세,6985,3191,3794
202007,43112,충청북도,청주시 서원구,75-79세,5729,2419,3310
202008,43112,충청북도,청주시 서원구,75-79세,5704,2406,3298
202009,43112,충청북도,청주시 서원구,75-79세,5677,2395,3282
202010,43112,충청북도,청주시 서원구,75-79세,5654,2391,3263
202011,43112,충청북도,청주시 서원구,75-79세,5619,2372,3247
202012,43112,충청북도,청주시 서원구,75-79세,5575,2352,3223
202101,43112,충청북도,청주시 서원구,75-79세,5536,2341,3195
202102,43112,충청북도,청주시 서원구,75-79세,5512,2323,3189
202103,43112,충청북도,청주시 서원구,75-79세,5511,2340,3171
202104,43112,충청북도,청주시 서원구,75-79세,5513,2340,3173
202105,43112,충청북도,청주시 서원구,75-79세,5508,2354,3154
202106,43112,충청북도,청주시 서원구,75-79세,5521,2366,3155
202007,43112,충청북도,청주시 서원구,80-84세,3916,1482,2434
202008,43112,충청북도,청주시 서원구,80-84세,3930,1493,2437
202009,43112,충청북도,청주시 서원구,80-84세,3954,1505,2449
202010,43112,충청북도,청주시 서원구,80-84세,3969,1517,2452
202011,43112,충청북도,청주시 서원구,80-84세,3963,1513,2450
202012,43112,충청북도,청주시 서원구,80-84세,3956,1513,2443
202101,43112,충청북도,청주시 서원구,80-84세,3974,1517,2457
202102,43112,충청북도,청주시 서원구,80-84세,3964,1521,2443
202103,43112,충청북도,청주시 서원구,80-84세,3965,1523,2442
202104,43112,충청북도,청주시 서원구,80-84세,3971,1531,2440
202105,43112,충청북도,청주시 서원구,80-84세,3982,1537,2445
202106,43112,충청북도,청주시 서원구,80-84세,3983,1532,2451
202007,43112,충청북도,청주시 서원구,85-89세,2040,572,1468
202008,43112,충청북도,청주시 서원구,85-89세,2060,577,1483
202009,43112,충청북도,청주시 서원구,85-89세,2060,585,1475
202010,43112,충청북도,청주시 서원구,85-89세,2070,586,1484
202011,43112,충청북도,청주시 서원구,85-89세,2078,596,1482
202012,43112,충청북도,청주시 서원구,85-89세,2106,611,1495
202101,43112,충청북도,청주시 서원구,85-89세,2142,630,1512
202102,43112,충청북도,청주시 서원구,85-89세,2173,647,1526
202103,43112,충청북도,청주시 서원구,85-89세,2200,661,1539
202104,43112,충청북도,청주시 서원구,85-89세,2233,677,1556
202105,43112,충청북도,청주시 서원구,85-89세,2267,689,1578
202106,43112,충청북도,청주시 서원구,85-89세,2284,699,1585
202007,43112,충청북도,청주시 서원구,90-94세,672,136,536
202008,43112,충청북도,청주시 서원구,90-94세,682,142,540
202009,43112,충청북도,청주시 서원구,90-94세,705,147,558
202010,43112,충청북도,청주시 서원구,90-94세,694,148,546
202011,43112,충청북도,청주시 서원구,90-94세,699,142,557
202012,43112,충청북도,청주시 서원구,90-94세,690,141,549
202101,43112,충청북도,청주시 서원구,90-94세,693,137,556
202102,43112,충청북도,청주시 서원구,90-94세,701,134,567
202103,43112,충청북도,청주시 서원구,90-94세,699,138,561
202104,43112,충청북도,청주시 서원구,90-94세,704,139,565
202105,43112,충청북도,청주시 서원구,90-94세,715,145,570
202106,43112,충청북도,청주시 서원구,90-94세,719,145,574
202007,43112,충청북도,청주시 서원구,95-99세,144,22,122
202008,43112,충청북도,청주시 서원구,95-99세,153,22,131
202009,43112,충청북도,청주시 서원구,95-99세,156,22,134
202010,43112,충청북도,청주시 서원구,95-99세,167,24,143
202011,43112,충청북도,청주시 서원구,95-99세,165,25,140
202012,43112,충청북도,청주시 서원구,95-99세,166,27,139
202101,43112,충청북도,청주시 서원구,95-99세,172,31,141
202102,43112,충청북도,청주시 서원구,95-99세,169,32,137
202103,43112,충청북도,청주시 서원구,95-99세,163,27,136
202104,43112,충청북도,청주시 서원구,95-99세,168,27,141
202105,43112,충청북도,청주시 서원구,95-99세,171,27,144
202106,43112,충청북도,청주시 서원구,95-99세,171,27,144
202007,43112,충청북도,청주시 서원구,100+,50,15,35
202008,43112,충청북도,청주시 서원구,100+,48,15,33
202009,43112,충청북도,청주시 서원구,100+,48,15,33
202010,43112,충청북도,청주시 서원구,100+,48,15,33
202011,43112,충청북도,청주시 서원구,100+,46,15,31
202012,43112,충청북도,청주시 서원구,100+,46,15,31
202101,43112,충청북도,청주시 서원구,100+,49,15,34
202102,43112,충청북도,청주시 서원구,100+,49,15,34
202103,43112,충청북도,청주시 서원구,100+,23,6,17
202104,43112,충청북도,청주시 서원구,100+,24,6,18
202105,43112,충청북도,청주시 서원구,100+,24,6,18
202106,43112,충청북도,청주시 서원구,100+,24,6,18
202007,43113,충청북도,청주시 흥덕구,0-4세,11163,5691,5472
202008,43113,충청북도,청주시 흥덕구,0-4세,11113,5667,5446
202009,43113,충청북도,청주시 흥덕구,0-4세,11070,5638,5432
202010,43113,충청북도,청주시 흥덕구,0-4세,10904,5552,5352
202011,43113,충청북도,청주시 흥덕구,0-4세,10861,5529,5332
202012,43113,충청북도,청주시 흥덕구,0-4세,10833,5490,5343
202101,43113,충청북도,청주시 흥덕구,0-4세,10794,5482,5312
202102,43113,충청북도,청주시 흥덕구,0-4세,10703,5448,5255
202103,43113,충청북도,청주시 흥덕구,0-4세,10634,5408,5226
202104,43113,충청북도,청주시 흥덕구,0-4세,10524,5352,5172
202105,43113,충청북도,청주시 흥덕구,0-4세,10431,5287,5144
202106,43113,충청북도,청주시 흥덕구,0-4세,10499,5315,5184
202007,43113,충청북도,청주시 흥덕구,5-9세,13375,6809,6566
202008,43113,충청북도,청주시 흥덕구,5-9세,13433,6857,6576
202009,43113,충청북도,청주시 흥덕구,5-9세,13416,6862,6554
202010,43113,충청북도,청주시 흥덕구,5-9세,13333,6804,6529
202011,43113,충청북도,청주시 흥덕구,5-9세,13323,6806,6517
202012,43113,충청북도,청주시 흥덕구,5-9세,13373,6844,6529
202101,43113,충청북도,청주시 흥덕구,5-9세,13347,6827,6520
202102,43113,충청북도,청주시 흥덕구,5-9세,13360,6838,6522
202103,43113,충청북도,청주시 흥덕구,5-9세,13315,6806,6509
202104,43113,충청북도,청주시 흥덕구,5-9세,13311,6800,6511
202105,43113,충청북도,청주시 흥덕구,5-9세,13287,6809,6478
202106,43113,충청북도,청주시 흥덕구,5-9세,13319,6824,6495
202007,43113,충청북도,청주시 흥덕구,10-14세,12987,6724,6263
202008,43113,충청북도,청주시 흥덕구,10-14세,12975,6722,6253
202009,43113,충청북도,청주시 흥덕구,10-14세,12991,6747,6244
202010,43113,충청북도,청주시 흥덕구,10-14세,13011,6760,6251
202011,43113,충청북도,청주시 흥덕구,10-14세,13027,6759,6268
202012,43113,충청북도,청주시 흥덕구,10-14세,13060,6776,6284
202101,43113,충청북도,청주시 흥덕구,10-14세,13115,6815,6300
202102,43113,충청북도,청주시 흥덕구,10-14세,13084,6793,6291
202103,43113,충청북도,청주시 흥덕구,10-14세,13125,6836,6289
202104,43113,충청북도,청주시 흥덕구,10-14세,13122,6819,6303
202105,43113,충청북도,청주시 흥덕구,10-14세,13145,6829,6316
202106,43113,충청북도,청주시 흥덕구,10-14세,13189,6839,6350
202007,43113,충청북도,청주시 흥덕구,15-19세,13831,7214,6617
202008,43113,충청북도,청주시 흥덕구,15-19세,13782,7175,6607
202009,43113,충청북도,청주시 흥덕구,15-19세,13717,7130,6587
202010,43113,충청북도,청주시 흥덕구,15-19세,13590,7059,6531
202011,43113,충청북도,청주시 흥덕구,15-19세,13527,7024,6503
202012,43113,충청북도,청주시 흥덕구,15-19세,13466,6997,6469
202101,43113,충청북도,청주시 흥덕구,15-19세,13422,6958,6464
202102,43113,충청북도,청주시 흥덕구,15-19세,13371,6940,6431
202103,43113,충청북도,청주시 흥덕구,15-19세,13267,6871,6396
202104,43113,충청북도,청주시 흥덕구,15-19세,13151,6830,6321
202105,43113,충청북도,청주시 흥덕구,15-19세,13062,6772,6290
202106,43113,충청북도,청주시 흥덕구,15-19세,13078,6778,6300
202007,43113,충청북도,청주시 흥덕구,20-24세,18601,9713,8888
202008,43113,충청북도,청주시 흥덕구,20-24세,18502,9685,8817
202009,43113,충청북도,청주시 흥덕구,20-24세,18406,9632,8774
202010,43113,충청북도,청주시 흥덕구,20-24세,18295,9582,8713
202011,43113,충청북도,청주시 흥덕구,20-24세,18172,9541,8631
202012,43113,충청북도,청주시 흥덕구,20-24세,18199,9541,8658
202101,43113,충청북도,청주시 흥덕구,20-24세,18165,9510,8655
202102,43113,충청북도,청주시 흥덕구,20-24세,18075,9449,8626
202103,43113,충청북도,청주시 흥덕구,20-24세,17920,9371,8549
202104,43113,충청북도,청주시 흥덕구,20-24세,17857,9315,8542
202105,43113,충청북도,청주시 흥덕구,20-24세,17803,9275,8528
202106,43113,충청북도,청주시 흥덕구,20-24세,17863,9303,8560
202007,43113,충청북도,청주시 흥덕구,25-29세,22554,12539,10015
202008,43113,충청북도,청주시 흥덕구,25-29세,22565,12553,10012
202009,43113,충청북도,청주시 흥덕구,25-29세,22636,12579,10057
202010,43113,충청북도,청주시 흥덕구,25-29세,22669,12611,10058
202011,43113,충청북도,청주시 흥덕구,25-29세,22797,12700,10097
202012,43113,충청북도,청주시 흥덕구,25-29세,22923,12785,10138
202101,43113,충청북도,청주시 흥덕구,25-29세,22913,12762,10151
202102,43113,충청북도,청주시 흥덕구,25-29세,22854,12713,10141
202103,43113,충청북도,청주시 흥덕구,25-29세,22864,12711,10153
202104,43113,충청북도,청주시 흥덕구,25-29세,22898,12733,10165
202105,43113,충청북도,청주시 흥덕구,25-29세,22918,12738,10180
202106,43113,충청북도,청주시 흥덕구,25-29세,22968,12775,10193
202007,43113,충청북도,청주시 흥덕구,30-34세,19760,10520,9240
202008,43113,충청북도,청주시 흥덕구,30-34세,19795,10550,9245
202009,43113,충청북도,청주시 흥덕구,30-34세,19810,10571,9239
202010,43113,충청북도,청주시 흥덕구,30-34세,19721,10509,9212
202011,43113,충청북도,청주시 흥덕구,30-34세,19736,10508,9228
202012,43113,충청북도,청주시 흥덕구,30-34세,19738,10537,9201
202101,43113,충청북도,청주시 흥덕구,30-34세,19738,10541,9197
202102,43113,충청북도,청주시 흥덕구,30-34세,19706,10516,9190
202103,43113,충청북도,청주시 흥덕구,30-34세,19699,10503,9196
202104,43113,충청북도,청주시 흥덕구,30-34세,19701,10509,9192
202105,43113,충청북도,청주시 흥덕구,30-34세,19762,10540,9222
202106,43113,충청북도,청주시 흥덕구,30-34세,19980,10639,9341
202007,43113,충청북도,청주시 흥덕구,35-39세,21627,11227,10400
202008,43113,충청북도,청주시 흥덕구,35-39세,21619,11264,10355
202009,43113,충청북도,청주시 흥덕구,35-39세,21566,11236,10330
202010,43113,충청북도,청주시 흥덕구,35-39세,21458,11176,10282
202011,43113,충청북도,청주시 흥덕구,35-39세,21420,11135,10285
202012,43113,충청북도,청주시 흥덕구,35-39세,21511,11198,10313
202101,43113,충청북도,청주시 흥덕구,35-39세,21532,11202,10330
202102,43113,충청북도,청주시 흥덕구,35-39세,21523,11249,10274
202103,43113,충청북도,청주시 흥덕구,35-39세,21363,11162,10201
202104,43113,충청북도,청주시 흥덕구,35-39세,21260,11082,10178
202105,43113,충청북도,청주시 흥덕구,35-39세,21225,11043,10182
202106,43113,충청북도,청주시 흥덕구,35-39세,21311,11094,10217
202007,43113,충청북도,청주시 흥덕구,40-44세,20684,10539,10145
202008,43113,충청북도,청주시 흥덕구,40-44세,20733,10554,10179
202009,43113,충청북도,청주시 흥덕구,40-44세,20783,10589,10194
202010,43113,충청북도,청주시 흥덕구,40-44세,20824,10594,10230
202011,43113,충청북도,청주시 흥덕구,40-44세,20873,10621,10252
202012,43113,충청북도,청주시 흥덕구,40-44세,20866,10660,10206
202101,43113,충청북도,청주시 흥덕구,40-44세,20867,10690,10177
202102,43113,충청북도,청주시 흥덕구,40-44세,20860,10681,10179
202103,43113,충청북도,청주시 흥덕구,40-44세,20800,10649,10151
202104,43113,충청북도,청주시 흥덕구,40-44세,20794,10659,10135
202105,43113,충청북도,청주시 흥덕구,40-44세,20866,10708,10158
202106,43113,충청북도,청주시 흥덕구,40-44세,21106,10839,10267
202007,43113,충청북도,청주시 흥덕구,45-49세,22812,11521,11291
202008,43113,충청북도,청주시 흥덕구,45-49세,22781,11503,11278
202009,43113,충청북도,청주시 흥덕구,45-49세,22632,11432,11200
202010,43113,충청북도,청주시 흥덕구,45-49세,22424,11341,11083
202011,43113,충청북도,청주시 흥덕구,45-49세,22269,11256,11013
202012,43113,충청북도,청주시 흥덕구,45-49세,22307,11222,11085
202101,43113,충청북도,청주시 흥덕구,45-49세,22384,11262,11122
202102,43113,충청북도,청주시 흥덕구,45-49세,22396,11255,11141
202103,43113,충청북도,청주시 흥덕구,45-49세,22346,11228,11118
202104,43113,충청북도,청주시 흥덕구,45-49세,22315,11223,11092
202105,43113,충청북도,청주시 흥덕구,45-49세,22146,11153,10993
202106,43113,충청북도,청주시 흥덕구,45-49세,22072,11118,10954
202007,43113,충청북도,청주시 흥덕구,50-54세,22667,11196,11471
202008,43113,충청북도,청주시 흥덕구,50-54세,22701,11234,11467
202009,43113,충청북도,청주시 흥덕구,50-54세,22760,11270,11490
202010,43113,충청북도,청주시 흥덕구,50-54세,22824,11319,11505
202011,43113,충청북도,청주시 흥덕구,50-54세,22879,11359,11520
202012,43113,충청북도,청주시 흥덕구,50-54세,22821,11376,11445
202101,43113,충청북도,청주시 흥덕구,50-54세,22868,11381,11487
202102,43113,충청북도,청주시 흥덕구,50-54세,22848,11386,11462
202103,43113,충청북도,청주시 흥덕구,50-54세,22727,11328,11399
202104,43113,충청북도,청주시 흥덕구,50-54세,22690,11309,11381
202105,43113,충청북도,청주시 흥덕구,50-54세,22805,11363,11442
202106,43113,충청북도,청주시 흥덕구,50-54세,23004,11464,11540
202007,43113,충청북도,청주시 흥덕구,55-59세,20373,10377,9996
202008,43113,충청북도,청주시 흥덕구,55-59세,20346,10351,9995
202009,43113,충청북도,청주시 흥덕구,55-59세,20346,10352,9994
202010,43113,충청북도,청주시 흥덕구,55-59세,20281,10294,9987
202011,43113,충청북도,청주시 흥덕구,55-59세,20245,10281,9964
202012,43113,충청북도,청주시 흥덕구,55-59세,20263,10280,9983
202101,43113,충청북도,청주시 흥덕구,55-59세,20174,10216,9958
202102,43113,충청북도,청주시 흥덕구,55-59세,20134,10181,9953
202103,43113,충청북도,청주시 흥덕구,55-59세,20016,10116,9900
202104,43113,충청북도,청주시 흥덕구,55-59세,19893,10051,9842
202105,43113,충청북도,청주시 흥덕구,55-59세,19779,9980,9799
202106,43113,충청북도,청주시 흥덕구,55-59세,19643,9916,9727
202007,43113,충청북도,청주시 흥덕구,60-64세,16404,8125,8279
202008,43113,충청북도,청주시 흥덕구,60-64세,16471,8171,8300
202009,43113,충청북도,청주시 흥덕구,60-64세,16561,8219,8342
202010,43113,충청북도,청주시 흥덕구,60-64세,16687,8296,8391
202011,43113,충청북도,청주시 흥덕구,60-64세,16772,8348,8424
202012,43113,충청북도,청주시 흥덕구,60-64세,16932,8400,8532
202101,43113,충청북도,청주시 흥덕구,60-64세,17048,8498,8550
202102,43113,충청북도,청주시 흥덕구,60-64세,17230,8583,8647
202103,43113,충청북도,청주시 흥덕구,60-64세,17414,8676,8738
202104,43113,충청북도,청주시 흥덕구,60-64세,17562,8761,8801
202105,43113,충청북도,청주시 흥덕구,60-64세,17768,8858,8910
202106,43113,충청북도,청주시 흥덕구,60-64세,18001,8947,9054
202007,43113,충청북도,청주시 흥덕구,65-69세,10295,4994,5301
202008,43113,충청북도,청주시 흥덕구,65-69세,10363,5010,5353
202009,43113,충청북도,청주시 흥덕구,65-69세,10442,5049,5393
202010,43113,충청북도,청주시 흥덕구,65-69세,10515,5077,5438
202011,43113,충청북도,청주시 흥덕구,65-69세,10623,5119,5504
202012,43113,충청북도,청주시 흥덕구,65-69세,10717,5185,5532
202101,43113,충청북도,청주시 흥덕구,65-69세,10893,5257,5636
202102,43113,충청북도,청주시 흥덕구,65-69세,10957,5299,5658
202103,43113,충청북도,청주시 흥덕구,65-69세,11117,5406,5711
202104,43113,충청북도,청주시 흥덕구,65-69세,11219,5453,5766
202105,43113,충청북도,청주시 흥덕구,65-69세,11308,5507,5801
202106,43113,충청북도,청주시 흥덕구,65-69세,11404,5563,5841
202007,43113,충청북도,청주시 흥덕구,70-74세,6642,3200,3442
202008,43113,충청북도,청주시 흥덕구,70-74세,6651,3223,3428
202009,43113,충청북도,청주시 흥덕구,70-74세,6709,3251,3458
202010,43113,충청북도,청주시 흥덕구,70-74세,6801,3298,3503
202011,43113,충청북도,청주시 흥덕구,70-74세,6825,3314,3511
202012,43113,충청북도,청주시 흥덕구,70-74세,6882,3330,3552
202101,43113,충청북도,청주시 흥덕구,70-74세,6958,3353,3605
202102,43113,충청북도,청주시 흥덕구,70-74세,6984,3363,3621
202103,43113,충청북도,청주시 흥덕구,70-74세,6960,3342,3618
202104,43113,충청북도,청주시 흥덕구,70-74세,6938,3333,3605
202105,43113,충청북도,청주시 흥덕구,70-74세,6957,3334,3623
202106,43113,충청북도,청주시 흥덕구,70-74세,6982,3341,3641
202007,43113,충청북도,청주시 흥덕구,75-79세,5381,2255,3126
202008,43113,충청북도,청주시 흥덕구,75-79세,5406,2266,3140
202009,43113,충청북도,청주시 흥덕구,75-79세,5396,2268,3128
202010,43113,충청북도,청주시 흥덕구,75-79세,5366,2255,3111
202011,43113,충청북도,청주시 흥덕구,75-79세,5325,2236,3089
202012,43113,충청북도,청주시 흥덕구,75-79세,5289,2228,3061
202101,43113,충청북도,청주시 흥덕구,75-79세,5259,2215,3044
202102,43113,충청북도,청주시 흥덕구,75-79세,5225,2208,3017
202103,43113,충청북도,청주시 흥덕구,75-79세,5240,2214,3026
202104,43113,충청북도,청주시 흥덕구,75-79세,5222,2204,3018
202105,43113,충청북도,청주시 흥덕구,75-79세,5210,2205,3005
202106,43113,충청북도,청주시 흥덕구,75-79세,5224,2227,2997
202007,43113,충청북도,청주시 흥덕구,80-84세,3746,1317,2429
202008,43113,충청북도,청주시 흥덕구,80-84세,3758,1322,2436
202009,43113,충청북도,청주시 흥덕구,80-84세,3731,1316,2415
202010,43113,충청북도,청주시 흥덕구,80-84세,3745,1322,2423
202011,43113,충청북도,청주시 흥덕구,80-84세,3748,1323,2425
202012,43113,충청북도,청주시 흥덕구,80-84세,3770,1330,2440
202101,43113,충청북도,청주시 흥덕구,80-84세,3779,1348,2431
202102,43113,충청북도,청주시 흥덕구,80-84세,3786,1352,2434
202103,43113,충청북도,청주시 흥덕구,80-84세,3780,1352,2428
202104,43113,충청북도,청주시 흥덕구,80-84세,3791,1361,2430
202105,43113,충청북도,청주시 흥덕구,80-84세,3790,1363,2427
202106,43113,충청북도,청주시 흥덕구,80-84세,3817,1373,2444
202007,43113,충청북도,청주시 흥덕구,85-89세,1997,585,1412
202008,43113,충청북도,청주시 흥덕구,85-89세,2007,594,1413
202009,43113,충청북도,청주시 흥덕구,85-89세,2022,596,1426
202010,43113,충청북도,청주시 흥덕구,85-89세,2018,597,1421
202011,43113,충청북도,청주시 흥덕구,85-89세,2034,598,1436
202012,43113,충청북도,청주시 흥덕구,85-89세,2059,614,1445
202101,43113,충청북도,청주시 흥덕구,85-89세,2083,619,1464
202102,43113,충청북도,청주시 흥덕구,85-89세,2119,631,1488
202103,43113,충청북도,청주시 흥덕구,85-89세,2148,644,1504
202104,43113,충청북도,청주시 흥덕구,85-89세,2171,657,1514
202105,43113,충청북도,청주시 흥덕구,85-89세,2209,669,1540
202106,43113,충청북도,청주시 흥덕구,85-89세,2214,673,1541
202007,43113,충청북도,청주시 흥덕구,90-94세,637,116,521
202008,43113,충청북도,청주시 흥덕구,90-94세,631,115,516
202009,43113,충청북도,청주시 흥덕구,90-94세,647,118,529
202010,43113,충청북도,청주시 흥덕구,90-94세,657,121,536
202011,43113,충청북도,청주시 흥덕구,90-94세,661,125,536
202012,43113,충청북도,청주시 흥덕구,90-94세,660,127,533
202101,43113,충청북도,청주시 흥덕구,90-94세,663,128,535
202102,43113,충청북도,청주시 흥덕구,90-94세,670,133,537
202103,43113,충청북도,청주시 흥덕구,90-94세,663,132,531
202104,43113,충청북도,청주시 흥덕구,90-94세,667,136,531
202105,43113,충청북도,청주시 흥덕구,90-94세,667,131,536
202106,43113,충청북도,청주시 흥덕구,90-94세,668,134,534
202007,43113,충청북도,청주시 흥덕구,95-99세,146,32,114
202008,43113,충청북도,청주시 흥덕구,95-99세,155,33,122
202009,43113,충청북도,청주시 흥덕구,95-99세,161,34,127
202010,43113,충청북도,청주시 흥덕구,95-99세,160,34,126
202011,43113,충청북도,청주시 흥덕구,95-99세,158,32,126
202012,43113,충청북도,청주시 흥덕구,95-99세,163,32,131
202101,43113,충청북도,청주시 흥덕구,95-99세,159,32,127
202102,43113,충청북도,청주시 흥덕구,95-99세,158,32,126
202103,43113,충청북도,청주시 흥덕구,95-99세,157,28,129
202104,43113,충청북도,청주시 흥덕구,95-99세,163,27,136
202105,43113,충청북도,청주시 흥덕구,95-99세,162,26,136
202106,43113,충청북도,청주시 흥덕구,95-99세,159,25,134
202007,43113,충청북도,청주시 흥덕구,100+,38,6,32
202008,43113,충청북도,청주시 흥덕구,100+,38,6,32
202009,43113,충청북도,청주시 흥덕구,100+,36,6,30
202010,43113,충청북도,청주시 흥덕구,100+,37,6,31
202011,43113,충청북도,청주시 흥덕구,100+,36,6,30
202012,43113,충청북도,청주시 흥덕구,100+,34,6,28
202101,43113,충청북도,청주시 흥덕구,100+,35,6,29
202102,43113,충청북도,청주시 흥덕구,100+,37,6,31
202103,43113,충청북도,청주시 흥덕구,100+,16,1,15
202104,43113,충청북도,청주시 흥덕구,100+,14,1,13
202105,43113,충청북도,청주시 흥덕구,100+,16,2,14
202106,43113,충청북도,청주시 흥덕구,100+,17,2,15
202007,43114,충청북도,청주시 청원구,0-4세,9353,4848,4505
202008,43114,충청북도,청주시 청원구,0-4세,9279,4811,4468
202009,43114,충청북도,청주시 청원구,0-4세,9173,4755,4418
202010,43114,충청북도,청주시 청원구,0-4세,9058,4713,4345
202011,43114,충청북도,청주시 청원구,0-4세,8996,4694,4302
202012,43114,충청북도,청주시 청원구,0-4세,8969,4678,4291
202101,43114,충청북도,청주시 청원구,0-4세,8815,4612,4203
202102,43114,충청북도,청주시 청원구,0-4세,8709,4545,4164
202103,43114,충청북도,청주시 청원구,0-4세,8591,4465,4126
202104,43114,충청북도,청주시 청원구,0-4세,8506,4419,4087
202105,43114,충청북도,청주시 청원구,0-4세,8447,4395,4052
202106,43114,충청북도,청주시 청원구,0-4세,8348,4348,4000
202007,43114,충청북도,청주시 청원구,5-9세,11326,5745,5581
202008,43114,충청북도,청주시 청원구,5-9세,11296,5735,5561
202009,43114,충청북도,청주시 청원구,5-9세,11263,5737,5526
202010,43114,충청북도,청주시 청원구,5-9세,11242,5707,5535
202011,43114,충청북도,청주시 청원구,5-9세,11180,5666,5514
202012,43114,충청북도,청주시 청원구,5-9세,11150,5653,5497
202101,43114,충청북도,청주시 청원구,5-9세,11101,5627,5474
202102,43114,충청북도,청주시 청원구,5-9세,11100,5646,5454
202103,43114,충청북도,청주시 청원구,5-9세,11134,5671,5463
202104,43114,충청북도,청주시 청원구,5-9세,11140,5668,5472
202105,43114,충청북도,청주시 청원구,5-9세,11143,5647,5496
202106,43114,충청북도,청주시 청원구,5-9세,11114,5630,5484
202007,43114,충청북도,청주시 청원구,10-14세,10071,5188,4883
202008,43114,충청북도,청주시 청원구,10-14세,10084,5180,4904
202009,43114,충청북도,청주시 청원구,10-14세,10147,5229,4918
202010,43114,충청북도,청주시 청원구,10-14세,10181,5230,4951
202011,43114,충청북도,청주시 청원구,10-14세,10234,5250,4984
202012,43114,충청북도,청주시 청원구,10-14세,10266,5251,5015
202101,43114,충청북도,청주시 청원구,10-14세,10271,5233,5038
202102,43114,충청북도,청주시 청원구,10-14세,10268,5215,5053
202103,43114,충청북도,청주시 청원구,10-14세,10273,5211,5062
202104,43114,충청북도,청주시 청원구,10-14세,10330,5242,5088
202105,43114,충청북도,청주시 청원구,10-14세,10361,5265,5096
202106,43114,충청북도,청주시 청원구,10-14세,10377,5264,5113
202007,43114,충청북도,청주시 청원구,15-19세,9341,4892,4449
202008,43114,충청북도,청주시 청원구,15-19세,9316,4881,4435
202009,43114,충청북도,청주시 청원구,15-19세,9296,4862,4434
202010,43114,충청북도,청주시 청원구,15-19세,9261,4848,4413
202011,43114,충청북도,청주시 청원구,15-19세,9259,4854,4405
202012,43114,충청북도,청주시 청원구,15-19세,9212,4841,4371
202101,43114,충청북도,청주시 청원구,15-19세,9132,4817,4315
202102,43114,충청북도,청주시 청원구,15-19세,9101,4812,4289
202103,43114,충청북도,청주시 청원구,15-19세,9030,4775,4255
202104,43114,충청북도,청주시 청원구,15-19세,8953,4734,4219
202105,43114,충청북도,청주시 청원구,15-19세,8937,4726,4211
202106,43114,충청북도,청주시 청원구,15-19세,8913,4734,4179
202007,43114,충청북도,청주시 청원구,20-24세,11779,6287,5492
202008,43114,충청북도,청주시 청원구,20-24세,11753,6275,5478
202009,43114,충청북도,청주시 청원구,20-24세,11697,6256,5441
202010,43114,충청북도,청주시 청원구,20-24세,11652,6243,5409
202011,43114,충청북도,청주시 청원구,20-24세,11689,6252,5437
202012,43114,충청북도,청주시 청원구,20-24세,11740,6264,5476
202101,43114,충청북도,청주시 청원구,20-24세,11695,6240,5455
202102,43114,충청북도,청주시 청원구,20-24세,11560,6184,5376
202103,43114,충청북도,청주시 청원구,20-24세,11444,6118,5326
202104,43114,충청북도,청주시 청원구,20-24세,11426,6121,5305
202105,43114,충청북도,청주시 청원구,20-24세,11406,6112,5294
202106,43114,충청북도,청주시 청원구,20-24세,11424,6117,5307
202007,43114,충청북도,청주시 청원구,25-29세,14054,8047,6007
202008,43114,충청북도,청주시 청원구,25-29세,14144,8095,6049
202009,43114,충청북도,청주시 청원구,25-29세,14126,8083,6043
202010,43114,충청북도,청주시 청원구,25-29세,14139,8110,6029
202011,43114,충청북도,청주시 청원구,25-29세,14227,8170,6057
202012,43114,충청북도,청주시 청원구,25-29세,14334,8261,6073
202101,43114,충청북도,청주시 청원구,25-29세,14352,8293,6059
202102,43114,충청북도,청주시 청원구,25-29세,14300,8251,6049
202103,43114,충청북도,청주시 청원구,25-29세,14384,8273,6111
202104,43114,충청북도,청주시 청원구,25-29세,14460,8331,6129
202105,43114,충청북도,청주시 청원구,25-29세,14478,8340,6138
202106,43114,충청북도,청주시 청원구,25-29세,14486,8330,6156
202007,43114,충청북도,청주시 청원구,30-34세,14609,7946,6663
202008,43114,충청북도,청주시 청원구,30-34세,14526,7912,6614
202009,43114,충청북도,청주시 청원구,30-34세,14445,7885,6560
202010,43114,충청북도,청주시 청원구,30-34세,14296,7838,6458
202011,43114,충청북도,청주시 청원구,30-34세,14314,7897,6417
202012,43114,충청북도,청주시 청원구,30-34세,14325,7923,6402
202101,43114,충청북도,청주시 청원구,30-34세,14318,7920,6398
202102,43114,충청북도,청주시 청원구,30-34세,14249,7899,6350
202103,43114,충청북도,청주시 청원구,30-34세,14237,7905,6332
202104,43114,충청북도,청주시 청원구,30-34세,14258,7904,6354
202105,43114,충청북도,청주시 청원구,30-34세,14251,7913,6338
202106,43114,충청북도,청주시 청원구,30-34세,14247,7934,6313
202007,43114,충청북도,청주시 청원구,35-39세,17586,9235,8351
202008,43114,충청북도,청주시 청원구,35-39세,17463,9160,8303
202009,43114,충청북도,청주시 청원구,35-39세,17397,9116,8281
202010,43114,충청북도,청주시 청원구,35-39세,17267,9027,8240
202011,43114,충청북도,청주시 청원구,35-39세,17233,9029,8204
202012,43114,충청북도,청주시 청원구,35-39세,17263,9010,8253
202101,43114,충청북도,청주시 청원구,35-39세,17168,8984,8184
202102,43114,충청북도,청주시 청원구,35-39세,17170,8983,8187
202103,43114,충청북도,청주시 청원구,35-39세,17041,8924,8117
202104,43114,충청북도,청주시 청원구,35-39세,16964,8891,8073
202105,43114,충청북도,청주시 청원구,35-39세,16923,8885,8038
202106,43114,충청북도,청주시 청원구,35-39세,16844,8831,8013
202007,43114,충청북도,청주시 청원구,40-44세,16419,8705,7714
202008,43114,충청북도,청주시 청원구,40-44세,16527,8746,7781
202009,43114,충청북도,청주시 청원구,40-44세,16585,8779,7806
202010,43114,충청북도,청주시 청원구,40-44세,16701,8856,7845
202011,43114,충청북도,청주시 청원구,40-44세,16713,8864,7849
202012,43114,충청북도,청주시 청원구,40-44세,16669,8871,7798
202101,43114,충청북도,청주시 청원구,40-44세,16595,8846,7749
202102,43114,충청북도,청주시 청원구,40-44세,16572,8835,7737
202103,43114,충청북도,청주시 청원구,40-44세,16484,8791,7693
202104,43114,충청북도,청주시 청원구,40-44세,16495,8795,7700
202105,43114,충청북도,청주시 청원구,40-44세,16560,8828,7732
202106,43114,충청북도,청주시 청원구,40-44세,16626,8889,7737
202007,43114,충청북도,청주시 청원구,45-49세,15576,8110,7466
202008,43114,충청북도,청주시 청원구,45-49세,15591,8126,7465
202009,43114,충청북도,청주시 청원구,45-49세,15606,8153,7453
202010,43114,충청북도,청주시 청원구,45-49세,15571,8129,7442
202011,43114,충청북도,청주시 청원구,45-49세,15594,8138,7456
202012,43114,충청북도,청주시 청원구,45-49세,15702,8171,7531
202101,43114,충청북도,청주시 청원구,45-49세,15707,8163,7544
202102,43114,충청북도,청주시 청원구,45-49세,15672,8147,7525
202103,43114,충청북도,청주시 청원구,45-49세,15617,8111,7506
202104,43114,충청북도,청주시 청원구,45-49세,15639,8127,7512
202105,43114,충청북도,청주시 청원구,45-49세,15570,8083,7487
202106,43114,충청북도,청주시 청원구,45-49세,15525,8056,7469
202007,43114,충청북도,청주시 청원구,50-54세,14441,7430,7011
202008,43114,충청북도,청주시 청원구,50-54세,14466,7441,7025
202009,43114,충청북도,청주시 청원구,50-54세,14486,7468,7018
202010,43114,충청북도,청주시 청원구,50-54세,14498,7471,7027
202011,43114,충청북도,청주시 청원구,50-54세,14555,7510,7045
202012,43114,충청북도,청주시 청원구,50-54세,14455,7452,7003
202101,43114,충청북도,청주시 청원구,50-54세,14492,7458,7034
202102,43114,충청북도,청주시 청원구,50-54세,14491,7491,7000
202103,43114,충청북도,청주시 청원구,50-54세,14488,7493,6995
202104,43114,충청북도,청주시 청원구,50-54세,14509,7509,7000
202105,43114,충청북도,청주시 청원구,50-54세,14628,7576,7052
202106,43114,충청북도,청주시 청원구,50-54세,14716,7622,7094
202007,43114,충청북도,청주시 청원구,55-59세,13134,6661,6473
202008,43114,충청북도,청주시 청원구,55-59세,13132,6657,6475
202009,43114,충청북도,청주시 청원구,55-59세,13138,6651,6487
202010,43114,충청북도,청주시 청원구,55-59세,13127,6661,6466
202011,43114,충청북도,청주시 청원구,55-59세,13164,6675,6489
202012,43114,충청북도,청주시 청원구,55-59세,13220,6703,6517
202101,43114,충청북도,청주시 청원구,55-59세,13126,6680,6446
202102,43114,충청북도,청주시 청원구,55-59세,13056,6642,6414
202103,43114,충청북도,청주시 청원구,55-59세,12978,6621,6357
202104,43114,충청북도,청주시 청원구,55-59세,12902,6566,6336
202105,43114,충청북도,청주시 청원구,55-59세,12830,6528,6302
202106,43114,충청북도,청주시 청원구,55-59세,12729,6489,6240
202007,43114,충청북도,청주시 청원구,60-64세,11910,5879,6031
202008,43114,충청북도,청주시 청원구,60-64세,11962,5909,6053
202009,43114,충청북도,청주시 청원구,60-64세,11929,5901,6028
202010,43114,충청북도,청주시 청원구,60-64세,11986,5937,6049
202011,43114,충청북도,청주시 청원구,60-64세,12091,5975,6116
202012,43114,충청북도,청주시 청원구,60-64세,12176,6023,6153
202101,43114,충청북도,청주시 청원구,60-64세,12244,6037,6207
202102,43114,충청북도,청주시 청원구,60-64세,12379,6111,6268
202103,43114,충청북도,청주시 청원구,60-64세,12501,6165,6336
202104,43114,충청북도,청주시 청원구,60-64세,12612,6232,6380
202105,43114,충청북도,청주시 청원구,60-64세,12727,6284,6443
202106,43114,충청북도,청주시 청원구,60-64세,12840,6346,6494
202007,43114,충청북도,청주시 청원구,65-69세,7884,3812,4072
202008,43114,충청북도,청주시 청원구,65-69세,7937,3846,4091
202009,43114,충청북도,청주시 청원구,65-69세,8008,3876,4132
202010,43114,충청북도,청주시 청원구,65-69세,8068,3901,4167
202011,43114,충청북도,청주시 청원구,65-69세,8128,3956,4172
202012,43114,충청북도,청주시 청원구,65-69세,8244,3998,4246
202101,43114,충청북도,청주시 청원구,65-69세,8311,4027,4284
202102,43114,충청북도,청주시 청원구,65-69세,8346,4039,4307
202103,43114,충청북도,청주시 청원구,65-69세,8476,4106,4370
202104,43114,충청북도,청주시 청원구,65-69세,8572,4151,4421
202105,43114,충청북도,청주시 청원구,65-69세,8664,4204,4460
202106,43114,충청북도,청주시 청원구,65-69세,8706,4218,4488
202007,43114,충청북도,청주시 청원구,70-74세,5515,2583,2932
202008,43114,충청북도,청주시 청원구,70-74세,5524,2590,2934
202009,43114,충청북도,청주시 청원구,70-74세,5543,2606,2937
202010,43114,충청북도,청주시 청원구,70-74세,5587,2634,2953
202011,43114,충청북도,청주시 청원구,70-74세,5639,2653,2986
202012,43114,충청북도,청주시 청원구,70-74세,5660,2660,3000
202101,43114,충청북도,청주시 청원구,70-74세,5718,2703,3015
202102,43114,충청북도,청주시 청원구,70-74세,5763,2724,3039
202103,43114,충청북도,청주시 청원구,70-74세,5721,2710,3011
202104,43114,충청북도,청주시 청원구,70-74세,5711,2712,2999
202105,43114,충청북도,청주시 청원구,70-74세,5719,2705,3014
202106,43114,충청북도,청주시 청원구,70-74세,5713,2704,3009
202007,43114,충청북도,청주시 청원구,75-79세,4801,2005,2796
202008,43114,충청북도,청주시 청원구,75-79세,4801,2009,2792
202009,43114,충청북도,청주시 청원구,75-79세,4814,2010,2804
202010,43114,충청북도,청주시 청원구,75-79세,4779,1986,2793
202011,43114,충청북도,청주시 청원구,75-79세,4772,1986,2786
202012,43114,충청북도,청주시 청원구,75-79세,4763,1984,2779
202101,43114,충청북도,청주시 청원구,75-79세,4734,1966,2768
202102,43114,충청북도,청주시 청원구,75-79세,4708,1961,2747
202103,43114,충청북도,청주시 청원구,75-79세,4681,1953,2728
202104,43114,충청북도,청주시 청원구,75-79세,4674,1951,2723
202105,43114,충청북도,청주시 청원구,75-79세,4694,1974,2720
202106,43114,충청북도,청주시 청원구,75-79세,4692,1970,2722
202007,43114,충청북도,청주시 청원구,80-84세,3562,1253,2309
202008,43114,충청북도,청주시 청원구,80-84세,3579,1263,2316
202009,43114,충청북도,청주시 청원구,80-84세,3562,1264,2298
202010,43114,충청북도,청주시 청원구,80-84세,3583,1274,2309
202011,43114,충청북도,청주시 청원구,80-84세,3577,1274,2303
202012,43114,충청북도,청주시 청원구,80-84세,3565,1280,2285
202101,43114,충청북도,청주시 청원구,80-84세,3541,1288,2253
202102,43114,충청북도,청주시 청원구,80-84세,3562,1288,2274
202103,43114,충청북도,청주시 청원구,80-84세,3557,1282,2275
202104,43114,충청북도,청주시 청원구,80-84세,3565,1289,2276
202105,43114,충청북도,청주시 청원구,80-84세,3569,1286,2283
202106,43114,충청북도,청주시 청원구,80-84세,3603,1307,2296
202007,43114,충청북도,청주시 청원구,85-89세,1757,489,1268
202008,43114,충청북도,청주시 청원구,85-89세,1775,494,1281
202009,43114,충청북도,청주시 청원구,85-89세,1788,502,1286
202010,43114,충청북도,청주시 청원구,85-89세,1812,511,1301
202011,43114,충청북도,청주시 청원구,85-89세,1824,519,1305
202012,43114,충청북도,청주시 청원구,85-89세,1870,529,1341
202101,43114,충청북도,청주시 청원구,85-89세,1883,531,1352
202102,43114,충청북도,청주시 청원구,85-89세,1923,534,1389
202103,43114,충청북도,청주시 청원구,85-89세,1946,542,1404
202104,43114,충청북도,청주시 청원구,85-89세,1974,541,1433
202105,43114,충청북도,청주시 청원구,85-89세,1990,548,1442
202106,43114,충청북도,청주시 청원구,85-89세,1987,541,1446
202007,43114,충청북도,청주시 청원구,90-94세,579,113,466
202008,43114,충청북도,청주시 청원구,90-94세,583,113,470
202009,43114,충청북도,청주시 청원구,90-94세,586,115,471
202010,43114,충청북도,청주시 청원구,90-94세,585,116,469
202011,43114,충청북도,청주시 청원구,90-94세,586,115,471
202012,43114,충청북도,청주시 청원구,90-94세,597,114,483
202101,43114,충청북도,청주시 청원구,90-94세,606,117,489
202102,43114,충청북도,청주시 청원구,90-94세,606,121,485
202103,43114,충청북도,청주시 청원구,90-94세,606,120,486
202104,43114,충청북도,청주시 청원구,90-94세,618,123,495
202105,43114,충청북도,청주시 청원구,90-94세,619,122,497
202106,43114,충청북도,청주시 청원구,90-94세,618,123,495
202007,43114,충청북도,청주시 청원구,95-99세,136,27,109
202008,43114,충청북도,청주시 청원구,95-99세,139,28,111
202009,43114,충청북도,청주시 청원구,95-99세,147,29,118
202010,43114,충청북도,청주시 청원구,95-99세,145,29,116
202011,43114,충청북도,청주시 청원구,95-99세,147,29,118
202012,43114,충청북도,청주시 청원구,95-99세,142,32,110
202101,43114,충청북도,청주시 청원구,95-99세,138,32,106
202102,43114,충청북도,청주시 청원구,95-99세,138,34,104
202103,43114,충청북도,청주시 청원구,95-99세,127,26,101
202104,43114,충청북도,청주시 청원구,95-99세,120,24,96
202105,43114,충청북도,청주시 청원구,95-99세,117,23,94
202106,43114,충청북도,청주시 청원구,95-99세,118,22,96
202007,43114,충청북도,청주시 청원구,100+,47,17,30
202008,43114,충청북도,청주시 청원구,100+,48,17,31
202009,43114,충청북도,청주시 청원구,100+,50,17,33
202010,43114,충청북도,청주시 청원구,100+,51,17,34
202011,43114,충청북도,청주시 청원구,100+,51,17,34
202012,43114,충청북도,청주시 청원구,100+,51,17,34
202101,43114,충청북도,청주시 청원구,100+,50,17,33
202102,43114,충청북도,청주시 청원구,100+,53,17,36
202103,43114,충청북도,청주시 청원구,100+,34,8,26
202104,43114,충청북도,청주시 청원구,100+,37,8,29
202105,43114,충청북도,청주시 청원구,100+,39,9,30
202106,43114,충청북도,청주시 청원구,100+,39,9,30
202007,43130,충청북도,충주시,0-4세,6431,3302,3129
202008,43130,충청북도,충주시,0-4세,6386,3287,3099
202009,43130,충청북도,충주시,0-4세,6329,3256,3073
202010,43130,충청북도,충주시,0-4세,6268,3221,3047
202011,43130,충청북도,충주시,0-4세,6249,3207,3042
202012,43130,충청북도,충주시,0-4세,6209,3176,3033
202101,43130,충청북도,충주시,0-4세,6152,3151,3001
202102,43130,충청북도,충주시,0-4세,6107,3136,2971
202103,43130,충청북도,충주시,0-4세,6040,3103,2937
202104,43130,충청북도,충주시,0-4세,6004,3086,2918
202105,43130,충청북도,충주시,0-4세,5953,3058,2895
202106,43130,충청북도,충주시,0-4세,5919,3045,2874
202007,43130,충청북도,충주시,5-9세,8518,4271,4247
202008,43130,충청북도,충주시,5-9세,8500,4265,4235
202009,43130,충청북도,충주시,5-9세,8471,4248,4223
202010,43130,충청북도,충주시,5-9세,8457,4268,4189
202011,43130,충청북도,충주시,5-9세,8401,4228,4173
202012,43130,충청북도,충주시,5-9세,8372,4208,4164
202101,43130,충청북도,충주시,5-9세,8322,4196,4126
202102,43130,충청북도,충주시,5-9세,8295,4177,4118
202103,43130,충청북도,충주시,5-9세,8273,4133,4140
202104,43130,충청북도,충주시,5-9세,8247,4112,4135
202105,43130,충청북도,충주시,5-9세,8235,4109,4126
202106,43130,충청북도,충주시,5-9세,8230,4098,4132
202007,43130,충청북도,충주시,10-14세,9030,4653,4377
202008,43130,충청북도,충주시,10-14세,9055,4656,4399
202009,43130,충청북도,충주시,10-14세,9096,4671,4425
202010,43130,충청북도,충주시,10-14세,9096,4653,4443
202011,43130,충청북도,충주시,10-14세,9110,4669,4441
202012,43130,충청북도,충주시,10-14세,9139,4696,4443
202101,43130,충청북도,충주시,10-14세,9184,4721,4463
202102,43130,충청북도,충주시,10-14세,9185,4743,4442
202103,43130,충청북도,충주시,10-14세,9222,4789,4433
202104,43130,충청북도,충주시,10-14세,9238,4806,4432
202105,43130,충청북도,충주시,10-14세,9256,4817,4439
202106,43130,충청북도,충주시,10-14세,9268,4823,4445
202007,43130,충청북도,충주시,15-19세,10112,5306,4806
202008,43130,충청북도,충주시,15-19세,10015,5252,4763
202009,43130,충청북도,충주시,15-19세,9948,5201,4747
202010,43130,충청북도,충주시,15-19세,9871,5173,4698
202011,43130,충청북도,충주시,15-19세,9824,5150,4674
202012,43130,충청북도,충주시,15-19세,9744,5090,4654
202101,43130,충청북도,충주시,15-19세,9662,5036,4626
202102,43130,충청북도,충주시,15-19세,9596,5008,4588
202103,43130,충청북도,충주시,15-19세,9460,4937,4523
202104,43130,충청북도,충주시,15-19세,9403,4904,4499
202105,43130,충청북도,충주시,15-19세,9357,4873,4484
202106,43130,충청북도,충주시,15-19세,9340,4861,4479
202007,43130,충청북도,충주시,20-24세,12348,6909,5439
202008,43130,충청북도,충주시,20-24세,12362,6938,5424
202009,43130,충청북도,충주시,20-24세,12341,6940,5401
202010,43130,충청북도,충주시,20-24세,12337,6927,5410
202011,43130,충청북도,충주시,20-24세,12332,6924,5408
202012,43130,충청북도,충주시,20-24세,12300,6913,5387
202101,43130,충청북도,충주시,20-24세,12265,6905,5360
202102,43130,충청북도,충주시,20-24세,12232,6878,5354
202103,43130,충청북도,충주시,20-24세,12147,6840,5307
202104,43130,충청북도,충주시,20-24세,12119,6822,5297
202105,43130,충청북도,충주시,20-24세,12095,6815,5280
202106,43130,충청북도,충주시,20-24세,12055,6785,5270
202007,43130,충청북도,충주시,25-29세,11940,7013,4927
202008,43130,충청북도,충주시,25-29세,11949,7015,4934
202009,43130,충청북도,충주시,25-29세,11972,7024,4948
202010,43130,충청북도,충주시,25-29세,12013,7055,4958
202011,43130,충청북도,충주시,25-29세,12022,7047,4975
202012,43130,충청북도,충주시,25-29세,12105,7064,5041
202101,43130,충청북도,충주시,25-29세,12046,7046,5000
202102,43130,충청북도,충주시,25-29세,12031,7035,4996
202103,43130,충청북도,충주시,25-29세,12061,7087,4974
202104,43130,충청북도,충주시,25-29세,12039,7090,4949
202105,43130,충청북도,충주시,25-29세,12004,7066,4938
202106,43130,충청북도,충주시,25-29세,12003,7060,4943
202007,43130,충청북도,충주시,30-34세,10514,5813,4701
202008,43130,충청북도,충주시,30-34세,10521,5810,4711
202009,43130,충청북도,충주시,30-34세,10524,5823,4701
202010,43130,충청북도,충주시,30-34세,10509,5823,4686
202011,43130,충청북도,충주시,30-34세,10556,5857,4699
202012,43130,충청북도,충주시,30-34세,10499,5854,4645
202101,43130,충청북도,충주시,30-34세,10520,5858,4662
202102,43130,충청북도,충주시,30-34세,10471,5844,4627
202103,43130,충청북도,충주시,30-34세,10482,5835,4647
202104,43130,충청북도,충주시,30-34세,10551,5848,4703
202105,43130,충청북도,충주시,30-34세,10576,5857,4719
202106,43130,충청북도,충주시,30-34세,10647,5909,4738
202007,43130,충청북도,충주시,35-39세,13125,6918,6207
202008,43130,충청북도,충주시,35-39세,13076,6906,6170
202009,43130,충청북도,충주시,35-39세,13013,6897,6116
202010,43130,충청북도,충주시,35-39세,12935,6858,6077
202011,43130,충청북도,충주시,35-39세,12865,6834,6031
202012,43130,충청북도,충주시,35-39세,12838,6809,6029
202101,43130,충청북도,충주시,35-39세,12787,6776,6011
202102,43130,충청북도,충주시,35-39세,12721,6766,5955
202103,43130,충청북도,충주시,35-39세,12607,6720,5887
202104,43130,충청북도,충주시,35-39세,12556,6689,5867
202105,43130,충청북도,충주시,35-39세,12538,6689,5849
202106,43130,충청북도,충주시,35-39세,12494,6653,5841
202007,43130,충청북도,충주시,40-44세,14143,7235,6908
202008,43130,충청북도,충주시,40-44세,14116,7232,6884
202009,43130,충청북도,충주시,40-44세,14130,7227,6903
202010,43130,충청북도,충주시,40-44세,14137,7221,6916
202011,43130,충청북도,충주시,40-44세,14155,7226,6929
202012,43130,충청북도,충주시,40-44세,14109,7210,6899
202101,43130,충청북도,충주시,40-44세,14068,7208,6860
202102,43130,충청북도,충주시,40-44세,14020,7165,6855
202103,43130,충청북도,충주시,40-44세,13913,7107,6806
202104,43130,충청북도,충주시,40-44세,13877,7095,6782
202105,43130,충청북도,충주시,40-44세,13879,7091,6788
202106,43130,충청북도,충주시,40-44세,13987,7165,6822
202007,43130,충청북도,충주시,45-49세,17051,8783,8268
202008,43130,충청북도,충주시,45-49세,17026,8765,8261
202009,43130,충청북도,충주시,45-49세,16952,8735,8217
202010,43130,충청북도,충주시,45-49세,16872,8689,8183
202011,43130,충청북도,충주시,45-49세,16830,8663,8167
202012,43130,충청북도,충주시,45-49세,16831,8659,8172
202101,43130,충청북도,충주시,45-49세,16812,8648,8164
202102,43130,충청북도,충주시,45-49세,16786,8648,8138
202103,43130,충청북도,충주시,45-49세,16723,8642,8081
202104,43130,충청북도,충주시,45-49세,16655,8594,8061
202105,43130,충청북도,충주시,45-49세,16522,8526,7996
202106,43130,충청북도,충주시,45-49세,16406,8472,7934
202007,43130,충청북도,충주시,50-54세,18799,9643,9156
202008,43130,충청북도,충주시,50-54세,18778,9617,9161
202009,43130,충청북도,충주시,50-54세,18770,9619,9151
202010,43130,충청북도,충주시,50-54세,18819,9620,9199
202011,43130,충청북도,충주시,50-54세,18842,9608,9234
202012,43130,충청북도,충주시,50-54세,18700,9539,9161
202101,43130,충청북도,충주시,50-54세,18732,9545,9187
202102,43130,충청북도,충주시,50-54세,18748,9544,9204
202103,43130,충청북도,충주시,50-54세,18613,9465,9148
202104,43130,충청북도,충주시,50-54세,18614,9459,9155
202105,43130,충청북도,충주시,50-54세,18705,9489,9216
202106,43130,충청북도,충주시,50-54세,18747,9506,9241
202007,43130,충청북도,충주시,55-59세,19100,9767,9333
202008,43130,충청북도,충주시,55-59세,19125,9807,9318
202009,43130,충청북도,충주시,55-59세,19094,9770,9324
202010,43130,충청북도,충주시,55-59세,19020,9734,9286
202011,43130,충청북도,충주시,55-59세,18990,9745,9245
202012,43130,충청북도,충주시,55-59세,18932,9714,9218
202101,43130,충청북도,충주시,55-59세,18799,9640,9159
202102,43130,충청북도,충주시,55-59세,18714,9608,9106
202103,43130,충청북도,충주시,55-59세,18525,9511,9014
202104,43130,충청북도,충주시,55-59세,18443,9490,8953
202105,43130,충청북도,충주시,55-59세,18351,9461,8890
202106,43130,충청북도,충주시,55-59세,18190,9362,8828
202007,43130,충청북도,충주시,60-64세,18039,9215,8824
202008,43130,충청북도,충주시,60-64세,18146,9239,8907
202009,43130,충청북도,충주시,60-64세,18271,9320,8951
202010,43130,충청북도,충주시,60-64세,18387,9387,9000
202011,43130,충청북도,충주시,60-64세,18458,9409,9049
202012,43130,충청북도,충주시,60-64세,18556,9454,9102
202101,43130,충청북도,충주시,60-64세,18715,9533,9182
202102,43130,충청북도,충주시,60-64세,18899,9636,9263
202103,43130,충청북도,충주시,60-64세,19036,9715,9321
202104,43130,충청북도,충주시,60-64세,19162,9753,9409
202105,43130,충청북도,충주시,60-64세,19306,9826,9480
202106,43130,충청북도,충주시,60-64세,19542,9961,9581
202007,43130,충청북도,충주시,65-69세,12613,6120,6493
202008,43130,충청북도,충주시,65-69세,12719,6184,6535
202009,43130,충청북도,충주시,65-69세,12809,6233,6576
202010,43130,충청북도,충주시,65-69세,12936,6288,6648
202011,43130,충청북도,충주시,65-69세,13034,6346,6688
202012,43130,충청북도,충주시,65-69세,13181,6429,6752
202101,43130,충청북도,충주시,65-69세,13296,6497,6799
202102,43130,충청북도,충주시,65-69세,13436,6567,6869
202103,43130,충청북도,충주시,65-69세,13622,6663,6959
202104,43130,충청북도,충주시,65-69세,13775,6760,7015
202105,43130,충청북도,충주시,65-69세,13910,6832,7078
202106,43130,충청북도,충주시,65-69세,13981,6864,7117
202007,43130,충청북도,충주시,70-74세,8782,4059,4723
202008,43130,충청북도,충주시,70-74세,8807,4063,4744
202009,43130,충청북도,충주시,70-74세,8840,4088,4752
202010,43130,충청북도,충주시,70-74세,8860,4109,4751
202011,43130,충청북도,충주시,70-74세,8902,4133,4769
202012,43130,충청북도,충주시,70-74세,8940,4156,4784
202101,43130,충청북도,충주시,70-74세,9025,4200,4825
202102,43130,충청북도,충주시,70-74세,9028,4201,4827
202103,43130,충청북도,충주시,70-74세,8987,4201,4786
202104,43130,충청북도,충주시,70-74세,8990,4208,4782
202105,43130,충청북도,충주시,70-74세,9000,4204,4796
202106,43130,충청북도,충주시,70-74세,9000,4198,4802
202007,43130,충청북도,충주시,75-79세,8717,3669,5048
202008,43130,충청북도,충주시,75-79세,8683,3653,5030
202009,43130,충청북도,충주시,75-79세,8625,3637,4988
202010,43130,충청북도,충주시,75-79세,8589,3619,4970
202011,43130,충청북도,충주시,75-79세,8555,3613,4942
202012,43130,충청북도,충주시,75-79세,8489,3600,4889
202101,43130,충청북도,충주시,75-79세,8429,3564,4865
202102,43130,충청북도,충주시,75-79세,8363,3535,4828
202103,43130,충청북도,충주시,75-79세,8311,3511,4800
202104,43130,충청북도,충주시,75-79세,8285,3495,4790
202105,43130,충청북도,충주시,75-79세,8244,3488,4756
202106,43130,충청북도,충주시,75-79세,8206,3480,4726
202007,43130,충청북도,충주시,80-84세,6474,2395,4079
202008,43130,충청북도,충주시,80-84세,6500,2413,4087
202009,43130,충청북도,충주시,80-84세,6518,2415,4103
202010,43130,충청북도,충주시,80-84세,6520,2416,4104
202011,43130,충청북도,충주시,80-84세,6519,2417,4102
202012,43130,충청북도,충주시,80-84세,6541,2416,4125
202101,43130,충청북도,충주시,80-84세,6558,2442,4116
202102,43130,충청북도,충주시,80-84세,6593,2459,4134
202103,43130,충청북도,충주시,80-84세,6588,2464,4124
202104,43130,충청북도,충주시,80-84세,6612,2472,4140
202105,43130,충청북도,충주시,80-84세,6642,2485,4157
202106,43130,충청북도,충주시,80-84세,6701,2500,4201
202007,43130,충청북도,충주시,85-89세,3199,901,2298
202008,43130,충청북도,충주시,85-89세,3219,915,2304
202009,43130,충청북도,충주시,85-89세,3247,920,2327
202010,43130,충청북도,충주시,85-89세,3266,928,2338
202011,43130,충청북도,충주시,85-89세,3306,944,2362
202012,43130,충청북도,충주시,85-89세,3340,960,2380
202101,43130,충청북도,충주시,85-89세,3397,974,2423
202102,43130,충청북도,충주시,85-89세,3461,998,2463
202103,43130,충청북도,충주시,85-89세,3494,1013,2481
202104,43130,충청북도,충주시,85-89세,3515,1016,2499
202105,43130,충청북도,충주시,85-89세,3546,1030,2516
202106,43130,충청북도,충주시,85-89세,3553,1036,2517
202007,43130,충청북도,충주시,90-94세,994,246,748
202008,43130,충청북도,충주시,90-94세,1015,246,769
202009,43130,충청북도,충주시,90-94세,1036,247,789
202010,43130,충청북도,충주시,90-94세,1044,245,799
202011,43130,충청북도,충주시,90-94세,1043,250,793
202012,43130,충청북도,충주시,90-94세,1042,247,795
202101,43130,충청북도,충주시,90-94세,1048,247,801
202102,43130,충청북도,충주시,90-94세,1049,244,805
202103,43130,충청북도,충주시,90-94세,1060,243,817
202104,43130,충청북도,충주시,90-94세,1073,247,826
202105,43130,충청북도,충주시,90-94세,1082,251,831
202106,43130,충청북도,충주시,90-94세,1090,256,834
202007,43130,충청북도,충주시,95-99세,228,63,165
202008,43130,충청북도,충주시,95-99세,236,66,170
202009,43130,충청북도,충주시,95-99세,241,64,177
202010,43130,충청북도,충주시,95-99세,238,61,177
202011,43130,충청북도,충주시,95-99세,250,64,186
202012,43130,충청북도,충주시,95-99세,249,64,185
202101,43130,충청북도,충주시,95-99세,253,67,186
202102,43130,충청북도,충주시,95-99세,252,67,185
202103,43130,충청북도,충주시,95-99세,242,64,178
202104,43130,충청북도,충주시,95-99세,243,64,179
202105,43130,충청북도,충주시,95-99세,247,65,182
202106,43130,충청북도,충주시,95-99세,246,61,185
202007,43130,충청북도,충주시,100+,71,16,55
202008,43130,충청북도,충주시,100+,70,16,54
202009,43130,충청북도,충주시,100+,72,17,55
202010,43130,충청북도,충주시,100+,72,17,55
202011,43130,충청북도,충주시,100+,70,16,54
202012,43130,충청북도,충주시,100+,70,15,55
202101,43130,충청북도,충주시,100+,69,15,54
202102,43130,충청북도,충주시,100+,71,15,56
202103,43130,충청북도,충주시,100+,37,8,29
202104,43130,충청북도,충주시,100+,33,8,25
202105,43130,충청북도,충주시,100+,35,8,27
202106,43130,충청북도,충주시,100+,33,7,26
202007,43150,충청북도,제천시,0-4세,3837,1988,1849
202008,43150,충청북도,제천시,0-4세,3795,1974,1821
202009,43150,충청북도,제천시,0-4세,3761,1961,1800
202010,43150,충청북도,제천시,0-4세,3718,1946,1772
202011,43150,충청북도,제천시,0-4세,3687,1926,1761
202012,43150,충청북도,제천시,0-4세,3665,1919,1746
202101,43150,충청북도,제천시,0-4세,3584,1876,1708
202102,43150,충청북도,제천시,0-4세,3543,1857,1686
202103,43150,충청북도,제천시,0-4세,3482,1829,1653
202104,43150,충청북도,제천시,0-4세,3452,1811,1641
202105,43150,충청북도,제천시,0-4세,3423,1787,1636
202106,43150,충청북도,제천시,0-4세,3406,1773,1633
202007,43150,충청북도,제천시,5-9세,5166,2615,2551
202008,43150,충청북도,제천시,5-9세,5154,2603,2551
202009,43150,충청북도,제천시,5-9세,5155,2600,2555
202010,43150,충청북도,제천시,5-9세,5145,2595,2550
202011,43150,충청북도,제천시,5-9세,5113,2575,2538
202012,43150,충청북도,제천시,5-9세,5075,2543,2532
202101,43150,충청북도,제천시,5-9세,5077,2564,2513
202102,43150,충청북도,제천시,5-9세,5072,2556,2516
202103,43150,충청북도,제천시,5-9세,5066,2548,2518
202104,43150,충청북도,제천시,5-9세,5051,2545,2506
202105,43150,충청북도,제천시,5-9세,5045,2553,2492
202106,43150,충청북도,제천시,5-9세,5019,2547,2472
202007,43150,충청북도,제천시,10-14세,5482,2783,2699
202008,43150,충청북도,제천시,10-14세,5465,2781,2684
202009,43150,충청북도,제천시,10-14세,5488,2803,2685
202010,43150,충청북도,제천시,10-14세,5487,2800,2687
202011,43150,충청북도,제천시,10-14세,5491,2800,2691
202012,43150,충청북도,제천시,10-14세,5512,2816,2696
202101,43150,충청북도,제천시,10-14세,5508,2806,2702
202102,43150,충청북도,제천시,10-14세,5489,2806,2683
202103,43150,충청북도,제천시,10-14세,5485,2802,2683
202104,43150,충청북도,제천시,10-14세,5505,2810,2695
202105,43150,충청북도,제천시,10-14세,5520,2816,2704
202106,43150,충청북도,제천시,10-14세,5518,2803,2715
202007,43150,충청북도,제천시,15-19세,6407,3359,3048
202008,43150,충청북도,제천시,15-19세,6375,3340,3035
202009,43150,충청북도,제천시,15-19세,6334,3303,3031
202010,43150,충청북도,제천시,15-19세,6302,3287,3015
202011,43150,충청북도,제천시,15-19세,6255,3264,2991
202012,43150,충청북도,제천시,15-19세,6183,3224,2959
202101,43150,충청북도,제천시,15-19세,6105,3196,2909
202102,43150,충청북도,제천시,15-19세,6053,3169,2884
202103,43150,충청북도,제천시,15-19세,6051,3192,2859
202104,43150,충청북도,제천시,15-19세,6055,3190,2865
202105,43150,충청북도,제천시,15-19세,6020,3171,2849
202106,43150,충청북도,제천시,15-19세,5989,3157,2832
202007,43150,충청북도,제천시,20-24세,8179,4437,3742
202008,43150,충청북도,제천시,20-24세,8105,4380,3725
202009,43150,충청북도,제천시,20-24세,8097,4372,3725
202010,43150,충청북도,제천시,20-24세,8071,4373,3698
202011,43150,충청북도,제천시,20-24세,8048,4361,3687
202012,43150,충청북도,제천시,20-24세,8023,4350,3673
202101,43150,충청북도,제천시,20-24세,7941,4294,3647
202102,43150,충청북도,제천시,20-24세,7869,4258,3611
202103,43150,충청북도,제천시,20-24세,7938,4282,3656
202104,43150,충청북도,제천시,20-24세,7963,4308,3655
202105,43150,충청북도,제천시,20-24세,8011,4312,3699
202106,43150,충청북도,제천시,20-24세,7997,4295,3702
202007,43150,충청북도,제천시,25-29세,6600,3774,2826
202008,43150,충청북도,제천시,25-29세,6645,3808,2837
202009,43150,충청북도,제천시,25-29세,6660,3822,2838
202010,43150,충청북도,제천시,25-29세,6697,3838,2859
202011,43150,충청북도,제천시,25-29세,6723,3840,2883
202012,43150,충청북도,제천시,25-29세,6716,3832,2884
202101,43150,충청북도,제천시,25-29세,6708,3858,2850
202102,43150,충청북도,제천시,25-29세,6675,3851,2824
202103,43150,충청북도,제천시,25-29세,6688,3868,2820
202104,43150,충청북도,제천시,25-29세,6702,3873,2829
202105,43150,충청북도,제천시,25-29세,6685,3868,2817
202106,43150,충청북도,제천시,25-29세,6678,3871,2807
202007,43150,충청북도,제천시,30-34세,5791,3059,2732
202008,43150,충청북도,제천시,30-34세,5778,3058,2720
202009,43150,충청북도,제천시,30-34세,5775,3054,2721
202010,43150,충청북도,제천시,30-34세,5751,3042,2709
202011,43150,충청북도,제천시,30-34세,5711,3013,2698
202012,43150,충청북도,제천시,30-34세,5695,3027,2668
202101,43150,충청북도,제천시,30-34세,5667,3019,2648
202102,43150,충청북도,제천시,30-34세,5640,3000,2640
202103,43150,충청북도,제천시,30-34세,5642,3012,2630
202104,43150,충청북도,제천시,30-34세,5662,3027,2635
202105,43150,충청북도,제천시,30-34세,5665,3032,2633
202106,43150,충청북도,제천시,30-34세,5638,3017,2621
202007,43150,충청북도,제천시,35-39세,7505,3866,3639
202008,43150,충청북도,제천시,35-39세,7448,3853,3595
202009,43150,충청북도,제천시,35-39세,7422,3829,3593
202010,43150,충청북도,제천시,35-39세,7365,3795,3570
202011,43150,충청북도,제천시,35-39세,7332,3784,3548
202012,43150,충청북도,제천시,35-39세,7316,3766,3550
202101,43150,충청북도,제천시,35-39세,7280,3769,3511
202102,43150,충청북도,제천시,35-39세,7199,3738,3461
202103,43150,충청북도,제천시,35-39세,7160,3716,3444
202104,43150,충청북도,제천시,35-39세,7109,3697,3412
202105,43150,충청북도,제천시,35-39세,7083,3692,3391
202106,43150,충청북도,제천시,35-39세,7049,3685,3364
202007,43150,충청북도,제천시,40-44세,8140,4195,3945
202008,43150,충청북도,제천시,40-44세,8172,4192,3980
202009,43150,충청북도,제천시,40-44세,8174,4216,3958
202010,43150,충청북도,제천시,40-44세,8178,4228,3950
202011,43150,충청북도,제천시,40-44세,8177,4227,3950
202012,43150,충청북도,제천시,40-44세,8162,4234,3928
202101,43150,충청북도,제천시,40-44세,8131,4212,3919
202102,43150,충청북도,제천시,40-44세,8130,4205,3925
202103,43150,충청북도,제천시,40-44세,8096,4196,3900
202104,43150,충청북도,제천시,40-44세,8059,4181,3878
202105,43150,충청북도,제천시,40-44세,8047,4171,3876
202106,43150,충청북도,제천시,40-44세,8064,4176,3888
202007,43150,충청북도,제천시,45-49세,10472,5393,5079
202008,43150,충청북도,제천시,45-49세,10411,5368,5043
202009,43150,충청북도,제천시,45-49세,10404,5358,5046
202010,43150,충청북도,제천시,45-49세,10339,5313,5026
202011,43150,충청북도,제천시,45-49세,10311,5288,5023
202012,43150,충청북도,제천시,45-49세,10280,5254,5026
202101,43150,충청북도,제천시,45-49세,10232,5241,4991
202102,43150,충청북도,제천시,45-49세,10180,5216,4964
202103,43150,충청북도,제천시,45-49세,10129,5188,4941
202104,43150,충청북도,제천시,45-49세,10115,5166,4949
202105,43150,충청북도,제천시,45-49세,10046,5143,4903
202106,43150,충청북도,제천시,45-49세,9920,5085,4835
202007,43150,충청북도,제천시,50-54세,11925,6165,5760
202008,43150,충청북도,제천시,50-54세,11942,6176,5766
202009,43150,충청북도,제천시,50-54세,11951,6173,5778
202010,43150,충청북도,제천시,50-54세,11977,6180,5797
202011,43150,충청북도,제천시,50-54세,11946,6169,5777
202012,43150,충청북도,제천시,50-54세,11893,6162,5731
202101,43150,충청북도,제천시,50-54세,11933,6165,5768
202102,43150,충청북도,제천시,50-54세,11902,6125,5777
202103,43150,충청북도,제천시,50-54세,11836,6095,5741
202104,43150,충청북도,제천시,50-54세,11812,6089,5723
202105,43150,충청북도,제천시,50-54세,11861,6093,5768
202106,43150,충청북도,제천시,50-54세,11856,6099,5757
202007,43150,충청북도,제천시,55-59세,12256,6210,6046
202008,43150,충청북도,제천시,55-59세,12240,6207,6033
202009,43150,충청북도,제천시,55-59세,12156,6166,5990
202010,43150,충청북도,제천시,55-59세,12138,6155,5983
202011,43150,충청북도,제천시,55-59세,12106,6125,5981
202012,43150,충청북도,제천시,55-59세,12117,6117,6000
202101,43150,충청북도,제천시,55-59세,12000,6067,5933
202102,43150,충청북도,제천시,55-59세,11986,6069,5917
202103,43150,충청북도,제천시,55-59세,11956,6052,5904
202104,43150,충청북도,제천시,55-59세,11925,6033,5892
202105,43150,충청북도,제천시,55-59세,11811,5987,5824
202106,43150,충청북도,제천시,55-59세,11655,5894,5761
202007,43150,충청북도,제천시,60-64세,12816,6388,6428
202008,43150,충청북도,제천시,60-64세,12860,6397,6463
202009,43150,충청북도,제천시,60-64세,12982,6458,6524
202010,43150,충청북도,제천시,60-64세,13017,6481,6536
202011,43150,충청북도,제천시,60-64세,13098,6532,6566
202012,43150,충청북도,제천시,60-64세,13125,6541,6584
202101,43150,충청북도,제천시,60-64세,13182,6557,6625
202102,43150,충청북도,제천시,60-64세,13240,6576,6664
202103,43150,충청북도,제천시,60-64세,13302,6590,6712
202104,43150,충청북도,제천시,60-64세,13375,6632,6743
202105,43150,충청북도,제천시,60-64세,13475,6690,6785
202106,43150,충청북도,제천시,60-64세,13558,6748,6810
202007,43150,충청북도,제천시,65-69세,9344,4612,4732
202008,43150,충청북도,제천시,65-69세,9370,4640,4730
202009,43150,충청북도,제천시,65-69세,9446,4672,4774
202010,43150,충청북도,제천시,65-69세,9516,4713,4803
202011,43150,충청북도,제천시,65-69세,9580,4747,4833
202012,43150,충청북도,제천시,65-69세,9678,4818,4860
202101,43150,충청북도,제천시,65-69세,9759,4860,4899
202102,43150,충청북도,제천시,65-69세,9800,4891,4909
202103,43150,충청북도,제천시,65-69세,9969,4998,4971
202104,43150,충청북도,제천시,65-69세,10078,5050,5028
202105,43150,충청북도,제천시,65-69세,10175,5093,5082
202106,43150,충청북도,제천시,65-69세,10222,5129,5093
202007,43150,충청북도,제천시,70-74세,6287,2968,3319
202008,43150,충청북도,제천시,70-74세,6317,2980,3337
202009,43150,충청북도,제천시,70-74세,6338,2995,3343
202010,43150,충청북도,제천시,70-74세,6388,3026,3362
202011,43150,충청북도,제천시,70-74세,6424,3049,3375
202012,43150,충청북도,제천시,70-74세,6482,3080,3402
202101,43150,충청북도,제천시,70-74세,6542,3110,3432
202102,43150,충청북도,제천시,70-74세,6590,3131,3459
202103,43150,충청북도,제천시,70-74세,6598,3140,3458
202104,43150,충청북도,제천시,70-74세,6588,3125,3463
202105,43150,충청북도,제천시,70-74세,6589,3123,3466
202106,43150,충청북도,제천시,70-74세,6586,3116,3470
202007,43150,충청북도,제천시,75-79세,6101,2640,3461
202008,43150,충청북도,제천시,75-79세,6097,2636,3461
202009,43150,충청북도,제천시,75-79세,6100,2634,3466
202010,43150,충청북도,제천시,75-79세,6048,2606,3442
202011,43150,충청북도,제천시,75-79세,6023,2590,3433
202012,43150,충청북도,제천시,75-79세,5962,2544,3418
202101,43150,충청북도,제천시,75-79세,5937,2546,3391
202102,43150,충청북도,제천시,75-79세,5912,2538,3374
202103,43150,충청북도,제천시,75-79세,5865,2511,3354
202104,43150,충청북도,제천시,75-79세,5828,2496,3332
202105,43150,충청북도,제천시,75-79세,5795,2479,3316
202106,43150,충청북도,제천시,75-79세,5779,2477,3302
202007,43150,충청북도,제천시,80-84세,4204,1615,2589
202008,43150,충청북도,제천시,80-84세,4212,1616,2596
202009,43150,충청북도,제천시,80-84세,4183,1600,2583
202010,43150,충청북도,제천시,80-84세,4213,1611,2602
202011,43150,충청북도,제천시,80-84세,4231,1623,2608
202012,43150,충청북도,제천시,80-84세,4273,1648,2625
202101,43150,충청북도,제천시,80-84세,4285,1653,2632
202102,43150,충청북도,제천시,80-84세,4302,1662,2640
202103,43150,충청북도,제천시,80-84세,4316,1664,2652
202104,43150,충청북도,제천시,80-84세,4339,1676,2663
202105,43150,충청북도,제천시,80-84세,4375,1690,2685
202106,43150,충청북도,제천시,80-84세,4378,1693,2685
202007,43150,충청북도,제천시,85-89세,1885,582,1303
202008,43150,충청북도,제천시,85-89세,1901,593,1308
202009,43150,충청북도,제천시,85-89세,1933,605,1328
202010,43150,충청북도,제천시,85-89세,1953,617,1336
202011,43150,충청북도,제천시,85-89세,1950,619,1331
202012,43150,충청북도,제천시,85-89세,1963,627,1336
202101,43150,충청북도,제천시,85-89세,1979,634,1345
202102,43150,충청북도,제천시,85-89세,2018,642,1376
202103,43150,충청북도,제천시,85-89세,2072,670,1402
202104,43150,충청북도,제천시,85-89세,2122,684,1438
202105,43150,충청북도,제천시,85-89세,2128,693,1435
202106,43150,충청북도,제천시,85-89세,2118,685,1433
202007,43150,충청북도,제천시,90-94세,647,144,503
202008,43150,충청북도,제천시,90-94세,650,144,506
202009,43150,충청북도,제천시,90-94세,648,144,504
202010,43150,충청북도,제천시,90-94세,661,144,517
202011,43150,충청북도,제천시,90-94세,673,147,526
202012,43150,충청북도,제천시,90-94세,662,145,517
202101,43150,충청북도,제천시,90-94세,674,148,526
202102,43150,충청북도,제천시,90-94세,668,149,519
202103,43150,충청북도,제천시,90-94세,676,154,522
202104,43150,충청북도,제천시,90-94세,686,154,532
202105,43150,충청북도,제천시,90-94세,686,154,532
202106,43150,충청북도,제천시,90-94세,673,153,520
202007,43150,충청북도,제천시,95-99세,162,35,127
202008,43150,충청북도,제천시,95-99세,161,35,126
202009,43150,충청북도,제천시,95-99세,167,37,130
202010,43150,충청북도,제천시,95-99세,165,38,127
202011,43150,충청북도,제천시,95-99세,162,37,125
202012,43150,충청북도,제천시,95-99세,160,33,127
202101,43150,충청북도,제천시,95-99세,158,33,125
202102,43150,충청북도,제천시,95-99세,159,33,126
202103,43150,충청북도,제천시,95-99세,152,30,122
202104,43150,충청북도,제천시,95-99세,151,29,122
202105,43150,충청북도,제천시,95-99세,153,30,123
202106,43150,충청북도,제천시,95-99세,152,29,123
202007,43150,충청북도,제천시,100+,71,23,48
202008,43150,충청북도,제천시,100+,72,23,49
202009,43150,충청북도,제천시,100+,72,23,49
202010,43150,충청북도,제천시,100+,74,23,51
202011,43150,충청북도,제천시,100+,74,23,51
202012,43150,충청북도,제천시,100+,76,25,51
202101,43150,충청북도,제천시,100+,77,25,52
202102,43150,충청북도,제천시,100+,79,26,53
202103,43150,충청북도,제천시,100+,63,21,42
202104,43150,충청북도,제천시,100+,66,21,45
202105,43150,충청북도,제천시,100+,66,21,45
202106,43150,충청북도,제천시,100+,58,17,41
202007,43720,충청북도,보은군,0-4세,652,344,308
202008,43720,충청북도,보은군,0-4세,651,345,306
202009,43720,충청북도,보은군,0-4세,641,334,307
202010,43720,충청북도,보은군,0-4세,638,331,307
202011,43720,충청북도,보은군,0-4세,630,321,309
202012,43720,충청북도,보은군,0-4세,629,321,308
202101,43720,충청북도,보은군,0-4세,616,312,304
202102,43720,충청북도,보은군,0-4세,610,312,298
202103,43720,충청북도,보은군,0-4세,595,307,288
202104,43720,충청북도,보은군,0-4세,599,309,290
202105,43720,충청북도,보은군,0-4세,586,302,284
202106,43720,충청북도,보은군,0-4세,575,296,279
202007,43720,충청북도,보은군,5-9세,855,440,415
202008,43720,충청북도,보은군,5-9세,847,435,412
202009,43720,충청북도,보은군,5-9세,839,430,409
202010,43720,충청북도,보은군,5-9세,836,430,406
202011,43720,충청북도,보은군,5-9세,829,428,401
202012,43720,충청북도,보은군,5-9세,835,428,407
202101,43720,충청북도,보은군,5-9세,829,426,403
202102,43720,충청북도,보은군,5-9세,828,419,409
202103,43720,충청북도,보은군,5-9세,830,424,406
202104,43720,충청북도,보은군,5-9세,821,417,404
202105,43720,충청북도,보은군,5-9세,818,414,404
202106,43720,충청북도,보은군,5-9세,817,415,402
202007,43720,충청북도,보은군,10-14세,954,531,423
202008,43720,충청북도,보은군,10-14세,966,534,432
202009,43720,충청북도,보은군,10-14세,972,531,441
202010,43720,충청북도,보은군,10-14세,968,526,442
202011,43720,충청북도,보은군,10-14세,969,533,436
202012,43720,충청북도,보은군,10-14세,968,537,431
202101,43720,충청북도,보은군,10-14세,961,529,432
202102,43720,충청북도,보은군,10-14세,952,522,430
202103,43720,충청북도,보은군,10-14세,963,528,435
202104,43720,충청북도,보은군,10-14세,974,538,436
202105,43720,충청북도,보은군,10-14세,974,537,437
202106,43720,충청북도,보은군,10-14세,972,538,434
202007,43720,충청북도,보은군,15-19세,1188,614,574
202008,43720,충청북도,보은군,15-19세,1181,611,570
202009,43720,충청북도,보은군,15-19세,1170,611,559
202010,43720,충청북도,보은군,15-19세,1166,608,558
202011,43720,충청북도,보은군,15-19세,1150,599,551
202012,43720,충청북도,보은군,15-19세,1143,592,551
202101,43720,충청북도,보은군,15-19세,1137,591,546
202102,43720,충청북도,보은군,15-19세,1138,600,538
202103,43720,충청북도,보은군,15-19세,1116,589,527
202104,43720,충청북도,보은군,15-19세,1099,575,524
202105,43720,충청북도,보은군,15-19세,1089,567,522
202106,43720,충청북도,보은군,15-19세,1080,556,524
202007,43720,충청북도,보은군,20-24세,1353,781,572
202008,43720,충청북도,보은군,20-24세,1349,787,562
202009,43720,충청북도,보은군,20-24세,1344,782,562
202010,43720,충청북도,보은군,20-24세,1339,775,564
202011,43720,충청북도,보은군,20-24세,1341,773,568
202012,43720,충청북도,보은군,20-24세,1341,760,581
202101,43720,충청북도,보은군,20-24세,1335,761,574
202102,43720,충청북도,보은군,20-24세,1321,760,561
202103,43720,충청북도,보은군,20-24세,1308,758,550
202104,43720,충청북도,보은군,20-24세,1317,762,555
202105,43720,충청북도,보은군,20-24세,1310,764,546
202106,43720,충청북도,보은군,20-24세,1298,764,534
202007,43720,충청북도,보은군,25-29세,1051,621,430
202008,43720,충청북도,보은군,25-29세,1048,627,421
202009,43720,충청북도,보은군,25-29세,1055,631,424
202010,43720,충청북도,보은군,25-29세,1045,626,419
202011,43720,충청북도,보은군,25-29세,1041,627,414
202012,43720,충청북도,보은군,25-29세,1036,630,406
202101,43720,충청북도,보은군,25-29세,1028,629,399
202102,43720,충청북도,보은군,25-29세,1023,620,403
202103,43720,충청북도,보은군,25-29세,1023,616,407
202104,43720,충청북도,보은군,25-29세,1029,620,409
202105,43720,충청북도,보은군,25-29세,1024,617,407
202106,43720,충청북도,보은군,25-29세,1032,617,415
202007,43720,충청북도,보은군,30-34세,975,551,424
202008,43720,충청북도,보은군,30-34세,975,549,426
202009,43720,충청북도,보은군,30-34세,974,551,423
202010,43720,충청북도,보은군,30-34세,972,552,420
202011,43720,충청북도,보은군,30-34세,958,540,418
202012,43720,충청북도,보은군,30-34세,942,534,408
202101,43720,충청북도,보은군,30-34세,935,528,407
202102,43720,충청북도,보은군,30-34세,933,530,403
202103,43720,충청북도,보은군,30-34세,927,527,400
202104,43720,충청북도,보은군,30-34세,915,522,393
202105,43720,충청북도,보은군,30-34세,911,520,391
202106,43720,충청북도,보은군,30-34세,897,513,384
202007,43720,충청북도,보은군,35-39세,1295,702,593
202008,43720,충청북도,보은군,35-39세,1294,700,594
202009,43720,충청북도,보은군,35-39세,1284,691,593
202010,43720,충청북도,보은군,35-39세,1265,676,589
202011,43720,충청북도,보은군,35-39세,1258,673,585
202012,43720,충청북도,보은군,35-39세,1268,675,593
202101,43720,충청북도,보은군,35-39세,1259,671,588
202102,43720,충청북도,보은군,35-39세,1241,667,574
202103,43720,충청북도,보은군,35-39세,1217,661,556
202104,43720,충청북도,보은군,35-39세,1205,652,553
202105,43720,충청북도,보은군,35-39세,1190,638,552
202106,43720,충청북도,보은군,35-39세,1173,628,545
202007,43720,충청북도,보은군,40-44세,1407,792,615
202008,43720,충청북도,보은군,40-44세,1402,786,616
202009,43720,충청북도,보은군,40-44세,1408,792,616
202010,43720,충청북도,보은군,40-44세,1420,798,622
202011,43720,충청북도,보은군,40-44세,1409,794,615
202012,43720,충청북도,보은군,40-44세,1389,786,603
202101,43720,충청북도,보은군,40-44세,1377,779,598
202102,43720,충청북도,보은군,40-44세,1400,787,613
202103,43720,충청북도,보은군,40-44세,1391,781,610
202104,43720,충청북도,보은군,40-44세,1392,776,616
202105,43720,충청북도,보은군,40-44세,1384,774,610
202106,43720,충청북도,보은군,40-44세,1396,778,618
202007,43720,충청북도,보은군,45-49세,1972,1103,869
202008,43720,충청북도,보은군,45-49세,1966,1102,864
202009,43720,충청북도,보은군,45-49세,1958,1104,854
202010,43720,충청북도,보은군,45-49세,1956,1104,852
202011,43720,충청북도,보은군,45-49세,1947,1097,850
202012,43720,충청북도,보은군,45-49세,1931,1088,843
202101,43720,충청북도,보은군,45-49세,1927,1079,848
202102,43720,충청북도,보은군,45-49세,1899,1062,837
202103,43720,충청북도,보은군,45-49세,1881,1048,833
202104,43720,충청북도,보은군,45-49세,1868,1036,832
202105,43720,충청북도,보은군,45-49세,1853,1028,825
202106,43720,충청북도,보은군,45-49세,1829,1011,818
202007,43720,충청북도,보은군,50-54세,2611,1457,1154
202008,43720,충청북도,보은군,50-54세,2604,1451,1153
202009,43720,충청북도,보은군,50-54세,2604,1439,1165
202010,43720,충청북도,보은군,50-54세,2584,1436,1148
202011,43720,충청북도,보은군,50-54세,2607,1454,1153
202012,43720,충청북도,보은군,50-54세,2561,1415,1146
202101,43720,충청북도,보은군,50-54세,2550,1415,1135
202102,43720,충청북도,보은군,50-54세,2557,1421,1136
202103,43720,충청북도,보은군,50-54세,2531,1411,1120
202104,43720,충청북도,보은군,50-54세,2517,1409,1108
202105,43720,충청북도,보은군,50-54세,2522,1409,1113
202106,43720,충청북도,보은군,50-54세,2519,1410,1109
202007,43720,충청북도,보은군,55-59세,3367,1832,1535
202008,43720,충청북도,보은군,55-59세,3366,1834,1532
202009,43720,충청북도,보은군,55-59세,3338,1827,1511
202010,43720,충청북도,보은군,55-59세,3347,1827,1520
202011,43720,충청북도,보은군,55-59세,3333,1826,1507
202012,43720,충청북도,보은군,55-59세,3339,1823,1516
202101,43720,충청북도,보은군,55-59세,3300,1794,1506
202102,43720,충청북도,보은군,55-59세,3286,1791,1495
202103,43720,충청북도,보은군,55-59세,3251,1780,1471
202104,43720,충청북도,보은군,55-59세,3234,1769,1465
202105,43720,충청북도,보은군,55-59세,3198,1755,1443
202106,43720,충청북도,보은군,55-59세,3162,1747,1415
202007,43720,충청북도,보은군,60-64세,3731,1955,1776
202008,43720,충청북도,보은군,60-64세,3740,1960,1780
202009,43720,충청북도,보은군,60-64세,3759,1964,1795
202010,43720,충청북도,보은군,60-64세,3763,1963,1800
202011,43720,충청북도,보은군,60-64세,3791,1979,1812
202012,43720,충청북도,보은군,60-64세,3813,2007,1806
202101,43720,충청북도,보은군,60-64세,3829,2026,1803
202102,43720,충청북도,보은군,60-64세,3867,2037,1830
202103,43720,충청북도,보은군,60-64세,3873,2045,1828
202104,43720,충청북도,보은군,60-64세,3914,2078,1836
202105,43720,충청북도,보은군,60-64세,3966,2103,1863
202106,43720,충청북도,보은군,60-64세,3981,2099,1882
202007,43720,충청북도,보은군,65-69세,2912,1447,1465
202008,43720,충청북도,보은군,65-69세,2928,1449,1479
202009,43720,충청북도,보은군,65-69세,2965,1475,1490
202010,43720,충청북도,보은군,65-69세,2962,1475,1487
202011,43720,충청북도,보은군,65-69세,2968,1476,1492
202012,43720,충청북도,보은군,65-69세,3001,1489,1512
202101,43720,충청북도,보은군,65-69세,3045,1510,1535
202102,43720,충청북도,보은군,65-69세,3075,1530,1545
202103,43720,충청북도,보은군,65-69세,3109,1548,1561
202104,43720,충청북도,보은군,65-69세,3130,1558,1572
202105,43720,충청북도,보은군,65-69세,3163,1578,1585
202106,43720,충청북도,보은군,65-69세,3181,1590,1591
202007,43720,충청북도,보은군,70-74세,2274,1115,1159
202008,43720,충청북도,보은군,70-74세,2284,1122,1162
202009,43720,충청북도,보은군,70-74세,2290,1119,1171
202010,43720,충청북도,보은군,70-74세,2306,1129,1177
202011,43720,충청북도,보은군,70-74세,2337,1146,1191
202012,43720,충청북도,보은군,70-74세,2357,1160,1197
202101,43720,충청북도,보은군,70-74세,2391,1183,1208
202102,43720,충청북도,보은군,70-74세,2404,1187,1217
202103,43720,충청북도,보은군,70-74세,2376,1178,1198
202104,43720,충청북도,보은군,70-74세,2373,1186,1187
202105,43720,충청북도,보은군,70-74세,2371,1189,1182
202106,43720,충청북도,보은군,70-74세,2364,1178,1186
202007,43720,충청북도,보은군,75-79세,2318,924,1394
202008,43720,충청북도,보은군,75-79세,2299,905,1394
202009,43720,충청북도,보은군,75-79세,2271,902,1369
202010,43720,충청북도,보은군,75-79세,2267,898,1369
202011,43720,충청북도,보은군,75-79세,2254,894,1360
202012,43720,충청북도,보은군,75-79세,2227,882,1345
202101,43720,충청북도,보은군,75-79세,2191,867,1324
202102,43720,충청북도,보은군,75-79세,2173,867,1306
202103,43720,충청북도,보은군,75-79세,2176,868,1308
202104,43720,충청북도,보은군,75-79세,2158,866,1292
202105,43720,충청북도,보은군,75-79세,2149,864,1285
202106,43720,충청북도,보은군,75-79세,2147,866,1281
202007,43720,충청북도,보은군,80-84세,1985,723,1262
202008,43720,충청북도,보은군,80-84세,1996,733,1263
202009,43720,충청북도,보은군,80-84세,2000,729,1271
202010,43720,충청북도,보은군,80-84세,1990,727,1263
202011,43720,충청북도,보은군,80-84세,1965,717,1248
202012,43720,충청북도,보은군,80-84세,1969,721,1248
202101,43720,충청북도,보은군,80-84세,1985,727,1258
202102,43720,충청북도,보은군,80-84세,1969,716,1253
202103,43720,충청북도,보은군,80-84세,1948,712,1236
202104,43720,충청북도,보은군,80-84세,1954,710,1244
202105,43720,충청북도,보은군,80-84세,1942,712,1230
202106,43720,충청북도,보은군,80-84세,1942,718,1224
202007,43720,충청북도,보은군,85-89세,1104,330,774
202008,43720,충청북도,보은군,85-89세,1106,331,775
202009,43720,충청북도,보은군,85-89세,1129,338,791
202010,43720,충청북도,보은군,85-89세,1130,339,791
202011,43720,충청북도,보은군,85-89세,1146,344,802
202012,43720,충청북도,보은군,85-89세,1145,342,803
202101,43720,충청북도,보은군,85-89세,1145,339,806
202102,43720,충청북도,보은군,85-89세,1166,347,819
202103,43720,충청북도,보은군,85-89세,1181,351,830
202104,43720,충청북도,보은군,85-89세,1199,358,841
202105,43720,충청북도,보은군,85-89세,1215,357,858
202106,43720,충청북도,보은군,85-89세,1214,355,859
202007,43720,충청북도,보은군,90-94세,419,99,320
202008,43720,충청북도,보은군,90-94세,417,96,321
202009,43720,충청북도,보은군,90-94세,417,96,321
202010,43720,충청북도,보은군,90-94세,416,95,321
202011,43720,충청북도,보은군,90-94세,416,91,325
202012,43720,충청북도,보은군,90-94세,415,89,326
202101,43720,충청북도,보은군,90-94세,417,92,325
202102,43720,충청북도,보은군,90-94세,425,94,331
202103,43720,충청북도,보은군,90-94세,420,90,330
202104,43720,충청북도,보은군,90-94세,424,92,332
202105,43720,충청북도,보은군,90-94세,425,92,333
202106,43720,충청북도,보은군,90-94세,426,92,334
202007,43720,충청북도,보은군,95-99세,73,11,62
202008,43720,충청북도,보은군,95-99세,76,12,64
202009,43720,충청북도,보은군,95-99세,77,12,65
202010,43720,충청북도,보은군,95-99세,79,12,67
202011,43720,충청북도,보은군,95-99세,79,13,66
202012,43720,충청북도,보은군,95-99세,75,12,63
202101,43720,충청북도,보은군,95-99세,80,12,68
202102,43720,충청북도,보은군,95-99세,77,11,66
202103,43720,충청북도,보은군,95-99세,75,13,62
202104,43720,충청북도,보은군,95-99세,74,13,61
202105,43720,충청북도,보은군,95-99세,76,16,60
202106,43720,충청북도,보은군,95-99세,78,17,61
202007,43720,충청북도,보은군,100+,26,1,25
202008,43720,충청북도,보은군,100+,27,1,26
202009,43720,충청북도,보은군,100+,27,1,26
202010,43720,충청북도,보은군,100+,27,1,26
202011,43720,충청북도,보은군,100+,28,1,27
202012,43720,충청북도,보은군,100+,28,1,27
202101,43720,충청북도,보은군,100+,27,1,26
202102,43720,충청북도,보은군,100+,27,1,26
202103,43720,충청북도,보은군,100+,15,0,15
202104,43720,충청북도,보은군,100+,15,0,15
202105,43720,충청북도,보은군,100+,14,0,14
202106,43720,충청북도,보은군,100+,13,0,13
202007,43730,충청북도,옥천군,0-4세,1034,541,493
202008,43730,충청북도,옥천군,0-4세,1033,543,490
202009,43730,충청북도,옥천군,0-4세,1021,541,480
202010,43730,충청북도,옥천군,0-4세,1019,539,480
202011,43730,충청북도,옥천군,0-4세,1016,535,481
202012,43730,충청북도,옥천군,0-4세,1004,531,473
202101,43730,충청북도,옥천군,0-4세,992,525,467
202102,43730,충청북도,옥천군,0-4세,988,519,469
202103,43730,충청북도,옥천군,0-4세,990,516,474
202104,43730,충청북도,옥천군,0-4세,987,513,474
202105,43730,충청북도,옥천군,0-4세,973,504,469
202106,43730,충청북도,옥천군,0-4세,961,495,466
202007,43730,충청북도,옥천군,5-9세,1658,864,794
202008,43730,충청북도,옥천군,5-9세,1651,856,795
202009,43730,충청북도,옥천군,5-9세,1655,851,804
202010,43730,충청북도,옥천군,5-9세,1632,844,788
202011,43730,충청북도,옥천군,5-9세,1602,832,770
202012,43730,충청북도,옥천군,5-9세,1586,820,766
202101,43730,충청북도,옥천군,5-9세,1572,809,763
202102,43730,충청북도,옥천군,5-9세,1580,815,765
202103,43730,충청북도,옥천군,5-9세,1560,802,758
202104,43730,충청북도,옥천군,5-9세,1562,800,762
202105,43730,충청북도,옥천군,5-9세,1558,796,762
202106,43730,충청북도,옥천군,5-9세,1560,797,763
202007,43730,충청북도,옥천군,10-14세,1851,971,880
202008,43730,충청북도,옥천군,10-14세,1862,978,884
202009,43730,충청북도,옥천군,10-14세,1860,978,882
202010,43730,충청북도,옥천군,10-14세,1873,980,893
202011,43730,충청북도,옥천군,10-14세,1878,979,899
202012,43730,충청북도,옥천군,10-14세,1882,988,894
202101,43730,충청북도,옥천군,10-14세,1890,989,901
202102,43730,충청북도,옥천군,10-14세,1884,990,894
202103,43730,충청북도,옥천군,10-14세,1902,995,907
202104,43730,충청북도,옥천군,10-14세,1904,996,908
202105,43730,충청북도,옥천군,10-14세,1895,990,905
202106,43730,충청북도,옥천군,10-14세,1885,992,893
202007,43730,충청북도,옥천군,15-19세,2093,1106,987
202008,43730,충청북도,옥천군,15-19세,2073,1099,974
202009,43730,충청북도,옥천군,15-19세,2061,1095,966
202010,43730,충청북도,옥천군,15-19세,2049,1096,953
202011,43730,충청북도,옥천군,15-19세,2032,1092,940
202012,43730,충청북도,옥천군,15-19세,2002,1074,928
202101,43730,충청북도,옥천군,15-19세,1997,1076,921
202102,43730,충청북도,옥천군,15-19세,1975,1068,907
202103,43730,충청북도,옥천군,15-19세,1945,1051,894
202104,43730,충청북도,옥천군,15-19세,1929,1040,889
202105,43730,충청북도,옥천군,15-19세,1905,1026,879
202106,43730,충청북도,옥천군,15-19세,1912,1025,887
202007,43730,충청북도,옥천군,20-24세,2508,1406,1102
202008,43730,충청북도,옥천군,20-24세,2518,1408,1110
202009,43730,충청북도,옥천군,20-24세,2496,1392,1104
202010,43730,충청북도,옥천군,20-24세,2486,1383,1103
202011,43730,충청북도,옥천군,20-24세,2466,1368,1098
202012,43730,충청북도,옥천군,20-24세,2470,1388,1082
202101,43730,충청북도,옥천군,20-24세,2442,1376,1066
202102,43730,충청북도,옥천군,20-24세,2445,1379,1066
202103,43730,충청북도,옥천군,20-24세,2424,1377,1047
202104,43730,충청북도,옥천군,20-24세,2416,1375,1041
202105,43730,충청북도,옥천군,20-24세,2403,1374,1029
202106,43730,충청북도,옥천군,20-24세,2380,1366,1014
202007,43730,충청북도,옥천군,25-29세,1947,1122,825
202008,43730,충청북도,옥천군,25-29세,1927,1104,823
202009,43730,충청북도,옥천군,25-29세,1921,1106,815
202010,43730,충청북도,옥천군,25-29세,1925,1109,816
202011,43730,충청북도,옥천군,25-29세,1936,1129,807
202012,43730,충청북도,옥천군,25-29세,1942,1129,813
202101,43730,충청북도,옥천군,25-29세,1906,1102,804
202102,43730,충청북도,옥천군,25-29세,1882,1090,792
202103,43730,충청북도,옥천군,25-29세,1884,1087,797
202104,43730,충청북도,옥천군,25-29세,1870,1068,802
202105,43730,충청북도,옥천군,25-29세,1873,1070,803
202106,43730,충청북도,옥천군,25-29세,1874,1070,804
202007,43730,충청북도,옥천군,30-34세,1658,877,781
202008,43730,충청북도,옥천군,30-34세,1651,872,779
202009,43730,충청북도,옥천군,30-34세,1658,879,779
202010,43730,충청북도,옥천군,30-34세,1633,868,765
202011,43730,충청북도,옥천군,30-34세,1611,857,754
202012,43730,충청북도,옥천군,30-34세,1602,861,741
202101,43730,충청북도,옥천군,30-34세,1602,866,736
202102,43730,충청북도,옥천군,30-34세,1596,851,745
202103,43730,충청북도,옥천군,30-34세,1606,849,757
202104,43730,충청북도,옥천군,30-34세,1610,846,764
202105,43730,충청북도,옥천군,30-34세,1614,850,764
202106,43730,충청북도,옥천군,30-34세,1617,856,761
202007,43730,충청북도,옥천군,35-39세,2329,1195,1134
202008,43730,충청북도,옥천군,35-39세,2329,1204,1125
202009,43730,충청북도,옥천군,35-39세,2321,1190,1131
202010,43730,충청북도,옥천군,35-39세,2295,1178,1117
202011,43730,충청북도,옥천군,35-39세,2275,1167,1108
202012,43730,충청북도,옥천군,35-39세,2275,1162,1113
202101,43730,충청북도,옥천군,35-39세,2264,1146,1118
202102,43730,충청북도,옥천군,35-39세,2247,1139,1108
202103,43730,충청북도,옥천군,35-39세,2236,1143,1093
202104,43730,충청북도,옥천군,35-39세,2213,1134,1079
202105,43730,충청북도,옥천군,35-39세,2201,1115,1086
202106,43730,충청북도,옥천군,35-39세,2168,1096,1072
202007,43730,충청북도,옥천군,40-44세,2755,1464,1291
202008,43730,충청북도,옥천군,40-44세,2763,1468,1295
202009,43730,충청북도,옥천군,40-44세,2755,1473,1282
202010,43730,충청북도,옥천군,40-44세,2767,1475,1292
202011,43730,충청북도,옥천군,40-44세,2762,1468,1294
202012,43730,충청북도,옥천군,40-44세,2719,1451,1268
202101,43730,충청북도,옥천군,40-44세,2704,1435,1269
202102,43730,충청북도,옥천군,40-44세,2694,1431,1263
202103,43730,충청북도,옥천군,40-44세,2661,1417,1244
202104,43730,충청북도,옥천군,40-44세,2659,1412,1247
202105,43730,충청북도,옥천군,40-44세,2647,1405,1242
202106,43730,충청북도,옥천군,40-44세,2683,1420,1263
202007,43730,충청북도,옥천군,45-49세,3581,1949,1632
202008,43730,충청북도,옥천군,45-49세,3573,1933,1640
202009,43730,충청북도,옥천군,45-49세,3560,1922,1638
202010,43730,충청북도,옥천군,45-49세,3531,1907,1624
202011,43730,충청북도,옥천군,45-49세,3519,1906,1613
202012,43730,충청북도,옥천군,45-49세,3534,1915,1619
202101,43730,충청북도,옥천군,45-49세,3509,1904,1605
202102,43730,충청북도,옥천군,45-49세,3524,1905,1619
202103,43730,충청북도,옥천군,45-49세,3508,1895,1613
202104,43730,충청북도,옥천군,45-49세,3503,1893,1610
202105,43730,충청북도,옥천군,45-49세,3458,1885,1573
202106,43730,충청북도,옥천군,45-49세,3431,1867,1564
202007,43730,충청북도,옥천군,50-54세,4203,2250,1953
202008,43730,충청북도,옥천군,50-54세,4205,2258,1947
202009,43730,충청북도,옥천군,50-54세,4210,2258,1952
202010,43730,충청북도,옥천군,50-54세,4206,2254,1952
202011,43730,충청북도,옥천군,50-54세,4184,2233,1951
202012,43730,충청북도,옥천군,50-54세,4148,2211,1937
202101,43730,충청북도,옥천군,50-54세,4164,2211,1953
202102,43730,충청북도,옥천군,50-54세,4167,2204,1963
202103,43730,충청북도,옥천군,50-54세,4144,2194,1950
202104,43730,충청북도,옥천군,50-54세,4136,2198,1938
202105,43730,충청북도,옥천군,50-54세,4195,2219,1976
202106,43730,충청북도,옥천군,50-54세,4205,2222,1983
202007,43730,충청북도,옥천군,55-59세,4915,2622,2293
202008,43730,충청북도,옥천군,55-59세,4898,2605,2293
202009,43730,충청북도,옥천군,55-59세,4853,2587,2266
202010,43730,충청북도,옥천군,55-59세,4839,2583,2256
202011,43730,충청북도,옥천군,55-59세,4822,2586,2236
202012,43730,충청북도,옥천군,55-59세,4814,2588,2226
202101,43730,충청북도,옥천군,55-59세,4776,2571,2205
202102,43730,충청북도,옥천군,55-59세,4736,2555,2181
202103,43730,충청북도,옥천군,55-59세,4677,2542,2135
202104,43730,충청북도,옥천군,55-59세,4653,2531,2122
202105,43730,충청북도,옥천군,55-59세,4606,2516,2090
202106,43730,충청북도,옥천군,55-59세,4552,2491,2061
202007,43730,충청북도,옥천군,60-64세,5313,2748,2565
202008,43730,충청북도,옥천군,60-64세,5345,2774,2571
202009,43730,충청북도,옥천군,60-64세,5368,2779,2589
202010,43730,충청북도,옥천군,60-64세,5393,2791,2602
202011,43730,충청북도,옥천군,60-64세,5441,2806,2635
202012,43730,충청북도,옥천군,60-64세,5469,2826,2643
202101,43730,충청북도,옥천군,60-64세,5507,2851,2656
202102,43730,충청북도,옥천군,60-64세,5538,2867,2671
202103,43730,충청북도,옥천군,60-64세,5551,2871,2680
202104,43730,충청북도,옥천군,60-64세,5597,2899,2698
202105,43730,충청북도,옥천군,60-64세,5618,2901,2717
202106,43730,충청북도,옥천군,60-64세,5667,2931,2736
202007,43730,충청북도,옥천군,65-69세,4328,2176,2152
202008,43730,충청북도,옥천군,65-69세,4334,2182,2152
202009,43730,충청북도,옥천군,65-69세,4362,2200,2162
202010,43730,충청북도,옥천군,65-69세,4356,2185,2171
202011,43730,충청북도,옥천군,65-69세,4366,2195,2171
202012,43730,충청북도,옥천군,65-69세,4386,2197,2189
202101,43730,충청북도,옥천군,65-69세,4426,2221,2205
202102,43730,충청북도,옥천군,65-69세,4480,2246,2234
202103,43730,충청북도,옥천군,65-69세,4540,2279,2261
202104,43730,충청북도,옥천군,65-69세,4566,2303,2263
202105,43730,충청북도,옥천군,65-69세,4612,2328,2284
202106,43730,충청북도,옥천군,65-69세,4647,2351,2296
202007,43730,충청북도,옥천군,70-74세,3204,1610,1594
202008,43730,충청북도,옥천군,70-74세,3243,1626,1617
202009,43730,충청북도,옥천군,70-74세,3250,1631,1619
202010,43730,충청북도,옥천군,70-74세,3294,1652,1642
202011,43730,충청북도,옥천군,70-74세,3321,1668,1653
202012,43730,충청북도,옥천군,70-74세,3343,1685,1658
202101,43730,충청북도,옥천군,70-74세,3370,1702,1668
202102,43730,충청북도,옥천군,70-74세,3378,1708,1670
202103,43730,충청북도,옥천군,70-74세,3378,1706,1672
202104,43730,충청북도,옥천군,70-74세,3386,1706,1680
202105,43730,충청북도,옥천군,70-74세,3400,1710,1690
202106,43730,충청북도,옥천군,70-74세,3398,1706,1692
202007,43730,충청북도,옥천군,75-79세,3050,1263,1787
202008,43730,충청북도,옥천군,75-79세,3054,1266,1788
202009,43730,충청북도,옥천군,75-79세,3051,1258,1793
202010,43730,충청북도,옥천군,75-79세,3047,1265,1782
202011,43730,충청북도,옥천군,75-79세,3039,1258,1781
202012,43730,충청북도,옥천군,75-79세,3015,1246,1769
202101,43730,충청북도,옥천군,75-79세,2989,1231,1758
202102,43730,충청북도,옥천군,75-79세,2959,1219,1740
202103,43730,충청북도,옥천군,75-79세,2944,1214,1730
202104,43730,충청북도,옥천군,75-79세,2934,1217,1717
202105,43730,충청북도,옥천군,75-79세,2928,1218,1710
202106,43730,충청북도,옥천군,75-79세,2907,1212,1695
202007,43730,충청북도,옥천군,80-84세,2351,848,1503
202008,43730,충청북도,옥천군,80-84세,2320,834,1486
202009,43730,충청북도,옥천군,80-84세,2323,834,1489
202010,43730,충청북도,옥천군,80-84세,2322,837,1485
202011,43730,충청북도,옥천군,80-84세,2305,833,1472
202012,43730,충청북도,옥천군,80-84세,2286,830,1456
202101,43730,충청북도,옥천군,80-84세,2292,844,1448
202102,43730,충청북도,옥천군,80-84세,2296,844,1452
202103,43730,충청북도,옥천군,80-84세,2285,838,1447
202104,43730,충청북도,옥천군,80-84세,2287,831,1456
202105,43730,충청북도,옥천군,80-84세,2280,830,1450
202106,43730,충청북도,옥천군,80-84세,2280,830,1450
202007,43730,충청북도,옥천군,85-89세,1401,413,988
202008,43730,충청북도,옥천군,85-89세,1410,419,991
202009,43730,충청북도,옥천군,85-89세,1409,419,990
202010,43730,충청북도,옥천군,85-89세,1420,418,1002
202011,43730,충청북도,옥천군,85-89세,1437,429,1008
202012,43730,충청북도,옥천군,85-89세,1454,435,1019
202101,43730,충청북도,옥천군,85-89세,1465,435,1030
202102,43730,충청북도,옥천군,85-89세,1489,444,1045
202103,43730,충청북도,옥천군,85-89세,1497,449,1048
202104,43730,충청북도,옥천군,85-89세,1518,461,1057
202105,43730,충청북도,옥천군,85-89세,1531,463,1068
202106,43730,충청북도,옥천군,85-89세,1530,463,1067
202007,43730,충청북도,옥천군,90-94세,470,123,347
202008,43730,충청북도,옥천군,90-94세,483,127,356
202009,43730,충청북도,옥천군,90-94세,488,126,362
202010,43730,충청북도,옥천군,90-94세,486,126,360
202011,43730,충청북도,옥천군,90-94세,487,125,362
202012,43730,충청북도,옥천군,90-94세,477,123,354
202101,43730,충청북도,옥천군,90-94세,484,124,360
202102,43730,충청북도,옥천군,90-94세,497,124,373
202103,43730,충청북도,옥천군,90-94세,499,124,375
202104,43730,충청북도,옥천군,90-94세,503,126,377
202105,43730,충청북도,옥천군,90-94세,514,131,383
202106,43730,충청북도,옥천군,90-94세,514,130,384
202007,43730,충청북도,옥천군,95-99세,91,19,72
202008,43730,충청북도,옥천군,95-99세,91,20,71
202009,43730,충청북도,옥천군,95-99세,94,22,72
202010,43730,충청북도,옥천군,95-99세,95,22,73
202011,43730,충청북도,옥천군,95-99세,94,22,72
202012,43730,충청북도,옥천군,95-99세,92,23,69
202101,43730,충청북도,옥천군,95-99세,90,23,67
202102,43730,충청북도,옥천군,95-99세,92,27,65
202103,43730,충청북도,옥천군,95-99세,89,26,63
202104,43730,충청북도,옥천군,95-99세,93,26,67
202105,43730,충청북도,옥천군,95-99세,94,24,70
202106,43730,충청북도,옥천군,95-99세,97,26,71
202007,43730,충청북도,옥천군,100+,28,7,21
202008,43730,충청북도,옥천군,100+,29,7,22
202009,43730,충청북도,옥천군,100+,29,7,22
202010,43730,충청북도,옥천군,100+,28,7,21
202011,43730,충청북도,옥천군,100+,26,6,20
202012,43730,충청북도,옥천군,100+,27,6,21
202101,43730,충청북도,옥천군,100+,27,6,21
202102,43730,충청북도,옥천군,100+,27,6,21
202103,43730,충청북도,옥천군,100+,17,3,14
202104,43730,충청북도,옥천군,100+,15,3,12
202105,43730,충청북도,옥천군,100+,15,3,12
202106,43730,충청북도,옥천군,100+,14,2,12
202007,43740,충청북도,영동군,0-4세,1097,590,507
202008,43740,충청북도,영동군,0-4세,1098,591,507
202009,43740,충청북도,영동군,0-4세,1097,587,510
202010,43740,충청북도,영동군,0-4세,1073,575,498
202011,43740,충청북도,영동군,0-4세,1068,577,491
202012,43740,충청북도,영동군,0-4세,1051,561,490
202101,43740,충청북도,영동군,0-4세,1014,532,482
202102,43740,충청북도,영동군,0-4세,992,516,476
202103,43740,충청북도,영동군,0-4세,971,507,464
202104,43740,충청북도,영동군,0-4세,962,503,459
202105,43740,충청북도,영동군,0-4세,962,501,461
202106,43740,충청북도,영동군,0-4세,964,503,461
202007,43740,충청북도,영동군,5-9세,1339,668,671
202008,43740,충청북도,영동군,5-9세,1335,662,673
202009,43740,충청북도,영동군,5-9세,1330,667,663
202010,43740,충청북도,영동군,5-9세,1324,659,665
202011,43740,충청북도,영동군,5-9세,1308,644,664
202012,43740,충청북도,영동군,5-9세,1285,629,656
202101,43740,충청북도,영동군,5-9세,1291,637,654
202102,43740,충청북도,영동군,5-9세,1273,629,644
202103,43740,충청북도,영동군,5-9세,1274,635,639
202104,43740,충청북도,영동군,5-9세,1267,627,640
202105,43740,충청북도,영동군,5-9세,1258,630,628
202106,43740,충청북도,영동군,5-9세,1247,628,619
202007,43740,충청북도,영동군,10-14세,1525,801,724
202008,43740,충청북도,영동군,10-14세,1523,806,717
202009,43740,충청북도,영동군,10-14세,1532,812,720
202010,43740,충청북도,영동군,10-14세,1531,813,718
202011,43740,충청북도,영동군,10-14세,1528,817,711
202012,43740,충청북도,영동군,10-14세,1533,825,708
202101,43740,충청북도,영동군,10-14세,1523,820,703
202102,43740,충청북도,영동군,10-14세,1519,814,705
202103,43740,충청북도,영동군,10-14세,1512,809,703
202104,43740,충청북도,영동군,10-14세,1510,809,701
202105,43740,충청북도,영동군,10-14세,1507,807,700
202106,43740,충청북도,영동군,10-14세,1500,801,699
202007,43740,충청북도,영동군,15-19세,1950,969,981
202008,43740,충청북도,영동군,15-19세,1924,958,966
202009,43740,충청북도,영동군,15-19세,1933,968,965
202010,43740,충청북도,영동군,15-19세,1905,959,946
202011,43740,충청북도,영동군,15-19세,1888,949,939
202012,43740,충청북도,영동군,15-19세,1857,941,916
202101,43740,충청북도,영동군,15-19세,1827,924,903
202102,43740,충청북도,영동군,15-19세,1810,920,890
202103,43740,충청북도,영동군,15-19세,1770,900,870
202104,43740,충청북도,영동군,15-19세,1768,901,867
202105,43740,충청북도,영동군,15-19세,1750,888,862
202106,43740,충청북도,영동군,15-19세,1743,883,860
202007,43740,충청북도,영동군,20-24세,2759,1495,1264
202008,43740,충청북도,영동군,20-24세,2760,1484,1276
202009,43740,충청북도,영동군,20-24세,2735,1472,1263
202010,43740,충청북도,영동군,20-24세,2742,1468,1274
202011,43740,충청북도,영동군,20-24세,2728,1454,1274
202012,43740,충청북도,영동군,20-24세,2714,1446,1268
202101,43740,충청북도,영동군,20-24세,2653,1415,1238
202102,43740,충청북도,영동군,20-24세,2579,1381,1198
202103,43740,충청북도,영동군,20-24세,2516,1354,1162
202104,43740,충청북도,영동군,20-24세,2476,1329,1147
202105,43740,충청북도,영동군,20-24세,2454,1328,1126
202106,43740,충청북도,영동군,20-24세,2426,1321,1105
202007,43740,충청북도,영동군,25-29세,1725,1017,708
202008,43740,충청북도,영동군,25-29세,1732,1032,700
202009,43740,충청북도,영동군,25-29세,1739,1037,702
202010,43740,충청북도,영동군,25-29세,1741,1049,692
202011,43740,충청북도,영동군,25-29세,1744,1056,688
202012,43740,충청북도,영동군,25-29세,1739,1053,686
202101,43740,충청북도,영동군,25-29세,1724,1046,678
202102,43740,충청북도,영동군,25-29세,1694,1028,666
202103,43740,충청북도,영동군,25-29세,1650,999,651
202104,43740,충청북도,영동군,25-29세,1664,1004,660
202105,43740,충청북도,영동군,25-29세,1666,1002,664
202106,43740,충청북도,영동군,25-29세,1655,988,667
202007,43740,충청북도,영동군,30-34세,1514,802,712
202008,43740,충청북도,영동군,30-34세,1513,801,712
202009,43740,충청북도,영동군,30-34세,1494,788,706
202010,43740,충청북도,영동군,30-34세,1470,777,693
202011,43740,충청북도,영동군,30-34세,1456,773,683
202012,43740,충청북도,영동군,30-34세,1433,756,677
202101,43740,충청북도,영동군,30-34세,1410,738,672
202102,43740,충청북도,영동군,30-34세,1401,738,663
202103,43740,충청북도,영동군,30-34세,1388,734,654
202104,43740,충청북도,영동군,30-34세,1364,717,647
202105,43740,충청북도,영동군,30-34세,1345,704,641
202106,43740,충청북도,영동군,30-34세,1323,698,625
202007,43740,충청북도,영동군,35-39세,1880,991,889
202008,43740,충청북도,영동군,35-39세,1870,985,885
202009,43740,충청북도,영동군,35-39세,1854,975,879
202010,43740,충청북도,영동군,35-39세,1839,972,867
202011,43740,충청북도,영동군,35-39세,1834,968,866
202012,43740,충청북도,영동군,35-39세,1838,970,868
202101,43740,충청북도,영동군,35-39세,1824,962,862
202102,43740,충청북도,영동군,35-39세,1803,948,855
202103,43740,충청북도,영동군,35-39세,1790,934,856
202104,43740,충청북도,영동군,35-39세,1775,932,843
202105,43740,충청북도,영동군,35-39세,1771,934,837
202106,43740,충청북도,영동군,35-39세,1756,928,828
202007,43740,충청북도,영동군,40-44세,2276,1197,1079
202008,43740,충청북도,영동군,40-44세,2275,1203,1072
202009,43740,충청북도,영동군,40-44세,2271,1202,1069
202010,43740,충청북도,영동군,40-44세,2258,1189,1069
202011,43740,충청북도,영동군,40-44세,2232,1166,1066
202012,43740,충청북도,영동군,40-44세,2213,1155,1058
202101,43740,충청북도,영동군,40-44세,2174,1142,1032
202102,43740,충청북도,영동군,40-44세,2172,1139,1033
202103,43740,충청북도,영동군,40-44세,2126,1126,1000
202104,43740,충청북도,영동군,40-44세,2098,1117,981
202105,43740,충청북도,영동군,40-44세,2095,1109,986
202106,43740,충청북도,영동군,40-44세,2094,1099,995
202007,43740,충청북도,영동군,45-49세,3203,1787,1416
202008,43740,충청북도,영동군,45-49세,3188,1775,1413
202009,43740,충청북도,영동군,45-49세,3173,1757,1416
202010,43740,충청북도,영동군,45-49세,3153,1749,1404
202011,43740,충청북도,영동군,45-49세,3151,1753,1398
202012,43740,충청북도,영동군,45-49세,3149,1752,1397
202101,43740,충청북도,영동군,45-49세,3140,1745,1395
202102,43740,충청북도,영동군,45-49세,3117,1733,1384
202103,43740,충청북도,영동군,45-49세,3066,1710,1356
202104,43740,충청북도,영동군,45-49세,3056,1697,1359
202105,43740,충청북도,영동군,45-49세,3024,1678,1346
202106,43740,충청북도,영동군,45-49세,3008,1669,1339
202007,43740,충청북도,영동군,50-54세,3929,2137,1792
202008,43740,충청북도,영동군,50-54세,3920,2131,1789
202009,43740,충청북도,영동군,50-54세,3922,2141,1781
202010,43740,충청북도,영동군,50-54세,3932,2140,1792
202011,43740,충청북도,영동군,50-54세,3932,2139,1793
202012,43740,충청북도,영동군,50-54세,3890,2127,1763
202101,43740,충청북도,영동군,50-54세,3883,2110,1773
202102,43740,충청북도,영동군,50-54세,3846,2106,1740
202103,43740,충청북도,영동군,50-54세,3802,2093,1709
202104,43740,충청북도,영동군,50-54세,3794,2101,1693
202105,43740,충청북도,영동군,50-54세,3807,2101,1706
202106,43740,충청북도,영동군,50-54세,3782,2086,1696
202007,43740,충청북도,영동군,55-59세,4619,2378,2241
202008,43740,충청북도,영동군,55-59세,4632,2379,2253
202009,43740,충청북도,영동군,55-59세,4602,2369,2233
202010,43740,충청북도,영동군,55-59세,4586,2366,2220
202011,43740,충청북도,영동군,55-59세,4571,2370,2201
202012,43740,충청북도,영동군,55-59세,4596,2386,2210
202101,43740,충청북도,영동군,55-59세,4551,2360,2191
202102,43740,충청북도,영동군,55-59세,4509,2334,2175
202103,43740,충청북도,영동군,55-59세,4427,2290,2137
202104,43740,충청북도,영동군,55-59세,4405,2269,2136
202105,43740,충청북도,영동군,55-59세,4362,2257,2105
202106,43740,충청북도,영동군,55-59세,4315,2234,2081
202007,43740,충청북도,영동군,60-64세,4982,2559,2423
202008,43740,충청북도,영동군,60-64세,5005,2575,2430
202009,43740,충청북도,영동군,60-64세,5018,2569,2449
202010,43740,충청북도,영동군,60-64세,5041,2575,2466
202011,43740,충청북도,영동군,60-64세,5072,2592,2480
202012,43740,충청북도,영동군,60-64세,5095,2594,2501
202101,43740,충청북도,영동군,60-64세,5105,2619,2486
202102,43740,충청북도,영동군,60-64세,5163,2653,2510
202103,43740,충청북도,영동군,60-64세,5195,2680,2515
202104,43740,충청북도,영동군,60-64세,5247,2710,2537
202105,43740,충청북도,영동군,60-64세,5304,2741,2563
202106,43740,충청북도,영동군,60-64세,5357,2759,2598
202007,43740,충청북도,영동군,65-69세,3958,1984,1974
202008,43740,충청북도,영동군,65-69세,3984,1996,1988
202009,43740,충청북도,영동군,65-69세,4021,2022,1999
202010,43740,충청북도,영동군,65-69세,4050,2048,2002
202011,43740,충청북도,영동군,65-69세,4083,2073,2010
202012,43740,충청북도,영동군,65-69세,4106,2097,2009
202101,43740,충청북도,영동군,65-69세,4127,2098,2029
202102,43740,충청북도,영동군,65-69세,4144,2108,2036
202103,43740,충청북도,영동군,65-69세,4184,2137,2047
202104,43740,충청북도,영동군,65-69세,4212,2151,2061
202105,43740,충청북도,영동군,65-69세,4238,2178,2060
202106,43740,충청북도,영동군,65-69세,4266,2199,2067
202007,43740,충청북도,영동군,70-74세,3236,1514,1722
202008,43740,충청북도,영동군,70-74세,3232,1507,1725
202009,43740,충청북도,영동군,70-74세,3251,1527,1724
202010,43740,충청북도,영동군,70-74세,3257,1529,1728
202011,43740,충청북도,영동군,70-74세,3279,1537,1742
202012,43740,충청북도,영동군,70-74세,3302,1545,1757
202101,43740,충청북도,영동군,70-74세,3324,1560,1764
202102,43740,충청북도,영동군,70-74세,3333,1570,1763
202103,43740,충청북도,영동군,70-74세,3308,1550,1758
202104,43740,충청북도,영동군,70-74세,3316,1560,1756
202105,43740,충청북도,영동군,70-74세,3301,1549,1752
202106,43740,충청북도,영동군,70-74세,3274,1532,1742
202007,43740,충청북도,영동군,75-79세,3270,1329,1941
202008,43740,충청북도,영동군,75-79세,3275,1334,1941
202009,43740,충청북도,영동군,75-79세,3270,1328,1942
202010,43740,충청북도,영동군,75-79세,3262,1329,1933
202011,43740,충청북도,영동군,75-79세,3232,1316,1916
202012,43740,충청북도,영동군,75-79세,3209,1307,1902
202101,43740,충청북도,영동군,75-79세,3201,1312,1889
202102,43740,충청북도,영동군,75-79세,3185,1299,1886
202103,43740,충청북도,영동군,75-79세,3144,1283,1861
202104,43740,충청북도,영동군,75-79세,3120,1279,1841
202105,43740,충청북도,영동군,75-79세,3110,1281,1829
202106,43740,충청북도,영동군,75-79세,3114,1288,1826
202007,43740,충청북도,영동군,80-84세,2586,942,1644
202008,43740,충청북도,영동군,80-84세,2571,937,1634
202009,43740,충청북도,영동군,80-84세,2562,937,1625
202010,43740,충청북도,영동군,80-84세,2550,929,1621
202011,43740,충청북도,영동군,80-84세,2545,931,1614
202012,43740,충청북도,영동군,80-84세,2542,938,1604
202101,43740,충청북도,영동군,80-84세,2529,922,1607
202102,43740,충청북도,영동군,80-84세,2533,932,1601
202103,43740,충청북도,영동군,80-84세,2531,929,1602
202104,43740,충청북도,영동군,80-84세,2526,932,1594
202105,43740,충청북도,영동군,80-84세,2538,933,1605
202106,43740,충청북도,영동군,80-84세,2542,934,1608
202007,43740,충청북도,영동군,85-89세,1281,394,887
202008,43740,충청북도,영동군,85-89세,1300,397,903
202009,43740,충청북도,영동군,85-89세,1308,396,912
202010,43740,충청북도,영동군,85-89세,1320,396,924
202011,43740,충청북도,영동군,85-89세,1340,404,936
202012,43740,충청북도,영동군,85-89세,1359,411,948
202101,43740,충청북도,영동군,85-89세,1364,414,950
202102,43740,충청북도,영동군,85-89세,1373,413,960
202103,43740,충청북도,영동군,85-89세,1395,422,973
202104,43740,충청북도,영동군,85-89세,1405,424,981
202105,43740,충청북도,영동군,85-89세,1413,431,982
202106,43740,충청북도,영동군,85-89세,1411,427,984
202007,43740,충청북도,영동군,90-94세,438,102,336
202008,43740,충청북도,영동군,90-94세,435,103,332
202009,43740,충청북도,영동군,90-94세,428,105,323
202010,43740,충청북도,영동군,90-94세,428,104,324
202011,43740,충청북도,영동군,90-94세,429,101,328
202012,43740,충청북도,영동군,90-94세,427,99,328
202101,43740,충청북도,영동군,90-94세,431,102,329
202102,43740,충청북도,영동군,90-94세,436,103,333
202103,43740,충청북도,영동군,90-94세,419,96,323
202104,43740,충청북도,영동군,90-94세,425,97,328
202105,43740,충청북도,영동군,90-94세,428,99,329
202106,43740,충청북도,영동군,90-94세,426,99,327
202007,43740,충청북도,영동군,95-99세,99,23,76
202008,43740,충청북도,영동군,95-99세,96,22,74
202009,43740,충청북도,영동군,95-99세,101,24,77
202010,43740,충청북도,영동군,95-99세,103,25,78
202011,43740,충청북도,영동군,95-99세,102,26,76
202012,43740,충청북도,영동군,95-99세,97,21,76
202101,43740,충청북도,영동군,95-99세,95,18,77
202102,43740,충청북도,영동군,95-99세,101,21,80
202103,43740,충청북도,영동군,95-99세,96,17,79
202104,43740,충청북도,영동군,95-99세,95,17,78
202105,43740,충청북도,영동군,95-99세,96,17,79
202106,43740,충청북도,영동군,95-99세,100,17,83
202007,43740,충청북도,영동군,100+,36,10,26
202008,43740,충청북도,영동군,100+,38,11,27
202009,43740,충청북도,영동군,100+,38,11,27
202010,43740,충청북도,영동군,100+,38,11,27
202011,43740,충청북도,영동군,100+,39,11,28
202012,43740,충청북도,영동군,100+,40,11,29
202101,43740,충청북도,영동군,100+,40,11,29
202102,43740,충청북도,영동군,100+,40,11,29
202103,43740,충청북도,영동군,100+,13,2,11
202104,43740,충청북도,영동군,100+,12,2,10
202105,43740,충청북도,영동군,100+,13,3,10
202106,43740,충청북도,영동군,100+,13,3,10
202007,43745,충청북도,증평군,0-4세,1506,788,718
202008,43745,충청북도,증평군,0-4세,1498,795,703
202009,43745,충청북도,증평군,0-4세,1485,779,706
202010,43745,충청북도,증평군,0-4세,1458,760,698
202011,43745,충청북도,증평군,0-4세,1441,761,680
202012,43745,충청북도,증평군,0-4세,1424,753,671
202101,43745,충청북도,증평군,0-4세,1382,725,657
202102,43745,충청북도,증평군,0-4세,1360,713,647
202103,43745,충청북도,증평군,0-4세,1353,717,636
202104,43745,충청북도,증평군,0-4세,1347,716,631
202105,43745,충청북도,증평군,0-4세,1329,703,626
202106,43745,충청북도,증평군,0-4세,1301,687,614
202007,43745,충청북도,증평군,5-9세,1918,964,954
202008,43745,충청북도,증평군,5-9세,1909,959,950
202009,43745,충청북도,증평군,5-9세,1900,961,939
202010,43745,충청북도,증평군,5-9세,1869,950,919
202011,43745,충청북도,증평군,5-9세,1854,941,913
202012,43745,충청북도,증평군,5-9세,1818,926,892
202101,43745,충청북도,증평군,5-9세,1817,922,895
202102,43745,충청북도,증평군,5-9세,1786,909,877
202103,43745,충청북도,증평군,5-9세,1789,910,879
202104,43745,충청북도,증평군,5-9세,1770,905,865
202105,43745,충청북도,증평군,5-9세,1759,902,857
202106,43745,충청북도,증평군,5-9세,1761,903,858
202007,43745,충청북도,증평군,10-14세,1713,898,815
202008,43745,충청북도,증평군,10-14세,1719,902,817
202009,43745,충청북도,증평군,10-14세,1707,894,813
202010,43745,충청북도,증평군,10-14세,1712,891,821
202011,43745,충청북도,증평군,10-14세,1722,893,829
202012,43745,충청북도,증평군,10-14세,1721,893,828
202101,43745,충청북도,증평군,10-14세,1742,903,839
202102,43745,충청북도,증평군,10-14세,1747,911,836
202103,43745,충청북도,증평군,10-14세,1751,912,839
202104,43745,충청북도,증평군,10-14세,1754,907,847
202105,43745,충청북도,증평군,10-14세,1761,910,851
202106,43745,충청북도,증평군,10-14세,1762,913,849
202007,43745,충청북도,증평군,15-19세,1702,874,828
202008,43745,충청북도,증평군,15-19세,1687,868,819
202009,43745,충청북도,증평군,15-19세,1673,872,801
202010,43745,충청북도,증평군,15-19세,1664,866,798
202011,43745,충청북도,증평군,15-19세,1649,860,789
202012,43745,충청북도,증평군,15-19세,1627,846,781
202101,43745,충청북도,증평군,15-19세,1611,837,774
202102,43745,충청북도,증평군,15-19세,1602,833,769
202103,43745,충청북도,증평군,15-19세,1598,834,764
202104,43745,충청북도,증평군,15-19세,1590,841,749
202105,43745,충청북도,증평군,15-19세,1582,839,743
202106,43745,충청북도,증평군,15-19세,1579,836,743
202007,43745,충청북도,증평군,20-24세,2159,1178,981
202008,43745,충청북도,증평군,20-24세,2156,1174,982
202009,43745,충청북도,증평군,20-24세,2156,1176,980
202010,43745,충청북도,증평군,20-24세,2150,1180,970
202011,43745,충청북도,증평군,20-24세,2139,1184,955
202012,43745,충청북도,증평군,20-24세,2122,1179,943
202101,43745,충청북도,증평군,20-24세,2131,1182,949
202102,43745,충청북도,증평군,20-24세,2124,1179,945
202103,43745,충청북도,증평군,20-24세,2100,1167,933
202104,43745,충청북도,증평군,20-24세,2084,1154,930
202105,43745,충청북도,증평군,20-24세,2086,1157,929
202106,43745,충청북도,증평군,20-24세,2097,1172,925
202007,43745,충청북도,증평군,25-29세,2367,1446,921
202008,43745,충청북도,증평군,25-29세,2366,1454,912
202009,43745,충청북도,증평군,25-29세,2388,1458,930
202010,43745,충청북도,증평군,25-29세,2384,1451,933
202011,43745,충청북도,증평군,25-29세,2394,1459,935
202012,43745,충청북도,증평군,25-29세,2394,1455,939
202101,43745,충청북도,증평군,25-29세,2381,1450,931
202102,43745,충청북도,증평군,25-29세,2359,1437,922
202103,43745,충청북도,증평군,25-29세,2353,1441,912
202104,43745,충청북도,증평군,25-29세,2358,1447,911
202105,43745,충청북도,증평군,25-29세,2349,1440,909
202106,43745,충청북도,증평군,25-29세,2352,1445,907
202007,43745,충청북도,증평군,30-34세,2178,1218,960
202008,43745,충청북도,증평군,30-34세,2169,1218,951
202009,43745,충청북도,증평군,30-34세,2165,1211,954
202010,43745,충청북도,증평군,30-34세,2161,1209,952
202011,43745,충청북도,증평군,30-34세,2162,1210,952
202012,43745,충청북도,증평군,30-34세,2173,1212,961
202101,43745,충청북도,증평군,30-34세,2162,1214,948
202102,43745,충청북도,증평군,30-34세,2123,1196,927
202103,43745,충청북도,증평군,30-34세,2088,1176,912
202104,43745,충청북도,증평군,30-34세,2089,1173,916
202105,43745,충청북도,증평군,30-34세,2080,1159,921
202106,43745,충청북도,증평군,30-34세,2038,1133,905
202007,43745,충청북도,증평군,35-39세,2664,1461,1203
202008,43745,충청북도,증평군,35-39세,2650,1455,1195
202009,43745,충청북도,증평군,35-39세,2650,1455,1195
202010,43745,충청북도,증평군,35-39세,2642,1461,1181
202011,43745,충청북도,증평군,35-39세,2614,1444,1170
202012,43745,충청북도,증평군,35-39세,2580,1432,1148
202101,43745,충청북도,증평군,35-39세,2563,1423,1140
202102,43745,충청북도,증평군,35-39세,2537,1405,1132
202103,43745,충청북도,증평군,35-39세,2529,1400,1129
202104,43745,충청북도,증평군,35-39세,2519,1396,1123
202105,43745,충청북도,증평군,35-39세,2500,1387,1113
202106,43745,충청북도,증평군,35-39세,2475,1365,1110
202007,43745,충청북도,증평군,40-44세,2714,1467,1247
202008,43745,충청북도,증평군,40-44세,2708,1453,1255
202009,43745,충청북도,증평군,40-44세,2712,1455,1257
202010,43745,충청북도,증평군,40-44세,2707,1457,1250
202011,43745,충청북도,증평군,40-44세,2712,1447,1265
202012,43745,충청북도,증평군,40-44세,2688,1440,1248
202101,43745,충청북도,증평군,40-44세,2695,1440,1255
202102,43745,충청북도,증평군,40-44세,2688,1447,1241
202103,43745,충청북도,증평군,40-44세,2675,1438,1237
202104,43745,충청북도,증평군,40-44세,2660,1420,1240
202105,43745,충청북도,증평군,40-44세,2683,1436,1247
202106,43745,충청북도,증평군,40-44세,2692,1447,1245
202007,43745,충청북도,증평군,45-49세,2995,1633,1362
202008,43745,충청북도,증평군,45-49세,2980,1630,1350
202009,43745,충청북도,증평군,45-49세,2957,1618,1339
202010,43745,충청북도,증평군,45-49세,2924,1599,1325
202011,43745,충청북도,증평군,45-49세,2910,1600,1310
202012,43745,충청북도,증평군,45-49세,2902,1579,1323
202101,43745,충청북도,증평군,45-49세,2885,1568,1317
202102,43745,충청북도,증평군,45-49세,2884,1568,1316
202103,43745,충청북도,증평군,45-49세,2861,1543,1318
202104,43745,충청북도,증평군,45-49세,2867,1557,1310
202105,43745,충청북도,증평군,45-49세,2854,1555,1299
202106,43745,충청북도,증평군,45-49세,2839,1545,1294
202007,43745,충청북도,증평군,50-54세,3113,1651,1462
202008,43745,충청북도,증평군,50-54세,3132,1656,1476
202009,43745,충청북도,증평군,50-54세,3117,1653,1464
202010,43745,충청북도,증평군,50-54세,3111,1642,1469
202011,43745,충청북도,증평군,50-54세,3149,1650,1499
202012,43745,충청북도,증평군,50-54세,3089,1635,1454
202101,43745,충청북도,증평군,50-54세,3109,1644,1465
202102,43745,충청북도,증평군,50-54세,3116,1647,1469
202103,43745,충청북도,증평군,50-54세,3086,1637,1449
202104,43745,충청북도,증평군,50-54세,3093,1636,1457
202105,43745,충청북도,증평군,50-54세,3113,1643,1470
202106,43745,충청북도,증평군,50-54세,3129,1655,1474
202007,43745,충청북도,증평군,55-59세,2959,1550,1409
202008,43745,충청북도,증평군,55-59세,2941,1540,1401
202009,43745,충청북도,증평군,55-59세,2955,1550,1405
202010,43745,충청북도,증평군,55-59세,2944,1553,1391
202011,43745,충청북도,증평군,55-59세,2908,1535,1373
202012,43745,충청북도,증평군,55-59세,2925,1527,1398
202101,43745,충청북도,증평군,55-59세,2921,1537,1384
202102,43745,충청북도,증평군,55-59세,2926,1539,1387
202103,43745,충청북도,증평군,55-59세,2906,1533,1373
202104,43745,충청북도,증평군,55-59세,2892,1526,1366
202105,43745,충청북도,증평군,55-59세,2869,1518,1351
202106,43745,충청북도,증평군,55-59세,2865,1512,1353
202007,43745,충청북도,증평군,60-64세,2856,1462,1394
202008,43745,충청북도,증평군,60-64세,2866,1466,1400
202009,43745,충청북도,증평군,60-64세,2887,1466,1421
202010,43745,충청북도,증평군,60-64세,2903,1473,1430
202011,43745,충청북도,증평군,60-64세,2915,1481,1434
202012,43745,충청북도,증평군,60-64세,2928,1490,1438
202101,43745,충청북도,증평군,60-64세,2945,1491,1454
202102,43745,충청북도,증평군,60-64세,2938,1487,1451
202103,43745,충청북도,증평군,60-64세,2946,1499,1447
202104,43745,충청북도,증평군,60-64세,2983,1526,1457
202105,43745,충청북도,증평군,60-64세,3025,1548,1477
202106,43745,충청북도,증평군,60-64세,3035,1557,1478
202007,43745,충청북도,증평군,65-69세,2015,989,1026
202008,43745,충청북도,증평군,65-69세,2032,995,1037
202009,43745,충청북도,증평군,65-69세,2031,997,1034
202010,43745,충청북도,증평군,65-69세,2052,1001,1051
202011,43745,충청북도,증평군,65-69세,2059,1007,1052
202012,43745,충청북도,증평군,65-69세,2062,1009,1053
202101,43745,충청북도,증평군,65-69세,2080,1020,1060
202102,43745,충청북도,증평군,65-69세,2122,1043,1079
202103,43745,충청북도,증평군,65-69세,2144,1043,1101
202104,43745,충청북도,증평군,65-69세,2172,1056,1116
202105,43745,충청북도,증평군,65-69세,2189,1064,1125
202106,43745,충청북도,증평군,65-69세,2205,1080,1125
202007,43745,충청북도,증평군,70-74세,1374,669,705
202008,43745,충청북도,증평군,70-74세,1370,664,706
202009,43745,충청북도,증평군,70-74세,1393,679,714
202010,43745,충청북도,증평군,70-74세,1376,670,706
202011,43745,충청북도,증평군,70-74세,1383,665,718
202012,43745,충청북도,증평군,70-74세,1403,679,724
202101,43745,충청북도,증평군,70-74세,1420,690,730
202102,43745,충청북도,증평군,70-74세,1413,682,731
202103,43745,충청북도,증평군,70-74세,1413,686,727
202104,43745,충청북도,증평군,70-74세,1412,685,727
202105,43745,충청북도,증평군,70-74세,1418,686,732
202106,43745,충청북도,증평군,70-74세,1428,690,738
202007,43745,충청북도,증평군,75-79세,1294,513,781
202008,43745,충청북도,증평군,75-79세,1310,528,782
202009,43745,충청북도,증평군,75-79세,1299,519,780
202010,43745,충청북도,증평군,75-79세,1300,525,775
202011,43745,충청북도,증평군,75-79세,1292,535,757
202012,43745,충청북도,증평군,75-79세,1274,522,752
202101,43745,충청북도,증평군,75-79세,1271,523,748
202102,43745,충청북도,증평군,75-79세,1272,526,746
202103,43745,충청북도,증평군,75-79세,1259,518,741
202104,43745,충청북도,증평군,75-79세,1249,514,735
202105,43745,충청북도,증평군,75-79세,1246,519,727
202106,43745,충청북도,증평군,75-79세,1238,515,723
202007,43745,충청북도,증평군,80-84세,977,374,603
202008,43745,충청북도,증평군,80-84세,979,375,604
202009,43745,충청북도,증평군,80-84세,973,374,599
202010,43745,충청북도,증평군,80-84세,972,371,601
202011,43745,충청북도,증평군,80-84세,969,371,598
202012,43745,충청북도,증평군,80-84세,972,375,597
202101,43745,충청북도,증평군,80-84세,971,372,599
202102,43745,충청북도,증평군,80-84세,968,375,593
202103,43745,충청북도,증평군,80-84세,970,373,597
202104,43745,충청북도,증평군,80-84세,970,379,591
202105,43745,충청북도,증평군,80-84세,969,375,594
202106,43745,충청북도,증평군,80-84세,978,380,598
202007,43745,충청북도,증평군,85-89세,486,118,368
202008,43745,충청북도,증평군,85-89세,485,118,367
202009,43745,충청북도,증평군,85-89세,490,118,372
202010,43745,충청북도,증평군,85-89세,495,120,375
202011,43745,충청북도,증평군,85-89세,502,123,379
202012,43745,충청북도,증평군,85-89세,519,128,391
202101,43745,충청북도,증평군,85-89세,530,135,395
202102,43745,충청북도,증평군,85-89세,530,134,396
202103,43745,충청북도,증평군,85-89세,537,138,399
202104,43745,충청북도,증평군,85-89세,543,137,406
202105,43745,충청북도,증평군,85-89세,544,136,408
202106,43745,충청북도,증평군,85-89세,544,139,405
202007,43745,충청북도,증평군,90-94세,135,38,97
202008,43745,충청북도,증평군,90-94세,137,38,99
202009,43745,충청북도,증평군,90-94세,140,38,102
202010,43745,충청북도,증평군,90-94세,144,40,104
202011,43745,충청북도,증평군,90-94세,143,39,104
202012,43745,충청북도,증평군,90-94세,144,39,105
202101,43745,충청북도,증평군,90-94세,148,39,109
202102,43745,충청북도,증평군,90-94세,144,38,106
202103,43745,충청북도,증평군,90-94세,140,38,102
202104,43745,충청북도,증평군,90-94세,142,41,101
202105,43745,충청북도,증평군,90-94세,142,41,101
202106,43745,충청북도,증평군,90-94세,143,38,105
202007,43745,충청북도,증평군,95-99세,30,7,23
202008,43745,충청북도,증평군,95-99세,31,7,24
202009,43745,충청북도,증평군,95-99세,32,6,26
202010,43745,충청북도,증평군,95-99세,31,6,25
202011,43745,충청북도,증평군,95-99세,32,6,26
202012,43745,충청북도,증평군,95-99세,32,6,26
202101,43745,충청북도,증평군,95-99세,33,6,27
202102,43745,충청북도,증평군,95-99세,36,7,29
202103,43745,충청북도,증평군,95-99세,35,6,29
202104,43745,충청북도,증평군,95-99세,35,5,30
202105,43745,충청북도,증평군,95-99세,35,5,30
202106,43745,충청북도,증평군,95-99세,34,5,29
202007,43745,충청북도,증평군,100+,11,3,8
202008,43745,충청북도,증평군,100+,11,3,8
202009,43745,충청북도,증평군,100+,12,4,8
202010,43745,충청북도,증평군,100+,12,4,8
202011,43745,충청북도,증평군,100+,11,4,7
202012,43745,충청북도,증평군,100+,10,4,6
202101,43745,충청북도,증평군,100+,10,4,6
202102,43745,충청북도,증평군,100+,10,4,6
202103,43745,충청북도,증평군,100+,3,2,1
202104,43745,충청북도,증평군,100+,3,2,1
202105,43745,충청북도,증평군,100+,3,2,1
202106,43745,충청북도,증평군,100+,4,2,2
202007,43750,충청북도,진천군,0-4세,3367,1749,1618
202008,43750,충청북도,진천군,0-4세,3351,1740,1611
202009,43750,충청북도,진천군,0-4세,3343,1739,1604
202010,43750,충청북도,진천군,0-4세,3384,1760,1624
202011,43750,충청북도,진천군,0-4세,3392,1772,1620
202012,43750,충청북도,진천군,0-4세,3360,1755,1605
202101,43750,충청북도,진천군,0-4세,3346,1757,1589
202102,43750,충청북도,진천군,0-4세,3333,1757,1576
202103,43750,충청북도,진천군,0-4세,3302,1734,1568
202104,43750,충청북도,진천군,0-4세,3267,1723,1544
202105,43750,충청북도,진천군,0-4세,3251,1720,1531
202106,43750,충청북도,진천군,0-4세,3248,1711,1537
202007,43750,충청북도,진천군,5-9세,4246,2181,2065
202008,43750,충청북도,진천군,5-9세,4241,2174,2067
202009,43750,충청북도,진천군,5-9세,4282,2196,2086
202010,43750,충청북도,진천군,5-9세,4334,2206,2128
202011,43750,충청북도,진천군,5-9세,4346,2217,2129
202012,43750,충청북도,진천군,5-9세,4368,2238,2130
202101,43750,충청북도,진천군,5-9세,4354,2227,2127
202102,43750,충청북도,진천군,5-9세,4373,2237,2136
202103,43750,충청북도,진천군,5-9세,4383,2240,2143
202104,43750,충청북도,진천군,5-9세,4367,2223,2144
202105,43750,충청북도,진천군,5-9세,4367,2219,2148
202106,43750,충청북도,진천군,5-9세,4351,2217,2134
202007,43750,충청북도,진천군,10-14세,4076,2096,1980
202008,43750,충청북도,진천군,10-14세,4103,2118,1985
202009,43750,충청북도,진천군,10-14세,4140,2151,1989
202010,43750,충청북도,진천군,10-14세,4155,2165,1990
202011,43750,충청북도,진천군,10-14세,4215,2192,2023
202012,43750,충청북도,진천군,10-14세,4239,2196,2043
202101,43750,충청북도,진천군,10-14세,4257,2211,2046
202102,43750,충청북도,진천군,10-14세,4282,2210,2072
202103,43750,충청북도,진천군,10-14세,4299,2220,2079
202104,43750,충청북도,진천군,10-14세,4320,2226,2094
202105,43750,충청북도,진천군,10-14세,4312,2219,2093
202106,43750,충청북도,진천군,10-14세,4326,2227,2099
202007,43750,충청북도,진천군,15-19세,3948,2101,1847
202008,43750,충청북도,진천군,15-19세,3934,2091,1843
202009,43750,충청북도,진천군,15-19세,3926,2078,1848
202010,43750,충청북도,진천군,15-19세,3926,2081,1845
202011,43750,충청북도,진천군,15-19세,3925,2077,1848
202012,43750,충청북도,진천군,15-19세,3853,2038,1815
202101,43750,충청북도,진천군,15-19세,3822,2024,1798
202102,43750,충청북도,진천군,15-19세,3806,2020,1786
202103,43750,충청북도,진천군,15-19세,3835,2033,1802
202104,43750,충청북도,진천군,15-19세,4002,2094,1908
202105,43750,충청북도,진천군,15-19세,4062,2133,1929
202106,43750,충청북도,진천군,15-19세,4058,2126,1932
202007,43750,충청북도,진천군,20-24세,4282,2411,1871
202008,43750,충청북도,진천군,20-24세,4243,2390,1853
202009,43750,충청북도,진천군,20-24세,4254,2393,1861
202010,43750,충청북도,진천군,20-24세,4313,2413,1900
202011,43750,충청북도,진천군,20-24세,4335,2433,1902
202012,43750,충청북도,진천군,20-24세,4300,2395,1905
202101,43750,충청북도,진천군,20-24세,4297,2411,1886
202102,43750,충청북도,진천군,20-24세,4315,2418,1897
202103,43750,충청북도,진천군,20-24세,4269,2400,1869
202104,43750,충청북도,진천군,20-24세,4285,2403,1882
202105,43750,충청북도,진천군,20-24세,4287,2408,1879
202106,43750,충청북도,진천군,20-24세,4265,2403,1862
202007,43750,충청북도,진천군,25-29세,4694,2771,1923
202008,43750,충청북도,진천군,25-29세,4702,2764,1938
202009,43750,충청북도,진천군,25-29세,4741,2798,1943
202010,43750,충청북도,진천군,25-29세,4844,2864,1980
202011,43750,충청북도,진천군,25-29세,4881,2887,1994
202012,43750,충청북도,진천군,25-29세,4926,2930,1996
202101,43750,충청북도,진천군,25-29세,4970,2932,2038
202102,43750,충청북도,진천군,25-29세,4946,2907,2039
202103,43750,충청북도,진천군,25-29세,4997,2950,2047
202104,43750,충청북도,진천군,25-29세,4988,2935,2053
202105,43750,충청북도,진천군,25-29세,4984,2948,2036
202106,43750,충청북도,진천군,25-29세,5004,2958,2046
202007,43750,충청북도,진천군,30-34세,4794,2688,2106
202008,43750,충청북도,진천군,30-34세,4802,2692,2110
202009,43750,충청북도,진천군,30-34세,4875,2723,2152
202010,43750,충청북도,진천군,30-34세,4930,2765,2165
202011,43750,충청북도,진천군,30-34세,4972,2790,2182
202012,43750,충청북도,진천군,30-34세,4953,2775,2178
202101,43750,충청북도,진천군,30-34세,4930,2775,2155
202102,43750,충청북도,진천군,30-34세,4974,2803,2171
202103,43750,충청북도,진천군,30-34세,4956,2799,2157
202104,43750,충청북도,진천군,30-34세,5001,2828,2173
202105,43750,충청북도,진천군,30-34세,5055,2864,2191
202106,43750,충청북도,진천군,30-34세,5089,2885,2204
202007,43750,충청북도,진천군,35-39세,6406,3432,2974
202008,43750,충청북도,진천군,35-39세,6387,3441,2946
202009,43750,충청북도,진천군,35-39세,6388,3447,2941
202010,43750,충청북도,진천군,35-39세,6488,3493,2995
202011,43750,충청북도,진천군,35-39세,6559,3520,3039
202012,43750,충청북도,진천군,35-39세,6566,3515,3051
202101,43750,충청북도,진천군,35-39세,6580,3541,3039
202102,43750,충청북도,진천군,35-39세,6580,3539,3041
202103,43750,충청북도,진천군,35-39세,6565,3540,3025
202104,43750,충청북도,진천군,35-39세,6535,3522,3013
202105,43750,충청북도,진천군,35-39세,6473,3494,2979
202106,43750,충청북도,진천군,35-39세,6418,3463,2955
202007,43750,충청북도,진천군,40-44세,6513,3545,2968
202008,43750,충청북도,진천군,40-44세,6528,3562,2966
202009,43750,충청북도,진천군,40-44세,6596,3590,3006
202010,43750,충청북도,진천군,40-44세,6713,3635,3078
202011,43750,충청북도,진천군,40-44세,6796,3681,3115
202012,43750,충청북도,진천군,40-44세,6808,3682,3126
202101,43750,충청북도,진천군,40-44세,6810,3673,3137
202102,43750,충청북도,진천군,40-44세,6828,3680,3148
202103,43750,충청북도,진천군,40-44세,6798,3652,3146
202104,43750,충청북도,진천군,40-44세,6789,3641,3148
202105,43750,충청북도,진천군,40-44세,6814,3642,3172
202106,43750,충청북도,진천군,40-44세,6889,3682,3207
202007,43750,충청북도,진천군,45-49세,6671,3685,2986
202008,43750,충청북도,진천군,45-49세,6687,3680,3007
202009,43750,충청북도,진천군,45-49세,6697,3689,3008
202010,43750,충청북도,진천군,45-49세,6687,3691,2996
202011,43750,충청북도,진천군,45-49세,6702,3695,3007
202012,43750,충청북도,진천군,45-49세,6754,3729,3025
202101,43750,충청북도,진천군,45-49세,6774,3747,3027
202102,43750,충청북도,진천군,45-49세,6798,3758,3040
202103,43750,충청북도,진천군,45-49세,6828,3781,3047
202104,43750,충청북도,진천군,45-49세,6854,3805,3049
202105,43750,충청북도,진천군,45-49세,6836,3801,3035
202106,43750,충청북도,진천군,45-49세,6792,3774,3018
202007,43750,충청북도,진천군,50-54세,6858,3777,3081
202008,43750,충청북도,진천군,50-54세,6868,3779,3089
202009,43750,충청북도,진천군,50-54세,6908,3799,3109
202010,43750,충청북도,진천군,50-54세,6973,3826,3147
202011,43750,충청북도,진천군,50-54세,7015,3838,3177
202012,43750,충청북도,진천군,50-54세,6977,3822,3155
202101,43750,충청북도,진천군,50-54세,7024,3837,3187
202102,43750,충청북도,진천군,50-54세,7047,3849,3198
202103,43750,충청북도,진천군,50-54세,7014,3837,3177
202104,43750,충청북도,진천군,50-54세,7042,3852,3190
202105,43750,충청북도,진천군,50-54세,7087,3884,3203
202106,43750,충청북도,진천군,50-54세,7150,3922,3228
202007,43750,충청북도,진천군,55-59세,6694,3644,3050
202008,43750,충청북도,진천군,55-59세,6740,3660,3080
202009,43750,충청북도,진천군,55-59세,6743,3657,3086
202010,43750,충청북도,진천군,55-59세,6742,3658,3084
202011,43750,충청북도,진천군,55-59세,6757,3677,3080
202012,43750,충청북도,진천군,55-59세,6756,3671,3085
202101,43750,충청북도,진천군,55-59세,6717,3652,3065
202102,43750,충청북도,진천군,55-59세,6705,3649,3056
202103,43750,충청북도,진천군,55-59세,6654,3633,3021
202104,43750,충청북도,진천군,55-59세,6612,3605,3007
202105,43750,충청북도,진천군,55-59세,6603,3601,3002
202106,43750,충청북도,진천군,55-59세,6578,3590,2988
202007,43750,충청북도,진천군,60-64세,5862,3062,2800
202008,43750,충청북도,진천군,60-64세,5854,3059,2795
202009,43750,충청북도,진천군,60-64세,5906,3089,2817
202010,43750,충청북도,진천군,60-64세,5962,3120,2842
202011,43750,충청북도,진천군,60-64세,6047,3160,2887
202012,43750,충청북도,진천군,60-64세,6096,3184,2912
202101,43750,충청북도,진천군,60-64세,6145,3216,2929
202102,43750,충청북도,진천군,60-64세,6229,3256,2973
202103,43750,충청북도,진천군,60-64세,6301,3290,3011
202104,43750,충청북도,진천군,60-64세,6404,3345,3059
202105,43750,충청북도,진천군,60-64세,6467,3380,3087
202106,43750,충청북도,진천군,60-64세,6537,3417,3120
202007,43750,충청북도,진천군,65-69세,4053,1989,2064
202008,43750,충청북도,진천군,65-69세,4101,2018,2083
202009,43750,충청북도,진천군,65-69세,4138,2041,2097
202010,43750,충청북도,진천군,65-69세,4194,2074,2120
202011,43750,충청북도,진천군,65-69세,4202,2073,2129
202012,43750,충청북도,진천군,65-69세,4258,2100,2158
202101,43750,충청북도,진천군,65-69세,4296,2118,2178
202102,43750,충청북도,진천군,65-69세,4350,2143,2207
202103,43750,충청북도,진천군,65-69세,4415,2187,2228
202104,43750,충청북도,진천군,65-69세,4456,2210,2246
202105,43750,충청북도,진천군,65-69세,4484,2224,2260
202106,43750,충청북도,진천군,65-69세,4497,2247,2250
202007,43750,충청북도,진천군,70-74세,2860,1418,1442
202008,43750,충청북도,진천군,70-74세,2858,1421,1437
202009,43750,충청북도,진천군,70-74세,2871,1430,1441
202010,43750,충청북도,진천군,70-74세,2897,1444,1453
202011,43750,충청북도,진천군,70-74세,2934,1466,1468
202012,43750,충청북도,진천군,70-74세,2958,1478,1480
202101,43750,충청북도,진천군,70-74세,2980,1485,1495
202102,43750,충청북도,진천군,70-74세,2989,1488,1501
202103,43750,충청북도,진천군,70-74세,2977,1485,1492
202104,43750,충청북도,진천군,70-74세,2972,1479,1493
202105,43750,충청북도,진천군,70-74세,2984,1488,1496
202106,43750,충청북도,진천군,70-74세,2975,1481,1494
202007,43750,충청북도,진천군,75-79세,2651,1081,1570
202008,43750,충청북도,진천군,75-79세,2643,1075,1568
202009,43750,충청북도,진천군,75-79세,2623,1071,1552
202010,43750,충청북도,진천군,75-79세,2612,1067,1545
202011,43750,충청북도,진천군,75-79세,2599,1059,1540
202012,43750,충청북도,진천군,75-79세,2574,1046,1528
202101,43750,충청북도,진천군,75-79세,2565,1047,1518
202102,43750,충청북도,진천군,75-79세,2557,1048,1509
202103,43750,충청북도,진천군,75-79세,2530,1030,1500
202104,43750,충청북도,진천군,75-79세,2525,1037,1488
202105,43750,충청북도,진천군,75-79세,2524,1042,1482
202106,43750,충청북도,진천군,75-79세,2521,1045,1476
202007,43750,충청북도,진천군,80-84세,2304,861,1443
202008,43750,충청북도,진천군,80-84세,2305,867,1438
202009,43750,충청북도,진천군,80-84세,2294,863,1431
202010,43750,충청북도,진천군,80-84세,2290,863,1427
202011,43750,충청북도,진천군,80-84세,2284,859,1425
202012,43750,충청북도,진천군,80-84세,2291,863,1428
202101,43750,충청북도,진천군,80-84세,2282,862,1420
202102,43750,충청북도,진천군,80-84세,2275,865,1410
202103,43750,충청북도,진천군,80-84세,2274,868,1406
202104,43750,충청북도,진천군,80-84세,2267,867,1400
202105,43750,충청북도,진천군,80-84세,2267,869,1398
202106,43750,충청북도,진천군,80-84세,2283,868,1415
202007,43750,충청북도,진천군,85-89세,1115,300,815
202008,43750,충청북도,진천군,85-89세,1122,296,826
202009,43750,충청북도,진천군,85-89세,1156,303,853
202010,43750,충청북도,진천군,85-89세,1166,307,859
202011,43750,충청북도,진천군,85-89세,1181,316,865
202012,43750,충청북도,진천군,85-89세,1196,327,869
202101,43750,충청북도,진천군,85-89세,1208,328,880
202102,43750,충청북도,진천군,85-89세,1228,329,899
202103,43750,충청북도,진천군,85-89세,1232,334,898
202104,43750,충청북도,진천군,85-89세,1253,341,912
202105,43750,충청북도,진천군,85-89세,1264,346,918
202106,43750,충청북도,진천군,85-89세,1272,351,921
202007,43750,충청북도,진천군,90-94세,372,73,299
202008,43750,충청북도,진천군,90-94세,378,75,303
202009,43750,충청북도,진천군,90-94세,378,74,304
202010,43750,충청북도,진천군,90-94세,376,72,304
202011,43750,충청북도,진천군,90-94세,375,72,303
202012,43750,충청북도,진천군,90-94세,380,74,306
202101,43750,충청북도,진천군,90-94세,388,75,313
202102,43750,충청북도,진천군,90-94세,396,75,321
202103,43750,충청북도,진천군,90-94세,394,74,320
202104,43750,충청북도,진천군,90-94세,404,78,326
202105,43750,충청북도,진천군,90-94세,410,79,331
202106,43750,충청북도,진천군,90-94세,401,77,324
202007,43750,충청북도,진천군,95-99세,80,12,68
202008,43750,충청북도,진천군,95-99세,83,14,69
202009,43750,충청북도,진천군,95-99세,84,13,71
202010,43750,충청북도,진천군,95-99세,85,13,72
202011,43750,충청북도,진천군,95-99세,84,13,71
202012,43750,충청북도,진천군,95-99세,85,13,72
202101,43750,충청북도,진천군,95-99세,85,14,71
202102,43750,충청북도,진천군,95-99세,86,14,72
202103,43750,충청북도,진천군,95-99세,82,11,71
202104,43750,충청북도,진천군,95-99세,82,11,71
202105,43750,충청북도,진천군,95-99세,80,12,68
202106,43750,충청북도,진천군,95-99세,79,12,67
202007,43750,충청북도,진천군,100+,19,4,15
202008,43750,충청북도,진천군,100+,19,4,15
202009,43750,충청북도,진천군,100+,19,5,14
202010,43750,충청북도,진천군,100+,19,5,14
202011,43750,충청북도,진천군,100+,20,5,15
202012,43750,충청북도,진천군,100+,20,5,15
202101,43750,충청북도,진천군,100+,19,5,14
202102,43750,충청북도,진천군,100+,19,5,14
202103,43750,충청북도,진천군,100+,13,3,10
202104,43750,충청북도,진천군,100+,12,3,9
202105,43750,충청북도,진천군,100+,12,3,9
202106,43750,충청북도,진천군,100+,13,3,10
202007,43760,충청북도,괴산군,0-4세,532,281,251
202008,43760,충청북도,괴산군,0-4세,525,279,246
202009,43760,충청북도,괴산군,0-4세,522,279,243
202010,43760,충청북도,괴산군,0-4세,517,281,236
202011,43760,충청북도,괴산군,0-4세,517,277,240
202012,43760,충청북도,괴산군,0-4세,538,290,248
202101,43760,충청북도,괴산군,0-4세,508,274,234
202102,43760,충청북도,괴산군,0-4세,505,266,239
202103,43760,충청북도,괴산군,0-4세,504,268,236
202104,43760,충청북도,괴산군,0-4세,499,261,238
202105,43760,충청북도,괴산군,0-4세,506,264,242
202106,43760,충청북도,괴산군,0-4세,492,251,241
202007,43760,충청북도,괴산군,5-9세,744,369,375
202008,43760,충청북도,괴산군,5-9세,741,363,378
202009,43760,충청북도,괴산군,5-9세,745,363,382
202010,43760,충청북도,괴산군,5-9세,765,368,397
202011,43760,충청북도,괴산군,5-9세,771,367,404
202012,43760,충청북도,괴산군,5-9세,808,385,423
202101,43760,충청북도,괴산군,5-9세,787,376,411
202102,43760,충청북도,괴산군,5-9세,797,381,416
202103,43760,충청북도,괴산군,5-9세,787,379,408
202104,43760,충청북도,괴산군,5-9세,787,381,406
202105,43760,충청북도,괴산군,5-9세,774,383,391
202106,43760,충청북도,괴산군,5-9세,769,387,382
202007,43760,충청북도,괴산군,10-14세,909,430,479
202008,43760,충청북도,괴산군,10-14세,912,436,476
202009,43760,충청북도,괴산군,10-14세,915,437,478
202010,43760,충청북도,괴산군,10-14세,910,435,475
202011,43760,충청북도,괴산군,10-14세,922,451,471
202012,43760,충청북도,괴산군,10-14세,987,488,499
202101,43760,충청북도,괴산군,10-14세,945,461,484
202102,43760,충청북도,괴산군,10-14세,930,453,477
202103,43760,충청북도,괴산군,10-14세,928,451,477
202104,43760,충청북도,괴산군,10-14세,917,443,474
202105,43760,충청북도,괴산군,10-14세,923,444,479
202106,43760,충청북도,괴산군,10-14세,926,440,486
202007,43760,충청북도,괴산군,15-19세,1152,635,517
202008,43760,충청북도,괴산군,15-19세,1132,623,509
202009,43760,충청북도,괴산군,15-19세,1123,624,499
202010,43760,충청북도,괴산군,15-19세,1117,621,496
202011,43760,충청북도,괴산군,15-19세,1111,613,498
202012,43760,충청북도,괴산군,15-19세,1174,639,535
202101,43760,충청북도,괴산군,15-19세,1123,620,503
202102,43760,충청북도,괴산군,15-19세,1096,605,491
202103,43760,충청북도,괴산군,15-19세,1065,586,479
202104,43760,충청북도,괴산군,15-19세,1058,584,474
202105,43760,충청북도,괴산군,15-19세,1034,561,473
202106,43760,충청북도,괴산군,15-19세,1011,548,463
202007,43760,충청북도,괴산군,20-24세,1622,950,672
202008,43760,충청북도,괴산군,20-24세,1630,949,681
202009,43760,충청북도,괴산군,20-24세,1615,937,678
202010,43760,충청북도,괴산군,20-24세,1604,929,675
202011,43760,충청북도,괴산군,20-24세,1621,940,681
202012,43760,충청북도,괴산군,20-24세,1797,1036,761
202101,43760,충청북도,괴산군,20-24세,1651,961,690
202102,43760,충청북도,괴산군,20-24세,1580,919,661
202103,43760,충청북도,괴산군,20-24세,1513,885,628
202104,43760,충청북도,괴산군,20-24세,1482,861,621
202105,43760,충청북도,괴산군,20-24세,1459,845,614
202106,43760,충청북도,괴산군,20-24세,1454,839,615
202007,43760,충청북도,괴산군,25-29세,1274,773,501
202008,43760,충청북도,괴산군,25-29세,1275,771,504
202009,43760,충청북도,괴산군,25-29세,1285,787,498
202010,43760,충청북도,괴산군,25-29세,1279,782,497
202011,43760,충청북도,괴산군,25-29세,1326,810,516
202012,43760,충청북도,괴산군,25-29세,1511,920,591
202101,43760,충청북도,괴산군,25-29세,1411,861,550
202102,43760,충청북도,괴산군,25-29세,1383,841,542
202103,43760,충청북도,괴산군,25-29세,1378,844,534
202104,43760,충청북도,괴산군,25-29세,1359,831,528
202105,43760,충청북도,괴산군,25-29세,1336,812,524
202106,43760,충청북도,괴산군,25-29세,1300,786,514
202007,43760,충청북도,괴산군,30-34세,1098,632,466
202008,43760,충청북도,괴산군,30-34세,1083,629,454
202009,43760,충청북도,괴산군,30-34세,1088,630,458
202010,43760,충청북도,괴산군,30-34세,1095,631,464
202011,43760,충청북도,괴산군,30-34세,1113,636,477
202012,43760,충청북도,괴산군,30-34세,1189,675,514
202101,43760,충청북도,괴산군,30-34세,1137,648,489
202102,43760,충청북도,괴산군,30-34세,1104,629,475
202103,43760,충청북도,괴산군,30-34세,1086,619,467
202104,43760,충청북도,괴산군,30-34세,1071,614,457
202105,43760,충청북도,괴산군,30-34세,1068,616,452
202106,43760,충청북도,괴산군,30-34세,1062,617,445
202007,43760,충청북도,괴산군,35-39세,1349,749,600
202008,43760,충청북도,괴산군,35-39세,1328,729,599
202009,43760,충청북도,괴산군,35-39세,1327,723,604
202010,43760,충청북도,괴산군,35-39세,1328,723,605
202011,43760,충청북도,괴산군,35-39세,1328,731,597
202012,43760,충청북도,괴산군,35-39세,1441,791,650
202101,43760,충청북도,괴산군,35-39세,1356,755,601
202102,43760,충청북도,괴산군,35-39세,1331,740,591
202103,43760,충청북도,괴산군,35-39세,1310,736,574
202104,43760,충청북도,괴산군,35-39세,1298,733,565
202105,43760,충청북도,괴산군,35-39세,1285,726,559
202106,43760,충청북도,괴산군,35-39세,1269,716,553
202007,43760,충청북도,괴산군,40-44세,1593,882,711
202008,43760,충청북도,괴산군,40-44세,1609,895,714
202009,43760,충청북도,괴산군,40-44세,1615,901,714
202010,43760,충청북도,괴산군,40-44세,1615,898,717
202011,43760,충청북도,괴산군,40-44세,1635,904,731
202012,43760,충청북도,괴산군,40-44세,1736,969,767
202101,43760,충청북도,괴산군,40-44세,1656,923,733
202102,43760,충청북도,괴산군,40-44세,1630,912,718
202103,43760,충청북도,괴산군,40-44세,1599,898,701
202104,43760,충청북도,괴산군,40-44세,1591,885,706
202105,43760,충청북도,괴산군,40-44세,1588,878,710
202106,43760,충청북도,괴산군,40-44세,1590,877,713
202007,43760,충청북도,괴산군,45-49세,2280,1345,935
202008,43760,충청북도,괴산군,45-49세,2275,1342,933
202009,43760,충청북도,괴산군,45-49세,2253,1323,930
202010,43760,충청북도,괴산군,45-49세,2247,1320,927
202011,43760,충청북도,괴산군,45-49세,2211,1307,904
202012,43760,충청북도,괴산군,45-49세,2369,1389,980
202101,43760,충청북도,괴산군,45-49세,2274,1344,930
202102,43760,충청북도,괴산군,45-49세,2244,1325,919
202103,43760,충청북도,괴산군,45-49세,2196,1317,879
202104,43760,충청북도,괴산군,45-49세,2156,1293,863
202105,43760,충청북도,괴산군,45-49세,2123,1275,848
202106,43760,충청북도,괴산군,45-49세,2108,1260,848
202007,43760,충청북도,괴산군,50-54세,3200,1793,1407
202008,43760,충청북도,괴산군,50-54세,3204,1796,1408
202009,43760,충청북도,괴산군,50-54세,3204,1799,1405
202010,43760,충청북도,괴산군,50-54세,3208,1800,1408
202011,43760,충청북도,괴산군,50-54세,3249,1823,1426
202012,43760,충청북도,괴산군,50-54세,3394,1892,1502
202101,43760,충청북도,괴산군,50-54세,3244,1825,1419
202102,43760,충청북도,괴산군,50-54세,3196,1804,1392
202103,43760,충청북도,괴산군,50-54세,3139,1765,1374
202104,43760,충청북도,괴산군,50-54세,3115,1755,1360
202105,43760,충청북도,괴산군,50-54세,3112,1763,1349
202106,43760,충청북도,괴산군,50-54세,3098,1758,1340
202007,43760,충청북도,괴산군,55-59세,4124,2177,1947
202008,43760,충청북도,괴산군,55-59세,4092,2155,1937
202009,43760,충청북도,괴산군,55-59세,4092,2151,1941
202010,43760,충청북도,괴산군,55-59세,4085,2153,1932
202011,43760,충청북도,괴산군,55-59세,4105,2158,1947
202012,43760,충청북도,괴산군,55-59세,4296,2276,2020
202101,43760,충청북도,괴산군,55-59세,4158,2192,1966
202102,43760,충청북도,괴산군,55-59세,4099,2153,1946
202103,43760,충청북도,괴산군,55-59세,4058,2136,1922
202104,43760,충청북도,괴산군,55-59세,4026,2130,1896
202105,43760,충청북도,괴산군,55-59세,3976,2094,1882
202106,43760,충청북도,괴산군,55-59세,3949,2083,1866
202007,43760,충청북도,괴산군,60-64세,4704,2555,2149
202008,43760,충청북도,괴산군,60-64세,4742,2577,2165
202009,43760,충청북도,괴산군,60-64세,4758,2582,2176
202010,43760,충청북도,괴산군,60-64세,4795,2599,2196
202011,43760,충청북도,괴산군,60-64세,4823,2617,2206
202012,43760,충청북도,괴산군,60-64세,4996,2709,2287
202101,43760,충청북도,괴산군,60-64세,4975,2693,2282
202102,43760,충청북도,괴산군,60-64세,4969,2699,2270
202103,43760,충청북도,괴산군,60-64세,4991,2723,2268
202104,43760,충청북도,괴산군,60-64세,5052,2751,2301
202105,43760,충청북도,괴산군,60-64세,5069,2756,2313
202106,43760,충청북도,괴산군,60-64세,5106,2775,2331
202007,43760,충청북도,괴산군,65-69세,3629,1808,1821
202008,43760,충청북도,괴산군,65-69세,3639,1813,1826
202009,43760,충청북도,괴산군,65-69세,3656,1829,1827
202010,43760,충청북도,괴산군,65-69세,3679,1849,1830
202011,43760,충청북도,괴산군,65-69세,3720,1865,1855
202012,43760,충청북도,괴산군,65-69세,3831,1916,1915
202101,43760,충청북도,괴산군,65-69세,3816,1929,1887
202102,43760,충청북도,괴산군,65-69세,3846,1949,1897
202103,43760,충청북도,괴산군,65-69세,3883,1981,1902
202104,43760,충청북도,괴산군,65-69세,3896,1988,1908
202105,43760,충청북도,괴산군,65-69세,3931,2018,1913
202106,43760,충청북도,괴산군,65-69세,3946,2029,1917
202007,43760,충청북도,괴산군,70-74세,2702,1399,1303
202008,43760,충청북도,괴산군,70-74세,2714,1404,1310
202009,43760,충청북도,괴산군,70-74세,2718,1404,1314
202010,43760,충청북도,괴산군,70-74세,2740,1412,1328
202011,43760,충청북도,괴산군,70-74세,2748,1422,1326
202012,43760,충청북도,괴산군,70-74세,2815,1444,1371
202101,43760,충청북도,괴산군,70-74세,2812,1447,1365
202102,43760,충청북도,괴산군,70-74세,2836,1461,1375
202103,43760,충청북도,괴산군,70-74세,2820,1447,1373
202104,43760,충청북도,괴산군,70-74세,2836,1453,1383
202105,43760,충청북도,괴산군,70-74세,2829,1452,1377
202106,43760,충청북도,괴산군,70-74세,2819,1447,1372
202007,43760,충청북도,괴산군,75-79세,2727,1124,1603
202008,43760,충청북도,괴산군,75-79세,2704,1115,1589
202009,43760,충청북도,괴산군,75-79세,2702,1113,1589
202010,43760,충청북도,괴산군,75-79세,2688,1112,1576
202011,43760,충청북도,괴산군,75-79세,2676,1108,1568
202012,43760,충청북도,괴산군,75-79세,2692,1119,1573
202101,43760,충청북도,괴산군,75-79세,2650,1103,1547
202102,43760,충청북도,괴산군,75-79세,2598,1082,1516
202103,43760,충청북도,괴산군,75-79세,2583,1081,1502
202104,43760,충청북도,괴산군,75-79세,2563,1064,1499
202105,43760,충청북도,괴산군,75-79세,2539,1055,1484
202106,43760,충청북도,괴산군,75-79세,2523,1054,1469
202007,43760,충청북도,괴산군,80-84세,2133,810,1323
202008,43760,충청북도,괴산군,80-84세,2155,829,1326
202009,43760,충청북도,괴산군,80-84세,2147,830,1317
202010,43760,충청북도,괴산군,80-84세,2159,835,1324
202011,43760,충청북도,괴산군,80-84세,2171,841,1330
202012,43760,충청북도,괴산군,80-84세,2171,839,1332
202101,43760,충청북도,괴산군,80-84세,2186,842,1344
202102,43760,충청북도,괴산군,80-84세,2182,844,1338
202103,43760,충청북도,괴산군,80-84세,2166,834,1332
202104,43760,충청북도,괴산군,80-84세,2160,839,1321
202105,43760,충청북도,괴산군,80-84세,2187,846,1341
202106,43760,충청북도,괴산군,80-84세,2213,855,1358
202007,43760,충청북도,괴산군,85-89세,1117,325,792
202008,43760,충청북도,괴산군,85-89세,1123,320,803
202009,43760,충청북도,괴산군,85-89세,1127,321,806
202010,43760,충청북도,괴산군,85-89세,1136,325,811
202011,43760,충청북도,괴산군,85-89세,1149,330,819
202012,43760,충청북도,괴산군,85-89세,1166,338,828
202101,43760,충청북도,괴산군,85-89세,1170,340,830
202102,43760,충청북도,괴산군,85-89세,1203,353,850
202103,43760,충청북도,괴산군,85-89세,1218,360,858
202104,43760,충청북도,괴산군,85-89세,1230,364,866
202105,43760,충청북도,괴산군,85-89세,1228,364,864
202106,43760,충청북도,괴산군,85-89세,1228,363,865
202007,43760,충청북도,괴산군,90-94세,363,77,286
202008,43760,충청북도,괴산군,90-94세,364,82,282
202009,43760,충청북도,괴산군,90-94세,364,83,281
202010,43760,충청북도,괴산군,90-94세,365,84,281
202011,43760,충청북도,괴산군,90-94세,363,82,281
202012,43760,충청북도,괴산군,90-94세,370,84,286
202101,43760,충청북도,괴산군,90-94세,365,83,282
202102,43760,충청북도,괴산군,90-94세,369,81,288
202103,43760,충청북도,괴산군,90-94세,371,82,289
202104,43760,충청북도,괴산군,90-94세,380,81,299
202105,43760,충청북도,괴산군,90-94세,384,85,299
202106,43760,충청북도,괴산군,90-94세,384,83,301
202007,43760,충청북도,괴산군,95-99세,76,22,54
202008,43760,충청북도,괴산군,95-99세,79,22,57
202009,43760,충청북도,괴산군,95-99세,83,22,61
202010,43760,충청북도,괴산군,95-99세,85,22,63
202011,43760,충청북도,괴산군,95-99세,82,20,62
202012,43760,충청북도,괴산군,95-99세,82,18,64
202101,43760,충청북도,괴산군,95-99세,84,17,67
202102,43760,충청북도,괴산군,95-99세,82,16,66
202103,43760,충청북도,괴산군,95-99세,75,15,60
202104,43760,충청북도,괴산군,95-99세,73,14,59
202105,43760,충청북도,괴산군,95-99세,74,14,60
202106,43760,충청북도,괴산군,95-99세,72,14,58
202007,43760,충청북도,괴산군,100+,29,7,22
202008,43760,충청북도,괴산군,100+,28,7,21
202009,43760,충청북도,괴산군,100+,29,7,22
202010,43760,충청북도,괴산군,100+,30,7,23
202011,43760,충청북도,괴산군,100+,30,7,23
202012,43760,충청북도,괴산군,100+,30,8,22
202101,43760,충청북도,괴산군,100+,30,8,22
202102,43760,충청북도,괴산군,100+,29,8,21
202103,43760,충청북도,괴산군,100+,18,5,13
202104,43760,충청북도,괴산군,100+,18,5,13
202105,43760,충청북도,괴산군,100+,17,5,12
202106,43760,충청북도,괴산군,100+,18,5,13
202007,43770,충청북도,음성군,0-4세,2655,1355,1300
202008,43770,충청북도,음성군,0-4세,2618,1337,1281
202009,43770,충청북도,음성군,0-4세,2566,1307,1259
202010,43770,충청북도,음성군,0-4세,2518,1287,1231
202011,43770,충청북도,음성군,0-4세,2455,1255,1200
202012,43770,충청북도,음성군,0-4세,2410,1232,1178
202101,43770,충청북도,음성군,0-4세,2373,1212,1161
202102,43770,충청북도,음성군,0-4세,2332,1182,1150
202103,43770,충청북도,음성군,0-4세,2303,1164,1139
202104,43770,충청북도,음성군,0-4세,2277,1159,1118
202105,43770,충청북도,음성군,0-4세,2265,1152,1113
202106,43770,충청북도,음성군,0-4세,2239,1138,1101
202007,43770,충청북도,음성군,5-9세,3626,1919,1707
202008,43770,충청북도,음성군,5-9세,3616,1922,1694
202009,43770,충청북도,음성군,5-9세,3559,1892,1667
202010,43770,충청북도,음성군,5-9세,3534,1879,1655
202011,43770,충청북도,음성군,5-9세,3496,1852,1644
202012,43770,충청북도,음성군,5-9세,3484,1838,1646
202101,43770,충청북도,음성군,5-9세,3459,1831,1628
202102,43770,충청북도,음성군,5-9세,3424,1820,1604
202103,43770,충청북도,음성군,5-9세,3427,1825,1602
202104,43770,충청북도,음성군,5-9세,3424,1822,1602
202105,43770,충청북도,음성군,5-9세,3425,1818,1607
202106,43770,충청북도,음성군,5-9세,3414,1817,1597
202007,43770,충청북도,음성군,10-14세,3695,1917,1778
202008,43770,충청북도,음성군,10-14세,3686,1908,1778
202009,43770,충청북도,음성군,10-14세,3684,1895,1789
202010,43770,충청북도,음성군,10-14세,3670,1888,1782
202011,43770,충청북도,음성군,10-14세,3665,1892,1773
202012,43770,충청북도,음성군,10-14세,3658,1885,1773
202101,43770,충청북도,음성군,10-14세,3641,1867,1774
202102,43770,충청북도,음성군,10-14세,3656,1883,1773
202103,43770,충청북도,음성군,10-14세,3646,1884,1762
202104,43770,충청북도,음성군,10-14세,3655,1892,1763
202105,43770,충청북도,음성군,10-14세,3659,1907,1752
202106,43770,충청북도,음성군,10-14세,3663,1907,1756
202007,43770,충청북도,음성군,15-19세,4196,2198,1998
202008,43770,충청북도,음성군,15-19세,4179,2183,1996
202009,43770,충청북도,음성군,15-19세,4108,2148,1960
202010,43770,충청북도,음성군,15-19세,4049,2112,1937
202011,43770,충청북도,음성군,15-19세,4014,2087,1927
202012,43770,충청북도,음성군,15-19세,3989,2073,1916
202101,43770,충청북도,음성군,15-19세,3974,2069,1905
202102,43770,충청북도,음성군,15-19세,3918,2035,1883
202103,43770,충청북도,음성군,15-19세,3888,2020,1868
202104,43770,충청북도,음성군,15-19세,3839,2008,1831
202105,43770,충청북도,음성군,15-19세,3816,1987,1829
202106,43770,충청북도,음성군,15-19세,3831,1997,1834
202007,43770,충청북도,음성군,20-24세,4751,2722,2029
202008,43770,충청북도,음성군,20-24세,4721,2701,2020
202009,43770,충청북도,음성군,20-24세,4704,2701,2003
202010,43770,충청북도,음성군,20-24세,4712,2696,2016
202011,43770,충청북도,음성군,20-24세,4684,2672,2012
202012,43770,충청북도,음성군,20-24세,4688,2671,2017
202101,43770,충청북도,음성군,20-24세,4640,2643,1997
202102,43770,충청북도,음성군,20-24세,4606,2625,1981
202103,43770,충청북도,음성군,20-24세,4543,2570,1973
202104,43770,충청북도,음성군,20-24세,4531,2560,1971
202105,43770,충청북도,음성군,20-24세,4526,2553,1973
202106,43770,충청북도,음성군,20-24세,4516,2543,1973
202007,43770,충청북도,음성군,25-29세,4894,2912,1982
202008,43770,충청북도,음성군,25-29세,4866,2891,1975
202009,43770,충청북도,음성군,25-29세,4843,2884,1959
202010,43770,충청북도,음성군,25-29세,4820,2871,1949
202011,43770,충청북도,음성군,25-29세,4815,2864,1951
202012,43770,충청북도,음성군,25-29세,4812,2878,1934
202101,43770,충청북도,음성군,25-29세,4791,2860,1931
202102,43770,충청북도,음성군,25-29세,4762,2847,1915
202103,43770,충청북도,음성군,25-29세,4771,2869,1902
202104,43770,충청북도,음성군,25-29세,4767,2856,1911
202105,43770,충청북도,음성군,25-29세,4720,2807,1913
202106,43770,충청북도,음성군,25-29세,4738,2814,1924
202007,43770,충청북도,음성군,30-34세,4503,2600,1903
202008,43770,충청북도,음성군,30-34세,4472,2588,1884
202009,43770,충청북도,음성군,30-34세,4416,2549,1867
202010,43770,충청북도,음성군,30-34세,4397,2536,1861
202011,43770,충청북도,음성군,30-34세,4370,2528,1842
202012,43770,충청북도,음성군,30-34세,4328,2502,1826
202101,43770,충청북도,음성군,30-34세,4317,2492,1825
202102,43770,충청북도,음성군,30-34세,4258,2477,1781
202103,43770,충청북도,음성군,30-34세,4234,2465,1769
202104,43770,충청북도,음성군,30-34세,4243,2467,1776
202105,43770,충청북도,음성군,30-34세,4227,2461,1766
202106,43770,충청북도,음성군,30-34세,4225,2459,1766
202007,43770,충청북도,음성군,35-39세,5654,3082,2572
202008,43770,충청북도,음성군,35-39세,5607,3055,2552
202009,43770,충청북도,음성군,35-39세,5512,3011,2501
202010,43770,충청북도,음성군,35-39세,5452,2982,2470
202011,43770,충청북도,음성군,35-39세,5377,2943,2434
202012,43770,충청북도,음성군,35-39세,5346,2936,2410
202101,43770,충청북도,음성군,35-39세,5270,2878,2392
202102,43770,충청북도,음성군,35-39세,5223,2845,2378
202103,43770,충청북도,음성군,35-39세,5175,2815,2360
202104,43770,충청북도,음성군,35-39세,5107,2780,2327
202105,43770,충청북도,음성군,35-39세,5060,2757,2303
202106,43770,충청북도,음성군,35-39세,5028,2735,2293
202007,43770,충청북도,음성군,40-44세,6323,3499,2824
202008,43770,충청북도,음성군,40-44세,6329,3507,2822
202009,43770,충청북도,음성군,40-44세,6340,3517,2823
202010,43770,충청북도,음성군,40-44세,6307,3505,2802
202011,43770,충청북도,음성군,40-44세,6281,3484,2797
202012,43770,충청북도,음성군,40-44세,6236,3465,2771
202101,43770,충청북도,음성군,40-44세,6188,3426,2762
202102,43770,충청북도,음성군,40-44세,6178,3417,2761
202103,43770,충청북도,음성군,40-44세,6131,3391,2740
202104,43770,충청북도,음성군,40-44세,6122,3384,2738
202105,43770,충청북도,음성군,40-44세,6145,3400,2745
202106,43770,충청북도,음성군,40-44세,6147,3400,2747
202007,43770,충청북도,음성군,45-49세,7741,4397,3344
202008,43770,충청북도,음성군,45-49세,7745,4406,3339
202009,43770,충청북도,음성군,45-49세,7634,4349,3285
202010,43770,충청북도,음성군,45-49세,7588,4325,3263
202011,43770,충청북도,음성군,45-49세,7524,4294,3230
202012,43770,충청북도,음성군,45-49세,7529,4281,3248
202101,43770,충청북도,음성군,45-49세,7485,4261,3224
202102,43770,충청북도,음성군,45-49세,7436,4219,3217
202103,43770,충청북도,음성군,45-49세,7393,4199,3194
202104,43770,충청북도,음성군,45-49세,7379,4184,3195
202105,43770,충청북도,음성군,45-49세,7335,4152,3183
202106,43770,충청북도,음성군,45-49세,7283,4110,3173
202007,43770,충청북도,음성군,50-54세,8712,4895,3817
202008,43770,충청북도,음성군,50-54세,8703,4891,3812
202009,43770,충청북도,음성군,50-54세,8718,4900,3818
202010,43770,충청북도,음성군,50-54세,8706,4886,3820
202011,43770,충청북도,음성군,50-54세,8711,4878,3833
202012,43770,충청북도,음성군,50-54세,8674,4865,3809
202101,43770,충청북도,음성군,50-54세,8678,4869,3809
202102,43770,충청북도,음성군,50-54세,8678,4882,3796
202103,43770,충청북도,음성군,50-54세,8613,4850,3763
202104,43770,충청북도,음성군,50-54세,8600,4834,3766
202105,43770,충청북도,음성군,50-54세,8624,4843,3781
202106,43770,충청북도,음성군,50-54세,8631,4841,3790
202007,43770,충청북도,음성군,55-59세,9144,5021,4123
202008,43770,충청북도,음성군,55-59세,9127,5024,4103
202009,43770,충청북도,음성군,55-59세,9100,5021,4079
202010,43770,충청북도,음성군,55-59세,9090,5026,4064
202011,43770,충청북도,음성군,55-59세,9078,5033,4045
202012,43770,충청북도,음성군,55-59세,9064,5019,4045
202101,43770,충청북도,음성군,55-59세,9018,4996,4022
202102,43770,충청북도,음성군,55-59세,8962,4946,4016
202103,43770,충청북도,음성군,55-59세,8916,4924,3992
202104,43770,충청북도,음성군,55-59세,8873,4886,3987
202105,43770,충청북도,음성군,55-59세,8803,4852,3951
202106,43770,충청북도,음성군,55-59세,8740,4831,3909
202007,43770,충청북도,음성군,60-64세,8786,4722,4064
202008,43770,충청북도,음성군,60-64세,8810,4743,4067
202009,43770,충청북도,음성군,60-64세,8835,4755,4080
202010,43770,충청북도,음성군,60-64세,8867,4764,4103
202011,43770,충청북도,음성군,60-64세,8911,4794,4117
202012,43770,충청북도,음성군,60-64세,8957,4816,4141
202101,43770,충청북도,음성군,60-64세,9038,4870,4168
202102,43770,충청북도,음성군,60-64세,9129,4925,4204
202103,43770,충청북도,음성군,60-64세,9202,4973,4229
202104,43770,충청북도,음성군,60-64세,9292,5029,4263
202105,43770,충청북도,음성군,60-64세,9345,5058,4287
202106,43770,충청북도,음성군,60-64세,9427,5098,4329
202007,43770,충청북도,음성군,65-69세,5982,3101,2881
202008,43770,충청북도,음성군,65-69세,6060,3137,2923
202009,43770,충청북도,음성군,65-69세,6150,3176,2974
202010,43770,충청북도,음성군,65-69세,6195,3204,2991
202011,43770,충청북도,음성군,65-69세,6246,3213,3033
202012,43770,충청북도,음성군,65-69세,6298,3245,3053
202101,43770,충청북도,음성군,65-69세,6344,3269,3075
202102,43770,충청북도,음성군,65-69세,6401,3304,3097
202103,43770,충청북도,음성군,65-69세,6493,3361,3132
202104,43770,충청북도,음성군,65-69세,6556,3400,3156
202105,43770,충청북도,음성군,65-69세,6619,3431,3188
202106,43770,충청북도,음성군,65-69세,6682,3463,3219
202007,43770,충청북도,음성군,70-74세,4254,2104,2150
202008,43770,충청북도,음성군,70-74세,4245,2104,2141
202009,43770,충청북도,음성군,70-74세,4255,2121,2134
202010,43770,충청북도,음성군,70-74세,4289,2138,2151
202011,43770,충청북도,음성군,70-74세,4299,2140,2159
202012,43770,충청북도,음성군,70-74세,4301,2132,2169
202101,43770,충청북도,음성군,70-74세,4338,2146,2192
202102,43770,충청북도,음성군,70-74세,4356,2157,2199
202103,43770,충청북도,음성군,70-74세,4327,2145,2182
202104,43770,충청북도,음성군,70-74세,4333,2143,2190
202105,43770,충청북도,음성군,70-74세,4336,2137,2199
202106,43770,충청북도,음성군,70-74세,4337,2140,2197
202007,43770,충청북도,음성군,75-79세,4041,1799,2242
202008,43770,충청북도,음성군,75-79세,4038,1797,2241
202009,43770,충청북도,음성군,75-79세,3988,1777,2211
202010,43770,충청북도,음성군,75-79세,3981,1769,2212
202011,43770,충청북도,음성군,75-79세,3967,1773,2194
202012,43770,충청북도,음성군,75-79세,3929,1753,2176
202101,43770,충청북도,음성군,75-79세,3911,1757,2154
202102,43770,충청북도,음성군,75-79세,3891,1745,2146
202103,43770,충청북도,음성군,75-79세,3886,1741,2145
202104,43770,충청북도,음성군,75-79세,3848,1729,2119
202105,43770,충청북도,음성군,75-79세,3814,1713,2101
202106,43770,충청북도,음성군,75-79세,3809,1714,2095
202007,43770,충청북도,음성군,80-84세,2996,1098,1898
202008,43770,충청북도,음성군,80-84세,2991,1097,1894
202009,43770,충청북도,음성군,80-84세,3012,1104,1908
202010,43770,충청북도,음성군,80-84세,2996,1095,1901
202011,43770,충청북도,음성군,80-84세,2998,1085,1913
202012,43770,충청북도,음성군,80-84세,2994,1096,1898
202101,43770,충청북도,음성군,80-84세,3003,1098,1905
202102,43770,충청북도,음성군,80-84세,3027,1115,1912
202103,43770,충청북도,음성군,80-84세,3016,1114,1902
202104,43770,충청북도,음성군,80-84세,3044,1132,1912
202105,43770,충청북도,음성군,80-84세,3028,1123,1905
202106,43770,충청북도,음성군,80-84세,3038,1128,1910
202007,43770,충청북도,음성군,85-89세,1616,461,1155
202008,43770,충청북도,음성군,85-89세,1620,465,1155
202009,43770,충청북도,음성군,85-89세,1629,471,1158
202010,43770,충청북도,음성군,85-89세,1637,479,1158
202011,43770,충청북도,음성군,85-89세,1646,484,1162
202012,43770,충청북도,음성군,85-89세,1675,491,1184
202101,43770,충청북도,음성군,85-89세,1690,497,1193
202102,43770,충청북도,음성군,85-89세,1693,498,1195
202103,43770,충청북도,음성군,85-89세,1690,495,1195
202104,43770,충청북도,음성군,85-89세,1705,496,1209
202105,43770,충청북도,음성군,85-89세,1727,500,1227
202106,43770,충청북도,음성군,85-89세,1739,504,1235
202007,43770,충청북도,음성군,90-94세,559,129,430
202008,43770,충청북도,음성군,90-94세,555,129,426
202009,43770,충청북도,음성군,90-94세,568,133,435
202010,43770,충청북도,음성군,90-94세,576,136,440
202011,43770,충청북도,음성군,90-94세,578,141,437
202012,43770,충청북도,음성군,90-94세,584,145,439
202101,43770,충청북도,음성군,90-94세,582,138,444
202102,43770,충청북도,음성군,90-94세,599,140,459
202103,43770,충청북도,음성군,90-94세,601,139,462
202104,43770,충청북도,음성군,90-94세,599,143,456
202105,43770,충청북도,음성군,90-94세,590,136,454
202106,43770,충청북도,음성군,90-94세,595,138,457
202007,43770,충청북도,음성군,95-99세,134,39,95
202008,43770,충청북도,음성군,95-99세,136,40,96
202009,43770,충청북도,음성군,95-99세,137,39,98
202010,43770,충청북도,음성군,95-99세,139,40,99
202011,43770,충청북도,음성군,95-99세,138,39,99
202012,43770,충청북도,음성군,95-99세,138,38,100
202101,43770,충청북도,음성군,95-99세,147,42,105
202102,43770,충청북도,음성군,95-99세,144,40,104
202103,43770,충청북도,음성군,95-99세,134,33,101
202104,43770,충청북도,음성군,95-99세,134,33,101
202105,43770,충청북도,음성군,95-99세,127,29,98
202106,43770,충청북도,음성군,95-99세,129,29,100
202007,43770,충청북도,음성군,100+,53,25,28
202008,43770,충청북도,음성군,100+,55,25,30
202009,43770,충청북도,음성군,100+,55,25,30
202010,43770,충청북도,음성군,100+,56,25,31
202011,43770,충청북도,음성군,100+,57,26,31
202012,43770,충청북도,음성군,100+,59,27,32
202101,43770,충청북도,음성군,100+,58,26,32
202102,43770,충청북도,음성군,100+,60,27,33
202103,43770,충청북도,음성군,100+,18,5,13
202104,43770,충청북도,음성군,100+,21,6,15
202105,43770,충청북도,음성군,100+,22,6,16
202106,43770,충청북도,음성군,100+,21,6,15
202007,43800,충청북도,단양군,0-4세,503,258,245
202008,43800,충청북도,단양군,0-4세,500,256,244
202009,43800,충청북도,단양군,0-4세,495,249,246
202010,43800,충청북도,단양군,0-4세,486,244,242
202011,43800,충청북도,단양군,0-4세,483,242,241
202012,43800,충청북도,단양군,0-4세,478,242,236
202101,43800,충청북도,단양군,0-4세,473,240,233
202102,43800,충청북도,단양군,0-4세,458,235,223
202103,43800,충청북도,단양군,0-4세,454,228,226
202104,43800,충청북도,단양군,0-4세,454,230,224
202105,43800,충청북도,단양군,0-4세,460,236,224
202106,43800,충청북도,단양군,0-4세,463,237,226
202007,43800,충청북도,단양군,5-9세,726,380,346
202008,43800,충청북도,단양군,5-9세,715,377,338
202009,43800,충청북도,단양군,5-9세,718,380,338
202010,43800,충청북도,단양군,5-9세,712,378,334
202011,43800,충청북도,단양군,5-9세,718,378,340
202012,43800,충청북도,단양군,5-9세,723,385,338
202101,43800,충청북도,단양군,5-9세,711,379,332
202102,43800,충청북도,단양군,5-9세,713,379,334
202103,43800,충청북도,단양군,5-9세,711,379,332
202104,43800,충청북도,단양군,5-9세,695,368,327
202105,43800,충청북도,단양군,5-9세,689,363,326
202106,43800,충청북도,단양군,5-9세,686,362,324
202007,43800,충청북도,단양군,10-14세,919,486,433
202008,43800,충청북도,단양군,10-14세,915,485,430
202009,43800,충청북도,단양군,10-14세,916,483,433
202010,43800,충청북도,단양군,10-14세,913,480,433
202011,43800,충청북도,단양군,10-14세,909,481,428
202012,43800,충청북도,단양군,10-14세,909,477,432
202101,43800,충청북도,단양군,10-14세,896,474,422
202102,43800,충청북도,단양군,10-14세,893,466,427
202103,43800,충청북도,단양군,10-14세,888,464,424
202104,43800,충청북도,단양군,10-14세,883,467,416
202105,43800,충청북도,단양군,10-14세,876,463,413
202106,43800,충청북도,단양군,10-14세,877,461,416
202007,43800,충청북도,단양군,15-19세,1122,601,521
202008,43800,충청북도,단양군,15-19세,1119,598,521
202009,43800,충청북도,단양군,15-19세,1131,610,521
202010,43800,충청북도,단양군,15-19세,1115,603,512
202011,43800,충청북도,단양군,15-19세,1104,597,507
202012,43800,충청북도,단양군,15-19세,1092,589,503
202101,43800,충청북도,단양군,15-19세,1074,577,497
202102,43800,충청북도,단양군,15-19세,1056,574,482
202103,43800,충청북도,단양군,15-19세,1045,568,477
202104,43800,충청북도,단양군,15-19세,1039,557,482
202105,43800,충청북도,단양군,15-19세,1041,557,484
202106,43800,충청북도,단양군,15-19세,1034,560,474
202007,43800,충청북도,단양군,20-24세,1237,711,526
202008,43800,충청북도,단양군,20-24세,1225,711,514
202009,43800,충청북도,단양군,20-24세,1221,701,520
202010,43800,충청북도,단양군,20-24세,1227,703,524
202011,43800,충청북도,단양군,20-24세,1217,697,520
202012,43800,충청북도,단양군,20-24세,1217,706,511
202101,43800,충청북도,단양군,20-24세,1189,689,500
202102,43800,충청북도,단양군,20-24세,1159,670,489
202103,43800,충청북도,단양군,20-24세,1145,660,485
202104,43800,충청북도,단양군,20-24세,1135,653,482
202105,43800,충청북도,단양군,20-24세,1129,648,481
202106,43800,충청북도,단양군,20-24세,1126,639,487
202007,43800,충청북도,단양군,25-29세,1065,621,444
202008,43800,충청북도,단양군,25-29세,1061,620,441
202009,43800,충청북도,단양군,25-29세,1044,611,433
202010,43800,충청북도,단양군,25-29세,1044,614,430
202011,43800,충청북도,단양군,25-29세,1043,626,417
202012,43800,충청북도,단양군,25-29세,1028,619,409
202101,43800,충청북도,단양군,25-29세,1012,608,404
202102,43800,충청북도,단양군,25-29세,1016,611,405
202103,43800,충청북도,단양군,25-29세,1003,604,399
202104,43800,충청북도,단양군,25-29세,1000,603,397
202105,43800,충청북도,단양군,25-29세,1002,599,403
202106,43800,충청북도,단양군,25-29세,993,585,408
202007,43800,충청북도,단양군,30-34세,883,489,394
202008,43800,충청북도,단양군,30-34세,878,487,391
202009,43800,충청북도,단양군,30-34세,885,490,395
202010,43800,충청북도,단양군,30-34세,890,498,392
202011,43800,충청북도,단양군,30-34세,902,499,403
202012,43800,충청북도,단양군,30-34세,885,495,390
202101,43800,충청북도,단양군,30-34세,893,498,395
202102,43800,충청북도,단양군,30-34세,877,491,386
202103,43800,충청북도,단양군,30-34세,872,486,386
202104,43800,충청북도,단양군,30-34세,869,482,387
202105,43800,충청북도,단양군,30-34세,867,485,382
202106,43800,충청북도,단양군,30-34세,859,480,379
202007,43800,충청북도,단양군,35-39세,1190,618,572
202008,43800,충청북도,단양군,35-39세,1168,606,562
202009,43800,충청북도,단양군,35-39세,1156,592,564
202010,43800,충청북도,단양군,35-39세,1145,583,562
202011,43800,충청북도,단양군,35-39세,1134,579,555
202012,43800,충청북도,단양군,35-39세,1133,579,554
202101,43800,충청북도,단양군,35-39세,1116,577,539
202102,43800,충청북도,단양군,35-39세,1076,553,523
202103,43800,충청북도,단양군,35-39세,1061,542,519
202104,43800,충청북도,단양군,35-39세,1057,544,513
202105,43800,충청북도,단양군,35-39세,1058,542,516
202106,43800,충청북도,단양군,35-39세,1047,542,505
202007,43800,충청북도,단양군,40-44세,1361,766,595
202008,43800,충청북도,단양군,40-44세,1357,770,587
202009,43800,충청북도,단양군,40-44세,1371,778,593
202010,43800,충청북도,단양군,40-44세,1385,785,600
202011,43800,충청북도,단양군,40-44세,1389,782,607
202012,43800,충청북도,단양군,40-44세,1372,767,605
202101,43800,충청북도,단양군,40-44세,1356,753,603
202102,43800,충청북도,단양군,40-44세,1358,753,605
202103,43800,충청북도,단양군,40-44세,1339,744,595
202104,43800,충청북도,단양군,40-44세,1322,734,588
202105,43800,충청북도,단양군,40-44세,1322,732,590
202106,43800,충청북도,단양군,40-44세,1321,728,593
202007,43800,충청북도,단양군,45-49세,2027,1102,925
202008,43800,충청북도,단양군,45-49세,2010,1088,922
202009,43800,충청북도,단양군,45-49세,1987,1067,920
202010,43800,충청북도,단양군,45-49세,1958,1056,902
202011,43800,충청북도,단양군,45-49세,1946,1053,893
202012,43800,충청북도,단양군,45-49세,1953,1061,892
202101,43800,충청북도,단양군,45-49세,1940,1061,879
202102,43800,충청북도,단양군,45-49세,1927,1061,866
202103,43800,충청북도,단양군,45-49세,1900,1043,857
202104,43800,충청북도,단양군,45-49세,1892,1039,853
202105,43800,충청북도,단양군,45-49세,1869,1029,840
202106,43800,충청북도,단양군,45-49세,1836,1005,831
202007,43800,충청북도,단양군,50-54세,2582,1391,1191
202008,43800,충청북도,단양군,50-54세,2565,1386,1179
202009,43800,충청북도,단양군,50-54세,2579,1402,1177
202010,43800,충청북도,단양군,50-54세,2584,1403,1181
202011,43800,충청북도,단양군,50-54세,2564,1389,1175
202012,43800,충청북도,단양군,50-54세,2523,1362,1161
202101,43800,충청북도,단양군,50-54세,2533,1361,1172
202102,43800,충청북도,단양군,50-54세,2510,1337,1173
202103,43800,충청북도,단양군,50-54세,2485,1327,1158
202104,43800,충청북도,단양군,50-54세,2466,1315,1151
202105,43800,충청북도,단양군,50-54세,2466,1313,1153
202106,43800,충청북도,단양군,50-54세,2474,1320,1154
202007,43800,충청북도,단양군,55-59세,3186,1686,1500
202008,43800,충청북도,단양군,55-59세,3203,1699,1504
202009,43800,충청북도,단양군,55-59세,3178,1698,1480
202010,43800,충청북도,단양군,55-59세,3168,1694,1474
202011,43800,충청북도,단양군,55-59세,3162,1686,1476
202012,43800,충청북도,단양군,55-59세,3145,1674,1471
202101,43800,충청북도,단양군,55-59세,3096,1643,1453
202102,43800,충청북도,단양군,55-59세,3085,1642,1443
202103,43800,충청북도,단양군,55-59세,3051,1636,1415
202104,43800,충청북도,단양군,55-59세,3029,1617,1412
202105,43800,충청북도,단양군,55-59세,2983,1601,1382
202106,43800,충청북도,단양군,55-59세,2955,1588,1367
202007,43800,충청북도,단양군,60-64세,3625,1861,1764
202008,43800,충청북도,단양군,60-64세,3615,1848,1767
202009,43800,충청북도,단양군,60-64세,3632,1855,1777
202010,43800,충청북도,단양군,60-64세,3652,1859,1793
202011,43800,충청북도,단양군,60-64세,3657,1860,1797
202012,43800,충청북도,단양군,60-64세,3671,1866,1805
202101,43800,충청북도,단양군,60-64세,3702,1882,1820
202102,43800,충청북도,단양군,60-64세,3734,1898,1836
202103,43800,충청북도,단양군,60-64세,3775,1913,1862
202104,43800,충청북도,단양군,60-64세,3801,1929,1872
202105,43800,충청북도,단양군,60-64세,3863,1954,1909
202106,43800,충청북도,단양군,60-64세,3863,1963,1900
202007,43800,충청북도,단양군,65-69세,2566,1321,1245
202008,43800,충청북도,단양군,65-69세,2602,1344,1258
202009,43800,충청북도,단양군,65-69세,2623,1354,1269
202010,43800,충청북도,단양군,65-69세,2639,1369,1270
202011,43800,충청북도,단양군,65-69세,2666,1384,1282
202012,43800,충청북도,단양군,65-69세,2683,1393,1290
202101,43800,충청북도,단양군,65-69세,2698,1404,1294
202102,43800,충청북도,단양군,65-69세,2719,1425,1294
202103,43800,충청북도,단양군,65-69세,2743,1435,1308
202104,43800,충청북도,단양군,65-69세,2758,1447,1311
202105,43800,충청북도,단양군,65-69세,2774,1451,1323
202106,43800,충청북도,단양군,65-69세,2799,1462,1337
202007,43800,충청북도,단양군,70-74세,2023,950,1073
202008,43800,충청북도,단양군,70-74세,2020,948,1072
202009,43800,충청북도,단양군,70-74세,2019,949,1070
202010,43800,충청북도,단양군,70-74세,2027,951,1076
202011,43800,충청북도,단양군,70-74세,2029,950,1079
202012,43800,충청북도,단양군,70-74세,2038,961,1077
202101,43800,충청북도,단양군,70-74세,2062,972,1090
202102,43800,충청북도,단양군,70-74세,2071,974,1097
202103,43800,충청북도,단양군,70-74세,2063,975,1088
202104,43800,충청북도,단양군,70-74세,2065,975,1090
202105,43800,충청북도,단양군,70-74세,2059,974,1085
202106,43800,충청북도,단양군,70-74세,2042,966,1076
202007,43800,충청북도,단양군,75-79세,1913,802,1111
202008,43800,충청북도,단양군,75-79세,1903,801,1102
202009,43800,충청북도,단양군,75-79세,1888,797,1091
202010,43800,충청북도,단양군,75-79세,1887,798,1089
202011,43800,충청북도,단양군,75-79세,1886,802,1084
202012,43800,충청북도,단양군,75-79세,1858,776,1082
202101,43800,충청북도,단양군,75-79세,1838,773,1065
202102,43800,충청북도,단양군,75-79세,1825,776,1049
202103,43800,충청북도,단양군,75-79세,1820,771,1049
202104,43800,충청북도,단양군,75-79세,1806,768,1038
202105,43800,충청북도,단양군,75-79세,1809,765,1044
202106,43800,충청북도,단양군,75-79세,1799,755,1044
202007,43800,충청북도,단양군,80-84세,1437,535,902
202008,43800,충청북도,단양군,80-84세,1433,528,905
202009,43800,충청북도,단양군,80-84세,1437,527,910
202010,43800,충청북도,단양군,80-84세,1437,525,912
202011,43800,충청북도,단양군,80-84세,1425,518,907
202012,43800,충청북도,단양군,80-84세,1435,535,900
202101,43800,충청북도,단양군,80-84세,1437,537,900
202102,43800,충청북도,단양군,80-84세,1445,536,909
202103,43800,충청북도,단양군,80-84세,1448,538,910
202104,43800,충청북도,단양군,80-84세,1453,542,911
202105,43800,충청북도,단양군,80-84세,1459,551,908
202106,43800,충청북도,단양군,80-84세,1446,548,898
202007,43800,충청북도,단양군,85-89세,680,204,476
202008,43800,충청북도,단양군,85-89세,683,204,479
202009,43800,충청북도,단양군,85-89세,685,206,479
202010,43800,충청북도,단양군,85-89세,694,211,483
202011,43800,충청북도,단양군,85-89세,697,214,483
202012,43800,충청북도,단양군,85-89세,701,212,489
202101,43800,충청북도,단양군,85-89세,716,215,501
202102,43800,충청북도,단양군,85-89세,709,213,496
202103,43800,충청북도,단양군,85-89세,719,218,501
202104,43800,충청북도,단양군,85-89세,723,217,506
202105,43800,충청북도,단양군,85-89세,726,217,509
202106,43800,충청북도,단양군,85-89세,728,216,512
202007,43800,충청북도,단양군,90-94세,218,51,167
202008,43800,충청북도,단양군,90-94세,221,52,169
202009,43800,충청북도,단양군,90-94세,230,55,175
202010,43800,충청북도,단양군,90-94세,228,56,172
202011,43800,충청북도,단양군,90-94세,234,58,176
202012,43800,충청북도,단양군,90-94세,234,59,175
202101,43800,충청북도,단양군,90-94세,229,60,169
202102,43800,충청북도,단양군,90-94세,236,61,175
202103,43800,충청북도,단양군,90-94세,239,60,179
202104,43800,충청북도,단양군,90-94세,241,63,178
202105,43800,충청북도,단양군,90-94세,243,61,182
202106,43800,충청북도,단양군,90-94세,237,60,177
202007,43800,충청북도,단양군,95-99세,53,16,37
202008,43800,충청북도,단양군,95-99세,54,16,38
202009,43800,충청북도,단양군,95-99세,54,15,39
202010,43800,충청북도,단양군,95-99세,53,15,38
202011,43800,충청북도,단양군,95-99세,52,14,38
202012,43800,충청북도,단양군,95-99세,55,15,40
202101,43800,충청북도,단양군,95-99세,55,14,41
202102,43800,충청북도,단양군,95-99세,52,14,38
202103,43800,충청북도,단양군,95-99세,55,15,40
202104,43800,충청북도,단양군,95-99세,51,14,37
202105,43800,충청북도,단양군,95-99세,51,14,37
202106,43800,충청북도,단양군,95-99세,51,14,37
202007,43800,충청북도,단양군,100+,21,8,13
202008,43800,충청북도,단양군,100+,21,8,13
202009,43800,충청북도,단양군,100+,21,8,13
202010,43800,충청북도,단양군,100+,21,8,13
202011,43800,충청북도,단양군,100+,22,9,13
202012,43800,충청북도,단양군,100+,22,9,13
202101,43800,충청북도,단양군,100+,23,9,14
202102,43800,충청북도,단양군,100+,24,9,15
202103,43800,충청북도,단양군,100+,19,7,12
202104,43800,충청북도,단양군,100+,19,7,12
202105,43800,충청북도,단양군,100+,20,7,13
202106,43800,충청북도,단양군,100+,16,4,12
202007,44131,충청남도,천안시 동남구,0-4세,8832,4557,4275
202008,44131,충청남도,천안시 동남구,0-4세,8720,4514,4206
202009,44131,충청남도,천안시 동남구,0-4세,8651,4482,4169
202010,44131,충청남도,천안시 동남구,0-4세,8547,4414,4133
202011,44131,충청남도,천안시 동남구,0-4세,8454,4353,4101
202012,44131,충청남도,천안시 동남구,0-4세,8435,4349,4086
202101,44131,충청남도,천안시 동남구,0-4세,8306,4284,4022
202102,44131,충청남도,천안시 동남구,0-4세,8241,4270,3971
202103,44131,충청남도,천안시 동남구,0-4세,8164,4232,3932
202104,44131,충청남도,천안시 동남구,0-4세,8121,4207,3914
202105,44131,충청남도,천안시 동남구,0-4세,8035,4157,3878
202106,44131,충청남도,천안시 동남구,0-4세,7948,4114,3834
202007,44131,충청남도,천안시 동남구,5-9세,12250,6276,5974
202008,44131,충청남도,천안시 동남구,5-9세,12219,6261,5958
202009,44131,충청남도,천안시 동남구,5-9세,12179,6245,5934
202010,44131,충청남도,천안시 동남구,5-9세,12138,6234,5904
202011,44131,충청남도,천안시 동남구,5-9세,12026,6188,5838
202012,44131,충청남도,천안시 동남구,5-9세,12014,6187,5827
202101,44131,충청남도,천안시 동남구,5-9세,11922,6136,5786
202102,44131,충청남도,천안시 동남구,5-9세,11858,6079,5779
202103,44131,충청남도,천안시 동남구,5-9세,11812,6052,5760
202104,44131,충청남도,천안시 동남구,5-9세,11780,6028,5752
202105,44131,충청남도,천안시 동남구,5-9세,11705,6003,5702
202106,44131,충청남도,천안시 동남구,5-9세,11636,5975,5661
202007,44131,충청남도,천안시 동남구,10-14세,12856,6699,6157
202008,44131,충청남도,천안시 동남구,10-14세,12819,6674,6145
202009,44131,충청남도,천안시 동남구,10-14세,12806,6666,6140
202010,44131,충청남도,천안시 동남구,10-14세,12849,6692,6157
202011,44131,충청남도,천안시 동남구,10-14세,12923,6725,6198
202012,44131,충청남도,천안시 동남구,10-14세,12930,6723,6207
202101,44131,충청남도,천안시 동남구,10-14세,12978,6722,6256
202102,44131,충청남도,천안시 동남구,10-14세,13003,6744,6259
202103,44131,충청남도,천안시 동남구,10-14세,13028,6783,6245
202104,44131,충청남도,천안시 동남구,10-14세,12993,6765,6228
202105,44131,충청남도,천안시 동남구,10-14세,13011,6769,6242
202106,44131,충청남도,천안시 동남구,10-14세,12988,6734,6254
202007,44131,충청남도,천안시 동남구,15-19세,13779,7130,6649
202008,44131,충청남도,천안시 동남구,15-19세,13725,7099,6626
202009,44131,충청남도,천안시 동남구,15-19세,13619,7029,6590
202010,44131,충청남도,천안시 동남구,15-19세,13504,7000,6504
202011,44131,충청남도,천안시 동남구,15-19세,13403,6956,6447
202012,44131,충청남도,천안시 동남구,15-19세,13298,6878,6420
202101,44131,충청남도,천안시 동남구,15-19세,13219,6854,6365
202102,44131,충청남도,천안시 동남구,15-19세,13110,6819,6291
202103,44131,충청남도,천안시 동남구,15-19세,12990,6759,6231
202104,44131,충청남도,천안시 동남구,15-19세,12918,6740,6178
202105,44131,충청남도,천안시 동남구,15-19세,12859,6710,6149
202106,44131,충청남도,천안시 동남구,15-19세,12820,6692,6128
202007,44131,충청남도,천안시 동남구,20-24세,17861,9359,8502
202008,44131,충청남도,천안시 동남구,20-24세,17834,9347,8487
202009,44131,충청남도,천안시 동남구,20-24세,17806,9319,8487
202010,44131,충청남도,천안시 동남구,20-24세,17774,9281,8493
202011,44131,충청남도,천안시 동남구,20-24세,17745,9264,8481
202012,44131,충청남도,천안시 동남구,20-24세,17763,9272,8491
202101,44131,충청남도,천안시 동남구,20-24세,17707,9249,8458
202102,44131,충청남도,천안시 동남구,20-24세,17674,9255,8419
202103,44131,충청남도,천안시 동남구,20-24세,17578,9170,8408
202104,44131,충청남도,천안시 동남구,20-24세,17523,9130,8393
202105,44131,충청남도,천안시 동남구,20-24세,17534,9142,8392
202106,44131,충청남도,천안시 동남구,20-24세,17458,9114,8344
202007,44131,충청남도,천안시 동남구,25-29세,17639,9483,8156
202008,44131,충청남도,천안시 동남구,25-29세,17640,9486,8154
202009,44131,충청남도,천안시 동남구,25-29세,17631,9485,8146
202010,44131,충청남도,천안시 동남구,25-29세,17637,9489,8148
202011,44131,충청남도,천안시 동남구,25-29세,17607,9473,8134
202012,44131,충청남도,천안시 동남구,25-29세,17612,9468,8144
202101,44131,충청남도,천안시 동남구,25-29세,17578,9448,8130
202102,44131,충청남도,천안시 동남구,25-29세,17426,9363,8063
202103,44131,충청남도,천안시 동남구,25-29세,17462,9404,8058
202104,44131,충청남도,천안시 동남구,25-29세,17447,9376,8071
202105,44131,충청남도,천안시 동남구,25-29세,17391,9368,8023
202106,44131,충청남도,천안시 동남구,25-29세,17365,9355,8010
202007,44131,충청남도,천안시 동남구,30-34세,15109,8119,6990
202008,44131,충청남도,천안시 동남구,30-34세,15042,8079,6963
202009,44131,충청남도,천안시 동남구,30-34세,14998,8052,6946
202010,44131,충청남도,천안시 동남구,30-34세,14980,8011,6969
202011,44131,충청남도,천안시 동남구,30-34세,14951,8027,6924
202012,44131,충청남도,천안시 동남구,30-34세,14855,7994,6861
202101,44131,충청남도,천안시 동남구,30-34세,14813,7975,6838
202102,44131,충청남도,천안시 동남구,30-34세,14781,7917,6864
202103,44131,충청남도,천안시 동남구,30-34세,14810,7928,6882
202104,44131,충청남도,천안시 동남구,30-34세,14827,7968,6859
202105,44131,충청남도,천안시 동남구,30-34세,14810,7949,6861
202106,44131,충청남도,천안시 동남구,30-34세,14724,7909,6815
202007,44131,충청남도,천안시 동남구,35-39세,18894,9697,9197
202008,44131,충청남도,천안시 동남구,35-39세,18785,9678,9107
202009,44131,충청남도,천안시 동남구,35-39세,18629,9585,9044
202010,44131,충청남도,천안시 동남구,35-39세,18546,9554,8992
202011,44131,충청남도,천안시 동남구,35-39세,18418,9481,8937
202012,44131,충청남도,천안시 동남구,35-39세,18384,9457,8927
202101,44131,충청남도,천안시 동남구,35-39세,18212,9392,8820
202102,44131,충청남도,천안시 동남구,35-39세,18069,9352,8717
202103,44131,충청남도,천안시 동남구,35-39세,17905,9267,8638
202104,44131,충청남도,천안시 동남구,35-39세,17836,9245,8591
202105,44131,충청남도,천안시 동남구,35-39세,17748,9198,8550
202106,44131,충청남도,천안시 동남구,35-39세,17599,9109,8490
202007,44131,충청남도,천안시 동남구,40-44세,20431,10529,9902
202008,44131,충청남도,천안시 동남구,40-44세,20424,10516,9908
202009,44131,충청남도,천안시 동남구,40-44세,20460,10558,9902
202010,44131,충청남도,천안시 동남구,40-44세,20509,10564,9945
202011,44131,충청남도,천안시 동남구,40-44세,20532,10572,9960
202012,44131,충청남도,천안시 동남구,40-44세,20421,10548,9873
202101,44131,충청남도,천안시 동남구,40-44세,20360,10498,9862
202102,44131,충청남도,천안시 동남구,40-44세,20328,10496,9832
202103,44131,충청남도,천안시 동남구,40-44세,20224,10467,9757
202104,44131,충청남도,천안시 동남구,40-44세,20207,10465,9742
202105,44131,충청남도,천안시 동남구,40-44세,20202,10463,9739
202106,44131,충청남도,천안시 동남구,40-44세,20279,10503,9776
202007,44131,충청남도,천안시 동남구,45-49세,22919,11796,11123
202008,44131,충청남도,천안시 동남구,45-49세,22828,11743,11085
202009,44131,충청남도,천안시 동남구,45-49세,22677,11677,11000
202010,44131,충청남도,천안시 동남구,45-49세,22507,11582,10925
202011,44131,충청남도,천안시 동남구,45-49세,22427,11523,10904
202012,44131,충청남도,천안시 동남구,45-49세,22431,11523,10908
202101,44131,충청남도,천안시 동남구,45-49세,22396,11517,10879
202102,44131,충청남도,천안시 동남구,45-49세,22436,11542,10894
202103,44131,충청남도,천안시 동남구,45-49세,22336,11509,10827
202104,44131,충청남도,천안시 동남구,45-49세,22290,11493,10797
202105,44131,충청남도,천안시 동남구,45-49세,22064,11374,10690
202106,44131,충청남도,천안시 동남구,45-49세,21911,11307,10604
202007,44131,충청남도,천안시 동남구,50-54세,22195,11297,10898
202008,44131,충청남도,천안시 동남구,50-54세,22265,11323,10942
202009,44131,충청남도,천안시 동남구,50-54세,22322,11333,10989
202010,44131,충청남도,천안시 동남구,50-54세,22423,11397,11026
202011,44131,충청남도,천안시 동남구,50-54세,22450,11424,11026
202012,44131,충청남도,천안시 동남구,50-54세,22355,11351,11004
202101,44131,충청남도,천안시 동남구,50-54세,22441,11409,11032
202102,44131,충청남도,천안시 동남구,50-54세,22479,11423,11056
202103,44131,충청남도,천안시 동남구,50-54세,22431,11383,11048
202104,44131,충청남도,천안시 동남구,50-54세,22466,11368,11098
202105,44131,충청남도,천안시 동남구,50-54세,22558,11436,11122
202106,44131,충청남도,천안시 동남구,50-54세,22662,11481,11181
202007,44131,충청남도,천안시 동남구,55-59세,21857,11259,10598
202008,44131,충청남도,천안시 동남구,55-59세,21768,11209,10559
202009,44131,충청남도,천안시 동남구,55-59세,21711,11178,10533
202010,44131,충청남도,천안시 동남구,55-59세,21644,11127,10517
202011,44131,충청남도,천안시 동남구,55-59세,21542,11058,10484
202012,44131,충청남도,천안시 동남구,55-59세,21475,11030,10445
202101,44131,충청남도,천안시 동남구,55-59세,21229,10913,10316
202102,44131,충청남도,천안시 동남구,55-59세,21125,10838,10287
202103,44131,충청남도,천안시 동남구,55-59세,20945,10714,10231
202104,44131,충청남도,천안시 동남구,55-59세,20865,10663,10202
202105,44131,충청남도,천안시 동남구,55-59세,20797,10617,10180
202106,44131,충청남도,천안시 동남구,55-59세,20656,10538,10118
202007,44131,충청남도,천안시 동남구,60-64세,18160,9165,8995
202008,44131,충청남도,천안시 동남구,60-64세,18251,9226,9025
202009,44131,충청남도,천안시 동남구,60-64세,18417,9294,9123
202010,44131,충청남도,천안시 동남구,60-64세,18545,9372,9173
202011,44131,충청남도,천안시 동남구,60-64세,18673,9465,9208
202012,44131,충청남도,천안시 동남구,60-64세,18800,9528,9272
202101,44131,충청남도,천안시 동남구,60-64세,19084,9645,9439
202102,44131,충청남도,천안시 동남구,60-64세,19253,9752,9501
202103,44131,충청남도,천안시 동남구,60-64세,19456,9863,9593
202104,44131,충청남도,천안시 동남구,60-64세,19579,9938,9641
202105,44131,충청남도,천안시 동남구,60-64세,19702,10002,9700
202106,44131,충청남도,천안시 동남구,60-64세,19819,10082,9737
202007,44131,충청남도,천안시 동남구,65-69세,11903,5939,5964
202008,44131,충청남도,천안시 동남구,65-69세,12029,5999,6030
202009,44131,충청남도,천안시 동남구,65-69세,12121,6062,6059
202010,44131,충청남도,천안시 동남구,65-69세,12247,6119,6128
202011,44131,충청남도,천안시 동남구,65-69세,12347,6156,6191
202012,44131,충청남도,천안시 동남구,65-69세,12398,6192,6206
202101,44131,충청남도,천안시 동남구,65-69세,12504,6226,6278
202102,44131,충청남도,천안시 동남구,65-69세,12630,6284,6346
202103,44131,충청남도,천안시 동남구,65-69세,12856,6385,6471
202104,44131,충청남도,천안시 동남구,65-69세,12967,6454,6513
202105,44131,충청남도,천안시 동남구,65-69세,13022,6485,6537
202106,44131,충청남도,천안시 동남구,65-69세,13111,6511,6600
202007,44131,충청남도,천안시 동남구,70-74세,8536,4095,4441
202008,44131,충청남도,천안시 동남구,70-74세,8569,4107,4462
202009,44131,충청남도,천안시 동남구,70-74세,8606,4122,4484
202010,44131,충청남도,천안시 동남구,70-74세,8651,4151,4500
202011,44131,충청남도,천안시 동남구,70-74세,8720,4179,4541
202012,44131,충청남도,천안시 동남구,70-74세,8799,4215,4584
202101,44131,충청남도,천안시 동남구,70-74세,8887,4271,4616
202102,44131,충청남도,천안시 동남구,70-74세,8921,4289,4632
202103,44131,충청남도,천안시 동남구,70-74세,8922,4292,4630
202104,44131,충청남도,천안시 동남구,70-74세,8939,4290,4649
202105,44131,충청남도,천안시 동남구,70-74세,8986,4311,4675
202106,44131,충청남도,천안시 동남구,70-74세,8995,4318,4677
202007,44131,충청남도,천안시 동남구,75-79세,6890,2942,3948
202008,44131,충청남도,천안시 동남구,75-79세,6884,2940,3944
202009,44131,충청남도,천안시 동남구,75-79세,6868,2928,3940
202010,44131,충청남도,천안시 동남구,75-79세,6821,2913,3908
202011,44131,충청남도,천안시 동남구,75-79세,6789,2909,3880
202012,44131,충청남도,천안시 동남구,75-79세,6734,2881,3853
202101,44131,충청남도,천안시 동남구,75-79세,6701,2877,3824
202102,44131,충청남도,천안시 동남구,75-79세,6677,2873,3804
202103,44131,충청남도,천안시 동남구,75-79세,6660,2871,3789
202104,44131,충청남도,천안시 동남구,75-79세,6638,2872,3766
202105,44131,충청남도,천안시 동남구,75-79세,6606,2866,3740
202106,44131,충청남도,천안시 동남구,75-79세,6600,2870,3730
202007,44131,충청남도,천안시 동남구,80-84세,5162,1918,3244
202008,44131,충청남도,천안시 동남구,80-84세,5186,1935,3251
202009,44131,충청남도,천안시 동남구,80-84세,5183,1948,3235
202010,44131,충청남도,천안시 동남구,80-84세,5200,1954,3246
202011,44131,충청남도,천안시 동남구,80-84세,5201,1959,3242
202012,44131,충청남도,천안시 동남구,80-84세,5185,1960,3225
202101,44131,충청남도,천안시 동남구,80-84세,5189,1960,3229
202102,44131,충청남도,천안시 동남구,80-84세,5215,1980,3235
202103,44131,충청남도,천안시 동남구,80-84세,5181,1965,3216
202104,44131,충청남도,천안시 동남구,80-84세,5195,1971,3224
202105,44131,충청남도,천안시 동남구,80-84세,5221,1992,3229
202106,44131,충청남도,천안시 동남구,80-84세,5259,2007,3252
202007,44131,충청남도,천안시 동남구,85-89세,2710,814,1896
202008,44131,충청남도,천안시 동남구,85-89세,2710,824,1886
202009,44131,충청남도,천안시 동남구,85-89세,2740,826,1914
202010,44131,충청남도,천안시 동남구,85-89세,2761,835,1926
202011,44131,충청남도,천안시 동남구,85-89세,2777,837,1940
202012,44131,충청남도,천안시 동남구,85-89세,2831,853,1978
202101,44131,충청남도,천안시 동남구,85-89세,2863,863,2000
202102,44131,충청남도,천안시 동남구,85-89세,2865,864,2001
202103,44131,충청남도,천안시 동남구,85-89세,2908,880,2028
202104,44131,충청남도,천안시 동남구,85-89세,2933,887,2046
202105,44131,충청남도,천안시 동남구,85-89세,2974,900,2074
202106,44131,충청남도,천안시 동남구,85-89세,2963,898,2065
202007,44131,충청남도,천안시 동남구,90-94세,909,206,703
202008,44131,충청남도,천안시 동남구,90-94세,913,203,710
202009,44131,충청남도,천안시 동남구,90-94세,923,212,711
202010,44131,충청남도,천안시 동남구,90-94세,927,215,712
202011,44131,충청남도,천안시 동남구,90-94세,934,221,713
202012,44131,충청남도,천안시 동남구,90-94세,942,230,712
202101,44131,충청남도,천안시 동남구,90-94세,953,230,723
202102,44131,충청남도,천안시 동남구,90-94세,964,231,733
202103,44131,충청남도,천안시 동남구,90-94세,974,230,744
202104,44131,충청남도,천안시 동남구,90-94세,983,230,753
202105,44131,충청남도,천안시 동남구,90-94세,975,224,751
202106,44131,충청남도,천안시 동남구,90-94세,974,225,749
202007,44131,충청남도,천안시 동남구,95-99세,241,58,183
202008,44131,충청남도,천안시 동남구,95-99세,245,58,187
202009,44131,충청남도,천안시 동남구,95-99세,250,57,193
202010,44131,충청남도,천안시 동남구,95-99세,258,59,199
202011,44131,충청남도,천안시 동남구,95-99세,261,59,202
202012,44131,충청남도,천안시 동남구,95-99세,260,58,202
202101,44131,충청남도,천안시 동남구,95-99세,257,54,203
202102,44131,충청남도,천안시 동남구,95-99세,255,55,200
202103,44131,충청남도,천안시 동남구,95-99세,234,53,181
202104,44131,충청남도,천안시 동남구,95-99세,234,53,181
202105,44131,충청남도,천안시 동남구,95-99세,234,51,183
202106,44131,충청남도,천안시 동남구,95-99세,234,53,181
202007,44131,충청남도,천안시 동남구,100+,86,23,63
202008,44131,충청남도,천안시 동남구,100+,86,23,63
202009,44131,충청남도,천안시 동남구,100+,88,23,65
202010,44131,충청남도,천안시 동남구,100+,88,23,65
202011,44131,충청남도,천안시 동남구,100+,89,23,66
202012,44131,충청남도,천안시 동남구,100+,87,22,65
202101,44131,충청남도,천안시 동남구,100+,84,23,61
202102,44131,충청남도,천안시 동남구,100+,87,23,64
202103,44131,충청남도,천안시 동남구,100+,55,14,41
202104,44131,충청남도,천안시 동남구,100+,56,14,42
202105,44131,충청남도,천안시 동남구,100+,48,11,37
202106,44131,충청남도,천안시 동남구,100+,46,11,35
202007,44133,충청남도,천안시 서북구,0-4세,19450,9886,9564
202008,44133,충청남도,천안시 서북구,0-4세,19363,9853,9510
202009,44133,충청남도,천안시 서북구,0-4세,19241,9803,9438
202010,44133,충청남도,천안시 서북구,0-4세,19035,9721,9314
202011,44133,충청남도,천안시 서북구,0-4세,18921,9689,9232
202012,44133,충청남도,천안시 서북구,0-4세,18806,9642,9164
202101,44133,충청남도,천안시 서북구,0-4세,18586,9532,9054
202102,44133,충청남도,천안시 서북구,0-4세,18457,9474,8983
202103,44133,충청남도,천안시 서북구,0-4세,18320,9441,8879
202104,44133,충청남도,천안시 서북구,0-4세,18192,9352,8840
202105,44133,충청남도,천안시 서북구,0-4세,18093,9304,8789
202106,44133,충청남도,천안시 서북구,0-4세,17909,9224,8685
202007,44133,충청남도,천안시 서북구,5-9세,22914,11651,11263
202008,44133,충청남도,천안시 서북구,5-9세,22957,11648,11309
202009,44133,충청남도,천안시 서북구,5-9세,22937,11625,11312
202010,44133,충청남도,천안시 서북구,5-9세,22915,11623,11292
202011,44133,충청남도,천안시 서북구,5-9세,22930,11640,11290
202012,44133,충청남도,천안시 서북구,5-9세,22901,11606,11295
202101,44133,충청남도,천안시 서북구,5-9세,22906,11610,11296
202102,44133,충청남도,천안시 서북구,5-9세,22926,11625,11301
202103,44133,충청남도,천안시 서북구,5-9세,22932,11607,11325
202104,44133,충청남도,천안시 서북구,5-9세,22904,11604,11300
202105,44133,충청남도,천안시 서북구,5-9세,22906,11606,11300
202106,44133,충청남도,천안시 서북구,5-9세,22908,11604,11304
202007,44133,충청남도,천안시 서북구,10-14세,20907,10867,10040
202008,44133,충청남도,천안시 서북구,10-14세,20922,10867,10055
202009,44133,충청남도,천안시 서북구,10-14세,21036,10956,10080
202010,44133,충청남도,천안시 서북구,10-14세,21119,10994,10125
202011,44133,충청남도,천안시 서북구,10-14세,21161,11012,10149
202012,44133,충청남도,천안시 서북구,10-14세,21141,11004,10137
202101,44133,충청남도,천안시 서북구,10-14세,21147,10984,10163
202102,44133,충청남도,천안시 서북구,10-14세,21151,10978,10173
202103,44133,충청남도,천안시 서북구,10-14세,21184,10982,10202
202104,44133,충청남도,천안시 서북구,10-14세,21256,11011,10245
202105,44133,충청남도,천안시 서북구,10-14세,21369,11051,10318
202106,44133,충청남도,천안시 서북구,10-14세,21427,11086,10341
202007,44133,충청남도,천안시 서북구,15-19세,21527,11097,10430
202008,44133,충청남도,천안시 서북구,15-19세,21398,11043,10355
202009,44133,충청남도,천안시 서북구,15-19세,21286,10986,10300
202010,44133,충청남도,천안시 서북구,15-19세,21182,10922,10260
202011,44133,충청남도,천안시 서북구,15-19세,21115,10878,10237
202012,44133,충청남도,천안시 서북구,15-19세,21028,10827,10201
202101,44133,충청남도,천안시 서북구,15-19세,20932,10777,10155
202102,44133,충청남도,천안시 서북구,15-19세,20898,10730,10168
202103,44133,충청남도,천안시 서북구,15-19세,20819,10695,10124
202104,44133,충청남도,천안시 서북구,15-19세,20729,10657,10072
202105,44133,충청남도,천안시 서북구,15-19세,20661,10630,10031
202106,44133,충청남도,천안시 서북구,15-19세,20604,10588,10016
202007,44133,충청남도,천안시 서북구,20-24세,27838,14375,13463
202008,44133,충청남도,천안시 서북구,20-24세,27888,14417,13471
202009,44133,충청남도,천안시 서북구,20-24세,27914,14478,13436
202010,44133,충청남도,천안시 서북구,20-24세,27910,14492,13418
202011,44133,충청남도,천안시 서북구,20-24세,27916,14494,13422
202012,44133,충청남도,천안시 서북구,20-24세,27926,14516,13410
202101,44133,충청남도,천안시 서북구,20-24세,27923,14495,13428
202102,44133,충청남도,천안시 서북구,20-24세,27885,14438,13447
202103,44133,충청남도,천안시 서북구,20-24세,27847,14403,13444
202104,44133,충청남도,천안시 서북구,20-24세,27728,14302,13426
202105,44133,충청남도,천안시 서북구,20-24세,27699,14284,13415
202106,44133,충청남도,천안시 서북구,20-24세,27710,14287,13423
202007,44133,충청남도,천안시 서북구,25-29세,32725,17160,15565
202008,44133,충청남도,천안시 서북구,25-29세,32783,17204,15579
202009,44133,충청남도,천안시 서북구,25-29세,32921,17279,15642
202010,44133,충청남도,천안시 서북구,25-29세,33044,17360,15684
202011,44133,충청남도,천안시 서북구,25-29세,33115,17406,15709
202012,44133,충청남도,천안시 서북구,25-29세,33286,17504,15782
202101,44133,충청남도,천안시 서북구,25-29세,33150,17469,15681
202102,44133,충청남도,천안시 서북구,25-29세,32892,17356,15536
202103,44133,충청남도,천안시 서북구,25-29세,32979,17422,15557
202104,44133,충청남도,천안시 서북구,25-29세,33044,17502,15542
202105,44133,충청남도,천안시 서북구,25-29세,33159,17574,15585
202106,44133,충청남도,천안시 서북구,25-29세,33181,17598,15583
202007,44133,충청남도,천안시 서북구,30-34세,34327,18302,16025
202008,44133,충청남도,천안시 서북구,30-34세,34263,18272,15991
202009,44133,충청남도,천안시 서북구,30-34세,34379,18315,16064
202010,44133,충청남도,천안시 서북구,30-34세,34347,18287,16060
202011,44133,충청남도,천안시 서북구,30-34세,34264,18270,15994
202012,44133,충청남도,천안시 서북구,30-34세,34113,18212,15901
202101,44133,충청남도,천안시 서북구,30-34세,34095,18175,15920
202102,44133,충청남도,천안시 서북구,30-34세,34026,18130,15896
202103,44133,충청남도,천안시 서북구,30-34세,33907,18064,15843
202104,44133,충청남도,천안시 서북구,30-34세,33874,18055,15819
202105,44133,충청남도,천안시 서북구,30-34세,33777,17991,15786
202106,44133,충청남도,천안시 서북구,30-34세,33700,17957,15743
202007,44133,충청남도,천안시 서북구,35-39세,38561,20587,17974
202008,44133,충청남도,천안시 서북구,35-39세,38469,20575,17894
202009,44133,충청남도,천안시 서북구,35-39세,38392,20561,17831
202010,44133,충청남도,천안시 서북구,35-39세,38183,20444,17739
202011,44133,충청남도,천안시 서북구,35-39세,38127,20399,17728
202012,44133,충청남도,천안시 서북구,35-39세,38104,20374,17730
202101,44133,충청남도,천안시 서북구,35-39세,37913,20290,17623
202102,44133,충청남도,천안시 서북구,35-39세,37732,20248,17484
202103,44133,충청남도,천안시 서북구,35-39세,37536,20112,17424
202104,44133,충청남도,천안시 서북구,35-39세,37380,20059,17321
202105,44133,충청남도,천안시 서북구,35-39세,37369,20077,17292
202106,44133,충청남도,천안시 서북구,35-39세,37240,19998,17242
202007,44133,충청남도,천안시 서북구,40-44세,34120,17963,16157
202008,44133,충청남도,천안시 서북구,40-44세,34259,18052,16207
202009,44133,충청남도,천안시 서북구,40-44세,34427,18146,16281
202010,44133,충청남도,천안시 서북구,40-44세,34697,18311,16386
202011,44133,충청남도,천안시 서북구,40-44세,34807,18405,16402
202012,44133,충청남도,천안시 서북구,40-44세,34714,18419,16295
202101,44133,충청남도,천안시 서북구,40-44세,34832,18554,16278
202102,44133,충청남도,천안시 서북구,40-44세,35136,18760,16376
202103,44133,충청남도,천안시 서북구,40-44세,35064,18769,16295
202104,44133,충청남도,천안시 서북구,40-44세,35086,18789,16297
202105,44133,충청남도,천안시 서북구,40-44세,35286,18847,16439
202106,44133,충청남도,천안시 서북구,40-44세,35519,19001,16518
202007,44133,충청남도,천안시 서북구,45-49세,34624,17537,17087
202008,44133,충청남도,천안시 서북구,45-49세,34509,17468,17041
202009,44133,충청남도,천안시 서북구,45-49세,34413,17435,16978
202010,44133,충청남도,천안시 서북구,45-49세,34286,17333,16953
202011,44133,충청남도,천안시 서북구,45-49세,34246,17300,16946
202012,44133,충청남도,천안시 서북구,45-49세,34336,17301,17035
202101,44133,충청남도,천안시 서북구,45-49세,34301,17267,17034
202102,44133,충청남도,천안시 서북구,45-49세,34268,17257,17011
202103,44133,충청남도,천안시 서북구,45-49세,34273,17243,17030
202104,44133,충청남도,천안시 서북구,45-49세,34287,17253,17034
202105,44133,충청남도,천안시 서북구,45-49세,34086,17163,16923
202106,44133,충청남도,천안시 서북구,45-49세,33975,17123,16852
202007,44133,충청남도,천안시 서북구,50-54세,31632,16067,15565
202008,44133,충청남도,천안시 서북구,50-54세,31706,16090,15616
202009,44133,충청남도,천안시 서북구,50-54세,31891,16196,15695
202010,44133,충청남도,천안시 서북구,50-54세,32102,16325,15777
202011,44133,충청남도,천안시 서북구,50-54세,32227,16415,15812
202012,44133,충청남도,천안시 서북구,50-54세,32168,16424,15744
202101,44133,충청남도,천안시 서북구,50-54세,32416,16576,15840
202102,44133,충청남도,천안시 서북구,50-54세,32511,16591,15920
202103,44133,충청남도,천안시 서북구,50-54세,32482,16580,15902
202104,44133,충청남도,천안시 서북구,50-54세,32554,16628,15926
202105,44133,충청남도,천안시 서북구,50-54세,32925,16822,16103
202106,44133,충청남도,천안시 서북구,50-54세,33002,16886,16116
202007,44133,충청남도,천안시 서북구,55-59세,27003,14162,12841
202008,44133,충청남도,천안시 서북구,55-59세,27024,14185,12839
202009,44133,충청남도,천안시 서북구,55-59세,27073,14183,12890
202010,44133,충청남도,천안시 서북구,55-59세,27007,14125,12882
202011,44133,충청남도,천안시 서북구,55-59세,27019,14130,12889
202012,44133,충청남도,천안시 서북구,55-59세,27040,14125,12915
202101,44133,충청남도,천안시 서북구,55-59세,26870,13998,12872
202102,44133,충청남도,천안시 서북구,55-59세,26836,13979,12857
202103,44133,충청남도,천안시 서북구,55-59세,26763,13982,12781
202104,44133,충청남도,천안시 서북구,55-59세,26744,13977,12767
202105,44133,충청남도,천안시 서북구,55-59세,26694,13981,12713
202106,44133,충청남도,천안시 서북구,55-59세,26567,13918,12649
202007,44133,충청남도,천안시 서북구,60-64세,19554,10049,9505
202008,44133,충청남도,천안시 서북구,60-64세,19670,10119,9551
202009,44133,충청남도,천안시 서북구,60-64세,19787,10184,9603
202010,44133,충청남도,천안시 서북구,60-64세,19975,10303,9672
202011,44133,충청남도,천안시 서북구,60-64세,20139,10371,9768
202012,44133,충청남도,천안시 서북구,60-64세,20321,10455,9866
202101,44133,충청남도,천안시 서북구,60-64세,20589,10605,9984
202102,44133,충청남도,천안시 서북구,60-64세,20792,10721,10071
202103,44133,충청남도,천안시 서북구,60-64세,21060,10846,10214
202104,44133,충청남도,천안시 서북구,60-64세,21263,10972,10291
202105,44133,충청남도,천안시 서북구,60-64세,21461,11061,10400
202106,44133,충청남도,천안시 서북구,60-64세,21733,11200,10533
202007,44133,충청남도,천안시 서북구,65-69세,11486,5631,5855
202008,44133,충청남도,천안시 서북구,65-69세,11608,5709,5899
202009,44133,충청남도,천안시 서북구,65-69세,11744,5775,5969
202010,44133,충청남도,천안시 서북구,65-69세,11891,5842,6049
202011,44133,충청남도,천안시 서북구,65-69세,11972,5887,6085
202012,44133,충청남도,천안시 서북구,65-69세,12123,5970,6153
202101,44133,충청남도,천안시 서북구,65-69세,12255,6055,6200
202102,44133,충청남도,천안시 서북구,65-69세,12385,6130,6255
202103,44133,충청남도,천안시 서북구,65-69세,12535,6213,6322
202104,44133,충청남도,천안시 서북구,65-69세,12617,6258,6359
202105,44133,충청남도,천안시 서북구,65-69세,12762,6331,6431
202106,44133,충청남도,천안시 서북구,65-69세,12866,6381,6485
202007,44133,충청남도,천안시 서북구,70-74세,8096,3758,4338
202008,44133,충청남도,천안시 서북구,70-74세,8124,3759,4365
202009,44133,충청남도,천안시 서북구,70-74세,8184,3796,4388
202010,44133,충청남도,천안시 서북구,70-74세,8255,3837,4418
202011,44133,충청남도,천안시 서북구,70-74세,8322,3875,4447
202012,44133,충청남도,천안시 서북구,70-74세,8369,3892,4477
202101,44133,충청남도,천안시 서북구,70-74세,8457,3931,4526
202102,44133,충청남도,천안시 서북구,70-74세,8511,3959,4552
202103,44133,충청남도,천안시 서북구,70-74세,8469,3928,4541
202104,44133,충청남도,천안시 서북구,70-74세,8491,3923,4568
202105,44133,충청남도,천안시 서북구,70-74세,8525,3934,4591
202106,44133,충청남도,천안시 서북구,70-74세,8547,3943,4604
202007,44133,충청남도,천안시 서북구,75-79세,6323,2612,3711
202008,44133,충청남도,천안시 서북구,75-79세,6333,2628,3705
202009,44133,충청남도,천안시 서북구,75-79세,6287,2611,3676
202010,44133,충청남도,천안시 서북구,75-79세,6281,2608,3673
202011,44133,충청남도,천안시 서북구,75-79세,6270,2603,3667
202012,44133,충청남도,천안시 서북구,75-79세,6215,2592,3623
202101,44133,충청남도,천안시 서북구,75-79세,6199,2586,3613
202102,44133,충청남도,천안시 서북구,75-79세,6180,2587,3593
202103,44133,충청남도,천안시 서북구,75-79세,6183,2608,3575
202104,44133,충청남도,천안시 서북구,75-79세,6179,2624,3555
202105,44133,충청남도,천안시 서북구,75-79세,6173,2621,3552
202106,44133,충청남도,천안시 서북구,75-79세,6177,2625,3552
202007,44133,충청남도,천안시 서북구,80-84세,4571,1651,2920
202008,44133,충청남도,천안시 서북구,80-84세,4569,1649,2920
202009,44133,충청남도,천안시 서북구,80-84세,4609,1666,2943
202010,44133,충청남도,천안시 서북구,80-84세,4633,1665,2968
202011,44133,충청남도,천안시 서북구,80-84세,4627,1658,2969
202012,44133,충청남도,천안시 서북구,80-84세,4650,1654,2996
202101,44133,충청남도,천안시 서북구,80-84세,4640,1664,2976
202102,44133,충청남도,천안시 서북구,80-84세,4684,1680,3004
202103,44133,충청남도,천안시 서북구,80-84세,4665,1660,3005
202104,44133,충청남도,천안시 서북구,80-84세,4679,1661,3018
202105,44133,충청남도,천안시 서북구,80-84세,4694,1678,3016
202106,44133,충청남도,천안시 서북구,80-84세,4721,1685,3036
202007,44133,충청남도,천안시 서북구,85-89세,2341,692,1649
202008,44133,충청남도,천안시 서북구,85-89세,2350,691,1659
202009,44133,충청남도,천안시 서북구,85-89세,2365,690,1675
202010,44133,충청남도,천안시 서북구,85-89세,2398,706,1692
202011,44133,충청남도,천안시 서북구,85-89세,2426,722,1704
202012,44133,충청남도,천안시 서북구,85-89세,2454,739,1715
202101,44133,충청남도,천안시 서북구,85-89세,2482,749,1733
202102,44133,충청남도,천안시 서북구,85-89세,2514,759,1755
202103,44133,충청남도,천안시 서북구,85-89세,2536,770,1766
202104,44133,충청남도,천안시 서북구,85-89세,2552,776,1776
202105,44133,충청남도,천안시 서북구,85-89세,2591,784,1807
202106,44133,충청남도,천안시 서북구,85-89세,2598,785,1813
202007,44133,충청남도,천안시 서북구,90-94세,802,187,615
202008,44133,충청남도,천안시 서북구,90-94세,812,188,624
202009,44133,충청남도,천안시 서북구,90-94세,823,192,631
202010,44133,충청남도,천안시 서북구,90-94세,822,189,633
202011,44133,충청남도,천안시 서북구,90-94세,827,183,644
202012,44133,충청남도,천안시 서북구,90-94세,828,181,647
202101,44133,충청남도,천안시 서북구,90-94세,833,180,653
202102,44133,충청남도,천안시 서북구,90-94세,830,181,649
202103,44133,충청남도,천안시 서북구,90-94세,836,176,660
202104,44133,충청남도,천안시 서북구,90-94세,828,173,655
202105,44133,충청남도,천안시 서북구,90-94세,839,183,656
202106,44133,충청남도,천안시 서북구,90-94세,850,183,667
202007,44133,충청남도,천안시 서북구,95-99세,176,37,139
202008,44133,충청남도,천안시 서북구,95-99세,177,40,137
202009,44133,충청남도,천안시 서북구,95-99세,190,43,147
202010,44133,충청남도,천안시 서북구,95-99세,186,42,144
202011,44133,충청남도,천안시 서북구,95-99세,190,44,146
202012,44133,충청남도,천안시 서북구,95-99세,188,41,147
202101,44133,충청남도,천안시 서북구,95-99세,188,40,148
202102,44133,충청남도,천안시 서북구,95-99세,192,37,155
202103,44133,충청남도,천안시 서북구,95-99세,188,33,155
202104,44133,충청남도,천안시 서북구,95-99세,188,34,154
202105,44133,충청남도,천안시 서북구,95-99세,187,33,154
202106,44133,충청남도,천안시 서북구,95-99세,185,32,153
202007,44133,충청남도,천안시 서북구,100+,84,23,61
202008,44133,충청남도,천안시 서북구,100+,86,23,63
202009,44133,충청남도,천안시 서북구,100+,86,23,63
202010,44133,충청남도,천안시 서북구,100+,87,23,64
202011,44133,충청남도,천안시 서북구,100+,87,23,64
202012,44133,충청남도,천안시 서북구,100+,88,24,64
202101,44133,충청남도,천안시 서북구,100+,91,25,66
202102,44133,충청남도,천안시 서북구,100+,92,26,66
202103,44133,충청남도,천안시 서북구,100+,40,8,32
202104,44133,충청남도,천안시 서북구,100+,38,8,30
202105,44133,충청남도,천안시 서북구,100+,37,7,30
202106,44133,충청남도,천안시 서북구,100+,37,7,30
202007,44150,충청남도,공주시,0-4세,2499,1282,1217
202008,44150,충청남도,공주시,0-4세,2455,1265,1190
202009,44150,충청남도,공주시,0-4세,2429,1255,1174
202010,44150,충청남도,공주시,0-4세,2383,1230,1153
202011,44150,충청남도,공주시,0-4세,2347,1209,1138
202012,44150,충청남도,공주시,0-4세,2332,1208,1124
202101,44150,충청남도,공주시,0-4세,2317,1207,1110
202102,44150,충청남도,공주시,0-4세,2279,1186,1093
202103,44150,충청남도,공주시,0-4세,2262,1173,1089
202104,44150,충청남도,공주시,0-4세,2260,1174,1086
202105,44150,충청남도,공주시,0-4세,2253,1169,1084
202106,44150,충청남도,공주시,0-4세,2235,1152,1083
202007,44150,충청남도,공주시,5-9세,3526,1847,1679
202008,44150,충청남도,공주시,5-9세,3535,1848,1687
202009,44150,충청남도,공주시,5-9세,3516,1842,1674
202010,44150,충청남도,공주시,5-9세,3490,1823,1667
202011,44150,충청남도,공주시,5-9세,3477,1815,1662
202012,44150,충청남도,공주시,5-9세,3441,1792,1649
202101,44150,충청남도,공주시,5-9세,3407,1764,1643
202102,44150,충청남도,공주시,5-9세,3402,1759,1643
202103,44150,충청남도,공주시,5-9세,3389,1756,1633
202104,44150,충청남도,공주시,5-9세,3362,1740,1622
202105,44150,충청남도,공주시,5-9세,3340,1732,1608
202106,44150,충청남도,공주시,5-9세,3328,1728,1600
202007,44150,충청남도,공주시,10-14세,3851,1976,1875
202008,44150,충청남도,공주시,10-14세,3833,1958,1875
202009,44150,충청남도,공주시,10-14세,3840,1973,1867
202010,44150,충청남도,공주시,10-14세,3843,1977,1866
202011,44150,충청남도,공주시,10-14세,3831,1979,1852
202012,44150,충청남도,공주시,10-14세,3825,1980,1845
202101,44150,충청남도,공주시,10-14세,3842,1992,1850
202102,44150,충청남도,공주시,10-14세,3822,1984,1838
202103,44150,충청남도,공주시,10-14세,3831,1995,1836
202104,44150,충청남도,공주시,10-14세,3826,1997,1829
202105,44150,충청남도,공주시,10-14세,3841,2012,1829
202106,44150,충청남도,공주시,10-14세,3826,2000,1826
202007,44150,충청남도,공주시,15-19세,4588,2383,2205
202008,44150,충청남도,공주시,15-19세,4564,2368,2196
202009,44150,충청남도,공주시,15-19세,4511,2335,2176
202010,44150,충청남도,공주시,15-19세,4464,2309,2155
202011,44150,충청남도,공주시,15-19세,4397,2270,2127
202012,44150,충청남도,공주시,15-19세,4334,2240,2094
202101,44150,충청남도,공주시,15-19세,4312,2220,2092
202102,44150,충청남도,공주시,15-19세,4278,2210,2068
202103,44150,충청남도,공주시,15-19세,4272,2196,2076
202104,44150,충청남도,공주시,15-19세,4248,2174,2074
202105,44150,충청남도,공주시,15-19세,4214,2150,2064
202106,44150,충청남도,공주시,15-19세,4200,2140,2060
202007,44150,충청남도,공주시,20-24세,6249,3344,2905
202008,44150,충청남도,공주시,20-24세,6216,3334,2882
202009,44150,충청남도,공주시,20-24세,6186,3306,2880
202010,44150,충청남도,공주시,20-24세,6140,3276,2864
202011,44150,충청남도,공주시,20-24세,6144,3267,2877
202012,44150,충청남도,공주시,20-24세,6119,3237,2882
202101,44150,충청남도,공주시,20-24세,6054,3219,2835
202102,44150,충청남도,공주시,20-24세,5999,3176,2823
202103,44150,충청남도,공주시,20-24세,5977,3149,2828
202104,44150,충청남도,공주시,20-24세,5983,3135,2848
202105,44150,충청남도,공주시,20-24세,5952,3116,2836
202106,44150,충청남도,공주시,20-24세,5906,3086,2820
202007,44150,충청남도,공주시,25-29세,5195,3020,2175
202008,44150,충청남도,공주시,25-29세,5186,3018,2168
202009,44150,충청남도,공주시,25-29세,5193,3022,2171
202010,44150,충청남도,공주시,25-29세,5204,3027,2177
202011,44150,충청남도,공주시,25-29세,5202,3024,2178
202012,44150,충청남도,공주시,25-29세,5157,2994,2163
202101,44150,충청남도,공주시,25-29세,5145,2985,2160
202102,44150,충청남도,공주시,25-29세,5092,2944,2148
202103,44150,충청남도,공주시,25-29세,5053,2912,2141
202104,44150,충청남도,공주시,25-29세,5034,2911,2123
202105,44150,충청남도,공주시,25-29세,5049,2920,2129
202106,44150,충청남도,공주시,25-29세,5044,2928,2116
202007,44150,충청남도,공주시,30-34세,4450,2414,2036
202008,44150,충청남도,공주시,30-34세,4439,2405,2034
202009,44150,충청남도,공주시,30-34세,4404,2381,2023
202010,44150,충청남도,공주시,30-34세,4403,2393,2010
202011,44150,충청남도,공주시,30-34세,4372,2382,1990
202012,44150,충청남도,공주시,30-34세,4348,2376,1972
202101,44150,충청남도,공주시,30-34세,4315,2369,1946
202102,44150,충청남도,공주시,30-34세,4290,2360,1930
202103,44150,충청남도,공주시,30-34세,4277,2363,1914
202104,44150,충청남도,공주시,30-34세,4282,2358,1924
202105,44150,충청남도,공주시,30-34세,4296,2372,1924
202106,44150,충청남도,공주시,30-34세,4310,2380,1930
202007,44150,충청남도,공주시,35-39세,5283,2770,2513
202008,44150,충청남도,공주시,35-39세,5268,2764,2504
202009,44150,충청남도,공주시,35-39세,5220,2747,2473
202010,44150,충청남도,공주시,35-39세,5173,2714,2459
202011,44150,충청남도,공주시,35-39세,5135,2691,2444
202012,44150,충청남도,공주시,35-39세,5141,2687,2454
202101,44150,충청남도,공주시,35-39세,5131,2692,2439
202102,44150,충청남도,공주시,35-39세,5116,2696,2420
202103,44150,충청남도,공주시,35-39세,5070,2664,2406
202104,44150,충청남도,공주시,35-39세,5009,2634,2375
202105,44150,충청남도,공주시,35-39세,4961,2613,2348
202106,44150,충청남도,공주시,35-39세,4919,2581,2338
202007,44150,충청남도,공주시,40-44세,5979,3160,2819
202008,44150,충청남도,공주시,40-44세,5971,3146,2825
202009,44150,충청남도,공주시,40-44세,6010,3163,2847
202010,44150,충청남도,공주시,40-44세,6029,3187,2842
202011,44150,충청남도,공주시,40-44세,6005,3176,2829
202012,44150,충청남도,공주시,40-44세,5973,3166,2807
202101,44150,충청남도,공주시,40-44세,5965,3155,2810
202102,44150,충청남도,공주시,40-44세,5966,3150,2816
202103,44150,충청남도,공주시,40-44세,5913,3114,2799
202104,44150,충청남도,공주시,40-44세,5935,3126,2809
202105,44150,충청남도,공주시,40-44세,5937,3120,2817
202106,44150,충청남도,공주시,40-44세,5967,3148,2819
202007,44150,충청남도,공주시,45-49세,7598,4009,3589
202008,44150,충청남도,공주시,45-49세,7547,3987,3560
202009,44150,충청남도,공주시,45-49세,7467,3942,3525
202010,44150,충청남도,공주시,45-49세,7397,3908,3489
202011,44150,충청남도,공주시,45-49세,7337,3865,3472
202012,44150,충청남도,공주시,45-49세,7343,3873,3470
202101,44150,충청남도,공주시,45-49세,7348,3870,3478
202102,44150,충청남도,공주시,45-49세,7295,3847,3448
202103,44150,충청남도,공주시,45-49세,7244,3837,3407
202104,44150,충청남도,공주시,45-49세,7248,3837,3411
202105,44150,충청남도,공주시,45-49세,7151,3788,3363
202106,44150,충청남도,공주시,45-49세,7097,3748,3349
202007,44150,충청남도,공주시,50-54세,8472,4437,4035
202008,44150,충청남도,공주시,50-54세,8512,4461,4051
202009,44150,충청남도,공주시,50-54세,8514,4462,4052
202010,44150,충청남도,공주시,50-54세,8532,4466,4066
202011,44150,충청남도,공주시,50-54세,8545,4474,4071
202012,44150,충청남도,공주시,50-54세,8523,4467,4056
202101,44150,충청남도,공주시,50-54세,8561,4492,4069
202102,44150,충청남도,공주시,50-54세,8599,4500,4099
202103,44150,충청남도,공주시,50-54세,8541,4467,4074
202104,44150,충청남도,공주시,50-54세,8564,4480,4084
202105,44150,충청남도,공주시,50-54세,8639,4527,4112
202106,44150,충청남도,공주시,50-54세,8685,4545,4140
202007,44150,충청남도,공주시,55-59세,10211,5236,4975
202008,44150,충청남도,공주시,55-59세,10217,5231,4986
202009,44150,충청남도,공주시,55-59세,10165,5204,4961
202010,44150,충청남도,공주시,55-59세,10078,5139,4939
202011,44150,충청남도,공주시,55-59세,10007,5086,4921
202012,44150,충청남도,공주시,55-59세,9922,5033,4889
202101,44150,충청남도,공주시,55-59세,9776,4954,4822
202102,44150,충청남도,공주시,55-59세,9721,4923,4798
202103,44150,충청남도,공주시,55-59세,9622,4897,4725
202104,44150,충청남도,공주시,55-59세,9512,4839,4673
202105,44150,충청남도,공주시,55-59세,9397,4775,4622
202106,44150,충청남도,공주시,55-59세,9283,4710,4573
202007,44150,충청남도,공주시,60-64세,10213,5099,5114
202008,44150,충청남도,공주시,60-64세,10195,5085,5110
202009,44150,충청남도,공주시,60-64세,10232,5098,5134
202010,44150,충청남도,공주시,60-64세,10255,5134,5121
202011,44150,충청남도,공주시,60-64세,10301,5158,5143
202012,44150,충청남도,공주시,60-64세,10412,5216,5196
202101,44150,충청남도,공주시,60-64세,10498,5276,5222
202102,44150,충청남도,공주시,60-64세,10578,5300,5278
202103,44150,충청남도,공주시,60-64세,10579,5305,5274
202104,44150,충청남도,공주시,60-64세,10642,5341,5301
202105,44150,충청남도,공주시,60-64세,10730,5384,5346
202106,44150,충청남도,공주시,60-64세,10821,5447,5374
202007,44150,충청남도,공주시,65-69세,7698,3844,3854
202008,44150,충청남도,공주시,65-69세,7786,3885,3901
202009,44150,충청남도,공주시,65-69세,7858,3921,3937
202010,44150,충청남도,공주시,65-69세,7926,3940,3986
202011,44150,충청남도,공주시,65-69세,7960,3964,3996
202012,44150,충청남도,공주시,65-69세,8012,3985,4027
202101,44150,충청남도,공주시,65-69세,8055,4015,4040
202102,44150,충청남도,공주시,65-69세,8100,4044,4056
202103,44150,충청남도,공주시,65-69세,8168,4089,4079
202104,44150,충청남도,공주시,65-69세,8246,4131,4115
202105,44150,충청남도,공주시,65-69세,8307,4174,4133
202106,44150,충청남도,공주시,65-69세,8310,4167,4143
202007,44150,충청남도,공주시,70-74세,5966,2935,3031
202008,44150,충청남도,공주시,70-74세,5994,2958,3036
202009,44150,충청남도,공주시,70-74세,6034,2985,3049
202010,44150,충청남도,공주시,70-74세,6073,3012,3061
202011,44150,충청남도,공주시,70-74세,6119,3045,3074
202012,44150,충청남도,공주시,70-74세,6175,3072,3103
202101,44150,충청남도,공주시,70-74세,6249,3107,3142
202102,44150,충청남도,공주시,70-74세,6281,3133,3148
202103,44150,충청남도,공주시,70-74세,6233,3109,3124
202104,44150,충청남도,공주시,70-74세,6233,3114,3119
202105,44150,충청남도,공주시,70-74세,6278,3131,3147
202106,44150,충청남도,공주시,70-74세,6300,3136,3164
202007,44150,충청남도,공주시,75-79세,5503,2295,3208
202008,44150,충청남도,공주시,75-79세,5493,2286,3207
202009,44150,충청남도,공주시,75-79세,5451,2267,3184
202010,44150,충청남도,공주시,75-79세,5396,2243,3153
202011,44150,충청남도,공주시,75-79세,5360,2219,3141
202012,44150,충청남도,공주시,75-79세,5303,2192,3111
202101,44150,충청남도,공주시,75-79세,5245,2165,3080
202102,44150,충청남도,공주시,75-79세,5233,2161,3072
202103,44150,충청남도,공주시,75-79세,5182,2144,3038
202104,44150,충청남도,공주시,75-79세,5149,2126,3023
202105,44150,충청남도,공주시,75-79세,5114,2120,2994
202106,44150,충청남도,공주시,75-79세,5099,2124,2975
202007,44150,충청남도,공주시,80-84세,4453,1611,2842
202008,44150,충청남도,공주시,80-84세,4460,1615,2845
202009,44150,충청남도,공주시,80-84세,4444,1609,2835
202010,44150,충청남도,공주시,80-84세,4458,1623,2835
202011,44150,충청남도,공주시,80-84세,4432,1619,2813
202012,44150,충청남도,공주시,80-84세,4419,1622,2797
202101,44150,충청남도,공주시,80-84세,4437,1627,2810
202102,44150,충청남도,공주시,80-84세,4412,1619,2793
202103,44150,충청남도,공주시,80-84세,4376,1619,2757
202104,44150,충청남도,공주시,80-84세,4360,1624,2736
202105,44150,충청남도,공주시,80-84세,4374,1625,2749
202106,44150,충청남도,공주시,80-84세,4392,1627,2765
202007,44150,충청남도,공주시,85-89세,2622,848,1774
202008,44150,충청남도,공주시,85-89세,2630,852,1778
202009,44150,충청남도,공주시,85-89세,2651,866,1785
202010,44150,충청남도,공주시,85-89세,2651,859,1792
202011,44150,충청남도,공주시,85-89세,2679,866,1813
202012,44150,충청남도,공주시,85-89세,2667,871,1796
202101,44150,충청남도,공주시,85-89세,2682,879,1803
202102,44150,충청남도,공주시,85-89세,2744,897,1847
202103,44150,충청남도,공주시,85-89세,2763,902,1861
202104,44150,충청남도,공주시,85-89세,2783,897,1886
202105,44150,충청남도,공주시,85-89세,2799,904,1895
202106,44150,충청남도,공주시,85-89세,2791,898,1893
202007,44150,충청남도,공주시,90-94세,816,224,592
202008,44150,충청남도,공주시,90-94세,822,225,597
202009,44150,충청남도,공주시,90-94세,832,225,607
202010,44150,충청남도,공주시,90-94세,838,228,610
202011,44150,충청남도,공주시,90-94세,850,232,618
202012,44150,충청남도,공주시,90-94세,858,229,629
202101,44150,충청남도,공주시,90-94세,863,229,634
202102,44150,충청남도,공주시,90-94세,868,231,637
202103,44150,충청남도,공주시,90-94세,876,234,642
202104,44150,충청남도,공주시,90-94세,892,239,653
202105,44150,충청남도,공주시,90-94세,905,241,664
202106,44150,충청남도,공주시,90-94세,911,240,671
202007,44150,충청남도,공주시,95-99세,164,35,129
202008,44150,충청남도,공주시,95-99세,170,37,133
202009,44150,충청남도,공주시,95-99세,174,40,134
202010,44150,충청남도,공주시,95-99세,178,41,137
202011,44150,충청남도,공주시,95-99세,174,40,134
202012,44150,충청남도,공주시,95-99세,179,44,135
202101,44150,충청남도,공주시,95-99세,177,42,135
202102,44150,충청남도,공주시,95-99세,181,43,138
202103,44150,충청남도,공주시,95-99세,173,39,134
202104,44150,충청남도,공주시,95-99세,176,40,136
202105,44150,충청남도,공주시,95-99세,177,43,134
202106,44150,충청남도,공주시,95-99세,176,42,134
202007,44150,충청남도,공주시,100+,60,13,47
202008,44150,충청남도,공주시,100+,60,13,47
202009,44150,충청남도,공주시,100+,61,13,48
202010,44150,충청남도,공주시,100+,61,13,48
202011,44150,충청남도,공주시,100+,62,13,49
202012,44150,충청남도,공주시,100+,62,13,49
202101,44150,충청남도,공주시,100+,63,14,49
202102,44150,충청남도,공주시,100+,63,14,49
202103,44150,충청남도,공주시,100+,38,8,30
202104,44150,충청남도,공주시,100+,38,8,30
202105,44150,충청남도,공주시,100+,38,8,30
202106,44150,충청남도,공주시,100+,40,8,32
202007,44180,충청남도,보령시,0-4세,2634,1338,1296
202008,44180,충청남도,보령시,0-4세,2600,1325,1275
202009,44180,충청남도,보령시,0-4세,2582,1316,1266
202010,44180,충청남도,보령시,0-4세,2549,1297,1252
202011,44180,충청남도,보령시,0-4세,2527,1287,1240
202012,44180,충청남도,보령시,0-4세,2523,1279,1244
202101,44180,충청남도,보령시,0-4세,2494,1261,1233
202102,44180,충청남도,보령시,0-4세,2468,1244,1224
202103,44180,충청남도,보령시,0-4세,2438,1226,1212
202104,44180,충청남도,보령시,0-4세,2422,1226,1196
202105,44180,충청남도,보령시,0-4세,2400,1222,1178
202106,44180,충청남도,보령시,0-4세,2387,1223,1164
202007,44180,충청남도,보령시,5-9세,3710,1856,1854
202008,44180,충청남도,보령시,5-9세,3702,1845,1857
202009,44180,충청남도,보령시,5-9세,3683,1843,1840
202010,44180,충청남도,보령시,5-9세,3661,1828,1833
202011,44180,충청남도,보령시,5-9세,3650,1824,1826
202012,44180,충청남도,보령시,5-9세,3614,1806,1808
202101,44180,충청남도,보령시,5-9세,3571,1788,1783
202102,44180,충청남도,보령시,5-9세,3528,1774,1754
202103,44180,충청남도,보령시,5-9세,3521,1775,1746
202104,44180,충청남도,보령시,5-9세,3500,1757,1743
202105,44180,충청남도,보령시,5-9세,3487,1750,1737
202106,44180,충청남도,보령시,5-9세,3471,1739,1732
202007,44180,충청남도,보령시,10-14세,3963,2031,1932
202008,44180,충청남도,보령시,10-14세,3987,2043,1944
202009,44180,충청남도,보령시,10-14세,3976,2036,1940
202010,44180,충청남도,보령시,10-14세,3968,2033,1935
202011,44180,충청남도,보령시,10-14세,3981,2034,1947
202012,44180,충청남도,보령시,10-14세,3976,2038,1938
202101,44180,충청남도,보령시,10-14세,3993,2051,1942
202102,44180,충청남도,보령시,10-14세,3995,2049,1946
202103,44180,충청남도,보령시,10-14세,3995,2057,1938
202104,44180,충청남도,보령시,10-14세,4002,2050,1952
202105,44180,충청남도,보령시,10-14세,4006,2048,1958
202106,44180,충청남도,보령시,10-14세,4009,2046,1963
202007,44180,충청남도,보령시,15-19세,4491,2364,2127
202008,44180,충청남도,보령시,15-19세,4443,2335,2108
202009,44180,충청남도,보령시,15-19세,4410,2321,2089
202010,44180,충청남도,보령시,15-19세,4385,2306,2079
202011,44180,충청남도,보령시,15-19세,4348,2280,2068
202012,44180,충청남도,보령시,15-19세,4319,2268,2051
202101,44180,충청남도,보령시,15-19세,4266,2236,2030
202102,44180,충청남도,보령시,15-19세,4220,2218,2002
202103,44180,충청남도,보령시,15-19세,4161,2185,1976
202104,44180,충청남도,보령시,15-19세,4146,2189,1957
202105,44180,충청남도,보령시,15-19세,4133,2177,1956
202106,44180,충청남도,보령시,15-19세,4126,2173,1953
202007,44180,충청남도,보령시,20-24세,5091,2950,2141
202008,44180,충청남도,보령시,20-24세,5099,2964,2135
202009,44180,충청남도,보령시,20-24세,5086,2960,2126
202010,44180,충청남도,보령시,20-24세,5102,2978,2124
202011,44180,충청남도,보령시,20-24세,5089,2972,2117
202012,44180,충청남도,보령시,20-24세,5077,2960,2117
202101,44180,충청남도,보령시,20-24세,5040,2927,2113
202102,44180,충청남도,보령시,20-24세,4985,2894,2091
202103,44180,충청남도,보령시,20-24세,4965,2886,2079
202104,44180,충청남도,보령시,20-24세,4943,2863,2080
202105,44180,충청남도,보령시,20-24세,4924,2868,2056
202106,44180,충청남도,보령시,20-24세,4894,2853,2041
202007,44180,충청남도,보령시,25-29세,4507,2669,1838
202008,44180,충청남도,보령시,25-29세,4494,2663,1831
202009,44180,충청남도,보령시,25-29세,4488,2660,1828
202010,44180,충청남도,보령시,25-29세,4457,2643,1814
202011,44180,충청남도,보령시,25-29세,4431,2629,1802
202012,44180,충청남도,보령시,25-29세,4451,2638,1813
202101,44180,충청남도,보령시,25-29세,4444,2641,1803
202102,44180,충청남도,보령시,25-29세,4423,2632,1791
202103,44180,충청남도,보령시,25-29세,4409,2622,1787
202104,44180,충청남도,보령시,25-29세,4387,2621,1766
202105,44180,충청남도,보령시,25-29세,4410,2636,1774
202106,44180,충청남도,보령시,25-29세,4415,2643,1772
202007,44180,충청남도,보령시,30-34세,4116,2241,1875
202008,44180,충청남도,보령시,30-34세,4091,2237,1854
202009,44180,충청남도,보령시,30-34세,4085,2235,1850
202010,44180,충청남도,보령시,30-34세,4075,2231,1844
202011,44180,충청남도,보령시,30-34세,4064,2227,1837
202012,44180,충청남도,보령시,30-34세,4074,2227,1847
202101,44180,충청남도,보령시,30-34세,4044,2203,1841
202102,44180,충청남도,보령시,30-34세,3983,2180,1803
202103,44180,충청남도,보령시,30-34세,3981,2180,1801
202104,44180,충청남도,보령시,30-34세,3979,2179,1800
202105,44180,충청남도,보령시,30-34세,3966,2180,1786
202106,44180,충청남도,보령시,30-34세,3965,2188,1777
202007,44180,충청남도,보령시,35-39세,5541,2974,2567
202008,44180,충청남도,보령시,35-39세,5497,2946,2551
202009,44180,충청남도,보령시,35-39세,5462,2919,2543
202010,44180,충청남도,보령시,35-39세,5430,2905,2525
202011,44180,충청남도,보령시,35-39세,5434,2910,2524
202012,44180,충청남도,보령시,35-39세,5387,2894,2493
202101,44180,충청남도,보령시,35-39세,5315,2862,2453
202102,44180,충청남도,보령시,35-39세,5249,2834,2415
202103,44180,충청남도,보령시,35-39세,5198,2808,2390
202104,44180,충청남도,보령시,35-39세,5182,2788,2394
202105,44180,충청남도,보령시,35-39세,5156,2771,2385
202106,44180,충청남도,보령시,35-39세,5128,2755,2373
202007,44180,충청남도,보령시,40-44세,6348,3469,2879
202008,44180,충청남도,보령시,40-44세,6338,3466,2872
202009,44180,충청남도,보령시,40-44세,6331,3477,2854
202010,44180,충청남도,보령시,40-44세,6331,3479,2852
202011,44180,충청남도,보령시,40-44세,6281,3446,2835
202012,44180,충청남도,보령시,40-44세,6223,3416,2807
202101,44180,충청남도,보령시,40-44세,6186,3396,2790
202102,44180,충청남도,보령시,40-44세,6201,3396,2805
202103,44180,충청남도,보령시,40-44세,6144,3361,2783
202104,44180,충청남도,보령시,40-44세,6118,3357,2761
202105,44180,충청남도,보령시,40-44세,6092,3344,2748
202106,44180,충청남도,보령시,40-44세,6118,3361,2757
202007,44180,충청남도,보령시,45-49세,7779,4277,3502
202008,44180,충청남도,보령시,45-49세,7781,4281,3500
202009,44180,충청남도,보령시,45-49세,7740,4256,3484
202010,44180,충청남도,보령시,45-49세,7689,4232,3457
202011,44180,충청남도,보령시,45-49세,7700,4239,3461
202012,44180,충청남도,보령시,45-49세,7722,4234,3488
202101,44180,충청남도,보령시,45-49세,7711,4220,3491
202102,44180,충청남도,보령시,45-49세,7682,4196,3486
202103,44180,충청남도,보령시,45-49세,7597,4161,3436
202104,44180,충청남도,보령시,45-49세,7585,4144,3441
202105,44180,충청남도,보령시,45-49세,7531,4123,3408
202106,44180,충청남도,보령시,45-49세,7506,4113,3393
202007,44180,충청남도,보령시,50-54세,8029,4366,3663
202008,44180,충청남도,보령시,50-54세,8015,4355,3660
202009,44180,충청남도,보령시,50-54세,8055,4383,3672
202010,44180,충청남도,보령시,50-54세,8098,4407,3691
202011,44180,충청남도,보령시,50-54세,8127,4431,3696
202012,44180,충청남도,보령시,50-54세,8112,4440,3672
202101,44180,충청남도,보령시,50-54세,8139,4447,3692
202102,44180,충청남도,보령시,50-54세,8131,4440,3691
202103,44180,충청남도,보령시,50-54세,8139,4448,3691
202104,44180,충청남도,보령시,50-54세,8120,4440,3680
202105,44180,충청남도,보령시,50-54세,8158,4449,3709
202106,44180,충청남도,보령시,50-54세,8152,4433,3719
202007,44180,충청남도,보령시,55-59세,9299,4875,4424
202008,44180,충청남도,보령시,55-59세,9257,4842,4415
202009,44180,충청남도,보령시,55-59세,9197,4800,4397
202010,44180,충청남도,보령시,55-59세,9165,4771,4394
202011,44180,충청남도,보령시,55-59세,9110,4748,4362
202012,44180,충청남도,보령시,55-59세,9100,4729,4371
202101,44180,충청남도,보령시,55-59세,8936,4663,4273
202102,44180,충청남도,보령시,55-59세,8877,4618,4259
202103,44180,충청남도,보령시,55-59세,8727,4552,4175
202104,44180,충청남도,보령시,55-59세,8671,4534,4137
202105,44180,충청남도,보령시,55-59세,8569,4499,4070
202106,44180,충청남도,보령시,55-59세,8481,4459,4022
202007,44180,충청남도,보령시,60-64세,9288,4609,4679
202008,44180,충청남도,보령시,60-64세,9335,4651,4684
202009,44180,충청남도,보령시,60-64세,9344,4662,4682
202010,44180,충청남도,보령시,60-64세,9346,4676,4670
202011,44180,충청남도,보령시,60-64세,9391,4696,4695
202012,44180,충청남도,보령시,60-64세,9440,4738,4702
202101,44180,충청남도,보령시,60-64세,9528,4759,4769
202102,44180,충청남도,보령시,60-64세,9533,4781,4752
202103,44180,충청남도,보령시,60-64세,9568,4801,4767
202104,44180,충청남도,보령시,60-64세,9638,4822,4816
202105,44180,충청남도,보령시,60-64세,9719,4860,4859
202106,44180,충청남도,보령시,60-64세,9825,4913,4912
202007,44180,충청남도,보령시,65-69세,7381,3535,3846
202008,44180,충청남도,보령시,65-69세,7426,3563,3863
202009,44180,충청남도,보령시,65-69세,7477,3585,3892
202010,44180,충청남도,보령시,65-69세,7556,3626,3930
202011,44180,충청남도,보령시,65-69세,7600,3644,3956
202012,44180,충청남도,보령시,65-69세,7647,3670,3977
202101,44180,충청남도,보령시,65-69세,7712,3699,4013
202102,44180,충청남도,보령시,65-69세,7771,3712,4059
202103,44180,충청남도,보령시,65-69세,7832,3744,4088
202104,44180,충청남도,보령시,65-69세,7867,3760,4107
202105,44180,충청남도,보령시,65-69세,7870,3769,4101
202106,44180,충청남도,보령시,65-69세,7873,3775,4098
202007,44180,충청남도,보령시,70-74세,6079,2858,3221
202008,44180,충청남도,보령시,70-74세,6096,2856,3240
202009,44180,충청남도,보령시,70-74세,6153,2875,3278
202010,44180,충청남도,보령시,70-74세,6185,2891,3294
202011,44180,충청남도,보령시,70-74세,6220,2911,3309
202012,44180,충청남도,보령시,70-74세,6279,2934,3345
202101,44180,충청남도,보령시,70-74세,6306,2960,3346
202102,44180,충청남도,보령시,70-74세,6309,2963,3346
202103,44180,충청남도,보령시,70-74세,6285,2955,3330
202104,44180,충청남도,보령시,70-74세,6303,2966,3337
202105,44180,충청남도,보령시,70-74세,6338,2977,3361
202106,44180,충청남도,보령시,70-74세,6351,2985,3366
202007,44180,충청남도,보령시,75-79세,5149,2154,2995
202008,44180,충청남도,보령시,75-79세,5165,2155,3010
202009,44180,충청남도,보령시,75-79세,5110,2127,2983
202010,44180,충청남도,보령시,75-79세,5084,2116,2968
202011,44180,충청남도,보령시,75-79세,5034,2088,2946
202012,44180,충청남도,보령시,75-79세,5000,2085,2915
202101,44180,충청남도,보령시,75-79세,4978,2088,2890
202102,44180,충청남도,보령시,75-79세,4977,2093,2884
202103,44180,충청남도,보령시,75-79세,4948,2090,2858
202104,44180,충청남도,보령시,75-79세,4926,2095,2831
202105,44180,충청남도,보령시,75-79세,4917,2090,2827
202106,44180,충청남도,보령시,75-79세,4908,2088,2820
202007,44180,충청남도,보령시,80-84세,4102,1539,2563
202008,44180,충청남도,보령시,80-84세,4093,1541,2552
202009,44180,충청남도,보령시,80-84세,4075,1534,2541
202010,44180,충청남도,보령시,80-84세,4064,1528,2536
202011,44180,충청남도,보령시,80-84세,4062,1539,2523
202012,44180,충청남도,보령시,80-84세,4051,1527,2524
202101,44180,충청남도,보령시,80-84세,4050,1529,2521
202102,44180,충청남도,보령시,80-84세,4037,1519,2518
202103,44180,충청남도,보령시,80-84세,4043,1532,2511
202104,44180,충청남도,보령시,80-84세,4025,1520,2505
202105,44180,충청남도,보령시,80-84세,4029,1522,2507
202106,44180,충청남도,보령시,80-84세,4040,1524,2516
202007,44180,충청남도,보령시,85-89세,2145,661,1484
202008,44180,충청남도,보령시,85-89세,2169,672,1497
202009,44180,충청남도,보령시,85-89세,2196,684,1512
202010,44180,충청남도,보령시,85-89세,2216,693,1523
202011,44180,충청남도,보령시,85-89세,2210,698,1512
202012,44180,충청남도,보령시,85-89세,2238,710,1528
202101,44180,충청남도,보령시,85-89세,2250,712,1538
202102,44180,충청남도,보령시,85-89세,2280,734,1546
202103,44180,충청남도,보령시,85-89세,2287,733,1554
202104,44180,충청남도,보령시,85-89세,2322,744,1578
202105,44180,충청남도,보령시,85-89세,2351,754,1597
202106,44180,충청남도,보령시,85-89세,2353,746,1607
202007,44180,충청남도,보령시,90-94세,720,163,557
202008,44180,충청남도,보령시,90-94세,724,162,562
202009,44180,충청남도,보령시,90-94세,737,168,569
202010,44180,충청남도,보령시,90-94세,741,172,569
202011,44180,충청남도,보령시,90-94세,751,172,579
202012,44180,충청남도,보령시,90-94세,759,175,584
202101,44180,충청남도,보령시,90-94세,758,175,583
202102,44180,충청남도,보령시,90-94세,781,181,600
202103,44180,충청남도,보령시,90-94세,788,181,607
202104,44180,충청남도,보령시,90-94세,794,183,611
202105,44180,충청남도,보령시,90-94세,786,184,602
202106,44180,충청남도,보령시,90-94세,786,186,600
202007,44180,충청남도,보령시,95-99세,169,27,142
202008,44180,충청남도,보령시,95-99세,165,26,139
202009,44180,충청남도,보령시,95-99세,167,27,140
202010,44180,충청남도,보령시,95-99세,171,25,146
202011,44180,충청남도,보령시,95-99세,175,26,149
202012,44180,충청남도,보령시,95-99세,172,26,146
202101,44180,충청남도,보령시,95-99세,177,27,150
202102,44180,충청남도,보령시,95-99세,177,28,149
202103,44180,충청남도,보령시,95-99세,165,25,140
202104,44180,충청남도,보령시,95-99세,163,26,137
202105,44180,충청남도,보령시,95-99세,163,27,136
202106,44180,충청남도,보령시,95-99세,163,25,138
202007,44180,충청남도,보령시,100+,60,13,47
202008,44180,충청남도,보령시,100+,61,13,48
202009,44180,충청남도,보령시,100+,61,13,48
202010,44180,충청남도,보령시,100+,63,13,50
202011,44180,충청남도,보령시,100+,64,13,51
202012,44180,충청남도,보령시,100+,65,13,52
202101,44180,충청남도,보령시,100+,66,13,53
202102,44180,충청남도,보령시,100+,66,13,53
202103,44180,충청남도,보령시,100+,43,7,36
202104,44180,충청남도,보령시,100+,44,7,37
202105,44180,충청남도,보령시,100+,43,7,36
202106,44180,충청남도,보령시,100+,42,7,35
202007,44200,충청남도,아산시,0-4세,14334,7342,6992
202008,44200,충청남도,아산시,0-4세,14215,7245,6970
202009,44200,충청남도,아산시,0-4세,14139,7197,6942
202010,44200,충청남도,아산시,0-4세,13979,7121,6858
202011,44200,충청남도,아산시,0-4세,13855,7049,6806
202012,44200,충청남도,아산시,0-4세,13715,6990,6725
202101,44200,충청남도,아산시,0-4세,13509,6879,6630
202102,44200,충청남도,아산시,0-4세,13400,6838,6562
202103,44200,충청남도,아산시,0-4세,13265,6774,6491
202104,44200,충청남도,아산시,0-4세,13138,6704,6434
202105,44200,충청남도,아산시,0-4세,13061,6670,6391
202106,44200,충청남도,아산시,0-4세,13042,6657,6385
202007,44200,충청남도,아산시,5-9세,19383,9978,9405
202008,44200,충청남도,아산시,5-9세,19356,9988,9368
202009,44200,충청남도,아산시,5-9세,19364,10003,9361
202010,44200,충청남도,아산시,5-9세,19300,9955,9345
202011,44200,충청남도,아산시,5-9세,19267,9965,9302
202012,44200,충청남도,아산시,5-9세,19231,9929,9302
202101,44200,충청남도,아산시,5-9세,19212,9913,9299
202102,44200,충청남도,아산시,5-9세,19144,9858,9286
202103,44200,충청남도,아산시,5-9세,19128,9838,9290
202104,44200,충청남도,아산시,5-9세,19086,9824,9262
202105,44200,충청남도,아산시,5-9세,19031,9799,9232
202106,44200,충청남도,아산시,5-9세,19036,9821,9215
202007,44200,충청남도,아산시,10-14세,17975,9185,8790
202008,44200,충청남도,아산시,10-14세,18030,9225,8805
202009,44200,충청남도,아산시,10-14세,18085,9260,8825
202010,44200,충청남도,아산시,10-14세,18191,9325,8866
202011,44200,충청남도,아산시,10-14세,18305,9364,8941
202012,44200,충청남도,아산시,10-14세,18389,9419,8970
202101,44200,충청남도,아산시,10-14세,18445,9447,8998
202102,44200,충청남도,아산시,10-14세,18554,9503,9051
202103,44200,충청남도,아산시,10-14세,18648,9579,9069
202104,44200,충청남도,아산시,10-14세,18750,9639,9111
202105,44200,충청남도,아산시,10-14세,18778,9678,9100
202106,44200,충청남도,아산시,10-14세,18842,9705,9137
202007,44200,충청남도,아산시,15-19세,16260,8437,7823
202008,44200,충청남도,아산시,15-19세,16264,8449,7815
202009,44200,충청남도,아산시,15-19세,16196,8396,7800
202010,44200,충청남도,아산시,15-19세,16147,8357,7790
202011,44200,충청남도,아산시,15-19세,16096,8327,7769
202012,44200,충청남도,아산시,15-19세,16071,8304,7767
202101,44200,충청남도,아산시,15-19세,16088,8324,7764
202102,44200,충청남도,아산시,15-19세,16052,8294,7758
202103,44200,충청남도,아산시,15-19세,16056,8270,7786
202104,44200,충청남도,아산시,15-19세,16030,8220,7810
202105,44200,충청남도,아산시,15-19세,16043,8220,7823
202106,44200,충청남도,아산시,15-19세,16072,8241,7831
202007,44200,충청남도,아산시,20-24세,17526,9585,7941
202008,44200,충청남도,아산시,20-24세,17578,9611,7967
202009,44200,충청남도,아산시,20-24세,17607,9639,7968
202010,44200,충청남도,아산시,20-24세,17671,9691,7980
202011,44200,충청남도,아산시,20-24세,17689,9707,7982
202012,44200,충청남도,아산시,20-24세,17679,9690,7989
202101,44200,충청남도,아산시,20-24세,17662,9661,8001
202102,44200,충청남도,아산시,20-24세,17736,9710,8026
202103,44200,충청남도,아산시,20-24세,17699,9724,7975
202104,44200,충청남도,아산시,20-24세,17797,9790,8007
202105,44200,충청남도,아산시,20-24세,17828,9786,8042
202106,44200,충청남도,아산시,20-24세,17905,9832,8073
202007,44200,충청남도,아산시,25-29세,18370,10358,8012
202008,44200,충청남도,아산시,25-29세,18398,10348,8050
202009,44200,충청남도,아산시,25-29세,18430,10387,8043
202010,44200,충청남도,아산시,25-29세,18472,10400,8072
202011,44200,충청남도,아산시,25-29세,18675,10506,8169
202012,44200,충청남도,아산시,25-29세,18912,10641,8271
202101,44200,충청남도,아산시,25-29세,18947,10669,8278
202102,44200,충청남도,아산시,25-29세,19019,10694,8325
202103,44200,충청남도,아산시,25-29세,19200,10817,8383
202104,44200,충청남도,아산시,25-29세,19269,10881,8388
202105,44200,충청남도,아산시,25-29세,19303,10903,8400
202106,44200,충청남도,아산시,25-29세,19416,10957,8459
202007,44200,충청남도,아산시,30-34세,20354,10786,9568
202008,44200,충청남도,아산시,30-34세,20394,10821,9573
202009,44200,충청남도,아산시,30-34세,20378,10823,9555
202010,44200,충청남도,아산시,30-34세,20298,10803,9495
202011,44200,충청남도,아산시,30-34세,20309,10823,9486
202012,44200,충청남도,아산시,30-34세,20292,10844,9448
202101,44200,충청남도,아산시,30-34세,20343,10865,9478
202102,44200,충청남도,아산시,30-34세,20359,10876,9483
202103,44200,충청남도,아산시,30-34세,20444,10936,9508
202104,44200,충청남도,아산시,30-34세,20524,10978,9546
202105,44200,충청남도,아산시,30-34세,20617,11065,9552
202106,44200,충청남도,아산시,30-34세,20787,11153,9634
202007,44200,충청남도,아산시,35-39세,28369,15228,13141
202008,44200,충청남도,아산시,35-39세,28344,15256,13088
202009,44200,충청남도,아산시,35-39세,28241,15177,13064
202010,44200,충청남도,아산시,35-39세,28162,15112,13050
202011,44200,충청남도,아산시,35-39세,28114,15076,13038
202012,44200,충청남도,아산시,35-39세,28128,15051,13077
202101,44200,충청남도,아산시,35-39세,27947,14970,12977
202102,44200,충청남도,아산시,35-39세,27827,14882,12945
202103,44200,충청남도,아산시,35-39세,27674,14771,12903
202104,44200,충청남도,아산시,35-39세,27614,14702,12912
202105,44200,충청남도,아산시,35-39세,27519,14616,12903
202106,44200,충청남도,아산시,35-39세,27516,14614,12902
202007,44200,충청남도,아산시,40-44세,28221,15252,12969
202008,44200,충청남도,아산시,40-44세,28351,15278,13073
202009,44200,충청남도,아산시,40-44세,28553,15432,13121
202010,44200,충청남도,아산시,40-44세,28711,15518,13193
202011,44200,충청남도,아산시,40-44세,28896,15627,13269
202012,44200,충청남도,아산시,40-44세,28967,15699,13268
202101,44200,충청남도,아산시,40-44세,29165,15780,13385
202102,44200,충청남도,아산시,40-44세,29394,15904,13490
202103,44200,충청남도,아산시,40-44세,29423,15981,13442
202104,44200,충청남도,아산시,40-44세,29486,16021,13465
202105,44200,충청남도,아산시,40-44세,29583,16078,13505
202106,44200,충청남도,아산시,40-44세,29777,16169,13608
202007,44200,충청남도,아산시,45-49세,27342,14959,12383
202008,44200,충청남도,아산시,45-49세,27328,14959,12369
202009,44200,충청남도,아산시,45-49세,27306,14920,12386
202010,44200,충청남도,아산시,45-49세,27204,14871,12333
202011,44200,충청남도,아산시,45-49세,27192,14833,12359
202012,44200,충청남도,아산시,45-49세,27334,14890,12444
202101,44200,충청남도,아산시,45-49세,27495,14984,12511
202102,44200,충청남도,아산시,45-49세,27533,15001,12532
202103,44200,충청남도,아산시,45-49세,27554,14998,12556
202104,44200,충청남도,아산시,45-49세,27652,15017,12635
202105,44200,충청남도,아산시,45-49세,27557,14963,12594
202106,44200,충청남도,아산시,45-49세,27583,14970,12613
202007,44200,충청남도,아산시,50-54세,23973,12973,11000
202008,44200,충청남도,아산시,50-54세,24147,13068,11079
202009,44200,충청남도,아산시,50-54세,24217,13103,11114
202010,44200,충청남도,아산시,50-54세,24407,13213,11194
202011,44200,충청남도,아산시,50-54세,24562,13311,11251
202012,44200,충청남도,아산시,50-54세,24613,13313,11300
202101,44200,충청남도,아산시,50-54세,24824,13436,11388
202102,44200,충청남도,아산시,50-54세,25036,13552,11484
202103,44200,충청남도,아산시,50-54세,25086,13595,11491
202104,44200,충청남도,아산시,50-54세,25177,13645,11532
202105,44200,충청남도,아산시,50-54세,25400,13756,11644
202106,44200,충청남도,아산시,50-54세,25579,13857,11722
202007,44200,충청남도,아산시,55-59세,21608,11609,9999
202008,44200,충청남도,아산시,55-59세,21586,11607,9979
202009,44200,충청남도,아산시,55-59세,21634,11637,9997
202010,44200,충청남도,아산시,55-59세,21594,11624,9970
202011,44200,충청남도,아산시,55-59세,21590,11619,9971
202012,44200,충청남도,아산시,55-59세,21676,11666,10010
202101,44200,충청남도,아산시,55-59세,21509,11608,9901
202102,44200,충청남도,아산시,55-59세,21521,11598,9923
202103,44200,충청남도,아산시,55-59세,21478,11590,9888
202104,44200,충청남도,아산시,55-59세,21479,11604,9875
202105,44200,충청남도,아산시,55-59세,21442,11600,9842
202106,44200,충청남도,아산시,55-59세,21395,11579,9816
202007,44200,충청남도,아산시,60-64세,18224,9208,9016
202008,44200,충청남도,아산시,60-64세,18306,9277,9029
202009,44200,충청남도,아산시,60-64세,18373,9327,9046
202010,44200,충청남도,아산시,60-64세,18513,9386,9127
202011,44200,충청남도,아산시,60-64세,18649,9471,9178
202012,44200,충청남도,아산시,60-64세,18767,9561,9206
202101,44200,충청남도,아산시,60-64세,18996,9649,9347
202102,44200,충청남도,아산시,60-64세,19202,9750,9452
202103,44200,충청남도,아산시,60-64세,19360,9845,9515
202104,44200,충청남도,아산시,60-64세,19585,9954,9631
202105,44200,충청남도,아산시,60-64세,19776,10058,9718
202106,44200,충청남도,아산시,60-64세,19999,10187,9812
202007,44200,충청남도,아산시,65-69세,12536,6083,6453
202008,44200,충청남도,아산시,65-69세,12655,6132,6523
202009,44200,충청남도,아산시,65-69세,12791,6196,6595
202010,44200,충청남도,아산시,65-69세,12859,6218,6641
202011,44200,충청남도,아산시,65-69세,12949,6257,6692
202012,44200,충청남도,아산시,65-69세,13118,6342,6776
202101,44200,충청남도,아산시,65-69세,13255,6413,6842
202102,44200,충청남도,아산시,65-69세,13414,6505,6909
202103,44200,충청남도,아산시,65-69세,13602,6612,6990
202104,44200,충청남도,아산시,65-69세,13716,6686,7030
202105,44200,충청남도,아산시,65-69세,13843,6767,7076
202106,44200,충청남도,아산시,65-69세,13885,6798,7087
202007,44200,충청남도,아산시,70-74세,9713,4475,5238
202008,44200,충청남도,아산시,70-74세,9784,4511,5273
202009,44200,충청남도,아산시,70-74세,9802,4516,5286
202010,44200,충청남도,아산시,70-74세,9889,4576,5313
202011,44200,충청남도,아산시,70-74세,9975,4615,5360
202012,44200,충청남도,아산시,70-74세,10052,4651,5401
202101,44200,충청남도,아산시,70-74세,10088,4676,5412
202102,44200,충청남도,아산시,70-74세,10120,4697,5423
202103,44200,충청남도,아산시,70-74세,10073,4684,5389
202104,44200,충청남도,아산시,70-74세,10110,4704,5406
202105,44200,충청남도,아산시,70-74세,10123,4708,5415
202106,44200,충청남도,아산시,70-74세,10164,4718,5446
202007,44200,충청남도,아산시,75-79세,8171,3422,4749
202008,44200,충청남도,아산시,75-79세,8144,3411,4733
202009,44200,충청남도,아산시,75-79세,8134,3417,4717
202010,44200,충청남도,아산시,75-79세,8089,3401,4688
202011,44200,충청남도,아산시,75-79세,8060,3392,4668
202012,44200,충청남도,아산시,75-79세,8037,3391,4646
202101,44200,충청남도,아산시,75-79세,8033,3375,4658
202102,44200,충청남도,아산시,75-79세,7995,3364,4631
202103,44200,충청남도,아산시,75-79세,7990,3354,4636
202104,44200,충청남도,아산시,75-79세,7977,3344,4633
202105,44200,충청남도,아산시,75-79세,7958,3349,4609
202106,44200,충청남도,아산시,75-79세,7954,3352,4602
202007,44200,충청남도,아산시,80-84세,6279,2371,3908
202008,44200,충청남도,아산시,80-84세,6271,2352,3919
202009,44200,충청남도,아산시,80-84세,6274,2363,3911
202010,44200,충청남도,아산시,80-84세,6261,2344,3917
202011,44200,충청남도,아산시,80-84세,6267,2345,3922
202012,44200,충청남도,아산시,80-84세,6260,2343,3917
202101,44200,충청남도,아산시,80-84세,6299,2371,3928
202102,44200,충청남도,아산시,80-84세,6322,2386,3936
202103,44200,충청남도,아산시,80-84세,6302,2380,3922
202104,44200,충청남도,아산시,80-84세,6307,2384,3923
202105,44200,충청남도,아산시,80-84세,6311,2374,3937
202106,44200,충청남도,아산시,80-84세,6332,2381,3951
202007,44200,충청남도,아산시,85-89세,3310,1002,2308
202008,44200,충청남도,아산시,85-89세,3333,1019,2314
202009,44200,충청남도,아산시,85-89세,3352,1020,2332
202010,44200,충청남도,아산시,85-89세,3391,1048,2343
202011,44200,충청남도,아산시,85-89세,3409,1055,2354
202012,44200,충청남도,아산시,85-89세,3448,1067,2381
202101,44200,충청남도,아산시,85-89세,3480,1077,2403
202102,44200,충청남도,아산시,85-89세,3532,1092,2440
202103,44200,충청남도,아산시,85-89세,3569,1090,2479
202104,44200,충청남도,아산시,85-89세,3607,1100,2507
202105,44200,충청남도,아산시,85-89세,3642,1125,2517
202106,44200,충청남도,아산시,85-89세,3636,1123,2513
202007,44200,충청남도,아산시,90-94세,1022,226,796
202008,44200,충청남도,아산시,90-94세,1040,231,809
202009,44200,충청남도,아산시,90-94세,1061,240,821
202010,44200,충청남도,아산시,90-94세,1067,236,831
202011,44200,충청남도,아산시,90-94세,1075,237,838
202012,44200,충청남도,아산시,90-94세,1091,240,851
202101,44200,충청남도,아산시,90-94세,1098,243,855
202102,44200,충청남도,아산시,90-94세,1112,249,863
202103,44200,충청남도,아산시,90-94세,1103,250,853
202104,44200,충청남도,아산시,90-94세,1112,248,864
202105,44200,충청남도,아산시,90-94세,1125,251,874
202106,44200,충청남도,아산시,90-94세,1139,253,886
202007,44200,충청남도,아산시,95-99세,235,53,182
202008,44200,충청남도,아산시,95-99세,233,52,181
202009,44200,충청남도,아산시,95-99세,232,52,180
202010,44200,충청남도,아산시,95-99세,233,52,181
202011,44200,충청남도,아산시,95-99세,233,51,182
202012,44200,충청남도,아산시,95-99세,235,54,181
202101,44200,충청남도,아산시,95-99세,230,54,176
202102,44200,충청남도,아산시,95-99세,236,53,183
202103,44200,충청남도,아산시,95-99세,226,48,178
202104,44200,충청남도,아산시,95-99세,227,48,179
202105,44200,충청남도,아산시,95-99세,229,48,181
202106,44200,충청남도,아산시,95-99세,226,49,177
202007,44200,충청남도,아산시,100+,114,34,80
202008,44200,충청남도,아산시,100+,114,33,81
202009,44200,충청남도,아산시,100+,113,33,80
202010,44200,충청남도,아산시,100+,114,33,81
202011,44200,충청남도,아산시,100+,112,31,81
202012,44200,충청남도,아산시,100+,114,30,84
202101,44200,충청남도,아산시,100+,115,30,85
202102,44200,충청남도,아산시,100+,118,32,86
202103,44200,충청남도,아산시,100+,53,8,45
202104,44200,충청남도,아산시,100+,56,10,46
202105,44200,충청남도,아산시,100+,56,9,47
202106,44200,충청남도,아산시,100+,55,9,46
202007,44210,충청남도,서산시,0-4세,6837,3506,3331
202008,44210,충청남도,서산시,0-4세,6831,3486,3345
202009,44210,충청남도,서산시,0-4세,6771,3468,3303
202010,44210,충청남도,서산시,0-4세,6732,3455,3277
202011,44210,충청남도,서산시,0-4세,6695,3430,3265
202012,44210,충청남도,서산시,0-4세,6673,3400,3273
202101,44210,충청남도,서산시,0-4세,6618,3367,3251
202102,44210,충청남도,서산시,0-4세,6593,3349,3244
202103,44210,충청남도,서산시,0-4세,6541,3315,3226
202104,44210,충청남도,서산시,0-4세,6488,3285,3203
202105,44210,충청남도,서산시,0-4세,6409,3236,3173
202106,44210,충청남도,서산시,0-4세,6338,3204,3134
202007,44210,충청남도,서산시,5-9세,8832,4566,4266
202008,44210,충청남도,서산시,5-9세,8849,4582,4267
202009,44210,충청남도,서산시,5-9세,8825,4564,4261
202010,44210,충청남도,서산시,5-9세,8798,4547,4251
202011,44210,충청남도,서산시,5-9세,8784,4542,4242
202012,44210,충청남도,서산시,5-9세,8773,4534,4239
202101,44210,충청남도,서산시,5-9세,8718,4489,4229
202102,44210,충청남도,서산시,5-9세,8724,4496,4228
202103,44210,충청남도,서산시,5-9세,8703,4494,4209
202104,44210,충청남도,서산시,5-9세,8708,4487,4221
202105,44210,충청남도,서산시,5-9세,8704,4488,4216
202106,44210,충청남도,서산시,5-9세,8741,4498,4243
202007,44210,충청남도,서산시,10-14세,8592,4456,4136
202008,44210,충청남도,서산시,10-14세,8622,4477,4145
202009,44210,충청남도,서산시,10-14세,8641,4488,4153
202010,44210,충청남도,서산시,10-14세,8690,4512,4178
202011,44210,충청남도,서산시,10-14세,8695,4524,4171
202012,44210,충청남도,서산시,10-14세,8702,4529,4173
202101,44210,충청남도,서산시,10-14세,8715,4539,4176
202102,44210,충청남도,서산시,10-14세,8794,4591,4203
202103,44210,충청남도,서산시,10-14세,8848,4595,4253
202104,44210,충청남도,서산시,10-14세,8859,4615,4244
202105,44210,충청남도,서산시,10-14세,8886,4637,4249
202106,44210,충청남도,서산시,10-14세,8875,4637,4238
202007,44210,충청남도,서산시,15-19세,8760,4743,4017
202008,44210,충청남도,서산시,15-19세,8712,4727,3985
202009,44210,충청남도,서산시,15-19세,8691,4714,3977
202010,44210,충청남도,서산시,15-19세,8638,4682,3956
202011,44210,충청남도,서산시,15-19세,8588,4661,3927
202012,44210,충청남도,서산시,15-19세,8550,4626,3924
202101,44210,충청남도,서산시,15-19세,8489,4596,3893
202102,44210,충청남도,서산시,15-19세,8392,4548,3844
202103,44210,충청남도,서산시,15-19세,8300,4509,3791
202104,44210,충청남도,서산시,15-19세,8288,4488,3800
202105,44210,충청남도,서산시,15-19세,8306,4488,3818
202106,44210,충청남도,서산시,15-19세,8259,4463,3796
202007,44210,충청남도,서산시,20-24세,9446,5440,4006
202008,44210,충청남도,서산시,20-24세,9418,5425,3993
202009,44210,충청남도,서산시,20-24세,9412,5423,3989
202010,44210,충청남도,서산시,20-24세,9397,5403,3994
202011,44210,충청남도,서산시,20-24세,9395,5400,3995
202012,44210,충청남도,서산시,20-24세,9388,5397,3991
202101,44210,충청남도,서산시,20-24세,9385,5393,3992
202102,44210,충청남도,서산시,20-24세,9330,5372,3958
202103,44210,충청남도,서산시,20-24세,9320,5375,3945
202104,44210,충청남도,서산시,20-24세,9295,5363,3932
202105,44210,충청남도,서산시,20-24세,9255,5356,3899
202106,44210,충청남도,서산시,20-24세,9260,5358,3902
202007,44210,충청남도,서산시,25-29세,9732,5843,3889
202008,44210,충청남도,서산시,25-29세,9733,5871,3862
202009,44210,충청남도,서산시,25-29세,9769,5900,3869
202010,44210,충청남도,서산시,25-29세,9787,5934,3853
202011,44210,충청남도,서산시,25-29세,9841,5972,3869
202012,44210,충청남도,서산시,25-29세,9889,6011,3878
202101,44210,충청남도,서산시,25-29세,9860,6017,3843
202102,44210,충청남도,서산시,25-29세,9755,5941,3814
202103,44210,충청남도,서산시,25-29세,9751,5957,3794
202104,44210,충청남도,서산시,25-29세,9761,5992,3769
202105,44210,충청남도,서산시,25-29세,9800,6018,3782
202106,44210,충청남도,서산시,25-29세,9790,6017,3773
202007,44210,충청남도,서산시,30-34세,10093,5764,4329
202008,44210,충청남도,서산시,30-34세,10098,5764,4334
202009,44210,충청남도,서산시,30-34세,10092,5776,4316
202010,44210,충청남도,서산시,30-34세,10069,5750,4319
202011,44210,충청남도,서산시,30-34세,10061,5763,4298
202012,44210,충청남도,서산시,30-34세,10058,5776,4282
202101,44210,충청남도,서산시,30-34세,9992,5739,4253
202102,44210,충청남도,서산시,30-34세,9955,5740,4215
202103,44210,충청남도,서산시,30-34세,10015,5781,4234
202104,44210,충청남도,서산시,30-34세,10037,5779,4258
202105,44210,충청남도,서산시,30-34세,10054,5781,4273
202106,44210,충청남도,서산시,30-34세,10064,5784,4280
202007,44210,충청남도,서산시,35-39세,12252,6575,5677
202008,44210,충청남도,서산시,35-39세,12242,6563,5679
202009,44210,충청남도,서산시,35-39세,12184,6548,5636
202010,44210,충청남도,서산시,35-39세,12143,6529,5614
202011,44210,충청남도,서산시,35-39세,12080,6493,5587
202012,44210,충청남도,서산시,35-39세,12065,6489,5576
202101,44210,충청남도,서산시,35-39세,12044,6483,5561
202102,44210,충청남도,서산시,35-39세,12016,6465,5551
202103,44210,충청남도,서산시,35-39세,11910,6392,5518
202104,44210,충청남도,서산시,35-39세,11868,6378,5490
202105,44210,충청남도,서산시,35-39세,11829,6364,5465
202106,44210,충청남도,서산시,35-39세,11775,6327,5448
202007,44210,충청남도,서산시,40-44세,13220,7003,6217
202008,44210,충청남도,서산시,40-44세,13237,7036,6201
202009,44210,충청남도,서산시,40-44세,13287,7066,6221
202010,44210,충청남도,서산시,40-44세,13340,7106,6234
202011,44210,충청남도,서산시,40-44세,13359,7117,6242
202012,44210,충청남도,서산시,40-44세,13278,7074,6204
202101,44210,충청남도,서산시,40-44세,13216,7038,6178
202102,44210,충청남도,서산시,40-44세,13246,7030,6216
202103,44210,충청남도,서산시,40-44세,13288,7076,6212
202104,44210,충청남도,서산시,40-44세,13283,7070,6213
202105,44210,충청남도,서산시,40-44세,13316,7086,6230
202106,44210,충청남도,서산시,40-44세,13414,7133,6281
202007,44210,충청남도,서산시,45-49세,14656,7873,6783
202008,44210,충청남도,서산시,45-49세,14643,7857,6786
202009,44210,충청남도,서산시,45-49세,14553,7809,6744
202010,44210,충청남도,서산시,45-49세,14467,7757,6710
202011,44210,충청남도,서산시,45-49세,14503,7792,6711
202012,44210,충청남도,서산시,45-49세,14536,7818,6718
202101,44210,충청남도,서산시,45-49세,14578,7851,6727
202102,44210,충청남도,서산시,45-49세,14597,7869,6728
202103,44210,충청남도,서산시,45-49세,14559,7846,6713
202104,44210,충청남도,서산시,45-49세,14559,7840,6719
202105,44210,충청남도,서산시,45-49세,14504,7795,6709
202106,44210,충청남도,서산시,45-49세,14423,7766,6657
202007,44210,충청남도,서산시,50-54세,14107,7556,6551
202008,44210,충청남도,서산시,50-54세,14170,7598,6572
202009,44210,충청남도,서산시,50-54세,14260,7647,6613
202010,44210,충청남도,서산시,50-54세,14400,7717,6683
202011,44210,충청남도,서산시,50-54세,14440,7744,6696
202012,44210,충청남도,서산시,50-54세,14488,7773,6715
202101,44210,충청남도,서산시,50-54세,14580,7819,6761
202102,44210,충청남도,서산시,50-54세,14668,7872,6796
202103,44210,충청남도,서산시,50-54세,14644,7891,6753
202104,44210,충청남도,서산시,50-54세,14730,7939,6791
202105,44210,충청남도,서산시,50-54세,14840,8016,6824
202106,44210,충청남도,서산시,50-54세,14922,8061,6861
202007,44210,충청남도,서산시,55-59세,14136,7499,6637
202008,44210,충청남도,서산시,55-59세,14074,7483,6591
202009,44210,충청남도,서산시,55-59세,14060,7484,6576
202010,44210,충청남도,서산시,55-59세,14002,7453,6549
202011,44210,충청남도,서산시,55-59세,13917,7406,6511
202012,44210,충청남도,서산시,55-59세,13882,7374,6508
202101,44210,충청남도,서산시,55-59세,13801,7335,6466
202102,44210,충청남도,서산시,55-59세,13760,7331,6429
202103,44210,충청남도,서산시,55-59세,13727,7301,6426
202104,44210,충청남도,서산시,55-59세,13646,7272,6374
202105,44210,충청남도,서산시,55-59세,13589,7268,6321
202106,44210,충청남도,서산시,55-59세,13459,7191,6268
202007,44210,충청남도,서산시,60-64세,12458,6273,6185
202008,44210,충청남도,서산시,60-64세,12536,6294,6242
202009,44210,충청남도,서산시,60-64세,12598,6321,6277
202010,44210,충청남도,서산시,60-64세,12684,6389,6295
202011,44210,충청남도,서산시,60-64세,12793,6463,6330
202012,44210,충청남도,서산시,60-64세,12873,6522,6351
202101,44210,충청남도,서산시,60-64세,12955,6570,6385
202102,44210,충청남도,서산시,60-64세,13048,6632,6416
202103,44210,충청남도,서산시,60-64세,13201,6708,6493
202104,44210,충청남도,서산시,60-64세,13318,6773,6545
202105,44210,충청남도,서산시,60-64세,13442,6822,6620
202106,44210,충청남도,서산시,60-64세,13607,6926,6681
202007,44210,충청남도,서산시,65-69세,8891,4376,4515
202008,44210,충청남도,서산시,65-69세,8932,4390,4542
202009,44210,충청남도,서산시,65-69세,8981,4417,4564
202010,44210,충청남도,서산시,65-69세,9026,4435,4591
202011,44210,충청남도,서산시,65-69세,9076,4461,4615
202012,44210,충청남도,서산시,65-69세,9156,4495,4661
202101,44210,충청남도,서산시,65-69세,9228,4538,4690
202102,44210,충청남도,서산시,65-69세,9280,4559,4721
202103,44210,충청남도,서산시,65-69세,9372,4612,4760
202104,44210,충청남도,서산시,65-69세,9491,4670,4821
202105,44210,충청남도,서산시,65-69세,9540,4710,4830
202106,44210,충청남도,서산시,65-69세,9584,4728,4856
202007,44210,충청남도,서산시,70-74세,7443,3686,3757
202008,44210,충청남도,서산시,70-74세,7488,3708,3780
202009,44210,충청남도,서산시,70-74세,7531,3713,3818
202010,44210,충청남도,서산시,70-74세,7586,3734,3852
202011,44210,충청남도,서산시,70-74세,7622,3749,3873
202012,44210,충청남도,서산시,70-74세,7659,3775,3884
202101,44210,충청남도,서산시,70-74세,7704,3784,3920
202102,44210,충청남도,서산시,70-74세,7755,3816,3939
202103,44210,충청남도,서산시,70-74세,7739,3806,3933
202104,44210,충청남도,서산시,70-74세,7764,3820,3944
202105,44210,충청남도,서산시,70-74세,7792,3834,3958
202106,44210,충청남도,서산시,70-74세,7803,3841,3962
202007,44210,충청남도,서산시,75-79세,6357,2737,3620
202008,44210,충청남도,서산시,75-79세,6353,2745,3608
202009,44210,충청남도,서산시,75-79세,6338,2751,3587
202010,44210,충청남도,서산시,75-79세,6279,2722,3557
202011,44210,충청남도,서산시,75-79세,6267,2718,3549
202012,44210,충청남도,서산시,75-79세,6227,2706,3521
202101,44210,충청남도,서산시,75-79세,6224,2718,3506
202102,44210,충청남도,서산시,75-79세,6219,2716,3503
202103,44210,충청남도,서산시,75-79세,6207,2730,3477
202104,44210,충청남도,서산시,75-79세,6170,2717,3453
202105,44210,충청남도,서산시,75-79세,6151,2717,3434
202106,44210,충청남도,서산시,75-79세,6158,2725,3433
202007,44210,충청남도,서산시,80-84세,5070,1911,3159
202008,44210,충청남도,서산시,80-84세,5054,1904,3150
202009,44210,충청남도,서산시,80-84세,5009,1896,3113
202010,44210,충청남도,서산시,80-84세,5046,1919,3127
202011,44210,충청남도,서산시,80-84세,5010,1899,3111
202012,44210,충청남도,서산시,80-84세,5000,1893,3107
202101,44210,충청남도,서산시,80-84세,5003,1904,3099
202102,44210,충청남도,서산시,80-84세,4965,1893,3072
202103,44210,충청남도,서산시,80-84세,4980,1897,3083
202104,44210,충청남도,서산시,80-84세,4977,1912,3065
202105,44210,충청남도,서산시,80-84세,4990,1921,3069
202106,44210,충청남도,서산시,80-84세,4975,1913,3062
202007,44210,충청남도,서산시,85-89세,3002,910,2092
202008,44210,충청남도,서산시,85-89세,3036,923,2113
202009,44210,충청남도,서산시,85-89세,3072,938,2134
202010,44210,충청남도,서산시,85-89세,3079,939,2140
202011,44210,충청남도,서산시,85-89세,3100,943,2157
202012,44210,충청남도,서산시,85-89세,3126,959,2167
202101,44210,충청남도,서산시,85-89세,3149,966,2183
202102,44210,충청남도,서산시,85-89세,3232,997,2235
202103,44210,충청남도,서산시,85-89세,3274,1011,2263
202104,44210,충청남도,서산시,85-89세,3289,1010,2279
202105,44210,충청남도,서산시,85-89세,3325,1013,2312
202106,44210,충청남도,서산시,85-89세,3333,1018,2315
202007,44210,충청남도,서산시,90-94세,951,201,750
202008,44210,충청남도,서산시,90-94세,945,198,747
202009,44210,충청남도,서산시,90-94세,954,200,754
202010,44210,충청남도,서산시,90-94세,962,204,758
202011,44210,충청남도,서산시,90-94세,956,203,753
202012,44210,충청남도,서산시,90-94세,958,205,753
202101,44210,충청남도,서산시,90-94세,971,208,763
202102,44210,충청남도,서산시,90-94세,979,209,770
202103,44210,충청남도,서산시,90-94세,980,212,768
202104,44210,충청남도,서산시,90-94세,990,213,777
202105,44210,충청남도,서산시,90-94세,1004,218,786
202106,44210,충청남도,서산시,90-94세,1013,225,788
202007,44210,충청남도,서산시,95-99세,228,34,194
202008,44210,충청남도,서산시,95-99세,238,36,202
202009,44210,충청남도,서산시,95-99세,241,36,205
202010,44210,충청남도,서산시,95-99세,241,34,207
202011,44210,충청남도,서산시,95-99세,248,34,214
202012,44210,충청남도,서산시,95-99세,253,36,217
202101,44210,충청남도,서산시,95-99세,256,38,218
202102,44210,충청남도,서산시,95-99세,258,38,220
202103,44210,충청남도,서산시,95-99세,254,37,217
202104,44210,충청남도,서산시,95-99세,256,38,218
202105,44210,충청남도,서산시,95-99세,255,38,217
202106,44210,충청남도,서산시,95-99세,259,37,222
202007,44210,충청남도,서산시,100+,61,8,53
202008,44210,충청남도,서산시,100+,61,9,52
202009,44210,충청남도,서산시,100+,61,9,52
202010,44210,충청남도,서산시,100+,60,7,53
202011,44210,충청남도,서산시,100+,57,7,50
202012,44210,충청남도,서산시,100+,57,7,50
202101,44210,충청남도,서산시,100+,57,7,50
202102,44210,충청남도,서산시,100+,57,7,50
202103,44210,충청남도,서산시,100+,37,3,34
202104,44210,충청남도,서산시,100+,40,3,37
202105,44210,충청남도,서산시,100+,40,3,37
202106,44210,충청남도,서산시,100+,38,3,35
202007,44230,충청남도,논산시,0-4세,3211,1652,1559
202008,44230,충청남도,논산시,0-4세,3190,1637,1553
202009,44230,충청남도,논산시,0-4세,3148,1616,1532
202010,44230,충청남도,논산시,0-4세,3123,1607,1516
202011,44230,충청남도,논산시,0-4세,3096,1605,1491
202012,44230,충청남도,논산시,0-4세,3043,1570,1473
202101,44230,충청남도,논산시,0-4세,3015,1546,1469
202102,44230,충청남도,논산시,0-4세,2973,1519,1454
202103,44230,충청남도,논산시,0-4세,2971,1513,1458
202104,44230,충청남도,논산시,0-4세,2949,1509,1440
202105,44230,충청남도,논산시,0-4세,2920,1505,1415
202106,44230,충청남도,논산시,0-4세,2913,1497,1416
202007,44230,충청남도,논산시,5-9세,4219,2156,2063
202008,44230,충청남도,논산시,5-9세,4205,2155,2050
202009,44230,충청남도,논산시,5-9세,4192,2150,2042
202010,44230,충청남도,논산시,5-9세,4181,2134,2047
202011,44230,충청남도,논산시,5-9세,4187,2134,2053
202012,44230,충청남도,논산시,5-9세,4189,2139,2050
202101,44230,충청남도,논산시,5-9세,4196,2139,2057
202102,44230,충청남도,논산시,5-9세,4167,2126,2041
202103,44230,충청남도,논산시,5-9세,4142,2119,2023
202104,44230,충청남도,논산시,5-9세,4134,2110,2024
202105,44230,충청남도,논산시,5-9세,4128,2099,2029
202106,44230,충청남도,논산시,5-9세,4106,2080,2026
202007,44230,충청남도,논산시,10-14세,4704,2418,2286
202008,44230,충청남도,논산시,10-14세,4717,2424,2293
202009,44230,충청남도,논산시,10-14세,4731,2431,2300
202010,44230,충청남도,논산시,10-14세,4739,2445,2294
202011,44230,충청남도,논산시,10-14세,4715,2427,2288
202012,44230,충청남도,논산시,10-14세,4696,2419,2277
202101,44230,충청남도,논산시,10-14세,4679,2421,2258
202102,44230,충청남도,논산시,10-14세,4695,2429,2266
202103,44230,충청남도,논산시,10-14세,4699,2428,2271
202104,44230,충청남도,논산시,10-14세,4663,2420,2243
202105,44230,충청남도,논산시,10-14세,4668,2419,2249
202106,44230,충청남도,논산시,10-14세,4672,2425,2247
202007,44230,충청남도,논산시,15-19세,5270,2744,2526
202008,44230,충청남도,논산시,15-19세,5214,2707,2507
202009,44230,충청남도,논산시,15-19세,5208,2716,2492
202010,44230,충청남도,논산시,15-19세,5172,2684,2488
202011,44230,충청남도,논산시,15-19세,5172,2678,2494
202012,44230,충청남도,논산시,15-19세,5110,2640,2470
202101,44230,충청남도,논산시,15-19세,5087,2628,2459
202102,44230,충청남도,논산시,15-19세,5047,2611,2436
202103,44230,충청남도,논산시,15-19세,4988,2586,2402
202104,44230,충청남도,논산시,15-19세,4984,2556,2428
202105,44230,충청남도,논산시,15-19세,4952,2540,2412
202106,44230,충청남도,논산시,15-19세,4919,2522,2397
202007,44230,충청남도,논산시,20-24세,6149,3422,2727
202008,44230,충청남도,논산시,20-24세,6128,3407,2721
202009,44230,충청남도,논산시,20-24세,6118,3391,2727
202010,44230,충청남도,논산시,20-24세,6084,3382,2702
202011,44230,충청남도,논산시,20-24세,6048,3373,2675
202012,44230,충청남도,논산시,20-24세,6025,3371,2654
202101,44230,충청남도,논산시,20-24세,5967,3356,2611
202102,44230,충청남도,논산시,20-24세,5891,3319,2572
202103,44230,충청남도,논산시,20-24세,5846,3294,2552
202104,44230,충청남도,논산시,20-24세,5828,3299,2529
202105,44230,충청남도,논산시,20-24세,5815,3287,2528
202106,44230,충청남도,논산시,20-24세,5800,3271,2529
202007,44230,충청남도,논산시,25-29세,5401,3063,2338
202008,44230,충청남도,논산시,25-29세,5384,3041,2343
202009,44230,충청남도,논산시,25-29세,5397,3025,2372
202010,44230,충청남도,논산시,25-29세,5361,3014,2347
202011,44230,충청남도,논산시,25-29세,5376,3021,2355
202012,44230,충청남도,논산시,25-29세,5362,3006,2356
202101,44230,충청남도,논산시,25-29세,5381,3000,2381
202102,44230,충청남도,논산시,25-29세,5324,2957,2367
202103,44230,충청남도,논산시,25-29세,5311,2947,2364
202104,44230,충청남도,논산시,25-29세,5323,2951,2372
202105,44230,충청남도,논산시,25-29세,5314,2949,2365
202106,44230,충청남도,논산시,25-29세,5285,2931,2354
202007,44230,충청남도,논산시,30-34세,5017,2709,2308
202008,44230,충청남도,논산시,30-34세,4994,2703,2291
202009,44230,충청남도,논산시,30-34세,4982,2696,2286
202010,44230,충청남도,논산시,30-34세,4996,2703,2293
202011,44230,충청남도,논산시,30-34세,4978,2691,2287
202012,44230,충청남도,논산시,30-34세,4943,2688,2255
202101,44230,충청남도,논산시,30-34세,4915,2680,2235
202102,44230,충청남도,논산시,30-34세,4855,2664,2191
202103,44230,충청남도,논산시,30-34세,4822,2645,2177
202104,44230,충청남도,논산시,30-34세,4794,2627,2167
202105,44230,충청남도,논산시,30-34세,4817,2638,2179
202106,44230,충청남도,논산시,30-34세,4821,2647,2174
202007,44230,충청남도,논산시,35-39세,6026,3116,2910
202008,44230,충청남도,논산시,35-39세,5972,3092,2880
202009,44230,충청남도,논산시,35-39세,5920,3073,2847
202010,44230,충청남도,논산시,35-39세,5878,3054,2824
202011,44230,충청남도,논산시,35-39세,5847,3037,2810
202012,44230,충청남도,논산시,35-39세,5821,3017,2804
202101,44230,충청남도,논산시,35-39세,5829,3016,2813
202102,44230,충청남도,논산시,35-39세,5784,2977,2807
202103,44230,충청남도,논산시,35-39세,5721,2958,2763
202104,44230,충청남도,논산시,35-39세,5693,2949,2744
202105,44230,충청남도,논산시,35-39세,5641,2917,2724
202106,44230,충청남도,논산시,35-39세,5561,2877,2684
202007,44230,충청남도,논산시,40-44세,6816,3591,3225
202008,44230,충청남도,논산시,40-44세,6823,3588,3235
202009,44230,충청남도,논산시,40-44세,6821,3574,3247
202010,44230,충청남도,논산시,40-44세,6809,3556,3253
202011,44230,충청남도,논산시,40-44세,6787,3531,3256
202012,44230,충청남도,논산시,40-44세,6762,3524,3238
202101,44230,충청남도,논산시,40-44세,6729,3501,3228
202102,44230,충청남도,논산시,40-44세,6699,3489,3210
202103,44230,충청남도,논산시,40-44세,6626,3453,3173
202104,44230,충청남도,논산시,40-44세,6644,3459,3185
202105,44230,충청남도,논산시,40-44세,6638,3451,3187
202106,44230,충청남도,논산시,40-44세,6698,3479,3219
202007,44230,충청남도,논산시,45-49세,8876,4763,4113
202008,44230,충청남도,논산시,45-49세,8845,4753,4092
202009,44230,충청남도,논산시,45-49세,8761,4707,4054
202010,44230,충청남도,논산시,45-49세,8686,4661,4025
202011,44230,충청남도,논산시,45-49세,8639,4651,3988
202012,44230,충청남도,논산시,45-49세,8641,4637,4004
202101,44230,충청남도,논산시,45-49세,8604,4619,3985
202102,44230,충청남도,논산시,45-49세,8597,4609,3988
202103,44230,충청남도,논산시,45-49세,8491,4566,3925
202104,44230,충청남도,논산시,45-49세,8412,4524,3888
202105,44230,충청남도,논산시,45-49세,8318,4482,3836
202106,44230,충청남도,논산시,45-49세,8259,4449,3810
202007,44230,충청남도,논산시,50-54세,9388,5002,4386
202008,44230,충청남도,논산시,50-54세,9346,4990,4356
202009,44230,충청남도,논산시,50-54세,9320,4980,4340
202010,44230,충청남도,논산시,50-54세,9327,5003,4324
202011,44230,충청남도,논산시,50-54세,9356,5027,4329
202012,44230,충청남도,논산시,50-54세,9352,5024,4328
202101,44230,충청남도,논산시,50-54세,9404,5051,4353
202102,44230,충청남도,논산시,50-54세,9416,5057,4359
202103,44230,충청남도,논산시,50-54세,9331,5025,4306
202104,44230,충청남도,논산시,50-54세,9374,5048,4326
202105,44230,충청남도,논산시,50-54세,9449,5068,4381
202106,44230,충청남도,논산시,50-54세,9484,5082,4402
202007,44230,충청남도,논산시,55-59세,10590,5460,5130
202008,44230,충청남도,논산시,55-59세,10563,5444,5119
202009,44230,충청남도,논산시,55-59세,10519,5441,5078
202010,44230,충청남도,논산시,55-59세,10476,5409,5067
202011,44230,충청남도,논산시,55-59세,10396,5378,5018
202012,44230,충청남도,논산시,55-59세,10351,5359,4992
202101,44230,충청남도,논산시,55-59세,10215,5273,4942
202102,44230,충청남도,논산시,55-59세,10139,5242,4897
202103,44230,충청남도,논산시,55-59세,10029,5215,4814
202104,44230,충청남도,논산시,55-59세,9982,5186,4796
202105,44230,충청남도,논산시,55-59세,9903,5152,4751
202106,44230,충청남도,논산시,55-59세,9815,5107,4708
202007,44230,충청남도,논산시,60-64세,11058,5655,5403
202008,44230,충청남도,논산시,60-64세,11083,5657,5426
202009,44230,충청남도,논산시,60-64세,11147,5685,5462
202010,44230,충청남도,논산시,60-64세,11194,5698,5496
202011,44230,충청남도,논산시,60-64세,11247,5702,5545
202012,44230,충청남도,논산시,60-64세,11285,5720,5565
202101,44230,충청남도,논산시,60-64세,11337,5763,5574
202102,44230,충청남도,논산시,60-64세,11371,5786,5585
202103,44230,충청남도,논산시,60-64세,11358,5785,5573
202104,44230,충청남도,논산시,60-64세,11436,5843,5593
202105,44230,충청남도,논산시,60-64세,11459,5860,5599
202106,44230,충청남도,논산시,60-64세,11523,5903,5620
202007,44230,충청남도,논산시,65-69세,8533,4191,4342
202008,44230,충청남도,논산시,65-69세,8566,4207,4359
202009,44230,충청남도,논산시,65-69세,8620,4247,4373
202010,44230,충청남도,논산시,65-69세,8658,4284,4374
202011,44230,충청남도,논산시,65-69세,8686,4299,4387
202012,44230,충청남도,논산시,65-69세,8722,4332,4390
202101,44230,충청남도,논산시,65-69세,8790,4381,4409
202102,44230,충청남도,논산시,65-69세,8881,4418,4463
202103,44230,충청남도,논산시,65-69세,8948,4461,4487
202104,44230,충청남도,논산시,65-69세,8990,4477,4513
202105,44230,충청남도,논산시,65-69세,9057,4515,4542
202106,44230,충청남도,논산시,65-69세,9095,4530,4565
202007,44230,충청남도,논산시,70-74세,6708,3170,3538
202008,44230,충청남도,논산시,70-74세,6765,3201,3564
202009,44230,충청남도,논산시,70-74세,6802,3218,3584
202010,44230,충청남도,논산시,70-74세,6843,3233,3610
202011,44230,충청남도,논산시,70-74세,6888,3255,3633
202012,44230,충청남도,논산시,70-74세,6945,3273,3672
202101,44230,충청남도,논산시,70-74세,7018,3313,3705
202102,44230,충청남도,논산시,70-74세,7031,3322,3709
202103,44230,충청남도,논산시,70-74세,7022,3316,3706
202104,44230,충청남도,논산시,70-74세,7041,3330,3711
202105,44230,충청남도,논산시,70-74세,7064,3340,3724
202106,44230,충청남도,논산시,70-74세,7068,3349,3719
202007,44230,충청남도,논산시,75-79세,6270,2554,3716
202008,44230,충청남도,논산시,75-79세,6267,2553,3714
202009,44230,충청남도,논산시,75-79세,6228,2535,3693
202010,44230,충청남도,논산시,75-79세,6187,2532,3655
202011,44230,충청남도,논산시,75-79세,6164,2525,3639
202012,44230,충청남도,논산시,75-79세,6102,2513,3589
202101,44230,충청남도,논산시,75-79세,6052,2497,3555
202102,44230,충청남도,논산시,75-79세,5998,2490,3508
202103,44230,충청남도,논산시,75-79세,5916,2466,3450
202104,44230,충청남도,논산시,75-79세,5869,2448,3421
202105,44230,충청남도,논산시,75-79세,5876,2453,3423
202106,44230,충청남도,논산시,75-79세,5862,2463,3399
202007,44230,충청남도,논산시,80-84세,5148,1844,3304
202008,44230,충청남도,논산시,80-84세,5094,1832,3262
202009,44230,충청남도,논산시,80-84세,5083,1837,3246
202010,44230,충청남도,논산시,80-84세,5074,1830,3244
202011,44230,충청남도,논산시,80-84세,5054,1822,3232
202012,44230,충청남도,논산시,80-84세,5047,1809,3238
202101,44230,충청남도,논산시,80-84세,5055,1806,3249
202102,44230,충청남도,논산시,80-84세,5077,1810,3267
202103,44230,충청남도,논산시,80-84세,5061,1779,3282
202104,44230,충청남도,논산시,80-84세,5061,1785,3276
202105,44230,충청남도,논산시,80-84세,5050,1775,3275
202106,44230,충청남도,논산시,80-84세,5077,1782,3295
202007,44230,충청남도,논산시,85-89세,2887,927,1960
202008,44230,충청남도,논산시,85-89세,2932,942,1990
202009,44230,충청남도,논산시,85-89세,2954,945,2009
202010,44230,충청남도,논산시,85-89세,2960,941,2019
202011,44230,충청남도,논산시,85-89세,2979,947,2032
202012,44230,충청남도,논산시,85-89세,3003,950,2053
202101,44230,충청남도,논산시,85-89세,3026,954,2072
202102,44230,충청남도,논산시,85-89세,3063,970,2093
202103,44230,충청남도,논산시,85-89세,3067,976,2091
202104,44230,충청남도,논산시,85-89세,3096,981,2115
202105,44230,충청남도,논산시,85-89세,3116,987,2129
202106,44230,충청남도,논산시,85-89세,3110,974,2136
202007,44230,충청남도,논산시,90-94세,963,254,709
202008,44230,충청남도,논산시,90-94세,963,250,713
202009,44230,충청남도,논산시,90-94세,971,253,718
202010,44230,충청남도,논산시,90-94세,976,247,729
202011,44230,충청남도,논산시,90-94세,965,248,717
202012,44230,충청남도,논산시,90-94세,966,250,716
202101,44230,충청남도,논산시,90-94세,979,257,722
202102,44230,충청남도,논산시,90-94세,996,263,733
202103,44230,충청남도,논산시,90-94세,979,252,727
202104,44230,충청남도,논산시,90-94세,999,257,742
202105,44230,충청남도,논산시,90-94세,998,256,742
202106,44230,충청남도,논산시,90-94세,991,258,733
202007,44230,충청남도,논산시,95-99세,199,51,148
202008,44230,충청남도,논산시,95-99세,200,52,148
202009,44230,충청남도,논산시,95-99세,213,52,161
202010,44230,충청남도,논산시,95-99세,215,55,160
202011,44230,충청남도,논산시,95-99세,218,55,163
202012,44230,충청남도,논산시,95-99세,217,54,163
202101,44230,충청남도,논산시,95-99세,216,55,161
202102,44230,충청남도,논산시,95-99세,217,52,165
202103,44230,충청남도,논산시,95-99세,197,41,156
202104,44230,충청남도,논산시,95-99세,200,42,158
202105,44230,충청남도,논산시,95-99세,199,40,159
202106,44230,충청남도,논산시,95-99세,198,39,159
202007,44230,충청남도,논산시,100+,87,21,66
202008,44230,충청남도,논산시,100+,89,21,68
202009,44230,충청남도,논산시,100+,91,21,70
202010,44230,충청남도,논산시,100+,91,21,70
202011,44230,충청남도,논산시,100+,90,20,70
202012,44230,충청남도,논산시,100+,93,21,72
202101,44230,충청남도,논산시,100+,93,21,72
202102,44230,충청남도,논산시,100+,94,21,73
202103,44230,충청남도,논산시,100+,48,10,38
202104,44230,충청남도,논산시,100+,48,9,39
202105,44230,충청남도,논산시,100+,49,9,40
202106,44230,충청남도,논산시,100+,48,9,39
202007,44250,충청남도,계룡시,0-4세,1513,781,732
202008,44250,충청남도,계룡시,0-4세,1507,775,732
202009,44250,충청남도,계룡시,0-4세,1500,776,724
202010,44250,충청남도,계룡시,0-4세,1471,762,709
202011,44250,충청남도,계룡시,0-4세,1454,750,704
202012,44250,충청남도,계룡시,0-4세,1459,746,713
202101,44250,충청남도,계룡시,0-4세,1437,742,695
202102,44250,충청남도,계룡시,0-4세,1444,744,700
202103,44250,충청남도,계룡시,0-4세,1449,739,710
202104,44250,충청남도,계룡시,0-4세,1453,747,706
202105,44250,충청남도,계룡시,0-4세,1434,738,696
202106,44250,충청남도,계룡시,0-4세,1413,724,689
202007,44250,충청남도,계룡시,5-9세,2491,1253,1238
202008,44250,충청남도,계룡시,5-9세,2492,1255,1237
202009,44250,충청남도,계룡시,5-9세,2473,1240,1233
202010,44250,충청남도,계룡시,5-9세,2461,1234,1227
202011,44250,충청남도,계룡시,5-9세,2438,1225,1213
202012,44250,충청남도,계룡시,5-9세,2404,1206,1198
202101,44250,충청남도,계룡시,5-9세,2441,1226,1215
202102,44250,충청남도,계룡시,5-9세,2457,1233,1224
202103,44250,충청남도,계룡시,5-9세,2468,1247,1221
202104,44250,충청남도,계룡시,5-9세,2475,1241,1234
202105,44250,충청남도,계룡시,5-9세,2467,1228,1239
202106,44250,충청남도,계룡시,5-9세,2451,1217,1234
202007,44250,충청남도,계룡시,10-14세,3073,1629,1444
202008,44250,충청남도,계룡시,10-14세,3059,1619,1440
202009,44250,충청남도,계룡시,10-14세,3068,1624,1444
202010,44250,충청남도,계룡시,10-14세,3034,1608,1426
202011,44250,충청남도,계룡시,10-14세,3019,1596,1423
202012,44250,충청남도,계룡시,10-14세,3011,1596,1415
202101,44250,충청남도,계룡시,10-14세,3020,1599,1421
202102,44250,충청남도,계룡시,10-14세,3062,1626,1436
202103,44250,충청남도,계룡시,10-14세,3053,1617,1436
202104,44250,충청남도,계룡시,10-14세,3038,1612,1426
202105,44250,충청남도,계룡시,10-14세,3025,1604,1421
202106,44250,충청남도,계룡시,10-14세,3023,1605,1418
202007,44250,충청남도,계룡시,15-19세,3351,1725,1626
202008,44250,충청남도,계룡시,15-19세,3322,1716,1606
202009,44250,충청남도,계룡시,15-19세,3318,1712,1606
202010,44250,충청남도,계룡시,15-19세,3305,1713,1592
202011,44250,충청남도,계룡시,15-19세,3298,1715,1583
202012,44250,충청남도,계룡시,15-19세,3289,1721,1568
202101,44250,충청남도,계룡시,15-19세,3258,1707,1551
202102,44250,충청남도,계룡시,15-19세,3247,1699,1548
202103,44250,충청남도,계룡시,15-19세,3241,1688,1553
202104,44250,충청남도,계룡시,15-19세,3239,1691,1548
202105,44250,충청남도,계룡시,15-19세,3254,1701,1553
202106,44250,충청남도,계룡시,15-19세,3247,1692,1555
202007,44250,충청남도,계룡시,20-24세,2869,1589,1280
202008,44250,충청남도,계룡시,20-24세,2869,1581,1288
202009,44250,충청남도,계룡시,20-24세,2856,1580,1276
202010,44250,충청남도,계룡시,20-24세,2862,1562,1300
202011,44250,충청남도,계룡시,20-24세,2882,1570,1312
202012,44250,충청남도,계룡시,20-24세,2864,1554,1310
202101,44250,충청남도,계룡시,20-24세,2865,1551,1314
202102,44250,충청남도,계룡시,20-24세,2856,1547,1309
202103,44250,충청남도,계룡시,20-24세,2850,1545,1305
202104,44250,충청남도,계룡시,20-24세,2839,1539,1300
202105,44250,충청남도,계룡시,20-24세,2828,1540,1288
202106,44250,충청남도,계룡시,20-24세,2835,1549,1286
202007,44250,충청남도,계룡시,25-29세,1990,1135,855
202008,44250,충청남도,계룡시,25-29세,1990,1134,856
202009,44250,충청남도,계룡시,25-29세,1986,1135,851
202010,44250,충청남도,계룡시,25-29세,1987,1135,852
202011,44250,충청남도,계룡시,25-29세,2004,1152,852
202012,44250,충청남도,계룡시,25-29세,2039,1177,862
202101,44250,충청남도,계룡시,25-29세,2037,1178,859
202102,44250,충청남도,계룡시,25-29세,2055,1185,870
202103,44250,충청남도,계룡시,25-29세,2068,1197,871
202104,44250,충청남도,계룡시,25-29세,2067,1183,884
202105,44250,충청남도,계룡시,25-29세,2067,1182,885
202106,44250,충청남도,계룡시,25-29세,2054,1173,881
202007,44250,충청남도,계룡시,30-34세,1713,868,845
202008,44250,충청남도,계룡시,30-34세,1725,867,858
202009,44250,충청남도,계룡시,30-34세,1733,873,860
202010,44250,충청남도,계룡시,30-34세,1739,886,853
202011,44250,충청남도,계룡시,30-34세,1737,889,848
202012,44250,충청남도,계룡시,30-34세,1724,884,840
202101,44250,충청남도,계룡시,30-34세,1717,882,835
202102,44250,충청남도,계룡시,30-34세,1761,915,846
202103,44250,충청남도,계룡시,30-34세,1783,921,862
202104,44250,충청남도,계룡시,30-34세,1794,934,860
202105,44250,충청남도,계룡시,30-34세,1799,940,859
202106,44250,충청남도,계룡시,30-34세,1803,944,859
202007,44250,충청남도,계룡시,35-39세,2978,1450,1528
202008,44250,충청남도,계룡시,35-39세,2940,1428,1512
202009,44250,충청남도,계룡시,35-39세,2910,1416,1494
202010,44250,충청남도,계룡시,35-39세,2885,1408,1477
202011,44250,충청남도,계룡시,35-39세,2886,1415,1471
202012,44250,충청남도,계룡시,35-39세,2887,1416,1471
202101,44250,충청남도,계룡시,35-39세,2909,1423,1486
202102,44250,충청남도,계룡시,35-39세,2910,1414,1496
202103,44250,충청남도,계룡시,35-39세,2907,1415,1492
202104,44250,충청남도,계룡시,35-39세,2897,1399,1498
202105,44250,충청남도,계룡시,35-39세,2860,1389,1471
202106,44250,충청남도,계룡시,35-39세,2827,1378,1449
202007,44250,충청남도,계룡시,40-44세,3727,1739,1988
202008,44250,충청남도,계룡시,40-44세,3726,1740,1986
202009,44250,충청남도,계룡시,40-44세,3748,1750,1998
202010,44250,충청남도,계룡시,40-44세,3746,1746,2000
202011,44250,충청남도,계룡시,40-44세,3735,1729,2006
202012,44250,충청남도,계룡시,40-44세,3706,1719,1987
202101,44250,충청남도,계룡시,40-44세,3700,1712,1988
202102,44250,충청남도,계룡시,40-44세,3756,1742,2014
202103,44250,충청남도,계룡시,40-44세,3756,1742,2014
202104,44250,충청남도,계룡시,40-44세,3756,1755,2001
202105,44250,충청남도,계룡시,40-44세,3769,1750,2019
202106,44250,충청남도,계룡시,40-44세,3781,1761,2020
202007,44250,충청남도,계룡시,45-49세,4715,2357,2358
202008,44250,충청남도,계룡시,45-49세,4715,2370,2345
202009,44250,충청남도,계룡시,45-49세,4717,2367,2350
202010,44250,충청남도,계룡시,45-49세,4690,2353,2337
202011,44250,충청남도,계룡시,45-49세,4688,2358,2330
202012,44250,충청남도,계룡시,45-49세,4687,2359,2328
202101,44250,충청남도,계룡시,45-49세,4633,2339,2294
202102,44250,충청남도,계룡시,45-49세,4657,2354,2303
202103,44250,충청남도,계룡시,45-49세,4629,2334,2295
202104,44250,충청남도,계룡시,45-49세,4617,2322,2295
202105,44250,충청남도,계룡시,45-49세,4601,2315,2286
202106,44250,충청남도,계룡시,45-49세,4545,2285,2260
202007,44250,충청남도,계룡시,50-54세,3876,1954,1922
202008,44250,충청남도,계룡시,50-54세,3914,1974,1940
202009,44250,충청남도,계룡시,50-54세,3915,1969,1946
202010,44250,충청남도,계룡시,50-54세,3916,1971,1945
202011,44250,충청남도,계룡시,50-54세,3931,1973,1958
202012,44250,충청남도,계룡시,50-54세,3923,1976,1947
202101,44250,충청남도,계룡시,50-54세,3934,1968,1966
202102,44250,충청남도,계룡시,50-54세,3957,1975,1982
202103,44250,충청남도,계룡시,50-54세,3986,1993,1993
202104,44250,충청남도,계룡시,50-54세,4023,2000,2023
202105,44250,충청남도,계룡시,50-54세,4048,2022,2026
202106,44250,충청남도,계룡시,50-54세,4081,2034,2047
202007,44250,충청남도,계룡시,55-59세,3000,1515,1485
202008,44250,충청남도,계룡시,55-59세,2995,1497,1498
202009,44250,충청남도,계룡시,55-59세,2976,1498,1478
202010,44250,충청남도,계룡시,55-59세,2994,1511,1483
202011,44250,충청남도,계룡시,55-59세,3018,1530,1488
202012,44250,충청남도,계룡시,55-59세,3004,1507,1497
202101,44250,충청남도,계룡시,55-59세,2985,1504,1481
202102,44250,충청남도,계룡시,55-59세,3001,1514,1487
202103,44250,충청남도,계룡시,55-59세,3013,1524,1489
202104,44250,충청남도,계룡시,55-59세,3006,1526,1480
202105,44250,충청남도,계룡시,55-59세,3004,1521,1483
202106,44250,충청남도,계룡시,55-59세,2991,1513,1478
202007,44250,충청남도,계룡시,60-64세,2529,1185,1344
202008,44250,충청남도,계룡시,60-64세,2569,1211,1358
202009,44250,충청남도,계룡시,60-64세,2595,1226,1369
202010,44250,충청남도,계룡시,60-64세,2613,1240,1373
202011,44250,충청남도,계룡시,60-64세,2653,1253,1400
202012,44250,충청남도,계룡시,60-64세,2684,1266,1418
202101,44250,충청남도,계룡시,60-64세,2694,1280,1414
202102,44250,충청남도,계룡시,60-64세,2721,1295,1426
202103,44250,충청남도,계룡시,60-64세,2722,1299,1423
202104,44250,충청남도,계룡시,60-64세,2741,1316,1425
202105,44250,충청남도,계룡시,60-64세,2769,1325,1444
202106,44250,충청남도,계룡시,60-64세,2776,1330,1446
202007,44250,충청남도,계룡시,65-69세,1705,858,847
202008,44250,충청남도,계룡시,65-69세,1722,866,856
202009,44250,충청남도,계룡시,65-69세,1757,880,877
202010,44250,충청남도,계룡시,65-69세,1784,888,896
202011,44250,충청남도,계룡시,65-69세,1795,898,897
202012,44250,충청남도,계룡시,65-69세,1815,913,902
202101,44250,충청남도,계룡시,65-69세,1831,910,921
202102,44250,충청남도,계룡시,65-69세,1859,920,939
202103,44250,충청남도,계룡시,65-69세,1869,928,941
202104,44250,충청남도,계룡시,65-69세,1900,940,960
202105,44250,충청남도,계룡시,65-69세,1917,941,976
202106,44250,충청남도,계룡시,65-69세,1929,944,985
202007,44250,충청남도,계룡시,70-74세,1121,543,578
202008,44250,충청남도,계룡시,70-74세,1133,543,590
202009,44250,충청남도,계룡시,70-74세,1134,547,587
202010,44250,충청남도,계룡시,70-74세,1142,556,586
202011,44250,충청남도,계룡시,70-74세,1155,564,591
202012,44250,충청남도,계룡시,70-74세,1159,566,593
202101,44250,충청남도,계룡시,70-74세,1178,578,600
202102,44250,충청남도,계룡시,70-74세,1204,588,616
202103,44250,충청남도,계룡시,70-74세,1199,581,618
202104,44250,충청남도,계룡시,70-74세,1200,584,616
202105,44250,충청남도,계룡시,70-74세,1204,589,615
202106,44250,충청남도,계룡시,70-74세,1214,592,622
202007,44250,충청남도,계룡시,75-79세,872,344,528
202008,44250,충청남도,계룡시,75-79세,876,344,532
202009,44250,충청남도,계룡시,75-79세,871,342,529
202010,44250,충청남도,계룡시,75-79세,874,342,532
202011,44250,충청남도,계룡시,75-79세,876,340,536
202012,44250,충청남도,계룡시,75-79세,887,344,543
202101,44250,충청남도,계룡시,75-79세,874,335,539
202102,44250,충청남도,계룡시,75-79세,871,342,529
202103,44250,충청남도,계룡시,75-79세,884,346,538
202104,44250,충청남도,계룡시,75-79세,874,344,530
202105,44250,충청남도,계룡시,75-79세,876,349,527
202106,44250,충청남도,계룡시,75-79세,874,354,520
202007,44250,충청남도,계룡시,80-84세,692,237,455
202008,44250,충청남도,계룡시,80-84세,683,235,448
202009,44250,충청남도,계룡시,80-84세,684,240,444
202010,44250,충청남도,계룡시,80-84세,683,241,442
202011,44250,충청남도,계룡시,80-84세,677,235,442
202012,44250,충청남도,계룡시,80-84세,678,235,443
202101,44250,충청남도,계룡시,80-84세,691,239,452
202102,44250,충청남도,계룡시,80-84세,696,239,457
202103,44250,충청남도,계룡시,80-84세,687,239,448
202104,44250,충청남도,계룡시,80-84세,694,242,452
202105,44250,충청남도,계룡시,80-84세,687,242,445
202106,44250,충청남도,계룡시,80-84세,689,245,444
202007,44250,충청남도,계룡시,85-89세,383,108,275
202008,44250,충청남도,계룡시,85-89세,384,108,276
202009,44250,충청남도,계룡시,85-89세,389,109,280
202010,44250,충청남도,계룡시,85-89세,396,110,286
202011,44250,충청남도,계룡시,85-89세,413,119,294
202012,44250,충청남도,계룡시,85-89세,417,119,298
202101,44250,충청남도,계룡시,85-89세,417,119,298
202102,44250,충청남도,계룡시,85-89세,425,121,304
202103,44250,충청남도,계룡시,85-89세,434,121,313
202104,44250,충청남도,계룡시,85-89세,435,124,311
202105,44250,충청남도,계룡시,85-89세,438,124,314
202106,44250,충청남도,계룡시,85-89세,437,122,315
202007,44250,충청남도,계룡시,90-94세,132,32,100
202008,44250,충청남도,계룡시,90-94세,136,33,103
202009,44250,충청남도,계룡시,90-94세,135,33,102
202010,44250,충청남도,계룡시,90-94세,139,35,104
202011,44250,충청남도,계룡시,90-94세,143,33,110
202012,44250,충청남도,계룡시,90-94세,137,32,105
202101,44250,충청남도,계룡시,90-94세,142,33,109
202102,44250,충청남도,계룡시,90-94세,145,35,110
202103,44250,충청남도,계룡시,90-94세,148,33,115
202104,44250,충청남도,계룡시,90-94세,148,32,116
202105,44250,충청남도,계룡시,90-94세,156,34,122
202106,44250,충청남도,계룡시,90-94세,158,34,124
202007,44250,충청남도,계룡시,95-99세,32,4,28
202008,44250,충청남도,계룡시,95-99세,35,4,31
202009,44250,충청남도,계룡시,95-99세,35,5,30
202010,44250,충청남도,계룡시,95-99세,35,5,30
202011,44250,충청남도,계룡시,95-99세,36,6,30
202012,44250,충청남도,계룡시,95-99세,38,7,31
202101,44250,충청남도,계룡시,95-99세,36,7,29
202102,44250,충청남도,계룡시,95-99세,35,7,28
202103,44250,충청남도,계룡시,95-99세,33,7,26
202104,44250,충청남도,계룡시,95-99세,36,8,28
202105,44250,충청남도,계룡시,95-99세,36,8,28
202106,44250,충청남도,계룡시,95-99세,37,8,29
202007,44250,충청남도,계룡시,100+,10,0,10
202008,44250,충청남도,계룡시,100+,10,0,10
202009,44250,충청남도,계룡시,100+,11,0,11
202010,44250,충청남도,계룡시,100+,11,0,11
202011,44250,충청남도,계룡시,100+,10,0,10
202012,44250,충청남도,계룡시,100+,10,0,10
202101,44250,충청남도,계룡시,100+,10,0,10
202102,44250,충청남도,계룡시,100+,9,0,9
202103,44250,충청남도,계룡시,100+,3,0,3
202104,44250,충청남도,계룡시,100+,3,0,3
202105,44250,충청남도,계룡시,100+,3,0,3
202106,44250,충청남도,계룡시,100+,3,0,3
202007,44270,충청남도,당진시,0-4세,6985,3553,3432
202008,44270,충청남도,당진시,0-4세,6915,3532,3383
202009,44270,충청남도,당진시,0-4세,6842,3508,3334
202010,44270,충청남도,당진시,0-4세,6745,3460,3285
202011,44270,충청남도,당진시,0-4세,6685,3442,3243
202012,44270,충청남도,당진시,0-4세,6621,3416,3205
202101,44270,충청남도,당진시,0-4세,6507,3347,3160
202102,44270,충청남도,당진시,0-4세,6459,3319,3140
202103,44270,충청남도,당진시,0-4세,6419,3283,3136
202104,44270,충청남도,당진시,0-4세,6372,3260,3112
202105,44270,충청남도,당진시,0-4세,6343,3235,3108
202106,44270,충청남도,당진시,0-4세,6285,3210,3075
202007,44270,충청남도,당진시,5-9세,8994,4610,4384
202008,44270,충청남도,당진시,5-9세,9032,4625,4407
202009,44270,충청남도,당진시,5-9세,8995,4584,4411
202010,44270,충청남도,당진시,5-9세,8966,4561,4405
202011,44270,충청남도,당진시,5-9세,8943,4549,4394
202012,44270,충청남도,당진시,5-9세,8940,4534,4406
202101,44270,충청남도,당진시,5-9세,8901,4526,4375
202102,44270,충청남도,당진시,5-9세,8850,4498,4352
202103,44270,충청남도,당진시,5-9세,8844,4487,4357
202104,44270,충청남도,당진시,5-9세,8823,4473,4350
202105,44270,충청남도,당진시,5-9세,8771,4442,4329
202106,44270,충청남도,당진시,5-9세,8730,4422,4308
202007,44270,충청남도,당진시,10-14세,8206,4313,3893
202008,44270,충청남도,당진시,10-14세,8209,4321,3888
202009,44270,충청남도,당진시,10-14세,8257,4347,3910
202010,44270,충청남도,당진시,10-14세,8291,4373,3918
202011,44270,충청남도,당진시,10-14세,8351,4396,3955
202012,44270,충청남도,당진시,10-14세,8366,4403,3963
202101,44270,충청남도,당진시,10-14세,8379,4409,3970
202102,44270,충청남도,당진시,10-14세,8427,4424,4003
202103,44270,충청남도,당진시,10-14세,8455,4447,4008
202104,44270,충청남도,당진시,10-14세,8468,4443,4025
202105,44270,충청남도,당진시,10-14세,8505,4465,4040
202106,44270,충청남도,당진시,10-14세,8550,4486,4064
202007,44270,충청남도,당진시,15-19세,7458,3901,3557
202008,44270,충청남도,당진시,15-19세,7428,3875,3553
202009,44270,충청남도,당진시,15-19세,7390,3860,3530
202010,44270,충청남도,당진시,15-19세,7400,3865,3535
202011,44270,충청남도,당진시,15-19세,7346,3848,3498
202012,44270,충청남도,당진시,15-19세,7321,3843,3478
202101,44270,충청남도,당진시,15-19세,7291,3823,3468
202102,44270,충청남도,당진시,15-19세,7232,3804,3428
202103,44270,충청남도,당진시,15-19세,7197,3785,3412
202104,44270,충청남도,당진시,15-19세,7206,3796,3410
202105,44270,충청남도,당진시,15-19세,7191,3778,3413
202106,44270,충청남도,당진시,15-19세,7163,3768,3395
202007,44270,충청남도,당진시,20-24세,7779,4402,3377
202008,44270,충청남도,당진시,20-24세,7751,4383,3368
202009,44270,충청남도,당진시,20-24세,7766,4404,3362
202010,44270,충청남도,당진시,20-24세,7787,4417,3370
202011,44270,충청남도,당진시,20-24세,7814,4432,3382
202012,44270,충청남도,당진시,20-24세,7814,4417,3397
202101,44270,충청남도,당진시,20-24세,7820,4410,3410
202102,44270,충청남도,당진시,20-24세,7831,4402,3429
202103,44270,충청남도,당진시,20-24세,7803,4389,3414
202104,44270,충청남도,당진시,20-24세,7786,4362,3424
202105,44270,충청남도,당진시,20-24세,7802,4362,3440
202106,44270,충청남도,당진시,20-24세,7808,4368,3440
202007,44270,충청남도,당진시,25-29세,8374,5060,3314
202008,44270,충청남도,당진시,25-29세,8358,5050,3308
202009,44270,충청남도,당진시,25-29세,8313,5019,3294
202010,44270,충청남도,당진시,25-29세,8297,5000,3297
202011,44270,충청남도,당진시,25-29세,8264,4978,3286
202012,44270,충청남도,당진시,25-29세,8261,4959,3302
202101,44270,충청남도,당진시,25-29세,8215,4930,3285
202102,44270,충청남도,당진시,25-29세,8141,4885,3256
202103,44270,충청남도,당진시,25-29세,8182,4907,3275
202104,44270,충청남도,당진시,25-29세,8154,4921,3233
202105,44270,충청남도,당진시,25-29세,8162,4925,3237
202106,44270,충청남도,당진시,25-29세,8195,4966,3229
202007,44270,충청남도,당진시,30-34세,9956,5710,4246
202008,44270,충청남도,당진시,30-34세,9877,5677,4200
202009,44270,충청남도,당진시,30-34세,9861,5690,4171
202010,44270,충청남도,당진시,30-34세,9848,5693,4155
202011,44270,충청남도,당진시,30-34세,9797,5652,4145
202012,44270,충청남도,당진시,30-34세,9812,5661,4151
202101,44270,충청남도,당진시,30-34세,9777,5667,4110
202102,44270,충청남도,당진시,30-34세,9733,5651,4082
202103,44270,충청남도,당진시,30-34세,9707,5645,4062
202104,44270,충청남도,당진시,30-34세,9706,5657,4049
202105,44270,충청남도,당진시,30-34세,9682,5649,4033
202106,44270,충청남도,당진시,30-34세,9681,5646,4035
202007,44270,충청남도,당진시,35-39세,13271,7450,5821
202008,44270,충청남도,당진시,35-39세,13228,7425,5803
202009,44270,충청남도,당진시,35-39세,13083,7328,5755
202010,44270,충청남도,당진시,35-39세,13033,7317,5716
202011,44270,충청남도,당진시,35-39세,13003,7304,5699
202012,44270,충청남도,당진시,35-39세,13015,7339,5676
202101,44270,충청남도,당진시,35-39세,12936,7308,5628
202102,44270,충청남도,당진시,35-39세,12832,7250,5582
202103,44270,충청남도,당진시,35-39세,12777,7220,5557
202104,44270,충청남도,당진시,35-39세,12691,7158,5533
202105,44270,충청남도,당진시,35-39세,12637,7131,5506
202106,44270,충청남도,당진시,35-39세,12584,7110,5474
202007,44270,충청남도,당진시,40-44세,13026,7190,5836
202008,44270,충청남도,당진시,40-44세,13069,7224,5845
202009,44270,충청남도,당진시,40-44세,13120,7266,5854
202010,44270,충청남도,당진시,40-44세,13164,7293,5871
202011,44270,충청남도,당진시,40-44세,13202,7316,5886
202012,44270,충청남도,당진시,40-44세,13149,7279,5870
202101,44270,충청남도,당진시,40-44세,13190,7293,5897
202102,44270,충청남도,당진시,40-44세,13280,7371,5909
202103,44270,충청남도,당진시,40-44세,13278,7400,5878
202104,44270,충청남도,당진시,40-44세,13324,7447,5877
202105,44270,충청남도,당진시,40-44세,13416,7506,5910
202106,44270,충청남도,당진시,40-44세,13529,7557,5972
202007,44270,충청남도,당진시,45-49세,13579,7786,5793
202008,44270,충청남도,당진시,45-49세,13559,7775,5784
202009,44270,충청남도,당진시,45-49세,13506,7730,5776
202010,44270,충청남도,당진시,45-49세,13470,7711,5759
202011,44270,충청남도,당진시,45-49세,13479,7722,5757
202012,44270,충청남도,당진시,45-49세,13521,7744,5777
202101,44270,충청남도,당진시,45-49세,13522,7755,5767
202102,44270,충청남도,당진시,45-49세,13513,7733,5780
202103,44270,충청남도,당진시,45-49세,13463,7675,5788
202104,44270,충청남도,당진시,45-49세,13516,7676,5840
202105,44270,충청남도,당진시,45-49세,13417,7590,5827
202106,44270,충청남도,당진시,45-49세,13379,7581,5798
202007,44270,충청남도,당진시,50-54세,12691,7165,5526
202008,44270,충청남도,당진시,50-54세,12747,7207,5540
202009,44270,충청남도,당진시,50-54세,12817,7242,5575
202010,44270,충청남도,당진시,50-54세,12924,7302,5622
202011,44270,충청남도,당진시,50-54세,12958,7343,5615
202012,44270,충청남도,당진시,50-54세,12936,7324,5612
202101,44270,충청남도,당진시,50-54세,13058,7395,5663
202102,44270,충청남도,당진시,50-54세,13115,7422,5693
202103,44270,충청남도,당진시,50-54세,13180,7466,5714
202104,44270,충청남도,당진시,50-54세,13221,7508,5713
202105,44270,충청남도,당진시,50-54세,13380,7611,5769
202106,44270,충청남도,당진시,50-54세,13493,7657,5836
202007,44270,충청남도,당진시,55-59세,13052,7245,5807
202008,44270,충청남도,당진시,55-59세,13027,7220,5807
202009,44270,충청남도,당진시,55-59세,13029,7230,5799
202010,44270,충청남도,당진시,55-59세,13022,7219,5803
202011,44270,충청남도,당진시,55-59세,13027,7217,5810
202012,44270,충청남도,당진시,55-59세,12998,7202,5796
202101,44270,충청남도,당진시,55-59세,12893,7155,5738
202102,44270,충청남도,당진시,55-59세,12875,7164,5711
202103,44270,충청남도,당진시,55-59세,12829,7165,5664
202104,44270,충청남도,당진시,55-59세,12761,7143,5618
202105,44270,충청남도,당진시,55-59세,12631,7082,5549
202106,44270,충청남도,당진시,55-59세,12561,7027,5534
202007,44270,충청남도,당진시,60-64세,11867,6119,5748
202008,44270,충청남도,당진시,60-64세,11925,6170,5755
202009,44270,충청남도,당진시,60-64세,11966,6194,5772
202010,44270,충청남도,당진시,60-64세,12014,6248,5766
202011,44270,충청남도,당진시,60-64세,12059,6285,5774
202012,44270,충청남도,당진시,60-64세,12164,6369,5795
202101,44270,충청남도,당진시,60-64세,12253,6430,5823
202102,44270,충청남도,당진시,60-64세,12384,6493,5891
202103,44270,충청남도,당진시,60-64세,12473,6539,5934
202104,44270,충청남도,당진시,60-64세,12614,6627,5987
202105,44270,충청남도,당진시,60-64세,12750,6699,6051
202106,44270,충청남도,당진시,60-64세,12887,6783,6104
202007,44270,충청남도,당진시,65-69세,8611,4265,4346
202008,44270,충청남도,당진시,65-69세,8661,4305,4356
202009,44270,충청남도,당진시,65-69세,8704,4319,4385
202010,44270,충청남도,당진시,65-69세,8703,4317,4386
202011,44270,충청남도,당진시,65-69세,8752,4330,4422
202012,44270,충청남도,당진시,65-69세,8843,4364,4479
202101,44270,충청남도,당진시,65-69세,8915,4391,4524
202102,44270,충청남도,당진시,65-69세,8982,4432,4550
202103,44270,충청남도,당진시,65-69세,9085,4503,4582
202104,44270,충청남도,당진시,65-69세,9172,4549,4623
202105,44270,충청남도,당진시,65-69세,9254,4597,4657
202106,44270,충청남도,당진시,65-69세,9295,4614,4681
202007,44270,충청남도,당진시,70-74세,7074,3493,3581
202008,44270,충청남도,당진시,70-74세,7118,3497,3621
202009,44270,충청남도,당진시,70-74세,7176,3526,3650
202010,44270,충청남도,당진시,70-74세,7259,3551,3708
202011,44270,충청남도,당진시,70-74세,7305,3567,3738
202012,44270,충청남도,당진시,70-74세,7363,3607,3756
202101,44270,충청남도,당진시,70-74세,7405,3622,3783
202102,44270,충청남도,당진시,70-74세,7409,3632,3777
202103,44270,충청남도,당진시,70-74세,7387,3625,3762
202104,44270,충청남도,당진시,70-74세,7408,3632,3776
202105,44270,충청남도,당진시,70-74세,7414,3636,3778
202106,44270,충청남도,당진시,70-74세,7453,3655,3798
202007,44270,충청남도,당진시,75-79세,6066,2659,3407
202008,44270,충청남도,당진시,75-79세,6079,2666,3413
202009,44270,충청남도,당진시,75-79세,6045,2648,3397
202010,44270,충청남도,당진시,75-79세,6002,2635,3367
202011,44270,충청남도,당진시,75-79세,5996,2632,3364
202012,44270,충청남도,당진시,75-79세,5943,2614,3329
202101,44270,충청남도,당진시,75-79세,5899,2601,3298
202102,44270,충청남도,당진시,75-79세,5875,2587,3288
202103,44270,충청남도,당진시,75-79세,5833,2566,3267
202104,44270,충청남도,당진시,75-79세,5798,2562,3236
202105,44270,충청남도,당진시,75-79세,5787,2577,3210
202106,44270,충청남도,당진시,75-79세,5794,2583,3211
202007,44270,충청남도,당진시,80-84세,5182,1939,3243
202008,44270,충청남도,당진시,80-84세,5149,1935,3214
202009,44270,충청남도,당진시,80-84세,5141,1936,3205
202010,44270,충청남도,당진시,80-84세,5138,1939,3199
202011,44270,충청남도,당진시,80-84세,5130,1938,3192
202012,44270,충청남도,당진시,80-84세,5098,1912,3186
202101,44270,충청남도,당진시,80-84세,5103,1915,3188
202102,44270,충청남도,당진시,80-84세,5084,1918,3166
202103,44270,충청남도,당진시,80-84세,5044,1917,3127
202104,44270,충청남도,당진시,80-84세,5050,1918,3132
202105,44270,충청남도,당진시,80-84세,5052,1906,3146
202106,44270,충청남도,당진시,80-84세,5058,1911,3147
202007,44270,충청남도,당진시,85-89세,2717,855,1862
202008,44270,충청남도,당진시,85-89세,2758,868,1890
202009,44270,충청남도,당진시,85-89세,2785,880,1905
202010,44270,충청남도,당진시,85-89세,2809,885,1924
202011,44270,충청남도,당진시,85-89세,2826,892,1934
202012,44270,충청남도,당진시,85-89세,2867,917,1950
202101,44270,충청남도,당진시,85-89세,2897,932,1965
202102,44270,충청남도,당진시,85-89세,2956,949,2007
202103,44270,충청남도,당진시,85-89세,3010,958,2052
202104,44270,충청남도,당진시,85-89세,3036,971,2065
202105,44270,충청남도,당진시,85-89세,3075,985,2090
202106,44270,충청남도,당진시,85-89세,3091,995,2096
202007,44270,충청남도,당진시,90-94세,890,242,648
202008,44270,충청남도,당진시,90-94세,902,243,659
202009,44270,충청남도,당진시,90-94세,912,244,668
202010,44270,충청남도,당진시,90-94세,916,239,677
202011,44270,충청남도,당진시,90-94세,923,242,681
202012,44270,충청남도,당진시,90-94세,932,247,685
202101,44270,충청남도,당진시,90-94세,939,245,694
202102,44270,충청남도,당진시,90-94세,953,251,702
202103,44270,충청남도,당진시,90-94세,961,252,709
202104,44270,충청남도,당진시,90-94세,970,254,716
202105,44270,충청남도,당진시,90-94세,965,249,716
202106,44270,충청남도,당진시,90-94세,965,245,720
202007,44270,충청남도,당진시,95-99세,211,36,175
202008,44270,충청남도,당진시,95-99세,207,37,170
202009,44270,충청남도,당진시,95-99세,215,40,175
202010,44270,충청남도,당진시,95-99세,215,42,173
202011,44270,충청남도,당진시,95-99세,215,41,174
202012,44270,충청남도,당진시,95-99세,215,41,174
202101,44270,충청남도,당진시,95-99세,218,43,175
202102,44270,충청남도,당진시,95-99세,215,42,173
202103,44270,충청남도,당진시,95-99세,209,42,167
202104,44270,충청남도,당진시,95-99세,206,43,163
202105,44270,충청남도,당진시,95-99세,205,44,161
202106,44270,충청남도,당진시,95-99세,202,45,157
202007,44270,충청남도,당진시,100+,68,14,54
202008,44270,충청남도,당진시,100+,68,14,54
202009,44270,충청남도,당진시,100+,68,14,54
202010,44270,충청남도,당진시,100+,70,14,56
202011,44270,충청남도,당진시,100+,70,14,56
202012,44270,충청남도,당진시,100+,70,14,56
202101,44270,충청남도,당진시,100+,71,14,57
202102,44270,충청남도,당진시,100+,72,14,58
202103,44270,충청남도,당진시,100+,50,8,42
202104,44270,충청남도,당진시,100+,51,8,43
202105,44270,충청남도,당진시,100+,52,8,44
202106,44270,충청남도,당진시,100+,51,8,43
202007,44710,충청남도,금산군,0-4세,1073,516,557
202008,44710,충청남도,금산군,0-4세,1053,509,544
202009,44710,충청남도,금산군,0-4세,1053,509,544
202010,44710,충청남도,금산군,0-4세,1035,501,534
202011,44710,충청남도,금산군,0-4세,1026,498,528
202012,44710,충청남도,금산군,0-4세,1016,495,521
202101,44710,충청남도,금산군,0-4세,999,486,513
202102,44710,충청남도,금산군,0-4세,995,484,511
202103,44710,충청남도,금산군,0-4세,981,472,509
202104,44710,충청남도,금산군,0-4세,970,463,507
202105,44710,충청남도,금산군,0-4세,968,462,506
202106,44710,충청남도,금산군,0-4세,947,453,494
202007,44710,충청남도,금산군,5-9세,1618,865,753
202008,44710,충청남도,금산군,5-9세,1614,858,756
202009,44710,충청남도,금산군,5-9세,1584,839,745
202010,44710,충청남도,금산군,5-9세,1579,829,750
202011,44710,충청남도,금산군,5-9세,1561,819,742
202012,44710,충청남도,금산군,5-9세,1549,810,739
202101,44710,충청남도,금산군,5-9세,1529,810,719
202102,44710,충청남도,금산군,5-9세,1522,799,723
202103,44710,충청남도,금산군,5-9세,1511,799,712
202104,44710,충청남도,금산군,5-9세,1500,793,707
202105,44710,충청남도,금산군,5-9세,1499,795,704
202106,44710,충청남도,금산군,5-9세,1488,785,703
202007,44710,충청남도,금산군,10-14세,2124,1106,1018
202008,44710,충청남도,금산군,10-14세,2119,1108,1011
202009,44710,충청남도,금산군,10-14세,2121,1107,1014
202010,44710,충청남도,금산군,10-14세,2114,1112,1002
202011,44710,충청남도,금산군,10-14세,2121,1121,1000
202012,44710,충청남도,금산군,10-14세,2121,1121,1000
202101,44710,충청남도,금산군,10-14세,2122,1115,1007
202102,44710,충청남도,금산군,10-14세,2141,1134,1007
202103,44710,충청남도,금산군,10-14세,2166,1142,1024
202104,44710,충청남도,금산군,10-14세,2141,1127,1014
202105,44710,충청남도,금산군,10-14세,2130,1125,1005
202106,44710,충청남도,금산군,10-14세,2137,1129,1008
202007,44710,충청남도,금산군,15-19세,2238,1178,1060
202008,44710,충청남도,금산군,15-19세,2240,1172,1068
202009,44710,충청남도,금산군,15-19세,2224,1163,1061
202010,44710,충청남도,금산군,15-19세,2210,1153,1057
202011,44710,충청남도,금산군,15-19세,2185,1127,1058
202012,44710,충청남도,금산군,15-19세,2168,1118,1050
202101,44710,충청남도,금산군,15-19세,2147,1103,1044
202102,44710,충청남도,금산군,15-19세,2113,1083,1030
202103,44710,충청남도,금산군,15-19세,2103,1076,1027
202104,44710,충청남도,금산군,15-19세,2123,1093,1030
202105,44710,충청남도,금산군,15-19세,2124,1103,1021
202106,44710,충청남도,금산군,15-19세,2124,1093,1031
202007,44710,충청남도,금산군,20-24세,2224,1274,950
202008,44710,충청남도,금산군,20-24세,2216,1278,938
202009,44710,충청남도,금산군,20-24세,2221,1281,940
202010,44710,충청남도,금산군,20-24세,2214,1275,939
202011,44710,충청남도,금산군,20-24세,2228,1283,945
202012,44710,충청남도,금산군,20-24세,2221,1275,946
202101,44710,충청남도,금산군,20-24세,2219,1265,954
202102,44710,충청남도,금산군,20-24세,2204,1251,953
202103,44710,충청남도,금산군,20-24세,2158,1235,923
202104,44710,충청남도,금산군,20-24세,2149,1221,928
202105,44710,충청남도,금산군,20-24세,2122,1203,919
202106,44710,충청남도,금산군,20-24세,2114,1207,907
202007,44710,충청남도,금산군,25-29세,1794,1024,770
202008,44710,충청남도,금산군,25-29세,1769,1011,758
202009,44710,충청남도,금산군,25-29세,1764,1012,752
202010,44710,충청남도,금산군,25-29세,1763,1012,751
202011,44710,충청남도,금산군,25-29세,1759,1013,746
202012,44710,충청남도,금산군,25-29세,1799,1034,765
202101,44710,충청남도,금산군,25-29세,1783,1025,758
202102,44710,충청남도,금산군,25-29세,1768,1025,743
202103,44710,충청남도,금산군,25-29세,1767,1023,744
202104,44710,충청남도,금산군,25-29세,1758,1013,745
202105,44710,충청남도,금산군,25-29세,1748,998,750
202106,44710,충청남도,금산군,25-29세,1740,995,745
202007,44710,충청남도,금산군,30-34세,1637,863,774
202008,44710,충청남도,금산군,30-34세,1631,853,778
202009,44710,충청남도,금산군,30-34세,1621,840,781
202010,44710,충청남도,금산군,30-34세,1605,836,769
202011,44710,충청남도,금산군,30-34세,1601,837,764
202012,44710,충청남도,금산군,30-34세,1599,840,759
202101,44710,충청남도,금산군,30-34세,1579,831,748
202102,44710,충청남도,금산군,30-34세,1555,822,733
202103,44710,충청남도,금산군,30-34세,1527,804,723
202104,44710,충청남도,금산군,30-34세,1509,790,719
202105,44710,충청남도,금산군,30-34세,1507,791,716
202106,44710,충청남도,금산군,30-34세,1477,776,701
202007,44710,충청남도,금산군,35-39세,2280,1206,1074
202008,44710,충청남도,금산군,35-39세,2251,1196,1055
202009,44710,충청남도,금산군,35-39세,2215,1174,1041
202010,44710,충청남도,금산군,35-39세,2195,1159,1036
202011,44710,충청남도,금산군,35-39세,2182,1151,1031
202012,44710,충청남도,금산군,35-39세,2166,1137,1029
202101,44710,충청남도,금산군,35-39세,2117,1112,1005
202102,44710,충청남도,금산군,35-39세,2094,1100,994
202103,44710,충청남도,금산군,35-39세,2078,1103,975
202104,44710,충청남도,금산군,35-39세,2069,1096,973
202105,44710,충청남도,금산군,35-39세,2061,1092,969
202106,44710,충청남도,금산군,35-39세,2043,1085,958
202007,44710,충청남도,금산군,40-44세,2713,1452,1261
202008,44710,충청남도,금산군,40-44세,2702,1439,1263
202009,44710,충청남도,금산군,40-44세,2715,1455,1260
202010,44710,충청남도,금산군,40-44세,2714,1449,1265
202011,44710,충청남도,금산군,40-44세,2719,1452,1267
202012,44710,충청남도,금산군,40-44세,2687,1442,1245
202101,44710,충청남도,금산군,40-44세,2683,1437,1246
202102,44710,충청남도,금산군,40-44세,2675,1427,1248
202103,44710,충청남도,금산군,40-44세,2629,1385,1244
202104,44710,충청남도,금산군,40-44세,2624,1386,1238
202105,44710,충청남도,금산군,40-44세,2602,1372,1230
202106,44710,충청남도,금산군,40-44세,2614,1380,1234
202007,44710,충청남도,금산군,45-49세,3612,2058,1554
202008,44710,충청남도,금산군,45-49세,3621,2058,1563
202009,44710,충청남도,금산군,45-49세,3589,2039,1550
202010,44710,충청남도,금산군,45-49세,3554,2019,1535
202011,44710,충청남도,금산군,45-49세,3539,2001,1538
202012,44710,충청남도,금산군,45-49세,3529,2000,1529
202101,44710,충청남도,금산군,45-49세,3517,1983,1534
202102,44710,충청남도,금산군,45-49세,3516,1984,1532
202103,44710,충청남도,금산군,45-49세,3492,1972,1520
202104,44710,충청남도,금산군,45-49세,3492,1977,1515
202105,44710,충청남도,금산군,45-49세,3467,1974,1493
202106,44710,충청남도,금산군,45-49세,3451,1964,1487
202007,44710,충청남도,금산군,50-54세,4193,2326,1867
202008,44710,충청남도,금산군,50-54세,4190,2329,1861
202009,44710,충청남도,금산군,50-54세,4204,2342,1862
202010,44710,충청남도,금산군,50-54세,4228,2361,1867
202011,44710,충청남도,금산군,50-54세,4228,2364,1864
202012,44710,충청남도,금산군,50-54세,4223,2338,1885
202101,44710,충청남도,금산군,50-54세,4225,2337,1888
202102,44710,충청남도,금산군,50-54세,4216,2332,1884
202103,44710,충청남도,금산군,50-54세,4196,2333,1863
202104,44710,충청남도,금산군,50-54세,4209,2342,1867
202105,44710,충청남도,금산군,50-54세,4248,2358,1890
202106,44710,충청남도,금산군,50-54세,4235,2336,1899
202007,44710,충청남도,금산군,55-59세,5024,2740,2284
202008,44710,충청남도,금산군,55-59세,4988,2726,2262
202009,44710,충청남도,금산군,55-59세,4955,2707,2248
202010,44710,충청남도,금산군,55-59세,4909,2691,2218
202011,44710,충청남도,금산군,55-59세,4900,2682,2218
202012,44710,충청남도,금산군,55-59세,4864,2679,2185
202101,44710,충청남도,금산군,55-59세,4802,2640,2162
202102,44710,충청남도,금산군,55-59세,4760,2619,2141
202103,44710,충청남도,금산군,55-59세,4668,2576,2092
202104,44710,충청남도,금산군,55-59세,4660,2584,2076
202105,44710,충청남도,금산군,55-59세,4644,2560,2084
202106,44710,충청남도,금산군,55-59세,4620,2553,2067
202007,44710,충청남도,금산군,60-64세,5231,2685,2546
202008,44710,충청남도,금산군,60-64세,5269,2703,2566
202009,44710,충청남도,금산군,60-64세,5295,2719,2576
202010,44710,충청남도,금산군,60-64세,5322,2726,2596
202011,44710,충청남도,금산군,60-64세,5348,2747,2601
202012,44710,충청남도,금산군,60-64세,5396,2772,2624
202101,44710,충청남도,금산군,60-64세,5434,2799,2635
202102,44710,충청남도,금산군,60-64세,5528,2843,2685
202103,44710,충청남도,금산군,60-64세,5567,2866,2701
202104,44710,충청남도,금산군,60-64세,5608,2892,2716
202105,44710,충청남도,금산군,60-64세,5640,2907,2733
202106,44710,충청남도,금산군,60-64세,5697,2933,2764
202007,44710,충청남도,금산군,65-69세,4334,2150,2184
202008,44710,충청남도,금산군,65-69세,4354,2166,2188
202009,44710,충청남도,금산군,65-69세,4382,2171,2211
202010,44710,충청남도,금산군,65-69세,4399,2180,2219
202011,44710,충청남도,금산군,65-69세,4399,2189,2210
202012,44710,충청남도,금산군,65-69세,4442,2218,2224
202101,44710,충청남도,금산군,65-69세,4456,2232,2224
202102,44710,충청남도,금산군,65-69세,4469,2252,2217
202103,44710,충청남도,금산군,65-69세,4507,2270,2237
202104,44710,충청남도,금산군,65-69세,4517,2278,2239
202105,44710,충청남도,금산군,65-69세,4519,2293,2226
202106,44710,충청남도,금산군,65-69세,4531,2301,2230
202007,44710,충청남도,금산군,70-74세,3538,1740,1798
202008,44710,충청남도,금산군,70-74세,3544,1742,1802
202009,44710,충청남도,금산군,70-74세,3552,1755,1797
202010,44710,충청남도,금산군,70-74세,3570,1761,1809
202011,44710,충청남도,금산군,70-74세,3598,1776,1822
202012,44710,충청남도,금산군,70-74세,3612,1771,1841
202101,44710,충청남도,금산군,70-74세,3642,1781,1861
202102,44710,충청남도,금산군,70-74세,3659,1792,1867
202103,44710,충청남도,금산군,70-74세,3641,1798,1843
202104,44710,충청남도,금산군,70-74세,3651,1795,1856
202105,44710,충청남도,금산군,70-74세,3663,1803,1860
202106,44710,충청남도,금산군,70-74세,3662,1800,1862
202007,44710,충청남도,금산군,75-79세,3296,1330,1966
202008,44710,충청남도,금산군,75-79세,3284,1329,1955
202009,44710,충청남도,금산군,75-79세,3276,1328,1948
202010,44710,충청남도,금산군,75-79세,3254,1320,1934
202011,44710,충청남도,금산군,75-79세,3251,1322,1929
202012,44710,충청남도,금산군,75-79세,3233,1317,1916
202101,44710,충청남도,금산군,75-79세,3206,1310,1896
202102,44710,충청남도,금산군,75-79세,3178,1312,1866
202103,44710,충청남도,금산군,75-79세,3149,1300,1849
202104,44710,충청남도,금산군,75-79세,3137,1307,1830
202105,44710,충청남도,금산군,75-79세,3140,1309,1831
202106,44710,충청남도,금산군,75-79세,3145,1325,1820
202007,44710,충청남도,금산군,80-84세,2772,966,1806
202008,44710,충청남도,금산군,80-84세,2772,960,1812
202009,44710,충청남도,금산군,80-84세,2754,962,1792
202010,44710,충청남도,금산군,80-84세,2760,972,1788
202011,44710,충청남도,금산군,80-84세,2745,965,1780
202012,44710,충청남도,금산군,80-84세,2715,949,1766
202101,44710,충청남도,금산군,80-84세,2719,943,1776
202102,44710,충청남도,금산군,80-84세,2719,935,1784
202103,44710,충청남도,금산군,80-84세,2706,931,1775
202104,44710,충청남도,금산군,80-84세,2709,930,1779
202105,44710,충청남도,금산군,80-84세,2703,924,1779
202106,44710,충청남도,금산군,80-84세,2706,924,1782
202007,44710,충청남도,금산군,85-89세,1434,445,989
202008,44710,충청남도,금산군,85-89세,1452,458,994
202009,44710,충청남도,금산군,85-89세,1464,462,1002
202010,44710,충청남도,금산군,85-89세,1474,462,1012
202011,44710,충청남도,금산군,85-89세,1465,462,1003
202012,44710,충청남도,금산군,85-89세,1487,474,1013
202101,44710,충청남도,금산군,85-89세,1492,472,1020
202102,44710,충청남도,금산군,85-89세,1520,480,1040
202103,44710,충청남도,금산군,85-89세,1541,480,1061
202104,44710,충청남도,금산군,85-89세,1555,485,1070
202105,44710,충청남도,금산군,85-89세,1577,492,1085
202106,44710,충청남도,금산군,85-89세,1585,492,1093
202007,44710,충청남도,금산군,90-94세,425,102,323
202008,44710,충청남도,금산군,90-94세,434,107,327
202009,44710,충청남도,금산군,90-94세,433,105,328
202010,44710,충청남도,금산군,90-94세,438,108,330
202011,44710,충청남도,금산군,90-94세,448,107,341
202012,44710,충청남도,금산군,90-94세,447,107,340
202101,44710,충청남도,금산군,90-94세,451,108,343
202102,44710,충청남도,금산군,90-94세,455,109,346
202103,44710,충청남도,금산군,90-94세,450,105,345
202104,44710,충청남도,금산군,90-94세,454,105,349
202105,44710,충청남도,금산군,90-94세,455,105,350
202106,44710,충청남도,금산군,90-94세,462,111,351
202007,44710,충청남도,금산군,95-99세,105,22,83
202008,44710,충청남도,금산군,95-99세,108,22,86
202009,44710,충청남도,금산군,95-99세,110,23,87
202010,44710,충청남도,금산군,95-99세,110,23,87
202011,44710,충청남도,금산군,95-99세,110,22,88
202012,44710,충청남도,금산군,95-99세,108,22,86
202101,44710,충청남도,금산군,95-99세,109,23,86
202102,44710,충청남도,금산군,95-99세,111,24,87
202103,44710,충청남도,금산군,95-99세,107,21,86
202104,44710,충청남도,금산군,95-99세,106,21,85
202105,44710,충청남도,금산군,95-99세,105,20,85
202106,44710,충청남도,금산군,95-99세,103,19,84
202007,44710,충청남도,금산군,100+,31,9,22
202008,44710,충청남도,금산군,100+,30,8,22
202009,44710,충청남도,금산군,100+,31,8,23
202010,44710,충청남도,금산군,100+,29,8,21
202011,44710,충청남도,금산군,100+,30,9,21
202012,44710,충청남도,금산군,100+,31,9,22
202101,44710,충청남도,금산군,100+,31,9,22
202102,44710,충청남도,금산군,100+,29,8,21
202103,44710,충청남도,금산군,100+,9,1,8
202104,44710,충청남도,금산군,100+,9,1,8
202105,44710,충청남도,금산군,100+,10,1,9
202106,44710,충청남도,금산군,100+,9,1,8
202007,44760,충청남도,부여군,0-4세,1157,602,555
202008,44760,충청남도,부여군,0-4세,1156,600,556
202009,44760,충청남도,부여군,0-4세,1144,594,550
202010,44760,충청남도,부여군,0-4세,1131,587,544
202011,44760,충청남도,부여군,0-4세,1111,575,536
202012,44760,충청남도,부여군,0-4세,1082,560,522
202101,44760,충청남도,부여군,0-4세,1073,564,509
202102,44760,충청남도,부여군,0-4세,1051,555,496
202103,44760,충청남도,부여군,0-4세,1035,546,489
202104,44760,충청남도,부여군,0-4세,1020,537,483
202105,44760,충청남도,부여군,0-4세,1012,533,479
202106,44760,충청남도,부여군,0-4세,996,528,468
202007,44760,충청남도,부여군,5-9세,1878,1029,849
202008,44760,충청남도,부여군,5-9세,1869,1021,848
202009,44760,충청남도,부여군,5-9세,1849,1005,844
202010,44760,충청남도,부여군,5-9세,1836,994,842
202011,44760,충청남도,부여군,5-9세,1830,983,847
202012,44760,충청남도,부여군,5-9세,1842,993,849
202101,44760,충청남도,부여군,5-9세,1836,986,850
202102,44760,충청남도,부여군,5-9세,1841,988,853
202103,44760,충청남도,부여군,5-9세,1828,979,849
202104,44760,충청남도,부여군,5-9세,1832,979,853
202105,44760,충청남도,부여군,5-9세,1810,965,845
202106,44760,충청남도,부여군,5-9세,1800,960,840
202007,44760,충청남도,부여군,10-14세,2134,1108,1026
202008,44760,충청남도,부여군,10-14세,2137,1120,1017
202009,44760,충청남도,부여군,10-14세,2149,1127,1022
202010,44760,충청남도,부여군,10-14세,2120,1115,1005
202011,44760,충청남도,부여군,10-14세,2110,1111,999
202012,44760,충청남도,부여군,10-14세,2102,1113,989
202101,44760,충청남도,부여군,10-14세,2112,1124,988
202102,44760,충청남도,부여군,10-14세,2087,1116,971
202103,44760,충청남도,부여군,10-14세,2099,1129,970
202104,44760,충청남도,부여군,10-14세,2082,1116,966
202105,44760,충청남도,부여군,10-14세,2077,1113,964
202106,44760,충청남도,부여군,10-14세,2074,1111,963
202007,44760,충청남도,부여군,15-19세,2653,1408,1245
202008,44760,충청남도,부여군,15-19세,2623,1389,1234
202009,44760,충청남도,부여군,15-19세,2599,1382,1217
202010,44760,충청남도,부여군,15-19세,2602,1392,1210
202011,44760,충청남도,부여군,15-19세,2580,1377,1203
202012,44760,충청남도,부여군,15-19세,2572,1357,1215
202101,44760,충청남도,부여군,15-19세,2547,1341,1206
202102,44760,충청남도,부여군,15-19세,2540,1338,1202
202103,44760,충청남도,부여군,15-19세,2485,1300,1185
202104,44760,충청남도,부여군,15-19세,2470,1290,1180
202105,44760,충청남도,부여군,15-19세,2453,1285,1168
202106,44760,충청남도,부여군,15-19세,2454,1283,1171
202007,44760,충청남도,부여군,20-24세,3136,1776,1360
202008,44760,충청남도,부여군,20-24세,3126,1773,1353
202009,44760,충청남도,부여군,20-24세,3096,1750,1346
202010,44760,충청남도,부여군,20-24세,3109,1749,1360
202011,44760,충청남도,부여군,20-24세,3104,1746,1358
202012,44760,충청남도,부여군,20-24세,3104,1742,1362
202101,44760,충청남도,부여군,20-24세,3051,1709,1342
202102,44760,충청남도,부여군,20-24세,2998,1678,1320
202103,44760,충청남도,부여군,20-24세,2975,1661,1314
202104,44760,충청남도,부여군,20-24세,2962,1664,1298
202105,44760,충청남도,부여군,20-24세,2943,1652,1291
202106,44760,충청남도,부여군,20-24세,2919,1642,1277
202007,44760,충청남도,부여군,25-29세,2344,1396,948
202008,44760,충청남도,부여군,25-29세,2320,1391,929
202009,44760,충청남도,부여군,25-29세,2328,1393,935
202010,44760,충청남도,부여군,25-29세,2322,1389,933
202011,44760,충청남도,부여군,25-29세,2321,1391,930
202012,44760,충청남도,부여군,25-29세,2321,1394,927
202101,44760,충청남도,부여군,25-29세,2316,1388,928
202102,44760,충청남도,부여군,25-29세,2283,1365,918
202103,44760,충청남도,부여군,25-29세,2294,1374,920
202104,44760,충청남도,부여군,25-29세,2284,1373,911
202105,44760,충청남도,부여군,25-29세,2279,1367,912
202106,44760,충청남도,부여군,25-29세,2273,1363,910
202007,44760,충청남도,부여군,30-34세,1990,1072,918
202008,44760,충청남도,부여군,30-34세,1982,1062,920
202009,44760,충청남도,부여군,30-34세,1971,1061,910
202010,44760,충청남도,부여군,30-34세,1955,1060,895
202011,44760,충청남도,부여군,30-34세,1949,1060,889
202012,44760,충청남도,부여군,30-34세,1935,1047,888
202101,44760,충청남도,부여군,30-34세,1910,1032,878
202102,44760,충청남도,부여군,30-34세,1890,1020,870
202103,44760,충청남도,부여군,30-34세,1862,1014,848
202104,44760,충청남도,부여군,30-34세,1860,1004,856
202105,44760,충청남도,부여군,30-34세,1854,1011,843
202106,44760,충청남도,부여군,30-34세,1845,1008,837
202007,44760,충청남도,부여군,35-39세,2543,1393,1150
202008,44760,충청남도,부여군,35-39세,2512,1378,1134
202009,44760,충청남도,부여군,35-39세,2500,1362,1138
202010,44760,충청남도,부여군,35-39세,2500,1363,1137
202011,44760,충청남도,부여군,35-39세,2485,1351,1134
202012,44760,충청남도,부여군,35-39세,2467,1337,1130
202101,44760,충청남도,부여군,35-39세,2453,1326,1127
202102,44760,충청남도,부여군,35-39세,2432,1320,1112
202103,44760,충청남도,부여군,35-39세,2415,1312,1103
202104,44760,충청남도,부여군,35-39세,2399,1305,1094
202105,44760,충청남도,부여군,35-39세,2382,1297,1085
202106,44760,충청남도,부여군,35-39세,2380,1294,1086
202007,44760,충청남도,부여군,40-44세,3069,1653,1416
202008,44760,충청남도,부여군,40-44세,3084,1659,1425
202009,44760,충청남도,부여군,40-44세,3061,1646,1415
202010,44760,충청남도,부여군,40-44세,3072,1655,1417
202011,44760,충청남도,부여군,40-44세,3070,1652,1418
202012,44760,충청남도,부여군,40-44세,3044,1646,1398
202101,44760,충청남도,부여군,40-44세,3038,1653,1385
202102,44760,충청남도,부여군,40-44세,3009,1632,1377
202103,44760,충청남도,부여군,40-44세,2961,1600,1361
202104,44760,충청남도,부여군,40-44세,2920,1580,1340
202105,44760,충청남도,부여군,40-44세,2926,1577,1349
202106,44760,충청남도,부여군,40-44세,2950,1589,1361
202007,44760,충청남도,부여군,45-49세,4289,2356,1933
202008,44760,충청남도,부여군,45-49세,4269,2353,1916
202009,44760,충청남도,부여군,45-49세,4231,2333,1898
202010,44760,충청남도,부여군,45-49세,4170,2296,1874
202011,44760,충청남도,부여군,45-49세,4144,2280,1864
202012,44760,충청남도,부여군,45-49세,4160,2282,1878
202101,44760,충청남도,부여군,45-49세,4128,2265,1863
202102,44760,충청남도,부여군,45-49세,4137,2266,1871
202103,44760,충청남도,부여군,45-49세,4077,2235,1842
202104,44760,충청남도,부여군,45-49세,4051,2224,1827
202105,44760,충청남도,부여군,45-49세,3981,2181,1800
202106,44760,충청남도,부여군,45-49세,3972,2174,1798
202007,44760,충청남도,부여군,50-54세,4872,2621,2251
202008,44760,충청남도,부여군,50-54세,4856,2612,2244
202009,44760,충청남도,부여군,50-54세,4863,2612,2251
202010,44760,충청남도,부여군,50-54세,4880,2622,2258
202011,44760,충청남도,부여군,50-54세,4890,2639,2251
202012,44760,충청남도,부여군,50-54세,4874,2632,2242
202101,44760,충청남도,부여군,50-54세,4885,2642,2243
202102,44760,충청남도,부여군,50-54세,4870,2639,2231
202103,44760,충청남도,부여군,50-54세,4846,2642,2204
202104,44760,충청남도,부여군,50-54세,4862,2646,2216
202105,44760,충청남도,부여군,50-54세,4891,2672,2219
202106,44760,충청남도,부여군,50-54세,4879,2661,2218
202007,44760,충청남도,부여군,55-59세,6197,3151,3046
202008,44760,충청남도,부여군,55-59세,6165,3139,3026
202009,44760,충청남도,부여군,55-59세,6125,3114,3011
202010,44760,충청남도,부여군,55-59세,6058,3079,2979
202011,44760,충청남도,부여군,55-59세,6026,3068,2958
202012,44760,충청남도,부여군,55-59세,5984,3047,2937
202101,44760,충청남도,부여군,55-59세,5889,2994,2895
202102,44760,충청남도,부여군,55-59세,5840,2975,2865
202103,44760,충청남도,부여군,55-59세,5751,2940,2811
202104,44760,충청남도,부여군,55-59세,5693,2912,2781
202105,44760,충청남도,부여군,55-59세,5644,2889,2755
202106,44760,충청남도,부여군,55-59세,5593,2865,2728
202007,44760,충청남도,부여군,60-64세,7115,3571,3544
202008,44760,충청남도,부여군,60-64세,7102,3563,3539
202009,44760,충청남도,부여군,60-64세,7111,3577,3534
202010,44760,충청남도,부여군,60-64세,7161,3602,3559
202011,44760,충청남도,부여군,60-64세,7171,3612,3559
202012,44760,충청남도,부여군,60-64세,7184,3635,3549
202101,44760,충청남도,부여군,60-64세,7215,3649,3566
202102,44760,충청남도,부여군,60-64세,7221,3650,3571
202103,44760,충청남도,부여군,60-64세,7177,3619,3558
202104,44760,충청남도,부여군,60-64세,7189,3626,3563
202105,44760,충청남도,부여군,60-64세,7244,3659,3585
202106,44760,충청남도,부여군,60-64세,7267,3673,3594
202007,44760,충청남도,부여군,65-69세,5653,2786,2867
202008,44760,충청남도,부여군,65-69세,5710,2811,2899
202009,44760,충청남도,부여군,65-69세,5751,2820,2931
202010,44760,충청남도,부여군,65-69세,5785,2841,2944
202011,44760,충청남도,부여군,65-69세,5814,2853,2961
202012,44760,충청남도,부여군,65-69세,5853,2868,2985
202101,44760,충청남도,부여군,65-69세,5921,2896,3025
202102,44760,충청남도,부여군,65-69세,6013,2960,3053
202103,44760,충청남도,부여군,65-69세,6074,3018,3056
202104,44760,충청남도,부여군,65-69세,6123,3053,3070
202105,44760,충청남도,부여군,65-69세,6134,3047,3087
202106,44760,충청남도,부여군,65-69세,6169,3075,3094
202007,44760,충청남도,부여군,70-74세,4837,2286,2551
202008,44760,충청남도,부여군,70-74세,4845,2285,2560
202009,44760,충청남도,부여군,70-74세,4887,2304,2583
202010,44760,충청남도,부여군,70-74세,4902,2310,2592
202011,44760,충청남도,부여군,70-74세,4935,2328,2607
202012,44760,충청남도,부여군,70-74세,4967,2339,2628
202101,44760,충청남도,부여군,70-74세,4980,2347,2633
202102,44760,충청남도,부여군,70-74세,4987,2341,2646
202103,44760,충청남도,부여군,70-74세,4969,2339,2630
202104,44760,충청남도,부여군,70-74세,5014,2367,2647
202105,44760,충청남도,부여군,70-74세,5051,2393,2658
202106,44760,충청남도,부여군,70-74세,5035,2390,2645
202007,44760,충청남도,부여군,75-79세,4679,1958,2721
202008,44760,충청남도,부여군,75-79세,4651,1953,2698
202009,44760,충청남도,부여군,75-79세,4609,1937,2672
202010,44760,충청남도,부여군,75-79세,4577,1926,2651
202011,44760,충청남도,부여군,75-79세,4540,1914,2626
202012,44760,충청남도,부여군,75-79세,4490,1897,2593
202101,44760,충청남도,부여군,75-79세,4457,1885,2572
202102,44760,충청남도,부여군,75-79세,4397,1861,2536
202103,44760,충청남도,부여군,75-79세,4382,1862,2520
202104,44760,충청남도,부여군,75-79세,4347,1847,2500
202105,44760,충청남도,부여군,75-79세,4305,1825,2480
202106,44760,충청남도,부여군,75-79세,4318,1826,2492
202007,44760,충청남도,부여군,80-84세,3912,1439,2473
202008,44760,충청남도,부여군,80-84세,3891,1433,2458
202009,44760,충청남도,부여군,80-84세,3888,1440,2448
202010,44760,충청남도,부여군,80-84세,3889,1443,2446
202011,44760,충청남도,부여군,80-84세,3892,1446,2446
202012,44760,충청남도,부여군,80-84세,3900,1449,2451
202101,44760,충청남도,부여군,80-84세,3892,1439,2453
202102,44760,충청남도,부여군,80-84세,3913,1451,2462
202103,44760,충청남도,부여군,80-84세,3894,1449,2445
202104,44760,충청남도,부여군,80-84세,3906,1447,2459
202105,44760,충청남도,부여군,80-84세,3896,1446,2450
202106,44760,충청남도,부여군,80-84세,3890,1446,2444
202007,44760,충청남도,부여군,85-89세,2358,752,1606
202008,44760,충청남도,부여군,85-89세,2390,771,1619
202009,44760,충청남도,부여군,85-89세,2406,779,1627
202010,44760,충청남도,부여군,85-89세,2410,778,1632
202011,44760,충청남도,부여군,85-89세,2415,778,1637
202012,44760,충청남도,부여군,85-89세,2430,782,1648
202101,44760,충청남도,부여군,85-89세,2454,792,1662
202102,44760,충청남도,부여군,85-89세,2478,802,1676
202103,44760,충청남도,부여군,85-89세,2486,809,1677
202104,44760,충청남도,부여군,85-89세,2491,812,1679
202105,44760,충청남도,부여군,85-89세,2512,829,1683
202106,44760,충청남도,부여군,85-89세,2521,834,1687
202007,44760,충청남도,부여군,90-94세,806,211,595
202008,44760,충청남도,부여군,90-94세,812,210,602
202009,44760,충청남도,부여군,90-94세,816,212,604
202010,44760,충청남도,부여군,90-94세,820,218,602
202011,44760,충청남도,부여군,90-94세,819,218,601
202012,44760,충청남도,부여군,90-94세,816,220,596
202101,44760,충청남도,부여군,90-94세,817,219,598
202102,44760,충청남도,부여군,90-94세,815,221,594
202103,44760,충청남도,부여군,90-94세,808,221,587
202104,44760,충청남도,부여군,90-94세,810,218,592
202105,44760,충청남도,부여군,90-94세,822,217,605
202106,44760,충청남도,부여군,90-94세,816,215,601
202007,44760,충청남도,부여군,95-99세,166,29,137
202008,44760,충청남도,부여군,95-99세,168,30,138
202009,44760,충청남도,부여군,95-99세,174,30,144
202010,44760,충청남도,부여군,95-99세,173,28,145
202011,44760,충청남도,부여군,95-99세,170,28,142
202012,44760,충청남도,부여군,95-99세,173,27,146
202101,44760,충청남도,부여군,95-99세,174,27,147
202102,44760,충청남도,부여군,95-99세,181,29,152
202103,44760,충청남도,부여군,95-99세,175,25,150
202104,44760,충청남도,부여군,95-99세,179,26,153
202105,44760,충청남도,부여군,95-99세,176,25,151
202106,44760,충청남도,부여군,95-99세,174,24,150
202007,44760,충청남도,부여군,100+,56,7,49
202008,44760,충청남도,부여군,100+,55,7,48
202009,44760,충청남도,부여군,100+,55,7,48
202010,44760,충청남도,부여군,100+,56,7,49
202011,44760,충청남도,부여군,100+,55,7,48
202012,44760,충청남도,부여군,100+,54,7,47
202101,44760,충청남도,부여군,100+,54,7,47
202102,44760,충청남도,부여군,100+,56,7,49
202103,44760,충청남도,부여군,100+,33,3,30
202104,44760,충청남도,부여군,100+,33,3,30
202105,44760,충청남도,부여군,100+,34,4,30
202106,44760,충청남도,부여군,100+,36,4,32
202007,44770,충청남도,서천군,0-4세,952,474,478
202008,44770,충청남도,서천군,0-4세,941,464,477
202009,44770,충청남도,서천군,0-4세,924,464,460
202010,44770,충청남도,서천군,0-4세,919,460,459
202011,44770,충청남도,서천군,0-4세,917,456,461
202012,44770,충청남도,서천군,0-4세,913,455,458
202101,44770,충청남도,서천군,0-4세,894,446,448
202102,44770,충청남도,서천군,0-4세,893,445,448
202103,44770,충청남도,서천군,0-4세,883,435,448
202104,44770,충청남도,서천군,0-4세,883,435,448
202105,44770,충청남도,서천군,0-4세,876,433,443
202106,44770,충청남도,서천군,0-4세,871,437,434
202007,44770,충청남도,서천군,5-9세,1441,713,728
202008,44770,충청남도,서천군,5-9세,1428,710,718
202009,44770,충청남도,서천군,5-9세,1422,705,717
202010,44770,충청남도,서천군,5-9세,1408,706,702
202011,44770,충청남도,서천군,5-9세,1395,702,693
202012,44770,충청남도,서천군,5-9세,1393,703,690
202101,44770,충청남도,서천군,5-9세,1392,704,688
202102,44770,충청남도,서천군,5-9세,1389,699,690
202103,44770,충청남도,서천군,5-9세,1375,698,677
202104,44770,충청남도,서천군,5-9세,1364,694,670
202105,44770,충청남도,서천군,5-9세,1351,688,663
202106,44770,충청남도,서천군,5-9세,1345,683,662
202007,44770,충청남도,서천군,10-14세,1550,804,746
202008,44770,충청남도,서천군,10-14세,1553,805,748
202009,44770,충청남도,서천군,10-14세,1552,800,752
202010,44770,충청남도,서천군,10-14세,1555,797,758
202011,44770,충청남도,서천군,10-14세,1559,802,757
202012,44770,충청남도,서천군,10-14세,1550,796,754
202101,44770,충청남도,서천군,10-14세,1549,793,756
202102,44770,충청남도,서천군,10-14세,1529,782,747
202103,44770,충청남도,서천군,10-14세,1538,781,757
202104,44770,충청남도,서천군,10-14세,1534,776,758
202105,44770,충청남도,서천군,10-14세,1547,784,763
202106,44770,충청남도,서천군,10-14세,1546,785,761
202007,44770,충청남도,서천군,15-19세,1987,1025,962
202008,44770,충청남도,서천군,15-19세,1976,1018,958
202009,44770,충청남도,서천군,15-19세,1957,1013,944
202010,44770,충청남도,서천군,15-19세,1939,1011,928
202011,44770,충청남도,서천군,15-19세,1940,1007,933
202012,44770,충청남도,서천군,15-19세,1937,1011,926
202101,44770,충청남도,서천군,15-19세,1915,1001,914
202102,44770,충청남도,서천군,15-19세,1909,992,917
202103,44770,충청남도,서천군,15-19세,1885,982,903
202104,44770,충청남도,서천군,15-19세,1869,969,900
202105,44770,충청남도,서천군,15-19세,1853,963,890
202106,44770,충청남도,서천군,15-19세,1837,951,886
202007,44770,충청남도,서천군,20-24세,2166,1271,895
202008,44770,충청남도,서천군,20-24세,2154,1261,893
202009,44770,충청남도,서천군,20-24세,2136,1254,882
202010,44770,충청남도,서천군,20-24세,2123,1235,888
202011,44770,충청남도,서천군,20-24세,2102,1223,879
202012,44770,충청남도,서천군,20-24세,2086,1207,879
202101,44770,충청남도,서천군,20-24세,2066,1201,865
202102,44770,충청남도,서천군,20-24세,2056,1201,855
202103,44770,충청남도,서천군,20-24세,2026,1180,846
202104,44770,충청남도,서천군,20-24세,2009,1170,839
202105,44770,충청남도,서천군,20-24세,2003,1159,844
202106,44770,충청남도,서천군,20-24세,2005,1164,841
202007,44770,충청남도,서천군,25-29세,1784,1053,731
202008,44770,충청남도,서천군,25-29세,1773,1043,730
202009,44770,충청남도,서천군,25-29세,1789,1044,745
202010,44770,충청남도,서천군,25-29세,1787,1048,739
202011,44770,충청남도,서천군,25-29세,1784,1040,744
202012,44770,충청남도,서천군,25-29세,1791,1040,751
202101,44770,충청남도,서천군,25-29세,1791,1034,757
202102,44770,충청남도,서천군,25-29세,1760,1012,748
202103,44770,충청남도,서천군,25-29세,1743,1006,737
202104,44770,충청남도,서천군,25-29세,1732,995,737
202105,44770,충청남도,서천군,25-29세,1733,999,734
202106,44770,충청남도,서천군,25-29세,1726,992,734
202007,44770,충청남도,서천군,30-34세,1508,858,650
202008,44770,충청남도,서천군,30-34세,1514,858,656
202009,44770,충청남도,서천군,30-34세,1505,850,655
202010,44770,충청남도,서천군,30-34세,1505,847,658
202011,44770,충청남도,서천군,30-34세,1523,859,664
202012,44770,충청남도,서천군,30-34세,1510,858,652
202101,44770,충청남도,서천군,30-34세,1498,853,645
202102,44770,충청남도,서천군,30-34세,1480,839,641
202103,44770,충청남도,서천군,30-34세,1485,843,642
202104,44770,충청남도,서천군,30-34세,1490,846,644
202105,44770,충청남도,서천군,30-34세,1476,835,641
202106,44770,충청남도,서천군,30-34세,1464,826,638
202007,44770,충청남도,서천군,35-39세,2041,1132,909
202008,44770,충청남도,서천군,35-39세,2023,1134,889
202009,44770,충청남도,서천군,35-39세,1993,1119,874
202010,44770,충청남도,서천군,35-39세,1974,1108,866
202011,44770,충청남도,서천군,35-39세,1968,1102,866
202012,44770,충청남도,서천군,35-39세,1955,1081,874
202101,44770,충청남도,서천군,35-39세,1936,1069,867
202102,44770,충청남도,서천군,35-39세,1908,1063,845
202103,44770,충청남도,서천군,35-39세,1876,1046,830
202104,44770,충청남도,서천군,35-39세,1871,1036,835
202105,44770,충청남도,서천군,35-39세,1846,1026,820
202106,44770,충청남도,서천군,35-39세,1824,1009,815
202007,44770,충청남도,서천군,40-44세,2522,1382,1140
202008,44770,충청남도,서천군,40-44세,2507,1378,1129
202009,44770,충청남도,서천군,40-44세,2501,1381,1120
202010,44770,충청남도,서천군,40-44세,2504,1383,1121
202011,44770,충청남도,서천군,40-44세,2503,1381,1122
202012,44770,충청남도,서천군,40-44세,2494,1378,1116
202101,44770,충청남도,서천군,40-44세,2474,1355,1119
202102,44770,충청남도,서천군,40-44세,2463,1342,1121
202103,44770,충청남도,서천군,40-44세,2420,1319,1101
202104,44770,충청남도,서천군,40-44세,2409,1313,1096
202105,44770,충청남도,서천군,40-44세,2420,1314,1106
202106,44770,충청남도,서천군,40-44세,2424,1317,1107
202007,44770,충청남도,서천군,45-49세,3465,1898,1567
202008,44770,충청남도,서천군,45-49세,3444,1881,1563
202009,44770,충청남도,서천군,45-49세,3414,1865,1549
202010,44770,충청남도,서천군,45-49세,3364,1835,1529
202011,44770,충청남도,서천군,45-49세,3344,1827,1517
202012,44770,충청남도,서천군,45-49세,3350,1827,1523
202101,44770,충청남도,서천군,45-49세,3328,1820,1508
202102,44770,충청남도,서천군,45-49세,3323,1823,1500
202103,44770,충청남도,서천군,45-49세,3267,1784,1483
202104,44770,충청남도,서천군,45-49세,3252,1776,1476
202105,44770,충청남도,서천군,45-49세,3218,1766,1452
202106,44770,충청남도,서천군,45-49세,3163,1734,1429
202007,44770,충청남도,서천군,50-54세,3834,2120,1714
202008,44770,충청남도,서천군,50-54세,3824,2115,1709
202009,44770,충청남도,서천군,50-54세,3834,2128,1706
202010,44770,충청남도,서천군,50-54세,3857,2144,1713
202011,44770,충청남도,서천군,50-54세,3875,2156,1719
202012,44770,충청남도,서천군,50-54세,3872,2156,1716
202101,44770,충청남도,서천군,50-54세,3882,2161,1721
202102,44770,충청남도,서천군,50-54세,3912,2181,1731
202103,44770,충청남도,서천군,50-54세,3899,2188,1711
202104,44770,충청남도,서천군,50-54세,3884,2172,1712
202105,44770,충청남도,서천군,50-54세,3889,2162,1727
202106,44770,충청남도,서천군,50-54세,3918,2182,1736
202007,44770,충청남도,서천군,55-59세,4790,2537,2253
202008,44770,충청남도,서천군,55-59세,4780,2535,2245
202009,44770,충청남도,서천군,55-59세,4747,2522,2225
202010,44770,충청남도,서천군,55-59세,4703,2507,2196
202011,44770,충청남도,서천군,55-59세,4669,2484,2185
202012,44770,충청남도,서천군,55-59세,4631,2453,2178
202101,44770,충청남도,서천군,55-59세,4579,2426,2153
202102,44770,충청남도,서천군,55-59세,4553,2413,2140
202103,44770,충청남도,서천군,55-59세,4477,2381,2096
202104,44770,충청남도,서천군,55-59세,4474,2389,2085
202105,44770,충청남도,서천군,55-59세,4465,2390,2075
202106,44770,충청남도,서천군,55-59세,4396,2364,2032
202007,44770,충청남도,서천군,60-64세,5359,2702,2657
202008,44770,충청남도,서천군,60-64세,5365,2697,2668
202009,44770,충청남도,서천군,60-64세,5355,2691,2664
202010,44770,충청남도,서천군,60-64세,5362,2686,2676
202011,44770,충청남도,서천군,60-64세,5378,2689,2689
202012,44770,충청남도,서천군,60-64세,5396,2696,2700
202101,44770,충청남도,서천군,60-64세,5416,2715,2701
202102,44770,충청남도,서천군,60-64세,5395,2700,2695
202103,44770,충청남도,서천군,60-64세,5403,2685,2718
202104,44770,충청남도,서천군,60-64세,5397,2682,2715
202105,44770,충청남도,서천군,60-64세,5423,2716,2707
202106,44770,충청남도,서천군,60-64세,5451,2735,2716
202007,44770,충청남도,서천군,65-69세,4717,2235,2482
202008,44770,충청남도,서천군,65-69세,4733,2241,2492
202009,44770,충청남도,서천군,65-69세,4763,2256,2507
202010,44770,충청남도,서천군,65-69세,4782,2261,2521
202011,44770,충청남도,서천군,65-69세,4811,2273,2538
202012,44770,충청남도,서천군,65-69세,4836,2289,2547
202101,44770,충청남도,서천군,65-69세,4851,2293,2558
202102,44770,충청남도,서천군,65-69세,4887,2323,2564
202103,44770,충청남도,서천군,65-69세,4930,2364,2566
202104,44770,충청남도,서천군,65-69세,4961,2379,2582
202105,44770,충청남도,서천군,65-69세,4967,2374,2593
202106,44770,충청남도,서천군,65-69세,4971,2376,2595
202007,44770,충청남도,서천군,70-74세,4165,1989,2176
202008,44770,충청남도,서천군,70-74세,4187,1995,2192
202009,44770,충청남도,서천군,70-74세,4215,2014,2201
202010,44770,충청남도,서천군,70-74세,4242,2028,2214
202011,44770,충청남도,서천군,70-74세,4269,2042,2227
202012,44770,충청남도,서천군,70-74세,4292,2050,2242
202101,44770,충청남도,서천군,70-74세,4323,2067,2256
202102,44770,충청남도,서천군,70-74세,4334,2071,2263
202103,44770,충청남도,서천군,70-74세,4341,2083,2258
202104,44770,충청남도,서천군,70-74세,4362,2087,2275
202105,44770,충청남도,서천군,70-74세,4392,2103,2289
202106,44770,충청남도,서천군,70-74세,4402,2108,2294
202007,44770,충청남도,서천군,75-79세,3867,1570,2297
202008,44770,충청남도,서천군,75-79세,3871,1570,2301
202009,44770,충청남도,서천군,75-79세,3828,1553,2275
202010,44770,충청남도,서천군,75-79세,3803,1544,2259
202011,44770,충청남도,서천군,75-79세,3778,1529,2249
202012,44770,충청남도,서천군,75-79세,3745,1512,2233
202101,44770,충청남도,서천군,75-79세,3706,1506,2200
202102,44770,충청남도,서천군,75-79세,3697,1506,2191
202103,44770,충청남도,서천군,75-79세,3656,1499,2157
202104,44770,충청남도,서천군,75-79세,3623,1489,2134
202105,44770,충청남도,서천군,75-79세,3610,1487,2123
202106,44770,충청남도,서천군,75-79세,3609,1494,2115
202007,44770,충청남도,서천군,80-84세,3333,1254,2079
202008,44770,충청남도,서천군,80-84세,3318,1248,2070
202009,44770,충청남도,서천군,80-84세,3307,1244,2063
202010,44770,충청남도,서천군,80-84세,3292,1242,2050
202011,44770,충청남도,서천군,80-84세,3279,1236,2043
202012,44770,충청남도,서천군,80-84세,3278,1246,2032
202101,44770,충청남도,서천군,80-84세,3276,1243,2033
202102,44770,충청남도,서천군,80-84세,3262,1236,2026
202103,44770,충청남도,서천군,80-84세,3265,1238,2027
202104,44770,충청남도,서천군,80-84세,3262,1229,2033
202105,44770,충청남도,서천군,80-84세,3281,1238,2043
202106,44770,충청남도,서천군,80-84세,3269,1227,2042
202007,44770,충청남도,서천군,85-89세,1903,624,1279
202008,44770,충청남도,서천군,85-89세,1898,626,1272
202009,44770,충청남도,서천군,85-89세,1922,639,1283
202010,44770,충청남도,서천군,85-89세,1943,644,1299
202011,44770,충청남도,서천군,85-89세,1958,658,1300
202012,44770,충청남도,서천군,85-89세,1962,654,1308
202101,44770,충청남도,서천군,85-89세,1991,658,1333
202102,44770,충청남도,서천군,85-89세,2021,668,1353
202103,44770,충청남도,서천군,85-89세,2021,668,1353
202104,44770,충청남도,서천군,85-89세,2032,681,1351
202105,44770,충청남도,서천군,85-89세,2033,679,1354
202106,44770,충청남도,서천군,85-89세,2041,678,1363
202007,44770,충청남도,서천군,90-94세,670,161,509
202008,44770,충청남도,서천군,90-94세,679,164,515
202009,44770,충청남도,서천군,90-94세,689,166,523
202010,44770,충청남도,서천군,90-94세,701,168,533
202011,44770,충청남도,서천군,90-94세,702,164,538
202012,44770,충청남도,서천군,90-94세,701,166,535
202101,44770,충청남도,서천군,90-94세,701,168,533
202102,44770,충청남도,서천군,90-94세,712,175,537
202103,44770,충청남도,서천군,90-94세,716,174,542
202104,44770,충청남도,서천군,90-94세,727,174,553
202105,44770,충청남도,서천군,90-94세,737,174,563
202106,44770,충청남도,서천군,90-94세,737,177,560
202007,44770,충청남도,서천군,95-99세,126,23,103
202008,44770,충청남도,서천군,95-99세,127,24,103
202009,44770,충청남도,서천군,95-99세,132,25,107
202010,44770,충청남도,서천군,95-99세,128,24,104
202011,44770,충청남도,서천군,95-99세,128,26,102
202012,44770,충청남도,서천군,95-99세,130,26,104
202101,44770,충청남도,서천군,95-99세,130,25,105
202102,44770,충청남도,서천군,95-99세,130,26,104
202103,44770,충청남도,서천군,95-99세,131,29,102
202104,44770,충청남도,서천군,95-99세,129,29,100
202105,44770,충청남도,서천군,95-99세,130,29,101
202106,44770,충청남도,서천군,95-99세,130,30,100
202007,44770,충청남도,서천군,100+,43,9,34
202008,44770,충청남도,서천군,100+,42,9,33
202009,44770,충청남도,서천군,100+,41,9,32
202010,44770,충청남도,서천군,100+,42,9,33
202011,44770,충청남도,서천군,100+,44,10,34
202012,44770,충청남도,서천군,100+,44,10,34
202101,44770,충청남도,서천군,100+,44,10,34
202102,44770,충청남도,서천군,100+,44,10,34
202103,44770,충청남도,서천군,100+,24,2,22
202104,44770,충청남도,서천군,100+,25,2,23
202105,44770,충청남도,서천군,100+,24,2,22
202106,44770,충청남도,서천군,100+,24,1,23
202007,44790,충청남도,청양군,0-4세,528,269,259
202008,44790,충청남도,청양군,0-4세,525,265,260
202009,44790,충청남도,청양군,0-4세,529,270,259
202010,44790,충청남도,청양군,0-4세,521,264,257
202011,44790,충청남도,청양군,0-4세,510,258,252
202012,44790,충청남도,청양군,0-4세,508,257,251
202101,44790,충청남도,청양군,0-4세,509,257,252
202102,44790,충청남도,청양군,0-4세,506,255,251
202103,44790,충청남도,청양군,0-4세,499,256,243
202104,44790,충청남도,청양군,0-4세,495,252,243
202105,44790,충청남도,청양군,0-4세,491,251,240
202106,44790,충청남도,청양군,0-4세,485,249,236
202007,44790,충청남도,청양군,5-9세,789,398,391
202008,44790,충청남도,청양군,5-9세,778,396,382
202009,44790,충청남도,청양군,5-9세,765,389,376
202010,44790,충청남도,청양군,5-9세,764,390,374
202011,44790,충청남도,청양군,5-9세,759,386,373
202012,44790,충청남도,청양군,5-9세,761,391,370
202101,44790,충청남도,청양군,5-9세,750,386,364
202102,44790,충청남도,청양군,5-9세,742,381,361
202103,44790,충청남도,청양군,5-9세,742,378,364
202104,44790,충청남도,청양군,5-9세,736,374,362
202105,44790,충청남도,청양군,5-9세,728,367,361
202106,44790,충청남도,청양군,5-9세,724,361,363
202007,44790,충청남도,청양군,10-14세,845,450,395
202008,44790,충청남도,청양군,10-14세,847,451,396
202009,44790,충청남도,청양군,10-14세,851,449,402
202010,44790,충청남도,청양군,10-14세,864,451,413
202011,44790,충청남도,청양군,10-14세,864,449,415
202012,44790,충청남도,청양군,10-14세,860,450,410
202101,44790,충청남도,청양군,10-14세,864,453,411
202102,44790,충청남도,청양군,10-14세,881,462,419
202103,44790,충청남도,청양군,10-14세,892,465,427
202104,44790,충청남도,청양군,10-14세,887,464,423
202105,44790,충청남도,청양군,10-14세,889,467,422
202106,44790,충청남도,청양군,10-14세,886,467,419
202007,44790,충청남도,청양군,15-19세,1183,618,565
202008,44790,충청남도,청양군,15-19세,1172,615,557
202009,44790,충청남도,청양군,15-19세,1162,610,552
202010,44790,충청남도,청양군,15-19세,1184,627,557
202011,44790,충청남도,청양군,15-19세,1199,648,551
202012,44790,충청남도,청양군,15-19세,1196,643,553
202101,44790,충청남도,청양군,15-19세,1154,614,540
202102,44790,충청남도,청양군,15-19세,1124,597,527
202103,44790,충청남도,청양군,15-19세,1107,589,518
202104,44790,충청남도,청양군,15-19세,1153,609,544
202105,44790,충청남도,청양군,15-19세,1126,593,533
202106,44790,충청남도,청양군,15-19세,1118,588,530
202007,44790,충청남도,청양군,20-24세,1528,848,680
202008,44790,충청남도,청양군,20-24세,1512,839,673
202009,44790,충청남도,청양군,20-24세,1487,828,659
202010,44790,충청남도,청양군,20-24세,1506,842,664
202011,44790,충청남도,청양군,20-24세,1503,839,664
202012,44790,충청남도,청양군,20-24세,1530,858,672
202101,44790,충청남도,청양군,20-24세,1510,852,658
202102,44790,충청남도,청양군,20-24세,1481,828,653
202103,44790,충청남도,청양군,20-24세,1470,835,635
202104,44790,충청남도,청양군,20-24세,1469,847,622
202105,44790,충청남도,청양군,20-24세,1466,840,626
202106,44790,충청남도,청양군,20-24세,1455,830,625
202007,44790,충청남도,청양군,25-29세,1134,683,451
202008,44790,충청남도,청양군,25-29세,1118,668,450
202009,44790,충청남도,청양군,25-29세,1109,667,442
202010,44790,충청남도,청양군,25-29세,1116,672,444
202011,44790,충청남도,청양군,25-29세,1107,671,436
202012,44790,충청남도,청양군,25-29세,1127,681,446
202101,44790,충청남도,청양군,25-29세,1107,666,441
202102,44790,충청남도,청양군,25-29세,1088,661,427
202103,44790,충청남도,청양군,25-29세,1078,651,427
202104,44790,충청남도,청양군,25-29세,1070,646,424
202105,44790,충청남도,청양군,25-29세,1078,652,426
202106,44790,충청남도,청양군,25-29세,1077,648,429
202007,44790,충청남도,청양군,30-34세,988,580,408
202008,44790,충청남도,청양군,30-34세,975,574,401
202009,44790,충청남도,청양군,30-34세,971,573,398
202010,44790,충청남도,청양군,30-34세,968,574,394
202011,44790,충청남도,청양군,30-34세,974,578,396
202012,44790,충청남도,청양군,30-34세,983,587,396
202101,44790,충청남도,청양군,30-34세,975,575,400
202102,44790,충청남도,청양군,30-34세,956,565,391
202103,44790,충청남도,청양군,30-34세,936,550,386
202104,44790,충청남도,청양군,30-34세,925,541,384
202105,44790,충청남도,청양군,30-34세,909,535,374
202106,44790,충청남도,청양군,30-34세,912,539,373
202007,44790,충청남도,청양군,35-39세,1127,633,494
202008,44790,충청남도,청양군,35-39세,1120,632,488
202009,44790,충청남도,청양군,35-39세,1117,627,490
202010,44790,충청남도,청양군,35-39세,1111,619,492
202011,44790,충청남도,청양군,35-39세,1099,612,487
202012,44790,충청남도,청양군,35-39세,1104,611,493
202101,44790,충청남도,청양군,35-39세,1112,622,490
202102,44790,충청남도,청양군,35-39세,1114,616,498
202103,44790,충청남도,청양군,35-39세,1114,614,500
202104,44790,충청남도,청양군,35-39세,1097,603,494
202105,44790,충청남도,청양군,35-39세,1077,587,490
202106,44790,충청남도,청양군,35-39세,1068,581,487
202007,44790,충청남도,청양군,40-44세,1326,773,553
202008,44790,충청남도,청양군,40-44세,1308,759,549
202009,44790,충청남도,청양군,40-44세,1303,758,545
202010,44790,충청남도,청양군,40-44세,1313,767,546
202011,44790,충청남도,청양군,40-44세,1298,753,545
202012,44790,충청남도,청양군,40-44세,1287,741,546
202101,44790,충청남도,청양군,40-44세,1261,726,535
202102,44790,충청남도,청양군,40-44세,1259,724,535
202103,44790,충청남도,청양군,40-44세,1231,711,520
202104,44790,충청남도,청양군,40-44세,1243,716,527
202105,44790,충청남도,청양군,40-44세,1251,726,525
202106,44790,충청남도,청양군,40-44세,1255,730,525
202007,44790,충청남도,청양군,45-49세,1866,1090,776
202008,44790,충청남도,청양군,45-49세,1856,1084,772
202009,44790,충청남도,청양군,45-49세,1854,1081,773
202010,44790,충청남도,청양군,45-49세,1807,1057,750
202011,44790,충청남도,청양군,45-49세,1804,1057,747
202012,44790,충청남도,청양군,45-49세,1833,1077,756
202101,44790,충청남도,청양군,45-49세,1839,1090,749
202102,44790,충청남도,청양군,45-49세,1828,1078,750
202103,44790,충청남도,청양군,45-49세,1818,1076,742
202104,44790,충청남도,청양군,45-49세,1805,1063,742
202105,44790,충청남도,청양군,45-49세,1791,1054,737
202106,44790,충청남도,청양군,45-49세,1774,1049,725
202007,44790,충청남도,청양군,50-54세,2283,1308,975
202008,44790,충청남도,청양군,50-54세,2277,1302,975
202009,44790,충청남도,청양군,50-54세,2265,1299,966
202010,44790,충청남도,청양군,50-54세,2289,1305,984
202011,44790,충청남도,청양군,50-54세,2291,1310,981
202012,44790,충청남도,청양군,50-54세,2306,1317,989
202101,44790,충청남도,청양군,50-54세,2310,1312,998
202102,44790,충청남도,청양군,50-54세,2330,1328,1002
202103,44790,충청남도,청양군,50-54세,2315,1328,987
202104,44790,충청남도,청양군,50-54세,2313,1321,992
202105,44790,충청남도,청양군,50-54세,2303,1312,991
202106,44790,충청남도,청양군,50-54세,2298,1302,996
202007,44790,충청남도,청양군,55-59세,3045,1592,1453
202008,44790,충청남도,청양군,55-59세,3043,1600,1443
202009,44790,충청남도,청양군,55-59세,3039,1589,1450
202010,44790,충청남도,청양군,55-59세,3003,1580,1423
202011,44790,충청남도,청양군,55-59세,2999,1586,1413
202012,44790,충청남도,청양군,55-59세,3006,1582,1424
202101,44790,충청남도,청양군,55-59세,2947,1552,1395
202102,44790,충청남도,청양군,55-59세,2904,1531,1373
202103,44790,충청남도,청양군,55-59세,2877,1518,1359
202104,44790,충청남도,청양군,55-59세,2855,1516,1339
202105,44790,충청남도,청양군,55-59세,2833,1505,1328
202106,44790,충청남도,청양군,55-59세,2802,1497,1305
202007,44790,충청남도,청양군,60-64세,3336,1712,1624
202008,44790,충청남도,청양군,60-64세,3333,1699,1634
202009,44790,충청남도,청양군,60-64세,3328,1696,1632
202010,44790,충청남도,청양군,60-64세,3341,1690,1651
202011,44790,충청남도,청양군,60-64세,3363,1691,1672
202012,44790,충청남도,청양군,60-64세,3388,1714,1674
202101,44790,충청남도,청양군,60-64세,3406,1726,1680
202102,44790,충청남도,청양군,60-64세,3417,1742,1675
202103,44790,충청남도,청양군,60-64세,3417,1749,1668
202104,44790,충청남도,청양군,60-64세,3465,1775,1690
202105,44790,충청남도,청양군,60-64세,3490,1796,1694
202106,44790,충청남도,청양군,60-64세,3520,1817,1703
202007,44790,충청남도,청양군,65-69세,2688,1389,1299
202008,44790,충청남도,청양군,65-69세,2703,1397,1306
202009,44790,충청남도,청양군,65-69세,2711,1403,1308
202010,44790,충청남도,청양군,65-69세,2729,1419,1310
202011,44790,충청남도,청양군,65-69세,2741,1424,1317
202012,44790,충청남도,청양군,65-69세,2771,1431,1340
202101,44790,충청남도,청양군,65-69세,2793,1433,1360
202102,44790,충청남도,청양군,65-69세,2812,1441,1371
202103,44790,충청남도,청양군,65-69세,2843,1457,1386
202104,44790,충청남도,청양군,65-69세,2851,1467,1384
202105,44790,충청남도,청양군,65-69세,2882,1485,1397
202106,44790,충청남도,청양군,65-69세,2889,1480,1409
202007,44790,충청남도,청양군,70-74세,2291,1098,1193
202008,44790,충청남도,청양군,70-74세,2302,1108,1194
202009,44790,충청남도,청양군,70-74세,2322,1120,1202
202010,44790,충청남도,청양군,70-74세,2339,1133,1206
202011,44790,충청남도,청양군,70-74세,2351,1141,1210
202012,44790,충청남도,청양군,70-74세,2367,1151,1216
202101,44790,충청남도,청양군,70-74세,2390,1170,1220
202102,44790,충청남도,청양군,70-74세,2405,1170,1235
202103,44790,충청남도,청양군,70-74세,2398,1171,1227
202104,44790,충청남도,청양군,70-74세,2415,1185,1230
202105,44790,충청남도,청양군,70-74세,2414,1186,1228
202106,44790,충청남도,청양군,70-74세,2418,1188,1230
202007,44790,충청남도,청양군,75-79세,2250,935,1315
202008,44790,충청남도,청양군,75-79세,2242,934,1308
202009,44790,충청남도,청양군,75-79세,2219,922,1297
202010,44790,충청남도,청양군,75-79세,2199,914,1285
202011,44790,충청남도,청양군,75-79세,2185,908,1277
202012,44790,충청남도,청양군,75-79세,2147,892,1255
202101,44790,충청남도,청양군,75-79세,2131,883,1248
202102,44790,충청남도,청양군,75-79세,2106,877,1229
202103,44790,충청남도,청양군,75-79세,2096,877,1219
202104,44790,충청남도,청양군,75-79세,2076,868,1208
202105,44790,충청남도,청양군,75-79세,2063,856,1207
202106,44790,충청남도,청양군,75-79세,2051,861,1190
202007,44790,충청남도,청양군,80-84세,2052,744,1308
202008,44790,충청남도,청양군,80-84세,2052,747,1305
202009,44790,충청남도,청양군,80-84세,2055,751,1304
202010,44790,충청남도,청양군,80-84세,2046,750,1296
202011,44790,충청남도,청양군,80-84세,2037,745,1292
202012,44790,충청남도,청양군,80-84세,2028,736,1292
202101,44790,충청남도,청양군,80-84세,2026,742,1284
202102,44790,충청남도,청양군,80-84세,2020,735,1285
202103,44790,충청남도,청양군,80-84세,1993,726,1267
202104,44790,충청남도,청양군,80-84세,1994,727,1267
202105,44790,충청남도,청양군,80-84세,1972,728,1244
202106,44790,충청남도,청양군,80-84세,1984,728,1256
202007,44790,충청남도,청양군,85-89세,1242,428,814
202008,44790,충청남도,청양군,85-89세,1248,430,818
202009,44790,충청남도,청양군,85-89세,1252,430,822
202010,44790,충청남도,청양군,85-89세,1264,434,830
202011,44790,충청남도,청양군,85-89세,1266,435,831
202012,44790,충청남도,청양군,85-89세,1276,440,836
202101,44790,충청남도,청양군,85-89세,1284,441,843
202102,44790,충청남도,청양군,85-89세,1305,451,854
202103,44790,충청남도,청양군,85-89세,1342,465,877
202104,44790,충청남도,청양군,85-89세,1348,467,881
202105,44790,충청남도,청양군,85-89세,1360,468,892
202106,44790,충청남도,청양군,85-89세,1364,470,894
202007,44790,충청남도,청양군,90-94세,366,89,277
202008,44790,충청남도,청양군,90-94세,372,94,278
202009,44790,충청남도,청양군,90-94세,378,97,281
202010,44790,충청남도,청양군,90-94세,377,96,281
202011,44790,충청남도,청양군,90-94세,381,99,282
202012,44790,충청남도,청양군,90-94세,385,99,286
202101,44790,충청남도,청양군,90-94세,382,96,286
202102,44790,충청남도,청양군,90-94세,383,94,289
202103,44790,충청남도,청양군,90-94세,382,96,286
202104,44790,충청남도,청양군,90-94세,383,95,288
202105,44790,충청남도,청양군,90-94세,390,95,295
202106,44790,충청남도,청양군,90-94세,391,95,296
202007,44790,충청남도,청양군,95-99세,64,27,37
202008,44790,충청남도,청양군,95-99세,61,25,36
202009,44790,충청남도,청양군,95-99세,62,24,38
202010,44790,충청남도,청양군,95-99세,63,27,36
202011,44790,충청남도,청양군,95-99세,66,29,37
202012,44790,충청남도,청양군,95-99세,66,28,38
202101,44790,충청남도,청양군,95-99세,71,31,40
202102,44790,충청남도,청양군,95-99세,70,31,39
202103,44790,충청남도,청양군,95-99세,68,30,38
202104,44790,충청남도,청양군,95-99세,71,31,40
202105,44790,충청남도,청양군,95-99세,69,28,41
202106,44790,충청남도,청양군,95-99세,68,27,41
202007,44790,충청남도,청양군,100+,19,3,16
202008,44790,충청남도,청양군,100+,19,4,15
202009,44790,충청남도,청양군,100+,18,4,14
202010,44790,충청남도,청양군,100+,19,5,14
202011,44790,충청남도,청양군,100+,19,5,14
202012,44790,충청남도,청양군,100+,19,5,14
202101,44790,충청남도,청양군,100+,19,5,14
202102,44790,충청남도,청양군,100+,19,5,14
202103,44790,충청남도,청양군,100+,7,2,5
202104,44790,충청남도,청양군,100+,7,2,5
202105,44790,충청남도,청양군,100+,8,2,6
202106,44790,충청남도,청양군,100+,9,3,6
202007,44800,충청남도,홍성군,0-4세,3342,1715,1627
202008,44800,충청남도,홍성군,0-4세,3324,1702,1622
202009,44800,충청남도,홍성군,0-4세,3297,1696,1601
202010,44800,충청남도,홍성군,0-4세,3287,1682,1605
202011,44800,충청남도,홍성군,0-4세,3273,1681,1592
202012,44800,충청남도,홍성군,0-4세,3260,1682,1578
202101,44800,충청남도,홍성군,0-4세,3244,1674,1570
202102,44800,충청남도,홍성군,0-4세,3242,1682,1560
202103,44800,충청남도,홍성군,0-4세,3213,1669,1544
202104,44800,충청남도,홍성군,0-4세,3213,1674,1539
202105,44800,충청남도,홍성군,0-4세,3193,1656,1537
202106,44800,충청남도,홍성군,0-4세,3180,1645,1535
202007,44800,충청남도,홍성군,5-9세,4575,2412,2163
202008,44800,충청남도,홍성군,5-9세,4578,2418,2160
202009,44800,충청남도,홍성군,5-9세,4554,2389,2165
202010,44800,충청남도,홍성군,5-9세,4510,2366,2144
202011,44800,충청남도,홍성군,5-9세,4497,2356,2141
202012,44800,충청남도,홍성군,5-9세,4456,2330,2126
202101,44800,충청남도,홍성군,5-9세,4402,2305,2097
202102,44800,충청남도,홍성군,5-9세,4395,2306,2089
202103,44800,충청남도,홍성군,5-9세,4401,2304,2097
202104,44800,충청남도,홍성군,5-9세,4408,2305,2103
202105,44800,충청남도,홍성군,5-9세,4385,2298,2087
202106,44800,충청남도,홍성군,5-9세,4390,2287,2103
202007,44800,충청남도,홍성군,10-14세,4762,2390,2372
202008,44800,충청남도,홍성군,10-14세,4751,2388,2363
202009,44800,충청남도,홍성군,10-14세,4784,2418,2366
202010,44800,충청남도,홍성군,10-14세,4819,2436,2383
202011,44800,충청남도,홍성군,10-14세,4806,2433,2373
202012,44800,충청남도,홍성군,10-14세,4810,2450,2360
202101,44800,충청남도,홍성군,10-14세,4812,2449,2363
202102,44800,충청남도,홍성군,10-14세,4811,2439,2372
202103,44800,충청남도,홍성군,10-14세,4808,2438,2370
202104,44800,충청남도,홍성군,10-14세,4804,2446,2358
202105,44800,충청남도,홍성군,10-14세,4809,2440,2369
202106,44800,충청남도,홍성군,10-14세,4815,2449,2366
202007,44800,충청남도,홍성군,15-19세,4892,2525,2367
202008,44800,충청남도,홍성군,15-19세,4876,2502,2374
202009,44800,충청남도,홍성군,15-19세,4841,2491,2350
202010,44800,충청남도,홍성군,15-19세,4813,2481,2332
202011,44800,충청남도,홍성군,15-19세,4809,2478,2331
202012,44800,충청남도,홍성군,15-19세,4796,2467,2329
202101,44800,충청남도,홍성군,15-19세,4727,2424,2303
202102,44800,충청남도,홍성군,15-19세,4712,2439,2273
202103,44800,충청남도,홍성군,15-19세,4738,2452,2286
202104,44800,충청남도,홍성군,15-19세,4730,2447,2283
202105,44800,충청남도,홍성군,15-19세,4733,2445,2288
202106,44800,충청남도,홍성군,15-19세,4728,2445,2283
202007,44800,충청남도,홍성군,20-24세,5183,2831,2352
202008,44800,충청남도,홍성군,20-24세,5168,2823,2345
202009,44800,충청남도,홍성군,20-24세,5132,2811,2321
202010,44800,충청남도,홍성군,20-24세,5129,2791,2338
202011,44800,충청남도,홍성군,20-24세,5138,2787,2351
202012,44800,충청남도,홍성군,20-24세,5160,2802,2358
202101,44800,충청남도,홍성군,20-24세,5123,2795,2328
202102,44800,충청남도,홍성군,20-24세,5043,2759,2284
202103,44800,충청남도,홍성군,20-24세,4982,2728,2254
202104,44800,충청남도,홍성군,20-24세,4994,2718,2276
202105,44800,충청남도,홍성군,20-24세,5009,2747,2262
202106,44800,충청남도,홍성군,20-24세,5014,2757,2257
202007,44800,충청남도,홍성군,25-29세,4486,2494,1992
202008,44800,충청남도,홍성군,25-29세,4480,2502,1978
202009,44800,충청남도,홍성군,25-29세,4483,2501,1982
202010,44800,충청남도,홍성군,25-29세,4477,2494,1983
202011,44800,충청남도,홍성군,25-29세,4497,2511,1986
202012,44800,충청남도,홍성군,25-29세,4570,2552,2018
202101,44800,충청남도,홍성군,25-29세,4502,2495,2007
202102,44800,충청남도,홍성군,25-29세,4459,2474,1985
202103,44800,충청남도,홍성군,25-29세,4477,2479,1998
202104,44800,충청남도,홍성군,25-29세,4456,2466,1990
202105,44800,충청남도,홍성군,25-29세,4430,2456,1974
202106,44800,충청남도,홍성군,25-29세,4390,2442,1948
202007,44800,충청남도,홍성군,30-34세,4572,2442,2130
202008,44800,충청남도,홍성군,30-34세,4581,2453,2128
202009,44800,충청남도,홍성군,30-34세,4571,2438,2133
202010,44800,충청남도,홍성군,30-34세,4535,2424,2111
202011,44800,충청남도,홍성군,30-34세,4538,2417,2121
202012,44800,충청남도,홍성군,30-34세,4520,2401,2119
202101,44800,충청남도,홍성군,30-34세,4520,2400,2120
202102,44800,충청남도,홍성군,30-34세,4487,2377,2110
202103,44800,충청남도,홍성군,30-34세,4484,2370,2114
202104,44800,충청남도,홍성군,30-34세,4481,2369,2112
202105,44800,충청남도,홍성군,30-34세,4480,2360,2120
202106,44800,충청남도,홍성군,30-34세,4488,2366,2122
202007,44800,충청남도,홍성군,35-39세,6099,3076,3023
202008,44800,충청남도,홍성군,35-39세,6057,3063,2994
202009,44800,충청남도,홍성군,35-39세,6013,3042,2971
202010,44800,충청남도,홍성군,35-39세,6011,3043,2968
202011,44800,충청남도,홍성군,35-39세,5965,3040,2925
202012,44800,충청남도,홍성군,35-39세,5961,3047,2914
202101,44800,충청남도,홍성군,35-39세,5915,3029,2886
202102,44800,충청남도,홍성군,35-39세,5880,2993,2887
202103,44800,충청남도,홍성군,35-39세,5859,2991,2868
202104,44800,충청남도,홍성군,35-39세,5812,2958,2854
202105,44800,충청남도,홍성군,35-39세,5769,2930,2839
202106,44800,충청남도,홍성군,35-39세,5727,2906,2821
202007,44800,충청남도,홍성군,40-44세,6706,3424,3282
202008,44800,충청남도,홍성군,40-44세,6690,3410,3280
202009,44800,충청남도,홍성군,40-44세,6689,3412,3277
202010,44800,충청남도,홍성군,40-44세,6666,3405,3261
202011,44800,충청남도,홍성군,40-44세,6679,3413,3266
202012,44800,충청남도,홍성군,40-44세,6646,3396,3250
202101,44800,충청남도,홍성군,40-44세,6622,3381,3241
202102,44800,충청남도,홍성군,40-44세,6624,3400,3224
202103,44800,충청남도,홍성군,40-44세,6613,3398,3215
202104,44800,충청남도,홍성군,40-44세,6618,3406,3212
202105,44800,충청남도,홍성군,40-44세,6635,3414,3221
202106,44800,충청남도,홍성군,40-44세,6658,3421,3237
202007,44800,충청남도,홍성군,45-49세,7911,4233,3678
202008,44800,충청남도,홍성군,45-49세,7910,4213,3697
202009,44800,충청남도,홍성군,45-49세,7857,4195,3662
202010,44800,충청남도,홍성군,45-49세,7807,4154,3653
202011,44800,충청남도,홍성군,45-49세,7783,4132,3651
202012,44800,충청남도,홍성군,45-49세,7834,4158,3676
202101,44800,충청남도,홍성군,45-49세,7817,4160,3657
202102,44800,충청남도,홍성군,45-49세,7821,4153,3668
202103,44800,충청남도,홍성군,45-49세,7797,4132,3665
202104,44800,충청남도,홍성군,45-49세,7781,4120,3661
202105,44800,충청남도,홍성군,45-49세,7706,4077,3629
202106,44800,충청남도,홍성군,45-49세,7632,4039,3593
202007,44800,충청남도,홍성군,50-54세,7507,3969,3538
202008,44800,충청남도,홍성군,50-54세,7519,3989,3530
202009,44800,충청남도,홍성군,50-54세,7564,4031,3533
202010,44800,충청남도,홍성군,50-54세,7618,4058,3560
202011,44800,충청남도,홍성군,50-54세,7681,4093,3588
202012,44800,충청남도,홍성군,50-54세,7676,4104,3572
202101,44800,충청남도,홍성군,50-54세,7697,4104,3593
202102,44800,충청남도,홍성군,50-54세,7740,4137,3603
202103,44800,충청남도,홍성군,50-54세,7773,4158,3615
202104,44800,충청남도,홍성군,50-54세,7805,4171,3634
202105,44800,충청남도,홍성군,50-54세,7882,4221,3661
202106,44800,충청남도,홍성군,50-54세,7843,4210,3633
202007,44800,충청남도,홍성군,55-59세,8376,4295,4081
202008,44800,충청남도,홍성군,55-59세,8370,4293,4077
202009,44800,충청남도,홍성군,55-59세,8320,4252,4068
202010,44800,충청남도,홍성군,55-59세,8284,4235,4049
202011,44800,충청남도,홍성군,55-59세,8249,4222,4027
202012,44800,충청남도,홍성군,55-59세,8249,4214,4035
202101,44800,충청남도,홍성군,55-59세,8165,4192,3973
202102,44800,충청남도,홍성군,55-59세,8090,4150,3940
202103,44800,충청남도,홍성군,55-59세,8027,4118,3909
202104,44800,충청남도,홍성군,55-59세,7983,4093,3890
202105,44800,충청남도,홍성군,55-59세,7924,4059,3865
202106,44800,충청남도,홍성군,55-59세,7813,4017,3796
202007,44800,충청남도,홍성군,60-64세,7993,3986,4007
202008,44800,충청남도,홍성군,60-64세,8013,3996,4017
202009,44800,충청남도,홍성군,60-64세,8058,4007,4051
202010,44800,충청남도,홍성군,60-64세,8056,4009,4047
202011,44800,충청남도,홍성군,60-64세,8096,4025,4071
202012,44800,충청남도,홍성군,60-64세,8159,4058,4101
202101,44800,충청남도,홍성군,60-64세,8208,4068,4140
202102,44800,충청남도,홍성군,60-64세,8240,4082,4158
202103,44800,충청남도,홍성군,60-64세,8304,4124,4180
202104,44800,충청남도,홍성군,60-64세,8348,4149,4199
202105,44800,충청남도,홍성군,60-64세,8422,4188,4234
202106,44800,충청남도,홍성군,60-64세,8481,4239,4242
202007,44800,충청남도,홍성군,65-69세,6366,3040,3326
202008,44800,충청남도,홍성군,65-69세,6400,3061,3339
202009,44800,충청남도,홍성군,65-69세,6438,3089,3349
202010,44800,충청남도,홍성군,65-69세,6498,3122,3376
202011,44800,충청남도,홍성군,65-69세,6526,3150,3376
202012,44800,충청남도,홍성군,65-69세,6600,3182,3418
202101,44800,충청남도,홍성군,65-69세,6640,3209,3431
202102,44800,충청남도,홍성군,65-69세,6724,3253,3471
202103,44800,충청남도,홍성군,65-69세,6810,3298,3512
202104,44800,충청남도,홍성군,65-69세,6842,3317,3525
202105,44800,충청남도,홍성군,65-69세,6881,3342,3539
202106,44800,충청남도,홍성군,65-69세,6832,3319,3513
202007,44800,충청남도,홍성군,70-74세,5295,2547,2748
202008,44800,충청남도,홍성군,70-74세,5314,2549,2765
202009,44800,충청남도,홍성군,70-74세,5345,2556,2789
202010,44800,충청남도,홍성군,70-74세,5387,2579,2808
202011,44800,충청남도,홍성군,70-74세,5431,2587,2844
202012,44800,충청남도,홍성군,70-74세,5472,2604,2868
202101,44800,충청남도,홍성군,70-74세,5527,2630,2897
202102,44800,충청남도,홍성군,70-74세,5550,2641,2909
202103,44800,충청남도,홍성군,70-74세,5546,2629,2917
202104,44800,충청남도,홍성군,70-74세,5566,2637,2929
202105,44800,충청남도,홍성군,70-74세,5574,2629,2945
202106,44800,충청남도,홍성군,70-74세,5553,2624,2929
202007,44800,충청남도,홍성군,75-79세,4727,1922,2805
202008,44800,충청남도,홍성군,75-79세,4720,1927,2793
202009,44800,충청남도,홍성군,75-79세,4692,1920,2772
202010,44800,충청남도,홍성군,75-79세,4669,1901,2768
202011,44800,충청남도,홍성군,75-79세,4630,1876,2754
202012,44800,충청남도,홍성군,75-79세,4586,1870,2716
202101,44800,충청남도,홍성군,75-79세,4566,1854,2712
202102,44800,충청남도,홍성군,75-79세,4536,1848,2688
202103,44800,충청남도,홍성군,75-79세,4536,1863,2673
202104,44800,충청남도,홍성군,75-79세,4519,1855,2664
202105,44800,충청남도,홍성군,75-79세,4518,1873,2645
202106,44800,충청남도,홍성군,75-79세,4497,1874,2623
202007,44800,충청남도,홍성군,80-84세,4084,1499,2585
202008,44800,충청남도,홍성군,80-84세,4055,1493,2562
202009,44800,충청남도,홍성군,80-84세,4041,1484,2557
202010,44800,충청남도,홍성군,80-84세,4029,1484,2545
202011,44800,충청남도,홍성군,80-84세,4030,1490,2540
202012,44800,충청남도,홍성군,80-84세,4023,1485,2538
202101,44800,충청남도,홍성군,80-84세,4007,1482,2525
202102,44800,충청남도,홍성군,80-84세,3999,1482,2517
202103,44800,충청남도,홍성군,80-84세,3961,1472,2489
202104,44800,충청남도,홍성군,80-84세,3935,1451,2484
202105,44800,충청남도,홍성군,80-84세,3928,1447,2481
202106,44800,충청남도,홍성군,80-84세,3929,1440,2489
202007,44800,충청남도,홍성군,85-89세,2246,699,1547
202008,44800,충청남도,홍성군,85-89세,2265,698,1567
202009,44800,충청남도,홍성군,85-89세,2307,718,1589
202010,44800,충청남도,홍성군,85-89세,2313,722,1591
202011,44800,충청남도,홍성군,85-89세,2326,732,1594
202012,44800,충청남도,홍성군,85-89세,2382,750,1632
202101,44800,충청남도,홍성군,85-89세,2402,761,1641
202102,44800,충청남도,홍성군,85-89세,2439,775,1664
202103,44800,충청남도,홍성군,85-89세,2505,797,1708
202104,44800,충청남도,홍성군,85-89세,2539,821,1718
202105,44800,충청남도,홍성군,85-89세,2549,825,1724
202106,44800,충청남도,홍성군,85-89세,2540,817,1723
202007,44800,충청남도,홍성군,90-94세,684,182,502
202008,44800,충청남도,홍성군,90-94세,689,183,506
202009,44800,충청남도,홍성군,90-94세,696,186,510
202010,44800,충청남도,홍성군,90-94세,705,186,519
202011,44800,충청남도,홍성군,90-94세,703,187,516
202012,44800,충청남도,홍성군,90-94세,710,188,522
202101,44800,충청남도,홍성군,90-94세,714,188,526
202102,44800,충청남도,홍성군,90-94세,721,191,530
202103,44800,충청남도,홍성군,90-94세,715,185,530
202104,44800,충청남도,홍성군,90-94세,725,182,543
202105,44800,충청남도,홍성군,90-94세,724,184,540
202106,44800,충청남도,홍성군,90-94세,722,181,541
202007,44800,충청남도,홍성군,95-99세,153,29,124
202008,44800,충청남도,홍성군,95-99세,164,33,131
202009,44800,충청남도,홍성군,95-99세,166,34,132
202010,44800,충청남도,홍성군,95-99세,170,35,135
202011,44800,충청남도,홍성군,95-99세,172,36,136
202012,44800,충청남도,홍성군,95-99세,171,37,134
202101,44800,충청남도,홍성군,95-99세,178,40,138
202102,44800,충청남도,홍성군,95-99세,177,39,138
202103,44800,충청남도,홍성군,95-99세,176,39,137
202104,44800,충청남도,홍성군,95-99세,171,39,132
202105,44800,충청남도,홍성군,95-99세,181,40,141
202106,44800,충청남도,홍성군,95-99세,183,40,143
202007,44800,충청남도,홍성군,100+,61,19,42
202008,44800,충청남도,홍성군,100+,60,19,41
202009,44800,충청남도,홍성군,100+,61,19,42
202010,44800,충청남도,홍성군,100+,61,19,42
202011,44800,충청남도,홍성군,100+,61,19,42
202012,44800,충청남도,홍성군,100+,61,19,42
202101,44800,충청남도,홍성군,100+,62,19,43
202102,44800,충청남도,홍성군,100+,63,19,44
202103,44800,충청남도,홍성군,100+,31,5,26
202104,44800,충청남도,홍성군,100+,25,3,22
202105,44800,충청남도,홍성군,100+,25,3,22
202106,44800,충청남도,홍성군,100+,25,4,21
202007,44810,충청남도,예산군,0-4세,1486,751,735
202008,44810,충청남도,예산군,0-4세,1470,744,726
202009,44810,충청남도,예산군,0-4세,1465,737,728
202010,44810,충청남도,예산군,0-4세,1438,728,710
202011,44810,충청남도,예산군,0-4세,1432,722,710
202012,44810,충청남도,예산군,0-4세,1423,722,701
202101,44810,충청남도,예산군,0-4세,1405,716,689
202102,44810,충청남도,예산군,0-4세,1394,714,680
202103,44810,충청남도,예산군,0-4세,1378,699,679
202104,44810,충청남도,예산군,0-4세,1374,701,673
202105,44810,충청남도,예산군,0-4세,1365,703,662
202106,44810,충청남도,예산군,0-4세,1352,691,661
202007,44810,충청남도,예산군,5-9세,2261,1182,1079
202008,44810,충청남도,예산군,5-9세,2260,1178,1082
202009,44810,충청남도,예산군,5-9세,2240,1180,1060
202010,44810,충청남도,예산군,5-9세,2225,1174,1051
202011,44810,충청남도,예산군,5-9세,2224,1179,1045
202012,44810,충청남도,예산군,5-9세,2208,1169,1039
202101,44810,충청남도,예산군,5-9세,2194,1156,1038
202102,44810,충청남도,예산군,5-9세,2190,1148,1042
202103,44810,충청남도,예산군,5-9세,2176,1136,1040
202104,44810,충청남도,예산군,5-9세,2156,1128,1028
202105,44810,충청남도,예산군,5-9세,2138,1114,1024
202106,44810,충청남도,예산군,5-9세,2119,1109,1010
202007,44810,충청남도,예산군,10-14세,2652,1362,1290
202008,44810,충청남도,예산군,10-14세,2628,1351,1277
202009,44810,충청남도,예산군,10-14세,2631,1352,1279
202010,44810,충청남도,예산군,10-14세,2626,1348,1278
202011,44810,충청남도,예산군,10-14세,2617,1341,1276
202012,44810,충청남도,예산군,10-14세,2616,1351,1265
202101,44810,충청남도,예산군,10-14세,2614,1358,1256
202102,44810,충청남도,예산군,10-14세,2596,1357,1239
202103,44810,충청남도,예산군,10-14세,2604,1371,1233
202104,44810,충청남도,예산군,10-14세,2613,1371,1242
202105,44810,충청남도,예산군,10-14세,2621,1372,1249
202106,44810,충청남도,예산군,10-14세,2596,1370,1226
202007,44810,충청남도,예산군,15-19세,3127,1611,1516
202008,44810,충청남도,예산군,15-19세,3117,1600,1517
202009,44810,충청남도,예산군,15-19세,3090,1583,1507
202010,44810,충청남도,예산군,15-19세,3073,1579,1494
202011,44810,충청남도,예산군,15-19세,3042,1561,1481
202012,44810,충청남도,예산군,15-19세,3040,1555,1485
202101,44810,충청남도,예산군,15-19세,3142,1606,1536
202102,44810,충청남도,예산군,15-19세,3094,1579,1515
202103,44810,충청남도,예산군,15-19세,3056,1565,1491
202104,44810,충청남도,예산군,15-19세,3016,1546,1470
202105,44810,충청남도,예산군,15-19세,3016,1546,1470
202106,44810,충청남도,예산군,15-19세,3011,1535,1476
202007,44810,충청남도,예산군,20-24세,3720,2107,1613
202008,44810,충청남도,예산군,20-24세,3685,2087,1598
202009,44810,충청남도,예산군,20-24세,3674,2076,1598
202010,44810,충청남도,예산군,20-24세,3668,2051,1617
202011,44810,충청남도,예산군,20-24세,3664,2044,1620
202012,44810,충청남도,예산군,20-24세,3630,2023,1607
202101,44810,충청남도,예산군,20-24세,3586,1997,1589
202102,44810,충청남도,예산군,20-24세,3565,1996,1569
202103,44810,충청남도,예산군,20-24세,3562,1996,1566
202104,44810,충청남도,예산군,20-24세,3551,2000,1551
202105,44810,충청남도,예산군,20-24세,3526,1991,1535
202106,44810,충청남도,예산군,20-24세,3496,1981,1515
202007,44810,충청남도,예산군,25-29세,3203,1821,1382
202008,44810,충청남도,예산군,25-29세,3192,1821,1371
202009,44810,충청남도,예산군,25-29세,3202,1822,1380
202010,44810,충청남도,예산군,25-29세,3198,1825,1373
202011,44810,충청남도,예산군,25-29세,3189,1815,1374
202012,44810,충청남도,예산군,25-29세,3200,1818,1382
202101,44810,충청남도,예산군,25-29세,3201,1819,1382
202102,44810,충청남도,예산군,25-29세,3178,1809,1369
202103,44810,충청남도,예산군,25-29세,3140,1789,1351
202104,44810,충청남도,예산군,25-29세,3141,1795,1346
202105,44810,충청남도,예산군,25-29세,3129,1794,1335
202106,44810,충청남도,예산군,25-29세,3128,1802,1326
202007,44810,충청남도,예산군,30-34세,2831,1620,1211
202008,44810,충청남도,예산군,30-34세,2810,1599,1211
202009,44810,충청남도,예산군,30-34세,2788,1589,1199
202010,44810,충청남도,예산군,30-34세,2786,1598,1188
202011,44810,충청남도,예산군,30-34세,2778,1585,1193
202012,44810,충청남도,예산군,30-34세,2771,1574,1197
202101,44810,충청남도,예산군,30-34세,2785,1579,1206
202102,44810,충청남도,예산군,30-34세,2767,1573,1194
202103,44810,충청남도,예산군,30-34세,2738,1560,1178
202104,44810,충청남도,예산군,30-34세,2729,1556,1173
202105,44810,충청남도,예산군,30-34세,2732,1553,1179
202106,44810,충청남도,예산군,30-34세,2725,1548,1177
202007,44810,충청남도,예산군,35-39세,3482,1898,1584
202008,44810,충청남도,예산군,35-39세,3446,1880,1566
202009,44810,충청남도,예산군,35-39세,3430,1871,1559
202010,44810,충청남도,예산군,35-39세,3395,1852,1543
202011,44810,충청남도,예산군,35-39세,3365,1838,1527
202012,44810,충청남도,예산군,35-39세,3359,1827,1532
202101,44810,충청남도,예산군,35-39세,3329,1813,1516
202102,44810,충청남도,예산군,35-39세,3318,1803,1515
202103,44810,충청남도,예산군,35-39세,3277,1780,1497
202104,44810,충청남도,예산군,35-39세,3257,1773,1484
202105,44810,충청남도,예산군,35-39세,3213,1749,1464
202106,44810,충청남도,예산군,35-39세,3165,1714,1451
202007,44810,충청남도,예산군,40-44세,4065,2187,1878
202008,44810,충청남도,예산군,40-44세,4050,2171,1879
202009,44810,충청남도,예산군,40-44세,4063,2173,1890
202010,44810,충청남도,예산군,40-44세,4089,2186,1903
202011,44810,충청남도,예산군,40-44세,4084,2188,1896
202012,44810,충청남도,예산군,40-44세,4023,2159,1864
202101,44810,충청남도,예산군,40-44세,4002,2146,1856
202102,44810,충청남도,예산군,40-44세,3958,2128,1830
202103,44810,충청남도,예산군,40-44세,3914,2115,1799
202104,44810,충청남도,예산군,40-44세,3912,2104,1808
202105,44810,충청남도,예산군,40-44세,3915,2102,1813
202106,44810,충청남도,예산군,40-44세,3926,2110,1816
202007,44810,충청남도,예산군,45-49세,5632,3160,2472
202008,44810,충청남도,예산군,45-49세,5601,3138,2463
202009,44810,충청남도,예산군,45-49세,5551,3108,2443
202010,44810,충청남도,예산군,45-49세,5513,3085,2428
202011,44810,충청남도,예산군,45-49세,5484,3068,2416
202012,44810,충청남도,예산군,45-49세,5500,3070,2430
202101,44810,충청남도,예산군,45-49세,5516,3078,2438
202102,44810,충청남도,예산군,45-49세,5506,3070,2436
202103,44810,충청남도,예산군,45-49세,5454,3035,2419
202104,44810,충청남도,예산군,45-49세,5434,3020,2414
202105,44810,충청남도,예산군,45-49세,5373,2990,2383
202106,44810,충청남도,예산군,45-49세,5330,2966,2364
202007,44810,충청남도,예산군,50-54세,6241,3403,2838
202008,44810,충청남도,예산군,50-54세,6245,3414,2831
202009,44810,충청남도,예산군,50-54세,6271,3430,2841
202010,44810,충청남도,예산군,50-54세,6285,3446,2839
202011,44810,충청남도,예산군,50-54세,6283,3448,2835
202012,44810,충청남도,예산군,50-54세,6265,3449,2816
202101,44810,충청남도,예산군,50-54세,6256,3451,2805
202102,44810,충청남도,예산군,50-54세,6260,3461,2799
202103,44810,충청남도,예산군,50-54세,6215,3435,2780
202104,44810,충청남도,예산군,50-54세,6217,3448,2769
202105,44810,충청남도,예산군,50-54세,6251,3462,2789
202106,44810,충청남도,예산군,50-54세,6290,3489,2801
202007,44810,충청남도,예산군,55-59세,7644,3951,3693
202008,44810,충청남도,예산군,55-59세,7585,3939,3646
202009,44810,충청남도,예산군,55-59세,7518,3912,3606
202010,44810,충청남도,예산군,55-59세,7472,3893,3579
202011,44810,충청남도,예산군,55-59세,7428,3866,3562
202012,44810,충청남도,예산군,55-59세,7412,3849,3563
202101,44810,충청남도,예산군,55-59세,7326,3819,3507
202102,44810,충청남도,예산군,55-59세,7300,3803,3497
202103,44810,충청남도,예산군,55-59세,7186,3754,3432
202104,44810,충청남도,예산군,55-59세,7120,3714,3406
202105,44810,충청남도,예산군,55-59세,7029,3695,3334
202106,44810,충청남도,예산군,55-59세,6942,3647,3295
202007,44810,충청남도,예산군,60-64세,7932,3990,3942
202008,44810,충청남도,예산군,60-64세,7948,3975,3973
202009,44810,충청남도,예산군,60-64세,7983,3981,4002
202010,44810,충청남도,예산군,60-64세,8017,3996,4021
202011,44810,충청남도,예산군,60-64세,8036,4009,4027
202012,44810,충청남도,예산군,60-64세,8010,3989,4021
202101,44810,충청남도,예산군,60-64세,8045,3993,4052
202102,44810,충청남도,예산군,60-64세,8102,4022,4080
202103,44810,충청남도,예산군,60-64세,8116,4044,4072
202104,44810,충청남도,예산군,60-64세,8191,4088,4103
202105,44810,충청남도,예산군,60-64세,8281,4123,4158
202106,44810,충청남도,예산군,60-64세,8349,4162,4187
202007,44810,충청남도,예산군,65-69세,6519,3154,3365
202008,44810,충청남도,예산군,65-69세,6577,3195,3382
202009,44810,충청남도,예산군,65-69세,6613,3214,3399
202010,44810,충청남도,예산군,65-69세,6631,3230,3401
202011,44810,충청남도,예산군,65-69세,6638,3236,3402
202012,44810,충청남도,예산군,65-69세,6733,3299,3434
202101,44810,충청남도,예산군,65-69세,6805,3346,3459
202102,44810,충청남도,예산군,65-69세,6869,3392,3477
202103,44810,충청남도,예산군,65-69세,6931,3443,3488
202104,44810,충청남도,예산군,65-69세,6963,3460,3503
202105,44810,충청남도,예산군,65-69세,6978,3472,3506
202106,44810,충청남도,예산군,65-69세,7017,3488,3529
202007,44810,충청남도,예산군,70-74세,5405,2610,2795
202008,44810,충청남도,예산군,70-74세,5432,2617,2815
202009,44810,충청남도,예산군,70-74세,5465,2646,2819
202010,44810,충청남도,예산군,70-74세,5496,2665,2831
202011,44810,충청남도,예산군,70-74세,5530,2683,2847
202012,44810,충청남도,예산군,70-74세,5558,2693,2865
202101,44810,충청남도,예산군,70-74세,5594,2706,2888
202102,44810,충청남도,예산군,70-74세,5616,2704,2912
202103,44810,충청남도,예산군,70-74세,5565,2669,2896
202104,44810,충청남도,예산군,70-74세,5592,2685,2907
202105,44810,충청남도,예산군,70-74세,5630,2696,2934
202106,44810,충청남도,예산군,70-74세,5623,2691,2932
202007,44810,충청남도,예산군,75-79세,5053,2136,2917
202008,44810,충청남도,예산군,75-79세,5010,2107,2903
202009,44810,충청남도,예산군,75-79세,4982,2079,2903
202010,44810,충청남도,예산군,75-79세,4947,2059,2888
202011,44810,충청남도,예산군,75-79세,4934,2065,2869
202012,44810,충청남도,예산군,75-79세,4893,2047,2846
202101,44810,충청남도,예산군,75-79세,4861,2033,2828
202102,44810,충청남도,예산군,75-79세,4809,2022,2787
202103,44810,충청남도,예산군,75-79세,4754,2003,2751
202104,44810,충청남도,예산군,75-79세,4720,1994,2726
202105,44810,충청남도,예산군,75-79세,4675,1979,2696
202106,44810,충청남도,예산군,75-79세,4670,1976,2694
202007,44810,충청남도,예산군,80-84세,4202,1593,2609
202008,44810,충청남도,예산군,80-84세,4198,1600,2598
202009,44810,충청남도,예산군,80-84세,4189,1608,2581
202010,44810,충청남도,예산군,80-84세,4190,1611,2579
202011,44810,충청남도,예산군,80-84세,4160,1594,2566
202012,44810,충청남도,예산군,80-84세,4149,1588,2561
202101,44810,충청남도,예산군,80-84세,4137,1588,2549
202102,44810,충청남도,예산군,80-84세,4167,1601,2566
202103,44810,충청남도,예산군,80-84세,4151,1601,2550
202104,44810,충청남도,예산군,80-84세,4142,1593,2549
202105,44810,충청남도,예산군,80-84세,4168,1603,2565
202106,44810,충청남도,예산군,80-84세,4167,1602,2565
202007,44810,충청남도,예산군,85-89세,2308,745,1563
202008,44810,충청남도,예산군,85-89세,2317,750,1567
202009,44810,충청남도,예산군,85-89세,2359,760,1599
202010,44810,충청남도,예산군,85-89세,2370,761,1609
202011,44810,충청남도,예산군,85-89세,2391,769,1622
202012,44810,충청남도,예산군,85-89세,2418,779,1639
202101,44810,충청남도,예산군,85-89세,2444,794,1650
202102,44810,충청남도,예산군,85-89세,2463,799,1664
202103,44810,충청남도,예산군,85-89세,2491,804,1687
202104,44810,충청남도,예산군,85-89세,2518,819,1699
202105,44810,충청남도,예산군,85-89세,2528,820,1708
202106,44810,충청남도,예산군,85-89세,2539,831,1708
202007,44810,충청남도,예산군,90-94세,661,155,506
202008,44810,충청남도,예산군,90-94세,664,158,506
202009,44810,충청남도,예산군,90-94세,668,160,508
202010,44810,충청남도,예산군,90-94세,678,162,516
202011,44810,충청남도,예산군,90-94세,678,164,514
202012,44810,충청남도,예산군,90-94세,686,166,520
202101,44810,충청남도,예산군,90-94세,701,168,533
202102,44810,충청남도,예산군,90-94세,712,173,539
202103,44810,충청남도,예산군,90-94세,710,176,534
202104,44810,충청남도,예산군,90-94세,724,181,543
202105,44810,충청남도,예산군,90-94세,731,186,545
202106,44810,충청남도,예산군,90-94세,732,184,548
202007,44810,충청남도,예산군,95-99세,147,24,123
202008,44810,충청남도,예산군,95-99세,147,24,123
202009,44810,충청남도,예산군,95-99세,150,22,128
202010,44810,충청남도,예산군,95-99세,150,22,128
202011,44810,충청남도,예산군,95-99세,149,22,127
202012,44810,충청남도,예산군,95-99세,150,24,126
202101,44810,충청남도,예산군,95-99세,147,24,123
202102,44810,충청남도,예산군,95-99세,144,25,119
202103,44810,충청남도,예산군,95-99세,139,27,112
202104,44810,충청남도,예산군,95-99세,139,25,114
202105,44810,충청남도,예산군,95-99세,137,24,113
202106,44810,충청남도,예산군,95-99세,138,23,115
202007,44810,충청남도,예산군,100+,38,5,33
202008,44810,충청남도,예산군,100+,38,5,33
202009,44810,충청남도,예산군,100+,38,5,33
202010,44810,충청남도,예산군,100+,39,5,34
202011,44810,충청남도,예산군,100+,40,5,35
202012,44810,충청남도,예산군,100+,40,5,35
202101,44810,충청남도,예산군,100+,39,5,34
202102,44810,충청남도,예산군,100+,40,5,35
202103,44810,충청남도,예산군,100+,28,4,24
202104,44810,충청남도,예산군,100+,29,4,25
202105,44810,충청남도,예산군,100+,32,5,27
202106,44810,충청남도,예산군,100+,33,6,27
202007,44825,충청남도,태안군,0-4세,1303,642,661
202008,44825,충청남도,태안군,0-4세,1303,636,667
202009,44825,충청남도,태안군,0-4세,1294,625,669
202010,44825,충청남도,태안군,0-4세,1284,619,665
202011,44825,충청남도,태안군,0-4세,1273,619,654
202012,44825,충청남도,태안군,0-4세,1264,617,647
202101,44825,충청남도,태안군,0-4세,1245,614,631
202102,44825,충청남도,태안군,0-4세,1215,593,622
202103,44825,충청남도,태안군,0-4세,1195,588,607
202104,44825,충청남도,태안군,0-4세,1189,594,595
202105,44825,충청남도,태안군,0-4세,1178,583,595
202106,44825,충청남도,태안군,0-4세,1156,581,575
202007,44825,충청남도,태안군,5-9세,1854,918,936
202008,44825,충청남도,태안군,5-9세,1849,914,935
202009,44825,충청남도,태안군,5-9세,1839,912,927
202010,44825,충청남도,태안군,5-9세,1851,916,935
202011,44825,충청남도,태안군,5-9세,1843,914,929
202012,44825,충청남도,태안군,5-9세,1839,911,928
202101,44825,충청남도,태안군,5-9세,1829,902,927
202102,44825,충청남도,태안군,5-9세,1808,900,908
202103,44825,충청남도,태안군,5-9세,1796,894,902
202104,44825,충청남도,태안군,5-9세,1787,886,901
202105,44825,충청남도,태안군,5-9세,1797,898,899
202106,44825,충청남도,태안군,5-9세,1801,895,906
202007,44825,충청남도,태안군,10-14세,2126,1114,1012
202008,44825,충청남도,태안군,10-14세,2118,1113,1005
202009,44825,충청남도,태안군,10-14세,2120,1113,1007
202010,44825,충청남도,태안군,10-14세,2110,1108,1002
202011,44825,충청남도,태안군,10-14세,2097,1100,997
202012,44825,충청남도,태안군,10-14세,2081,1098,983
202101,44825,충청남도,태안군,10-14세,2078,1097,981
202102,44825,충청남도,태안군,10-14세,2067,1074,993
202103,44825,충청남도,태안군,10-14세,2074,1072,1002
202104,44825,충청남도,태안군,10-14세,2059,1070,989
202105,44825,충청남도,태안군,10-14세,2055,1070,985
202106,44825,충청남도,태안군,10-14세,2059,1070,989
202007,44825,충청남도,태안군,15-19세,2410,1248,1162
202008,44825,충청남도,태안군,15-19세,2408,1248,1160
202009,44825,충청남도,태안군,15-19세,2421,1258,1163
202010,44825,충청남도,태안군,15-19세,2400,1240,1160
202011,44825,충청남도,태안군,15-19세,2393,1238,1155
202012,44825,충청남도,태안군,15-19세,2343,1202,1141
202101,44825,충청남도,태안군,15-19세,2311,1180,1131
202102,44825,충청남도,태안군,15-19세,2286,1168,1118
202103,44825,충청남도,태안군,15-19세,2275,1168,1107
202104,44825,충청남도,태안군,15-19세,2276,1171,1105
202105,44825,충청남도,태안군,15-19세,2264,1173,1091
202106,44825,충청남도,태안군,15-19세,2242,1166,1076
202007,44825,충청남도,태안군,20-24세,2688,1567,1121
202008,44825,충청남도,태안군,20-24세,2683,1568,1115
202009,44825,충청남도,태안군,20-24세,2681,1552,1129
202010,44825,충청남도,태안군,20-24세,2679,1547,1132
202011,44825,충청남도,태안군,20-24세,2663,1533,1130
202012,44825,충청남도,태안군,20-24세,2628,1522,1106
202101,44825,충청남도,태안군,20-24세,2595,1501,1094
202102,44825,충청남도,태안군,20-24세,2563,1476,1087
202103,44825,충청남도,태안군,20-24세,2502,1443,1059
202104,44825,충청남도,태안군,20-24세,2496,1438,1058
202105,44825,충청남도,태안군,20-24세,2526,1449,1077
202106,44825,충청남도,태안군,20-24세,2520,1436,1084
202007,44825,충청남도,태안군,25-29세,2393,1423,970
202008,44825,충청남도,태안군,25-29세,2374,1408,966
202009,44825,충청남도,태안군,25-29세,2364,1409,955
202010,44825,충청남도,태안군,25-29세,2382,1418,964
202011,44825,충청남도,태안군,25-29세,2390,1440,950
202012,44825,충청남도,태안군,25-29세,2409,1448,961
202101,44825,충청남도,태안군,25-29세,2377,1444,933
202102,44825,충청남도,태안군,25-29세,2316,1396,920
202103,44825,충청남도,태안군,25-29세,2327,1396,931
202104,44825,충청남도,태안군,25-29세,2316,1386,930
202105,44825,충청남도,태안군,25-29세,2309,1390,919
202106,44825,충청남도,태안군,25-29세,2308,1395,913
202007,44825,충청남도,태안군,30-34세,2242,1263,979
202008,44825,충청남도,태안군,30-34세,2232,1262,970
202009,44825,충청남도,태안군,30-34세,2227,1260,967
202010,44825,충청남도,태안군,30-34세,2206,1248,958
202011,44825,충청남도,태안군,30-34세,2176,1236,940
202012,44825,충청남도,태안군,30-34세,2157,1227,930
202101,44825,충청남도,태안군,30-34세,2139,1209,930
202102,44825,충청남도,태안군,30-34세,2127,1206,921
202103,44825,충청남도,태안군,30-34세,2107,1194,913
202104,44825,충청남도,태안군,30-34세,2099,1190,909
202105,44825,충청남도,태안군,30-34세,2105,1185,920
202106,44825,충청남도,태안군,30-34세,2088,1176,912
202007,44825,충청남도,태안군,35-39세,3007,1663,1344
202008,44825,충청남도,태안군,35-39세,2990,1647,1343
202009,44825,충청남도,태안군,35-39세,2962,1638,1324
202010,44825,충청남도,태안군,35-39세,2961,1634,1327
202011,44825,충청남도,태안군,35-39세,2960,1632,1328
202012,44825,충청남도,태안군,35-39세,2960,1638,1322
202101,44825,충청남도,태안군,35-39세,2929,1612,1317
202102,44825,충청남도,태안군,35-39세,2865,1578,1287
202103,44825,충청남도,태안군,35-39세,2820,1536,1284
202104,44825,충청남도,태안군,35-39세,2813,1528,1285
202105,44825,충청남도,태안군,35-39세,2769,1506,1263
202106,44825,충청남도,태안군,35-39세,2748,1488,1260
202007,44825,충청남도,태안군,40-44세,3471,1954,1517
202008,44825,충청남도,태안군,40-44세,3490,1968,1522
202009,44825,충청남도,태안군,40-44세,3505,1970,1535
202010,44825,충청남도,태안군,40-44세,3505,1974,1531
202011,44825,충청남도,태안군,40-44세,3496,1958,1538
202012,44825,충청남도,태안군,40-44세,3460,1930,1530
202101,44825,충청남도,태안군,40-44세,3450,1925,1525
202102,44825,충청남도,태안군,40-44세,3421,1913,1508
202103,44825,충청남도,태안군,40-44세,3388,1898,1490
202104,44825,충청남도,태안군,40-44세,3369,1893,1476
202105,44825,충청남도,태안군,40-44세,3368,1898,1470
202106,44825,충청남도,태안군,40-44세,3405,1923,1482
202007,44825,충청남도,태안군,45-49세,4320,2448,1872
202008,44825,충청남도,태안군,45-49세,4282,2423,1859
202009,44825,충청남도,태안군,45-49세,4252,2409,1843
202010,44825,충청남도,태안군,45-49세,4235,2396,1839
202011,44825,충청남도,태안군,45-49세,4210,2387,1823
202012,44825,충청남도,태안군,45-49세,4200,2380,1820
202101,44825,충청남도,태안군,45-49세,4189,2372,1817
202102,44825,충청남도,태안군,45-49세,4214,2374,1840
202103,44825,충청남도,태안군,45-49세,4212,2378,1834
202104,44825,충청남도,태안군,45-49세,4221,2379,1842
202105,44825,충청남도,태안군,45-49세,4204,2367,1837
202106,44825,충청남도,태안군,45-49세,4183,2349,1834
202007,44825,충청남도,태안군,50-54세,4952,2668,2284
202008,44825,충청남도,태안군,50-54세,4964,2665,2299
202009,44825,충청남도,태안군,50-54세,4993,2695,2298
202010,44825,충청남도,태안군,50-54세,5000,2704,2296
202011,44825,충청남도,태안군,50-54세,5008,2706,2302
202012,44825,충청남도,태안군,50-54세,5013,2703,2310
202101,44825,충청남도,태안군,50-54세,5017,2696,2321
202102,44825,충청남도,태안군,50-54세,5019,2697,2322
202103,44825,충청남도,태안군,50-54세,4982,2691,2291
202104,44825,충청남도,태안군,50-54세,4978,2690,2288
202105,44825,충청남도,태안군,50-54세,4982,2692,2290
202106,44825,충청남도,태안군,50-54세,5019,2723,2296
202007,44825,충청남도,태안군,55-59세,5936,3046,2890
202008,44825,충청남도,태안군,55-59세,5935,3057,2878
202009,44825,충청남도,태안군,55-59세,5904,3032,2872
202010,44825,충청남도,태안군,55-59세,5895,3025,2870
202011,44825,충청남도,태안군,55-59세,5899,3039,2860
202012,44825,충청남도,태안군,55-59세,5890,3036,2854
202101,44825,충청남도,태안군,55-59세,5816,2998,2818
202102,44825,충청남도,태안군,55-59세,5774,2980,2794
202103,44825,충청남도,태안군,55-59세,5742,2956,2786
202104,44825,충청남도,태안군,55-59세,5716,2941,2775
202105,44825,충청남도,태안군,55-59세,5643,2923,2720
202106,44825,충청남도,태안군,55-59세,5578,2886,2692
202007,44825,충청남도,태안군,60-64세,6495,3097,3398
202008,44825,충청남도,태안군,60-64세,6507,3096,3411
202009,44825,충청남도,태안군,60-64세,6554,3125,3429
202010,44825,충청남도,태안군,60-64세,6578,3146,3432
202011,44825,충청남도,태안군,60-64세,6596,3154,3442
202012,44825,충청남도,태안군,60-64세,6614,3183,3431
202101,44825,충청남도,태안군,60-64세,6654,3196,3458
202102,44825,충청남도,태안군,60-64세,6688,3229,3459
202103,44825,충청남도,태안군,60-64세,6717,3253,3464
202104,44825,충청남도,태안군,60-64세,6789,3297,3492
202105,44825,충청남도,태안군,60-64세,6865,3329,3536
202106,44825,충청남도,태안군,60-64세,6926,3376,3550
202007,44825,충청남도,태안군,65-69세,5278,2552,2726
202008,44825,충청남도,태안군,65-69세,5309,2575,2734
202009,44825,충청남도,태안군,65-69세,5350,2593,2757
202010,44825,충청남도,태안군,65-69세,5376,2602,2774
202011,44825,충청남도,태안군,65-69세,5397,2608,2789
202012,44825,충청남도,태안군,65-69세,5410,2603,2807
202101,44825,충청남도,태안군,65-69세,5417,2619,2798
202102,44825,충청남도,태안군,65-69세,5483,2642,2841
202103,44825,충청남도,태안군,65-69세,5555,2674,2881
202104,44825,충청남도,태안군,65-69세,5604,2696,2908
202105,44825,충청남도,태안군,65-69세,5616,2703,2913
202106,44825,충청남도,태안군,65-69세,5663,2714,2949
202007,44825,충청남도,태안군,70-74세,4716,2370,2346
202008,44825,충청남도,태안군,70-74세,4733,2381,2352
202009,44825,충청남도,태안군,70-74세,4751,2390,2361
202010,44825,충청남도,태안군,70-74세,4786,2407,2379
202011,44825,충청남도,태안군,70-74세,4804,2416,2388
202012,44825,충청남도,태안군,70-74세,4833,2433,2400
202101,44825,충청남도,태안군,70-74세,4877,2458,2419
202102,44825,충청남도,태안군,70-74세,4866,2450,2416
202103,44825,충청남도,태안군,70-74세,4860,2448,2412
202104,44825,충청남도,태안군,70-74세,4870,2454,2416
202105,44825,충청남도,태안군,70-74세,4905,2458,2447
202106,44825,충청남도,태안군,70-74세,4919,2466,2453
202007,44825,충청남도,태안군,75-79세,4011,1716,2295
202008,44825,충청남도,태안군,75-79세,4026,1721,2305
202009,44825,충청남도,태안군,75-79세,4026,1731,2295
202010,44825,충청남도,태안군,75-79세,4005,1724,2281
202011,44825,충청남도,태안군,75-79세,4008,1726,2282
202012,44825,충청남도,태안군,75-79세,3996,1728,2268
202101,44825,충청남도,태안군,75-79세,3993,1736,2257
202102,44825,충청남도,태안군,75-79세,3990,1749,2241
202103,44825,충청남도,태안군,75-79세,4003,1764,2239
202104,44825,충청남도,태안군,75-79세,3989,1764,2225
202105,44825,충청남도,태안군,75-79세,3991,1774,2217
202106,44825,충청남도,태안군,75-79세,4000,1773,2227
202007,44825,충청남도,태안군,80-84세,2853,1091,1762
202008,44825,충청남도,태안군,80-84세,2840,1088,1752
202009,44825,충청남도,태안군,80-84세,2843,1087,1756
202010,44825,충청남도,태안군,80-84세,2840,1093,1747
202011,44825,충청남도,태안군,80-84세,2817,1085,1732
202012,44825,충청남도,태안군,80-84세,2803,1074,1729
202101,44825,충청남도,태안군,80-84세,2783,1069,1714
202102,44825,충청남도,태안군,80-84세,2771,1059,1712
202103,44825,충청남도,태안군,80-84세,2785,1069,1716
202104,44825,충청남도,태안군,80-84세,2774,1062,1712
202105,44825,충청남도,태안군,80-84세,2780,1065,1715
202106,44825,충청남도,태안군,80-84세,2779,1070,1709
202007,44825,충청남도,태안군,85-89세,1603,482,1121
202008,44825,충청남도,태안군,85-89세,1620,490,1130
202009,44825,충청남도,태안군,85-89세,1633,494,1139
202010,44825,충청남도,태안군,85-89세,1655,498,1157
202011,44825,충청남도,태안군,85-89세,1676,507,1169
202012,44825,충청남도,태안군,85-89세,1675,509,1166
202101,44825,충청남도,태안군,85-89세,1704,514,1190
202102,44825,충청남도,태안군,85-89세,1739,529,1210
202103,44825,충청남도,태안군,85-89세,1768,545,1223
202104,44825,충청남도,태안군,85-89세,1787,550,1237
202105,44825,충청남도,태안군,85-89세,1786,544,1242
202106,44825,충청남도,태안군,85-89세,1788,544,1244
202007,44825,충청남도,태안군,90-94세,493,102,391
202008,44825,충청남도,태안군,90-94세,494,103,391
202009,44825,충청남도,태안군,90-94세,502,109,393
202010,44825,충청남도,태안군,90-94세,499,106,393
202011,44825,충청남도,태안군,90-94세,499,105,394
202012,44825,충청남도,태안군,90-94세,493,105,388
202101,44825,충청남도,태안군,90-94세,495,108,387
202102,44825,충청남도,태안군,90-94세,506,111,395
202103,44825,충청남도,태안군,90-94세,515,110,405
202104,44825,충청남도,태안군,90-94세,521,113,408
202105,44825,충청남도,태안군,90-94세,525,116,409
202106,44825,충청남도,태안군,90-94세,531,120,411
202007,44825,충청남도,태안군,95-99세,106,20,86
202008,44825,충청남도,태안군,95-99세,114,21,93
202009,44825,충청남도,태안군,95-99세,117,19,98
202010,44825,충청남도,태안군,95-99세,117,19,98
202011,44825,충청남도,태안군,95-99세,115,20,95
202012,44825,충청남도,태안군,95-99세,120,19,101
202101,44825,충청남도,태안군,95-99세,126,19,107
202102,44825,충청남도,태안군,95-99세,126,19,107
202103,44825,충청남도,태안군,95-99세,128,20,108
202104,44825,충청남도,태안군,95-99세,127,19,108
202105,44825,충청남도,태안군,95-99세,126,18,108
202106,44825,충청남도,태안군,95-99세,131,18,113
202007,44825,충청남도,태안군,100+,24,4,20
202008,44825,충청남도,태안군,100+,25,4,21
202009,44825,충청남도,태안군,100+,26,5,21
202010,44825,충청남도,태안군,100+,26,5,21
202011,44825,충청남도,태안군,100+,26,5,21
202012,44825,충청남도,태안군,100+,26,5,21
202101,44825,충청남도,태안군,100+,26,5,21
202102,44825,충청남도,태안군,100+,27,5,22
202103,44825,충청남도,태안군,100+,20,5,15
202104,44825,충청남도,태안군,100+,22,7,15
202105,44825,충청남도,태안군,100+,24,8,16
202106,44825,충청남도,태안군,100+,23,8,15
202007,45111,전라북도,전주시 완산구,0-4세,10145,5284,4861
202008,45111,전라북도,전주시 완산구,0-4세,10142,5284,4858
202009,45111,전라북도,전주시 완산구,0-4세,10116,5260,4856
202010,45111,전라북도,전주시 완산구,0-4세,10034,5228,4806
202011,45111,전라북도,전주시 완산구,0-4세,9971,5186,4785
202012,45111,전라북도,전주시 완산구,0-4세,9916,5177,4739
202101,45111,전라북도,전주시 완산구,0-4세,9779,5105,4674
202102,45111,전라북도,전주시 완산구,0-4세,9678,5031,4647
202103,45111,전라북도,전주시 완산구,0-4세,9559,4969,4590
202104,45111,전라북도,전주시 완산구,0-4세,9471,4930,4541
202105,45111,전라북도,전주시 완산구,0-4세,9391,4887,4504
202106,45111,전라북도,전주시 완산구,0-4세,9313,4827,4486
202007,45111,전라북도,전주시 완산구,5-9세,15086,7703,7383
202008,45111,전라북도,전주시 완산구,5-9세,15079,7700,7379
202009,45111,전라북도,전주시 완산구,5-9세,15040,7664,7376
202010,45111,전라북도,전주시 완산구,5-9세,14959,7610,7349
202011,45111,전라북도,전주시 완산구,5-9세,14931,7607,7324
202012,45111,전라북도,전주시 완산구,5-9세,14930,7608,7322
202101,45111,전라북도,전주시 완산구,5-9세,14794,7553,7241
202102,45111,전라북도,전주시 완산구,5-9세,14761,7544,7217
202103,45111,전라북도,전주시 완산구,5-9세,14732,7522,7210
202104,45111,전라북도,전주시 완산구,5-9세,14722,7512,7210
202105,45111,전라북도,전주시 완산구,5-9세,14666,7495,7171
202106,45111,전라북도,전주시 완산구,5-9세,14627,7495,7132
202007,45111,전라북도,전주시 완산구,10-14세,16249,8486,7763
202008,45111,전라북도,전주시 완산구,10-14세,16307,8523,7784
202009,45111,전라북도,전주시 완산구,10-14세,16319,8528,7791
202010,45111,전라북도,전주시 완산구,10-14세,16404,8554,7850
202011,45111,전라북도,전주시 완산구,10-14세,16440,8546,7894
202012,45111,전라북도,전주시 완산구,10-14세,16445,8541,7904
202101,45111,전라북도,전주시 완산구,10-14세,16470,8552,7918
202102,45111,전라북도,전주시 완산구,10-14세,16476,8551,7925
202103,45111,전라북도,전주시 완산구,10-14세,16476,8556,7920
202104,45111,전라북도,전주시 완산구,10-14세,16467,8537,7930
202105,45111,전라북도,전주시 완산구,10-14세,16449,8521,7928
202106,45111,전라북도,전주시 완산구,10-14세,16453,8511,7942
202007,45111,전라북도,전주시 완산구,15-19세,20518,10649,9869
202008,45111,전라북도,전주시 완산구,15-19세,20330,10567,9763
202009,45111,전라북도,전주시 완산구,15-19세,20230,10524,9706
202010,45111,전라북도,전주시 완산구,15-19세,20068,10442,9626
202011,45111,전라북도,전주시 완산구,15-19세,19952,10407,9545
202012,45111,전라북도,전주시 완산구,15-19세,19747,10306,9441
202101,45111,전라북도,전주시 완산구,15-19세,19586,10213,9373
202102,45111,전라북도,전주시 완산구,15-19세,19486,10156,9330
202103,45111,전라북도,전주시 완산구,15-19세,19249,10068,9181
202104,45111,전라북도,전주시 완산구,15-19세,19063,9977,9086
202105,45111,전라북도,전주시 완산구,15-19세,18960,9932,9028
202106,45111,전라북도,전주시 완산구,15-19세,18875,9884,8991
202007,45111,전라북도,전주시 완산구,20-24세,26016,13517,12499
202008,45111,전라북도,전주시 완산구,20-24세,25991,13498,12493
202009,45111,전라북도,전주시 완산구,20-24세,25977,13449,12528
202010,45111,전라북도,전주시 완산구,20-24세,25973,13439,12534
202011,45111,전라북도,전주시 완산구,20-24세,25981,13420,12561
202012,45111,전라북도,전주시 완산구,20-24세,25913,13372,12541
202101,45111,전라북도,전주시 완산구,20-24세,25879,13339,12540
202102,45111,전라북도,전주시 완산구,20-24세,25774,13275,12499
202103,45111,전라북도,전주시 완산구,20-24세,25602,13175,12427
202104,45111,전라북도,전주시 완산구,20-24세,25488,13115,12373
202105,45111,전라북도,전주시 완산구,20-24세,25403,13074,12329
202106,45111,전라북도,전주시 완산구,20-24세,25383,13053,12330
202007,45111,전라북도,전주시 완산구,25-29세,23224,12064,11160
202008,45111,전라북도,전주시 완산구,25-29세,23360,12146,11214
202009,45111,전라북도,전주시 완산구,25-29세,23417,12189,11228
202010,45111,전라북도,전주시 완산구,25-29세,23458,12243,11215
202011,45111,전라북도,전주시 완산구,25-29세,23514,12240,11274
202012,45111,전라북도,전주시 완산구,25-29세,23591,12248,11343
202101,45111,전라북도,전주시 완산구,25-29세,23595,12248,11347
202102,45111,전라북도,전주시 완산구,25-29세,23527,12180,11347
202103,45111,전라북도,전주시 완산구,25-29세,23638,12264,11374
202104,45111,전라북도,전주시 완산구,25-29세,23699,12314,11385
202105,45111,전라북도,전주시 완산구,25-29세,23763,12343,11420
202106,45111,전라북도,전주시 완산구,25-29세,23872,12426,11446
202007,45111,전라북도,전주시 완산구,30-34세,18425,9435,8990
202008,45111,전라북도,전주시 완산구,30-34세,18472,9459,9013
202009,45111,전라북도,전주시 완산구,30-34세,18498,9486,9012
202010,45111,전라북도,전주시 완산구,30-34세,18512,9484,9028
202011,45111,전라북도,전주시 완산구,30-34세,18556,9507,9049
202012,45111,전라북도,전주시 완산구,30-34세,18473,9479,8994
202101,45111,전라북도,전주시 완산구,30-34세,18497,9498,8999
202102,45111,전라북도,전주시 완산구,30-34세,18484,9495,8989
202103,45111,전라북도,전주시 완산구,30-34세,18535,9537,8998
202104,45111,전라북도,전주시 완산구,30-34세,18649,9626,9023
202105,45111,전라북도,전주시 완산구,30-34세,18710,9669,9041
202106,45111,전라북도,전주시 완산구,30-34세,18761,9687,9074
202007,45111,전라북도,전주시 완산구,35-39세,21815,10933,10882
202008,45111,전라북도,전주시 완산구,35-39세,21764,10897,10867
202009,45111,전라북도,전주시 완산구,35-39세,21674,10848,10826
202010,45111,전라북도,전주시 완산구,35-39세,21565,10793,10772
202011,45111,전라북도,전주시 완산구,35-39세,21533,10818,10715
202012,45111,전라북도,전주시 완산구,35-39세,21520,10790,10730
202101,45111,전라북도,전주시 완산구,35-39세,21386,10737,10649
202102,45111,전라북도,전주시 완산구,35-39세,21252,10662,10590
202103,45111,전라북도,전주시 완산구,35-39세,21068,10562,10506
202104,45111,전라북도,전주시 완산구,35-39세,20940,10462,10478
202105,45111,전라북도,전주시 완산구,35-39세,20803,10386,10417
202106,45111,전라북도,전주시 완산구,35-39세,20758,10355,10403
202007,45111,전라북도,전주시 완산구,40-44세,23831,11447,12384
202008,45111,전라북도,전주시 완산구,40-44세,23889,11487,12402
202009,45111,전라북도,전주시 완산구,40-44세,23998,11530,12468
202010,45111,전라북도,전주시 완산구,40-44세,23986,11525,12461
202011,45111,전라북도,전주시 완산구,40-44세,23962,11511,12451
202012,45111,전라북도,전주시 완산구,40-44세,23848,11481,12367
202101,45111,전라북도,전주시 완산구,40-44세,23757,11448,12309
202102,45111,전라북도,전주시 완산구,40-44세,23838,11530,12308
202103,45111,전라북도,전주시 완산구,40-44세,23704,11474,12230
202104,45111,전라북도,전주시 완산구,40-44세,23659,11477,12182
202105,45111,전라북도,전주시 완산구,40-44세,23690,11526,12164
202106,45111,전라북도,전주시 완산구,40-44세,23770,11584,12186
202007,45111,전라북도,전주시 완산구,45-49세,30250,14418,15832
202008,45111,전라북도,전주시 완산구,45-49세,30131,14335,15796
202009,45111,전라북도,전주시 완산구,45-49세,30022,14298,15724
202010,45111,전라북도,전주시 완산구,45-49세,29832,14186,15646
202011,45111,전라북도,전주시 완산구,45-49세,29737,14152,15585
202012,45111,전라북도,전주시 완산구,45-49세,29623,14071,15552
202101,45111,전라북도,전주시 완산구,45-49세,29473,13974,15499
202102,45111,전라북도,전주시 완산구,45-49세,29387,13939,15448
202103,45111,전라북도,전주시 완산구,45-49세,29214,13843,15371
202104,45111,전라북도,전주시 완산구,45-49세,29093,13770,15323
202105,45111,전라북도,전주시 완산구,45-49세,28809,13628,15181
202106,45111,전라북도,전주시 완산구,45-49세,28633,13533,15100
202007,45111,전라북도,전주시 완산구,50-54세,29686,14345,15341
202008,45111,전라북도,전주시 완산구,50-54세,29755,14407,15348
202009,45111,전라북도,전주시 완산구,50-54세,29731,14389,15342
202010,45111,전라북도,전주시 완산구,50-54세,29795,14455,15340
202011,45111,전라북도,전주시 완산구,50-54세,29831,14456,15375
202012,45111,전라북도,전주시 완산구,50-54세,29782,14461,15321
202101,45111,전라북도,전주시 완산구,50-54세,29944,14529,15415
202102,45111,전라북도,전주시 완산구,50-54세,30032,14553,15479
202103,45111,전라북도,전주시 완산구,50-54세,29901,14483,15418
202104,45111,전라북도,전주시 완산구,50-54세,29932,14513,15419
202105,45111,전라북도,전주시 완산구,50-54세,30144,14632,15512
202106,45111,전라북도,전주시 완산구,50-54세,30232,14670,15562
202007,45111,전라북도,전주시 완산구,55-59세,27309,13103,14206
202008,45111,전라북도,전주시 완산구,55-59세,27293,13072,14221
202009,45111,전라북도,전주시 완산구,55-59세,27359,13129,14230
202010,45111,전라북도,전주시 완산구,55-59세,27322,13110,14212
202011,45111,전라북도,전주시 완산구,55-59세,27243,13090,14153
202012,45111,전라북도,전주시 완산구,55-59세,27268,13075,14193
202101,45111,전라북도,전주시 완산구,55-59세,27192,13054,14138
202102,45111,전라북도,전주시 완산구,55-59세,27190,13080,14110
202103,45111,전라북도,전주시 완산구,55-59세,27169,13096,14073
202104,45111,전라북도,전주시 완산구,55-59세,27116,13039,14077
202105,45111,전라북도,전주시 완산구,55-59세,26972,12995,13977
202106,45111,전라북도,전주시 완산구,55-59세,26824,12939,13885
202007,45111,전라북도,전주시 완산구,60-64세,24061,11392,12669
202008,45111,전라북도,전주시 완산구,60-64세,24217,11473,12744
202009,45111,전라북도,전주시 완산구,60-64세,24352,11525,12827
202010,45111,전라북도,전주시 완산구,60-64세,24460,11549,12911
202011,45111,전라북도,전주시 완산구,60-64세,24619,11595,13024
202012,45111,전라북도,전주시 완산구,60-64세,24755,11674,13081
202101,45111,전라북도,전주시 완산구,60-64세,24901,11723,13178
202102,45111,전라북도,전주시 완산구,60-64세,25006,11745,13261
202103,45111,전라북도,전주시 완산구,60-64세,25050,11769,13281
202104,45111,전라북도,전주시 완산구,60-64세,25156,11825,13331
202105,45111,전라북도,전주시 완산구,60-64세,25338,11882,13456
202106,45111,전라북도,전주시 완산구,60-64세,25534,11960,13574
202007,45111,전라북도,전주시 완산구,65-69세,17112,8086,9026
202008,45111,전라북도,전주시 완산구,65-69세,17234,8144,9090
202009,45111,전라북도,전주시 완산구,65-69세,17362,8190,9172
202010,45111,전라북도,전주시 완산구,65-69세,17489,8248,9241
202011,45111,전라북도,전주시 완산구,65-69세,17608,8322,9286
202012,45111,전라북도,전주시 완산구,65-69세,17652,8334,9318
202101,45111,전라북도,전주시 완산구,65-69세,17754,8417,9337
202102,45111,전라북도,전주시 완산구,65-69세,17810,8450,9360
202103,45111,전라북도,전주시 완산구,65-69세,17938,8515,9423
202104,45111,전라북도,전주시 완산구,65-69세,17979,8518,9461
202105,45111,전라북도,전주시 완산구,65-69세,18059,8562,9497
202106,45111,전라북도,전주시 완산구,65-69세,18147,8616,9531
202007,45111,전라북도,전주시 완산구,70-74세,13625,6263,7362
202008,45111,전라북도,전주시 완산구,70-74세,13676,6298,7378
202009,45111,전라북도,전주시 완산구,70-74세,13757,6349,7408
202010,45111,전라북도,전주시 완산구,70-74세,13868,6411,7457
202011,45111,전라북도,전주시 완산구,70-74세,13953,6432,7521
202012,45111,전라북도,전주시 완산구,70-74세,14091,6502,7589
202101,45111,전라북도,전주시 완산구,70-74세,14210,6555,7655
202102,45111,전라북도,전주시 완산구,70-74세,14287,6596,7691
202103,45111,전라북도,전주시 완산구,70-74세,14309,6594,7715
202104,45111,전라북도,전주시 완산구,70-74세,14297,6594,7703
202105,45111,전라북도,전주시 완산구,70-74세,14307,6574,7733
202106,45111,전라북도,전주시 완산구,70-74세,14318,6571,7747
202007,45111,전라북도,전주시 완산구,75-79세,9864,4191,5673
202008,45111,전라북도,전주시 완산구,75-79세,9902,4201,5701
202009,45111,전라북도,전주시 완산구,75-79세,9937,4203,5734
202010,45111,전라북도,전주시 완산구,75-79세,9922,4181,5741
202011,45111,전라북도,전주시 완산구,75-79세,9877,4184,5693
202012,45111,전라북도,전주시 완산구,75-79세,9845,4166,5679
202101,45111,전라북도,전주시 완산구,75-79세,9839,4162,5677
202102,45111,전라북도,전주시 완산구,75-79세,9829,4155,5674
202103,45111,전라북도,전주시 완산구,75-79세,9799,4148,5651
202104,45111,전라북도,전주시 완산구,75-79세,9803,4159,5644
202105,45111,전라북도,전주시 완산구,75-79세,9846,4199,5647
202106,45111,전라북도,전주시 완산구,75-79세,9862,4211,5651
202007,45111,전라북도,전주시 완산구,80-84세,6835,2556,4279
202008,45111,전라북도,전주시 완산구,80-84세,6832,2559,4273
202009,45111,전라북도,전주시 완산구,80-84세,6808,2567,4241
202010,45111,전라북도,전주시 완산구,80-84세,6820,2580,4240
202011,45111,전라북도,전주시 완산구,80-84세,6837,2585,4252
202012,45111,전라북도,전주시 완산구,80-84세,6868,2607,4261
202101,45111,전라북도,전주시 완산구,80-84세,6852,2608,4244
202102,45111,전라북도,전주시 완산구,80-84세,6883,2637,4246
202103,45111,전라북도,전주시 완산구,80-84세,6884,2640,4244
202104,45111,전라북도,전주시 완산구,80-84세,6909,2654,4255
202105,45111,전라북도,전주시 완산구,80-84세,6914,2664,4250
202106,45111,전라북도,전주시 완산구,80-84세,6969,2694,4275
202007,45111,전라북도,전주시 완산구,85-89세,3644,1112,2532
202008,45111,전라북도,전주시 완산구,85-89세,3676,1130,2546
202009,45111,전라북도,전주시 완산구,85-89세,3710,1137,2573
202010,45111,전라북도,전주시 완산구,85-89세,3740,1149,2591
202011,45111,전라북도,전주시 완산구,85-89세,3770,1154,2616
202012,45111,전라북도,전주시 완산구,85-89세,3784,1153,2631
202101,45111,전라북도,전주시 완산구,85-89세,3830,1169,2661
202102,45111,전라북도,전주시 완산구,85-89세,3844,1160,2684
202103,45111,전라북도,전주시 완산구,85-89세,3869,1171,2698
202104,45111,전라북도,전주시 완산구,85-89세,3885,1180,2705
202105,45111,전라북도,전주시 완산구,85-89세,3904,1192,2712
202106,45111,전라북도,전주시 완산구,85-89세,3924,1205,2719
202007,45111,전라북도,전주시 완산구,90-94세,1272,304,968
202008,45111,전라북도,전주시 완산구,90-94세,1297,305,992
202009,45111,전라북도,전주시 완산구,90-94세,1313,310,1003
202010,45111,전라북도,전주시 완산구,90-94세,1316,308,1008
202011,45111,전라북도,전주시 완산구,90-94세,1310,310,1000
202012,45111,전라북도,전주시 완산구,90-94세,1319,312,1007
202101,45111,전라북도,전주시 완산구,90-94세,1321,309,1012
202102,45111,전라북도,전주시 완산구,90-94세,1342,321,1021
202103,45111,전라북도,전주시 완산구,90-94세,1357,326,1031
202104,45111,전라북도,전주시 완산구,90-94세,1367,326,1041
202105,45111,전라북도,전주시 완산구,90-94세,1375,326,1049
202106,45111,전라북도,전주시 완산구,90-94세,1390,331,1059
202007,45111,전라북도,전주시 완산구,95-99세,267,43,224
202008,45111,전라북도,전주시 완산구,95-99세,266,41,225
202009,45111,전라북도,전주시 완산구,95-99세,272,44,228
202010,45111,전라북도,전주시 완산구,95-99세,271,44,227
202011,45111,전라북도,전주시 완산구,95-99세,266,41,225
202012,45111,전라북도,전주시 완산구,95-99세,266,39,227
202101,45111,전라북도,전주시 완산구,95-99세,268,37,231
202102,45111,전라북도,전주시 완산구,95-99세,261,36,225
202103,45111,전라북도,전주시 완산구,95-99세,257,36,221
202104,45111,전라북도,전주시 완산구,95-99세,259,38,221
202105,45111,전라북도,전주시 완산구,95-99세,263,40,223
202106,45111,전라북도,전주시 완산구,95-99세,266,41,225
202007,45111,전라북도,전주시 완산구,100+,83,16,67
202008,45111,전라북도,전주시 완산구,100+,82,16,66
202009,45111,전라북도,전주시 완산구,100+,83,16,67
202010,45111,전라북도,전주시 완산구,100+,83,16,67
202011,45111,전라북도,전주시 완산구,100+,82,17,65
202012,45111,전라북도,전주시 완산구,100+,82,17,65
202101,45111,전라북도,전주시 완산구,100+,79,16,63
202102,45111,전라북도,전주시 완산구,100+,80,16,64
202103,45111,전라북도,전주시 완산구,100+,53,10,43
202104,45111,전라북도,전주시 완산구,100+,56,10,46
202105,45111,전라북도,전주시 완산구,100+,56,10,46
202106,45111,전라북도,전주시 완산구,100+,57,10,47
202007,45113,전라북도,전주시 덕진구,0-4세,12247,6292,5955
202008,45113,전라북도,전주시 덕진구,0-4세,12071,6207,5864
202009,45113,전라북도,전주시 덕진구,0-4세,11971,6139,5832
202010,45113,전라북도,전주시 덕진구,0-4세,11900,6106,5794
202011,45113,전라북도,전주시 덕진구,0-4세,11864,6077,5787
202012,45113,전라북도,전주시 덕진구,0-4세,11805,6035,5770
202101,45113,전라북도,전주시 덕진구,0-4세,11654,5954,5700
202102,45113,전라북도,전주시 덕진구,0-4세,11603,5914,5689
202103,45113,전라북도,전주시 덕진구,0-4세,11505,5868,5637
202104,45113,전라북도,전주시 덕진구,0-4세,11440,5829,5611
202105,45113,전라북도,전주시 덕진구,0-4세,11359,5780,5579
202106,45113,전라북도,전주시 덕진구,0-4세,11308,5752,5556
202007,45113,전라북도,전주시 덕진구,5-9세,17547,8916,8631
202008,45113,전라북도,전주시 덕진구,5-9세,17545,8927,8618
202009,45113,전라북도,전주시 덕진구,5-9세,17554,8954,8600
202010,45113,전라북도,전주시 덕진구,5-9세,17583,8970,8613
202011,45113,전라북도,전주시 덕진구,5-9세,17554,8951,8603
202012,45113,전라북도,전주시 덕진구,5-9세,17566,8963,8603
202101,45113,전라북도,전주시 덕진구,5-9세,17581,8984,8597
202102,45113,전라북도,전주시 덕진구,5-9세,17592,8997,8595
202103,45113,전라북도,전주시 덕진구,5-9세,17575,8967,8608
202104,45113,전라북도,전주시 덕진구,5-9세,17488,8922,8566
202105,45113,전라북도,전주시 덕진구,5-9세,17455,8925,8530
202106,45113,전라북도,전주시 덕진구,5-9세,17409,8887,8522
202007,45113,전라북도,전주시 덕진구,10-14세,17426,9034,8392
202008,45113,전라북도,전주시 덕진구,10-14세,17481,9045,8436
202009,45113,전라북도,전주시 덕진구,10-14세,17571,9105,8466
202010,45113,전라북도,전주시 덕진구,10-14세,17647,9129,8518
202011,45113,전라북도,전주시 덕진구,10-14세,17684,9139,8545
202012,45113,전라북도,전주시 덕진구,10-14세,17742,9156,8586
202101,45113,전라북도,전주시 덕진구,10-14세,17838,9193,8645
202102,45113,전라북도,전주시 덕진구,10-14세,17897,9217,8680
202103,45113,전라북도,전주시 덕진구,10-14세,17927,9238,8689
202104,45113,전라북도,전주시 덕진구,10-14세,18015,9272,8743
202105,45113,전라북도,전주시 덕진구,10-14세,18034,9259,8775
202106,45113,전라북도,전주시 덕진구,10-14세,18042,9287,8755
202007,45113,전라북도,전주시 덕진구,15-19세,18318,9370,8948
202008,45113,전라북도,전주시 덕진구,15-19세,18238,9323,8915
202009,45113,전라북도,전주시 덕진구,15-19세,18124,9241,8883
202010,45113,전라북도,전주시 덕진구,15-19세,18018,9201,8817
202011,45113,전라북도,전주시 덕진구,15-19세,17946,9173,8773
202012,45113,전라북도,전주시 덕진구,15-19세,17802,9105,8697
202101,45113,전라북도,전주시 덕진구,15-19세,17733,9093,8640
202102,45113,전라북도,전주시 덕진구,15-19세,17660,9067,8593
202103,45113,전라북도,전주시 덕진구,15-19세,17556,9025,8531
202104,45113,전라북도,전주시 덕진구,15-19세,17381,8908,8473
202105,45113,전라북도,전주시 덕진구,15-19세,17295,8882,8413
202106,45113,전라북도,전주시 덕진구,15-19세,17282,8848,8434
202007,45113,전라북도,전주시 덕진구,20-24세,22569,11976,10593
202008,45113,전라북도,전주시 덕진구,20-24세,22530,11941,10589
202009,45113,전라북도,전주시 덕진구,20-24세,22481,11944,10537
202010,45113,전라북도,전주시 덕진구,20-24세,22505,11948,10557
202011,45113,전라북도,전주시 덕진구,20-24세,22503,11928,10575
202012,45113,전라북도,전주시 덕진구,20-24세,22431,11873,10558
202101,45113,전라북도,전주시 덕진구,20-24세,22440,11862,10578
202102,45113,전라북도,전주시 덕진구,20-24세,22433,11855,10578
202103,45113,전라북도,전주시 덕진구,20-24세,22382,11811,10571
202104,45113,전라북도,전주시 덕진구,20-24세,22369,11802,10567
202105,45113,전라북도,전주시 덕진구,20-24세,22407,11791,10616
202106,45113,전라북도,전주시 덕진구,20-24세,22416,11805,10611
202007,45113,전라북도,전주시 덕진구,25-29세,20607,10993,9614
202008,45113,전라북도,전주시 덕진구,25-29세,20679,11034,9645
202009,45113,전라북도,전주시 덕진구,25-29세,20775,11081,9694
202010,45113,전라북도,전주시 덕진구,25-29세,20851,11149,9702
202011,45113,전라북도,전주시 덕진구,25-29세,20979,11228,9751
202012,45113,전라북도,전주시 덕진구,25-29세,21036,11276,9760
202101,45113,전라북도,전주시 덕진구,25-29세,21058,11294,9764
202102,45113,전라북도,전주시 덕진구,25-29세,21091,11322,9769
202103,45113,전라북도,전주시 덕진구,25-29세,21228,11440,9788
202104,45113,전라북도,전주시 덕진구,25-29세,21277,11452,9825
202105,45113,전라북도,전주시 덕진구,25-29세,21399,11537,9862
202106,45113,전라북도,전주시 덕진구,25-29세,21492,11564,9928
202007,45113,전라북도,전주시 덕진구,30-34세,18482,9424,9058
202008,45113,전라북도,전주시 덕진구,30-34세,18422,9414,9008
202009,45113,전라북도,전주시 덕진구,30-34세,18532,9484,9048
202010,45113,전라북도,전주시 덕진구,30-34세,18542,9481,9061
202011,45113,전라북도,전주시 덕진구,30-34세,18505,9466,9039
202012,45113,전라북도,전주시 덕진구,30-34세,18420,9423,8997
202101,45113,전라북도,전주시 덕진구,30-34세,18467,9449,9018
202102,45113,전라북도,전주시 덕진구,30-34세,18472,9455,9017
202103,45113,전라북도,전주시 덕진구,30-34세,18506,9474,9032
202104,45113,전라북도,전주시 덕진구,30-34세,18577,9523,9054
202105,45113,전라북도,전주시 덕진구,30-34세,18728,9583,9145
202106,45113,전라북도,전주시 덕진구,30-34세,18765,9591,9174
202007,45113,전라북도,전주시 덕진구,35-39세,23625,11730,11895
202008,45113,전라북도,전주시 덕진구,35-39세,23568,11732,11836
202009,45113,전라북도,전주시 덕진구,35-39세,23482,11677,11805
202010,45113,전라북도,전주시 덕진구,35-39세,23457,11696,11761
202011,45113,전라북도,전주시 덕진구,35-39세,23467,11685,11782
202012,45113,전라북도,전주시 덕진구,35-39세,23497,11682,11815
202101,45113,전라북도,전주시 덕진구,35-39세,23524,11689,11835
202102,45113,전라북도,전주시 덕진구,35-39세,23527,11719,11808
202103,45113,전라북도,전주시 덕진구,35-39세,23429,11678,11751
202104,45113,전라북도,전주시 덕진구,35-39세,23301,11613,11688
202105,45113,전라북도,전주시 덕진구,35-39세,23201,11572,11629
202106,45113,전라북도,전주시 덕진구,35-39세,23160,11587,11573
202007,45113,전라북도,전주시 덕진구,40-44세,25564,12715,12849
202008,45113,전라북도,전주시 덕진구,40-44세,25554,12683,12871
202009,45113,전라북도,전주시 덕진구,40-44세,25653,12719,12934
202010,45113,전라북도,전주시 덕진구,40-44세,25784,12786,12998
202011,45113,전라북도,전주시 덕진구,40-44세,25880,12815,13065
202012,45113,전라북도,전주시 덕진구,40-44세,25798,12793,13005
202101,45113,전라북도,전주시 덕진구,40-44세,25730,12770,12960
202102,45113,전라북도,전주시 덕진구,40-44세,25825,12812,13013
202103,45113,전라북도,전주시 덕진구,40-44세,25809,12808,13001
202104,45113,전라북도,전주시 덕진구,40-44세,25858,12799,13059
202105,45113,전라북도,전주시 덕진구,40-44세,25852,12814,13038
202106,45113,전라북도,전주시 덕진구,40-44세,25945,12868,13077
202007,45113,전라북도,전주시 덕진구,45-49세,28044,14199,13845
202008,45113,전라북도,전주시 덕진구,45-49세,28023,14194,13829
202009,45113,전라북도,전주시 덕진구,45-49세,27927,14171,13756
202010,45113,전라북도,전주시 덕진구,45-49세,27897,14161,13736
202011,45113,전라북도,전주시 덕진구,45-49세,27862,14144,13718
202012,45113,전라북도,전주시 덕진구,45-49세,27848,14130,13718
202101,45113,전라북도,전주시 덕진구,45-49세,27902,14139,13763
202102,45113,전라북도,전주시 덕진구,45-49세,27908,14100,13808
202103,45113,전라북도,전주시 덕진구,45-49세,27857,14068,13789
202104,45113,전라북도,전주시 덕진구,45-49세,27849,14081,13768
202105,45113,전라북도,전주시 덕진구,45-49세,27668,13949,13719
202106,45113,전라북도,전주시 덕진구,45-49세,27516,13852,13664
202007,45113,전라북도,전주시 덕진구,50-54세,25859,12987,12872
202008,45113,전라북도,전주시 덕진구,50-54세,25888,13016,12872
202009,45113,전라북도,전주시 덕진구,50-54세,25973,13037,12936
202010,45113,전라북도,전주시 덕진구,50-54세,26078,13091,12987
202011,45113,전라북도,전주시 덕진구,50-54세,26112,13116,12996
202012,45113,전라북도,전주시 덕진구,50-54세,26100,13108,12992
202101,45113,전라북도,전주시 덕진구,50-54세,26308,13214,13094
202102,45113,전라북도,전주시 덕진구,50-54세,26422,13317,13105
202103,45113,전라북도,전주시 덕진구,50-54세,26363,13300,13063
202104,45113,전라북도,전주시 덕진구,50-54세,26403,13302,13101
202105,45113,전라북도,전주시 덕진구,50-54세,26663,13440,13223
202106,45113,전라북도,전주시 덕진구,50-54세,26808,13531,13277
202007,45113,전라북도,전주시 덕진구,55-59세,22905,11477,11428
202008,45113,전라북도,전주시 덕진구,55-59세,22801,11381,11420
202009,45113,전라북도,전주시 덕진구,55-59세,22736,11347,11389
202010,45113,전라북도,전주시 덕진구,55-59세,22758,11338,11420
202011,45113,전라북도,전주시 덕진구,55-59세,22786,11342,11444
202012,45113,전라북도,전주시 덕진구,55-59세,22847,11376,11471
202101,45113,전라북도,전주시 덕진구,55-59세,22766,11329,11437
202102,45113,전라북도,전주시 덕진구,55-59세,22775,11330,11445
202103,45113,전라북도,전주시 덕진구,55-59세,22858,11373,11485
202104,45113,전라북도,전주시 덕진구,55-59세,22773,11335,11438
202105,45113,전라북도,전주시 덕진구,55-59세,22721,11312,11409
202106,45113,전라북도,전주시 덕진구,55-59세,22640,11272,11368
202007,45113,전라북도,전주시 덕진구,60-64세,19578,9545,10033
202008,45113,전라북도,전주시 덕진구,60-64세,19769,9667,10102
202009,45113,전라북도,전주시 덕진구,60-64세,19848,9719,10129
202010,45113,전라북도,전주시 덕진구,60-64세,19966,9791,10175
202011,45113,전라북도,전주시 덕진구,60-64세,20081,9840,10241
202012,45113,전라북도,전주시 덕진구,60-64세,20167,9868,10299
202101,45113,전라북도,전주시 덕진구,60-64세,20347,9950,10397
202102,45113,전라북도,전주시 덕진구,60-64세,20514,10028,10486
202103,45113,전라북도,전주시 덕진구,60-64세,20595,10046,10549
202104,45113,전라북도,전주시 덕진구,60-64세,20750,10133,10617
202105,45113,전라북도,전주시 덕진구,60-64세,20875,10193,10682
202106,45113,전라북도,전주시 덕진구,60-64세,21004,10233,10771
202007,45113,전라북도,전주시 덕진구,65-69세,13884,6606,7278
202008,45113,전라북도,전주시 덕진구,65-69세,13954,6632,7322
202009,45113,전라북도,전주시 덕진구,65-69세,14055,6679,7376
202010,45113,전라북도,전주시 덕진구,65-69세,14153,6720,7433
202011,45113,전라북도,전주시 덕진구,65-69세,14233,6754,7479
202012,45113,전라북도,전주시 덕진구,65-69세,14279,6787,7492
202101,45113,전라북도,전주시 덕진구,65-69세,14367,6836,7531
202102,45113,전라북도,전주시 덕진구,65-69세,14405,6858,7547
202103,45113,전라북도,전주시 덕진구,65-69세,14551,6937,7614
202104,45113,전라북도,전주시 덕진구,65-69세,14595,6935,7660
202105,45113,전라북도,전주시 덕진구,65-69세,14661,6944,7717
202106,45113,전라북도,전주시 덕진구,65-69세,14767,7011,7756
202007,45113,전라북도,전주시 덕진구,70-74세,11350,5127,6223
202008,45113,전라북도,전주시 덕진구,70-74세,11392,5153,6239
202009,45113,전라북도,전주시 덕진구,70-74세,11473,5184,6289
202010,45113,전라북도,전주시 덕진구,70-74세,11548,5216,6332
202011,45113,전라북도,전주시 덕진구,70-74세,11634,5259,6375
202012,45113,전라북도,전주시 덕진구,70-74세,11679,5270,6409
202101,45113,전라북도,전주시 덕진구,70-74세,11779,5311,6468
202102,45113,전라북도,전주시 덕진구,70-74세,11838,5337,6501
202103,45113,전라북도,전주시 덕진구,70-74세,11804,5346,6458
202104,45113,전라북도,전주시 덕진구,70-74세,11846,5362,6484
202105,45113,전라북도,전주시 덕진구,70-74세,11863,5382,6481
202106,45113,전라북도,전주시 덕진구,70-74세,11841,5362,6479
202007,45113,전라북도,전주시 덕진구,75-79세,8534,3687,4847
202008,45113,전라북도,전주시 덕진구,75-79세,8548,3699,4849
202009,45113,전라북도,전주시 덕진구,75-79세,8508,3693,4815
202010,45113,전라북도,전주시 덕진구,75-79세,8492,3671,4821
202011,45113,전라북도,전주시 덕진구,75-79세,8517,3690,4827
202012,45113,전라북도,전주시 덕진구,75-79세,8483,3673,4810
202101,45113,전라북도,전주시 덕진구,75-79세,8482,3675,4807
202102,45113,전라북도,전주시 덕진구,75-79세,8449,3653,4796
202103,45113,전라북도,전주시 덕진구,75-79세,8403,3630,4773
202104,45113,전라북도,전주시 덕진구,75-79세,8411,3628,4783
202105,45113,전라북도,전주시 덕진구,75-79세,8449,3665,4784
202106,45113,전라북도,전주시 덕진구,75-79세,8502,3693,4809
202007,45113,전라북도,전주시 덕진구,80-84세,5864,2299,3565
202008,45113,전라북도,전주시 덕진구,80-84세,5891,2317,3574
202009,45113,전라북도,전주시 덕진구,80-84세,5899,2313,3586
202010,45113,전라북도,전주시 덕진구,80-84세,5934,2336,3598
202011,45113,전라북도,전주시 덕진구,80-84세,5940,2328,3612
202012,45113,전라북도,전주시 덕진구,80-84세,5938,2316,3622
202101,45113,전라북도,전주시 덕진구,80-84세,5953,2324,3629
202102,45113,전라북도,전주시 덕진구,80-84세,6007,2355,3652
202103,45113,전라북도,전주시 덕진구,80-84세,6023,2356,3667
202104,45113,전라북도,전주시 덕진구,80-84세,6047,2365,3682
202105,45113,전라북도,전주시 덕진구,80-84세,6067,2364,3703
202106,45113,전라북도,전주시 덕진구,80-84세,6117,2398,3719
202007,45113,전라북도,전주시 덕진구,85-89세,2835,905,1930
202008,45113,전라북도,전주시 덕진구,85-89세,2857,909,1948
202009,45113,전라북도,전주시 덕진구,85-89세,2909,941,1968
202010,45113,전라북도,전주시 덕진구,85-89세,2932,948,1984
202011,45113,전라북도,전주시 덕진구,85-89세,2951,968,1983
202012,45113,전라북도,전주시 덕진구,85-89세,3003,1000,2003
202101,45113,전라북도,전주시 덕진구,85-89세,3036,1010,2026
202102,45113,전라북도,전주시 덕진구,85-89세,3046,1010,2036
202103,45113,전라북도,전주시 덕진구,85-89세,3092,1024,2068
202104,45113,전라북도,전주시 덕진구,85-89세,3118,1039,2079
202105,45113,전라북도,전주시 덕진구,85-89세,3151,1050,2101
202106,45113,전라북도,전주시 덕진구,85-89세,3180,1051,2129
202007,45113,전라북도,전주시 덕진구,90-94세,952,225,727
202008,45113,전라북도,전주시 덕진구,90-94세,960,234,726
202009,45113,전라북도,전주시 덕진구,90-94세,958,234,724
202010,45113,전라북도,전주시 덕진구,90-94세,975,238,737
202011,45113,전라북도,전주시 덕진구,90-94세,986,244,742
202012,45113,전라북도,전주시 덕진구,90-94세,990,241,749
202101,45113,전라북도,전주시 덕진구,90-94세,1004,245,759
202102,45113,전라북도,전주시 덕진구,90-94세,1022,247,775
202103,45113,전라북도,전주시 덕진구,90-94세,1014,247,767
202104,45113,전라북도,전주시 덕진구,90-94세,1020,250,770
202105,45113,전라북도,전주시 덕진구,90-94세,1039,252,787
202106,45113,전라북도,전주시 덕진구,90-94세,1047,257,790
202007,45113,전라북도,전주시 덕진구,95-99세,197,39,158
202008,45113,전라북도,전주시 덕진구,95-99세,202,39,163
202009,45113,전라북도,전주시 덕진구,95-99세,203,39,164
202010,45113,전라북도,전주시 덕진구,95-99세,208,39,169
202011,45113,전라북도,전주시 덕진구,95-99세,207,38,169
202012,45113,전라북도,전주시 덕진구,95-99세,204,40,164
202101,45113,전라북도,전주시 덕진구,95-99세,207,42,165
202102,45113,전라북도,전주시 덕진구,95-99세,206,42,164
202103,45113,전라북도,전주시 덕진구,95-99세,190,33,157
202104,45113,전라북도,전주시 덕진구,95-99세,192,33,159
202105,45113,전라북도,전주시 덕진구,95-99세,189,35,154
202106,45113,전라북도,전주시 덕진구,95-99세,183,34,149
202007,45113,전라북도,전주시 덕진구,100+,80,14,66
202008,45113,전라북도,전주시 덕진구,100+,81,14,67
202009,45113,전라북도,전주시 덕진구,100+,81,15,66
202010,45113,전라북도,전주시 덕진구,100+,80,15,65
202011,45113,전라북도,전주시 덕진구,100+,81,15,66
202012,45113,전라북도,전주시 덕진구,100+,79,14,65
202101,45113,전라북도,전주시 덕진구,100+,79,14,65
202102,45113,전라북도,전주시 덕진구,100+,79,14,65
202103,45113,전라북도,전주시 덕진구,100+,34,5,29
202104,45113,전라북도,전주시 덕진구,100+,35,5,30
202105,45113,전라북도,전주시 덕진구,100+,36,5,31
202106,45113,전라북도,전주시 덕진구,100+,36,5,31
202007,45130,전라북도,군산시,0-4세,8493,4288,4205
202008,45130,전라북도,군산시,0-4세,8425,4243,4182
202009,45130,전라북도,군산시,0-4세,8362,4193,4169
202010,45130,전라북도,군산시,0-4세,8286,4145,4141
202011,45130,전라북도,군산시,0-4세,8200,4116,4084
202012,45130,전라북도,군산시,0-4세,8147,4083,4064
202101,45130,전라북도,군산시,0-4세,8064,4037,4027
202102,45130,전라북도,군산시,0-4세,7983,4006,3977
202103,45130,전라북도,군산시,0-4세,7880,3970,3910
202104,45130,전라북도,군산시,0-4세,7842,3948,3894
202105,45130,전라북도,군산시,0-4세,7761,3909,3852
202106,45130,전라북도,군산시,0-4세,7682,3871,3811
202007,45130,전라북도,군산시,5-9세,13100,6713,6387
202008,45130,전라북도,군산시,5-9세,13025,6696,6329
202009,45130,전라북도,군산시,5-9세,12994,6686,6308
202010,45130,전라북도,군산시,5-9세,12896,6642,6254
202011,45130,전라북도,군산시,5-9세,12846,6610,6236
202012,45130,전라북도,군산시,5-9세,12804,6580,6224
202101,45130,전라북도,군산시,5-9세,12701,6514,6187
202102,45130,전라북도,군산시,5-9세,12689,6499,6190
202103,45130,전라북도,군산시,5-9세,12623,6471,6152
202104,45130,전라북도,군산시,5-9세,12564,6450,6114
202105,45130,전라북도,군산시,5-9세,12560,6447,6113
202106,45130,전라북도,군산시,5-9세,12537,6421,6116
202007,45130,전라북도,군산시,10-14세,12992,6694,6298
202008,45130,전라북도,군산시,10-14세,12992,6676,6316
202009,45130,전라북도,군산시,10-14세,13035,6703,6332
202010,45130,전라북도,군산시,10-14세,13124,6740,6384
202011,45130,전라북도,군산시,10-14세,13135,6747,6388
202012,45130,전라북도,군산시,10-14세,13139,6762,6377
202101,45130,전라북도,군산시,10-14세,13185,6794,6391
202102,45130,전라북도,군산시,10-14세,13172,6780,6392
202103,45130,전라북도,군산시,10-14세,13207,6802,6405
202104,45130,전라북도,군산시,10-14세,13216,6800,6416
202105,45130,전라북도,군산시,10-14세,13224,6799,6425
202106,45130,전라북도,군산시,10-14세,13247,6827,6420
202007,45130,전라북도,군산시,15-19세,14102,7343,6759
202008,45130,전라북도,군산시,15-19세,14068,7314,6754
202009,45130,전라북도,군산시,15-19세,13970,7251,6719
202010,45130,전라북도,군산시,15-19세,13879,7206,6673
202011,45130,전라북도,군산시,15-19세,13773,7134,6639
202012,45130,전라북도,군산시,15-19세,13691,7080,6611
202101,45130,전라북도,군산시,15-19세,13564,7029,6535
202102,45130,전라북도,군산시,15-19세,13473,6999,6474
202103,45130,전라북도,군산시,15-19세,13361,6928,6433
202104,45130,전라북도,군산시,15-19세,13285,6886,6399
202105,45130,전라북도,군산시,15-19세,13215,6841,6374
202106,45130,전라북도,군산시,15-19세,13171,6830,6341
202007,45130,전라북도,군산시,20-24세,15966,8715,7251
202008,45130,전라북도,군산시,20-24세,15913,8709,7204
202009,45130,전라북도,군산시,20-24세,15912,8734,7178
202010,45130,전라북도,군산시,20-24세,15891,8683,7208
202011,45130,전라북도,군산시,20-24세,15911,8702,7209
202012,45130,전라북도,군산시,20-24세,15894,8702,7192
202101,45130,전라북도,군산시,20-24세,15914,8722,7192
202102,45130,전라북도,군산시,20-24세,15850,8716,7134
202103,45130,전라북도,군산시,20-24세,15714,8629,7085
202104,45130,전라북도,군산시,20-24세,15660,8607,7053
202105,45130,전라북도,군산시,20-24세,15656,8596,7060
202106,45130,전라북도,군산시,20-24세,15669,8602,7067
202007,45130,전라북도,군산시,25-29세,13681,7474,6207
202008,45130,전라북도,군산시,25-29세,13655,7452,6203
202009,45130,전라북도,군산시,25-29세,13673,7475,6198
202010,45130,전라북도,군산시,25-29세,13738,7540,6198
202011,45130,전라북도,군산시,25-29세,13754,7552,6202
202012,45130,전라북도,군산시,25-29세,13827,7609,6218
202101,45130,전라북도,군산시,25-29세,13828,7593,6235
202102,45130,전라북도,군산시,25-29세,13797,7580,6217
202103,45130,전라북도,군산시,25-29세,13807,7594,6213
202104,45130,전라북도,군산시,25-29세,13819,7604,6215
202105,45130,전라북도,군산시,25-29세,13839,7626,6213
202106,45130,전라북도,군산시,25-29세,13870,7657,6213
202007,45130,전라북도,군산시,30-34세,12950,6779,6171
202008,45130,전라북도,군산시,30-34세,12884,6756,6128
202009,45130,전라북도,군산시,30-34세,12841,6740,6101
202010,45130,전라북도,군산시,30-34세,12788,6734,6054
202011,45130,전라북도,군산시,30-34세,12720,6701,6019
202012,45130,전라북도,군산시,30-34세,12669,6671,5998
202101,45130,전라북도,군산시,30-34세,12584,6601,5983
202102,45130,전라북도,군산시,30-34세,12471,6550,5921
202103,45130,전라북도,군산시,30-34세,12438,6554,5884
202104,45130,전라북도,군산시,30-34세,12454,6558,5896
202105,45130,전라북도,군산시,30-34세,12468,6564,5904
202106,45130,전라북도,군산시,30-34세,12472,6579,5893
202007,45130,전라북도,군산시,35-39세,18500,9638,8862
202008,45130,전라북도,군산시,35-39세,18374,9559,8815
202009,45130,전라북도,군산시,35-39세,18285,9498,8787
202010,45130,전라북도,군산시,35-39세,18108,9389,8719
202011,45130,전라북도,군산시,35-39세,18049,9359,8690
202012,45130,전라북도,군산시,35-39세,18036,9360,8676
202101,45130,전라북도,군산시,35-39세,17895,9314,8581
202102,45130,전라북도,군산시,35-39세,17796,9274,8522
202103,45130,전라북도,군산시,35-39세,17638,9174,8464
202104,45130,전라북도,군산시,35-39세,17508,9121,8387
202105,45130,전라북도,군산시,35-39세,17363,9033,8330
202106,45130,전라북도,군산시,35-39세,17269,8967,8302
202007,45130,전라북도,군산시,40-44세,20067,10467,9600
202008,45130,전라북도,군산시,40-44세,20017,10460,9557
202009,45130,전라북도,군산시,40-44세,20096,10495,9601
202010,45130,전라북도,군산시,40-44세,20163,10523,9640
202011,45130,전라북도,군산시,40-44세,20215,10572,9643
202012,45130,전라북도,군산시,40-44세,20117,10529,9588
202101,45130,전라북도,군산시,40-44세,20182,10559,9623
202102,45130,전라북도,군산시,40-44세,20200,10566,9634
202103,45130,전라북도,군산시,40-44세,20184,10556,9628
202104,45130,전라북도,군산시,40-44세,20216,10563,9653
202105,45130,전라북도,군산시,40-44세,20226,10582,9644
202106,45130,전라북도,군산시,40-44세,20329,10642,9687
202007,45130,전라북도,군산시,45-49세,23776,12543,11233
202008,45130,전라북도,군산시,45-49세,23741,12507,11234
202009,45130,전라북도,군산시,45-49세,23621,12456,11165
202010,45130,전라북도,군산시,45-49세,23469,12362,11107
202011,45130,전라북도,군산시,45-49세,23335,12292,11043
202012,45130,전라북도,군산시,45-49세,23316,12268,11048
202101,45130,전라북도,군산시,45-49세,23236,12247,10989
202102,45130,전라북도,군산시,45-49세,23175,12200,10975
202103,45130,전라북도,군산시,45-49세,23033,12096,10937
202104,45130,전라북도,군산시,45-49세,22994,12087,10907
202105,45130,전라북도,군산시,45-49세,22797,11969,10828
202106,45130,전라북도,군산시,45-49세,22668,11892,10776
202007,45130,전라북도,군산시,50-54세,22372,11836,10536
202008,45130,전라북도,군산시,50-54세,22409,11834,10575
202009,45130,전라북도,군산시,50-54세,22439,11833,10606
202010,45130,전라북도,군산시,50-54세,22572,11892,10680
202011,45130,전라북도,군산시,50-54세,22640,11943,10697
202012,45130,전라북도,군산시,50-54세,22618,11946,10672
202101,45130,전라북도,군산시,50-54세,22755,12004,10751
202102,45130,전라북도,군산시,50-54세,22859,12064,10795
202103,45130,전라북도,군산시,50-54세,22793,12053,10740
202104,45130,전라북도,군산시,50-54세,22861,12091,10770
202105,45130,전라북도,군산시,50-54세,22983,12165,10818
202106,45130,전라북도,군산시,50-54세,23069,12203,10866
202007,45130,전라북도,군산시,55-59세,21577,11142,10435
202008,45130,전라북도,군산시,55-59세,21525,11143,10382
202009,45130,전라북도,군산시,55-59세,21501,11173,10328
202010,45130,전라북도,군산시,55-59세,21449,11184,10265
202011,45130,전라북도,군산시,55-59세,21389,11132,10257
202012,45130,전라북도,군산시,55-59세,21346,11093,10253
202101,45130,전라북도,군산시,55-59세,21260,11050,10210
202102,45130,전라북도,군산시,55-59세,21180,11019,10161
202103,45130,전라북도,군산시,55-59세,21206,11048,10158
202104,45130,전라북도,군산시,55-59세,21199,11040,10159
202105,45130,전라북도,군산시,55-59세,21042,11017,10025
202106,45130,전라북도,군산시,55-59세,20866,10938,9928
202007,45130,전라북도,군산시,60-64세,20926,10323,10603
202008,45130,전라북도,군산시,60-64세,21027,10384,10643
202009,45130,전라북도,군산시,60-64세,21173,10440,10733
202010,45130,전라북도,군산시,60-64세,21284,10483,10801
202011,45130,전라북도,군산시,60-64세,21425,10559,10866
202012,45130,전라북도,군산시,60-64세,21555,10630,10925
202101,45130,전라북도,군산시,60-64세,21682,10700,10982
202102,45130,전라북도,군산시,60-64세,21851,10765,11086
202103,45130,전라북도,군산시,60-64세,21860,10801,11059
202104,45130,전라북도,군산시,60-64세,21862,10792,11070
202105,45130,전라북도,군산시,60-64세,21900,10820,11080
202106,45130,전라북도,군산시,60-64세,22077,10902,11175
202007,45130,전라북도,군산시,65-69세,15669,7737,7932
202008,45130,전라북도,군산시,65-69세,15749,7777,7972
202009,45130,전라북도,군산시,65-69세,15840,7822,8018
202010,45130,전라북도,군산시,65-69세,15930,7856,8074
202011,45130,전라북도,군산시,65-69세,15979,7861,8118
202012,45130,전라북도,군산시,65-69세,16042,7891,8151
202101,45130,전라북도,군산시,65-69세,16139,7924,8215
202102,45130,전라북도,군산시,65-69세,16174,7954,8220
202103,45130,전라북도,군산시,65-69세,16266,7974,8292
202104,45130,전라북도,군산시,65-69세,16350,8023,8327
202105,45130,전라북도,군산시,65-69세,16320,8040,8280
202106,45130,전라북도,군산시,65-69세,16375,8067,8308
202007,45130,전라북도,군산시,70-74세,12796,6009,6787
202008,45130,전라북도,군산시,70-74세,12835,6029,6806
202009,45130,전라북도,군산시,70-74세,12915,6086,6829
202010,45130,전라북도,군산시,70-74세,12989,6126,6863
202011,45130,전라북도,군산시,70-74세,13106,6184,6922
202012,45130,전라북도,군산시,70-74세,13216,6237,6979
202101,45130,전라북도,군산시,70-74세,13315,6292,7023
202102,45130,전라북도,군산시,70-74세,13408,6332,7076
202103,45130,전라북도,군산시,70-74세,13444,6367,7077
202104,45130,전라북도,군산시,70-74세,13449,6370,7079
202105,45130,전라북도,군산시,70-74세,13394,6334,7060
202106,45130,전라북도,군산시,70-74세,13379,6337,7042
202007,45130,전라북도,군산시,75-79세,9715,4077,5638
202008,45130,전라북도,군산시,75-79세,9718,4086,5632
202009,45130,전라북도,군산시,75-79세,9727,4089,5638
202010,45130,전라북도,군산시,75-79세,9731,4099,5632
202011,45130,전라북도,군산시,75-79세,9731,4087,5644
202012,45130,전라북도,군산시,75-79세,9684,4079,5605
202101,45130,전라북도,군산시,75-79세,9665,4089,5576
202102,45130,전라북도,군산시,75-79세,9613,4090,5523
202103,45130,전라북도,군산시,75-79세,9615,4083,5532
202104,45130,전라북도,군산시,75-79세,9657,4113,5544
202105,45130,전라북도,군산시,75-79세,9670,4133,5537
202106,45130,전라북도,군산시,75-79세,9727,4166,5561
202007,45130,전라북도,군산시,80-84세,6428,2382,4046
202008,45130,전라북도,군산시,80-84세,6448,2397,4051
202009,45130,전라북도,군산시,80-84세,6440,2391,4049
202010,45130,전라북도,군산시,80-84세,6463,2397,4066
202011,45130,전라북도,군산시,80-84세,6450,2398,4052
202012,45130,전라북도,군산시,80-84세,6482,2408,4074
202101,45130,전라북도,군산시,80-84세,6492,2414,4078
202102,45130,전라북도,군산시,80-84세,6535,2430,4105
202103,45130,전라북도,군산시,80-84세,6540,2429,4111
202104,45130,전라북도,군산시,80-84세,6548,2433,4115
202105,45130,전라북도,군산시,80-84세,6548,2429,4119
202106,45130,전라북도,군산시,80-84세,6587,2441,4146
202007,45130,전라북도,군산시,85-89세,3519,998,2521
202008,45130,전라북도,군산시,85-89세,3537,1001,2536
202009,45130,전라북도,군산시,85-89세,3544,1007,2537
202010,45130,전라북도,군산시,85-89세,3552,1018,2534
202011,45130,전라북도,군산시,85-89세,3561,1019,2542
202012,45130,전라북도,군산시,85-89세,3586,1036,2550
202101,45130,전라북도,군산시,85-89세,3629,1056,2573
202102,45130,전라북도,군산시,85-89세,3660,1060,2600
202103,45130,전라북도,군산시,85-89세,3703,1082,2621
202104,45130,전라북도,군산시,85-89세,3733,1086,2647
202105,45130,전라북도,군산시,85-89세,3716,1090,2626
202106,45130,전라북도,군산시,85-89세,3725,1106,2619
202007,45130,전라북도,군산시,90-94세,1238,258,980
202008,45130,전라북도,군산시,90-94세,1265,265,1000
202009,45130,전라북도,군산시,90-94세,1282,274,1008
202010,45130,전라북도,군산시,90-94세,1293,281,1012
202011,45130,전라북도,군산시,90-94세,1311,289,1022
202012,45130,전라북도,군산시,90-94세,1305,293,1012
202101,45130,전라북도,군산시,90-94세,1321,298,1023
202102,45130,전라북도,군산시,90-94세,1330,300,1030
202103,45130,전라북도,군산시,90-94세,1332,297,1035
202104,45130,전라북도,군산시,90-94세,1349,303,1046
202105,45130,전라북도,군산시,90-94세,1355,299,1056
202106,45130,전라북도,군산시,90-94세,1362,295,1067
202007,45130,전라북도,군산시,95-99세,258,44,214
202008,45130,전라북도,군산시,95-99세,256,42,214
202009,45130,전라북도,군산시,95-99세,254,38,216
202010,45130,전라북도,군산시,95-99세,260,39,221
202011,45130,전라북도,군산시,95-99세,258,38,220
202012,45130,전라북도,군산시,95-99세,261,38,223
202101,45130,전라북도,군산시,95-99세,261,37,224
202102,45130,전라북도,군산시,95-99세,270,42,228
202103,45130,전라북도,군산시,95-99세,254,34,220
202104,45130,전라북도,군산시,95-99세,252,33,219
202105,45130,전라북도,군산시,95-99세,252,34,218
202106,45130,전라북도,군산시,95-99세,254,34,220
202007,45130,전라북도,군산시,100+,118,37,81
202008,45130,전라북도,군산시,100+,119,37,82
202009,45130,전라북도,군산시,100+,121,37,84
202010,45130,전라북도,군산시,100+,122,37,85
202011,45130,전라북도,군산시,100+,123,37,86
202012,45130,전라북도,군산시,100+,124,37,87
202101,45130,전라북도,군산시,100+,126,37,89
202102,45130,전라북도,군산시,100+,126,37,89
202103,45130,전라북도,군산시,100+,61,10,51
202104,45130,전라북도,군산시,100+,60,10,50
202105,45130,전라북도,군산시,100+,56,9,47
202106,45130,전라북도,군산시,100+,54,9,45
202007,45140,전라북도,익산시,0-4세,7994,3971,4023
202008,45140,전라북도,익산시,0-4세,7919,3950,3969
202009,45140,전라북도,익산시,0-4세,7834,3921,3913
202010,45140,전라북도,익산시,0-4세,7741,3867,3874
202011,45140,전라북도,익산시,0-4세,7631,3806,3825
202012,45140,전라북도,익산시,0-4세,7536,3780,3756
202101,45140,전라북도,익산시,0-4세,7424,3722,3702
202102,45140,전라북도,익산시,0-4세,7323,3664,3659
202103,45140,전라북도,익산시,0-4세,7220,3627,3593
202104,45140,전라북도,익산시,0-4세,7147,3600,3547
202105,45140,전라북도,익산시,0-4세,7057,3556,3501
202106,45140,전라북도,익산시,0-4세,6988,3524,3464
202007,45140,전라북도,익산시,5-9세,11893,6172,5721
202008,45140,전라북도,익산시,5-9세,11853,6138,5715
202009,45140,전라북도,익산시,5-9세,11776,6092,5684
202010,45140,전라북도,익산시,5-9세,11704,6071,5633
202011,45140,전라북도,익산시,5-9세,11669,6067,5602
202012,45140,전라북도,익산시,5-9세,11630,6032,5598
202101,45140,전라북도,익산시,5-9세,11537,5989,5548
202102,45140,전라북도,익산시,5-9세,11468,5966,5502
202103,45140,전라북도,익산시,5-9세,11407,5943,5464
202104,45140,전라북도,익산시,5-9세,11362,5923,5439
202105,45140,전라북도,익산시,5-9세,11331,5910,5421
202106,45140,전라북도,익산시,5-9세,11275,5876,5399
202007,45140,전라북도,익산시,10-14세,12864,6556,6308
202008,45140,전라북도,익산시,10-14세,12835,6537,6298
202009,45140,전라북도,익산시,10-14세,12800,6518,6282
202010,45140,전라북도,익산시,10-14세,12839,6537,6302
202011,45140,전라북도,익산시,10-14세,12838,6528,6310
202012,45140,전라북도,익산시,10-14세,12853,6525,6328
202101,45140,전라북도,익산시,10-14세,12850,6531,6319
202102,45140,전라북도,익산시,10-14세,12839,6521,6318
202103,45140,전라북도,익산시,10-14세,12836,6511,6325
202104,45140,전라북도,익산시,10-14세,12831,6495,6336
202105,45140,전라북도,익산시,10-14세,12832,6494,6338
202106,45140,전라북도,익산시,10-14세,12854,6513,6341
202007,45140,전라북도,익산시,15-19세,15590,8017,7573
202008,45140,전라북도,익산시,15-19세,15456,7925,7531
202009,45140,전라북도,익산시,15-19세,15353,7880,7473
202010,45140,전라북도,익산시,15-19세,15231,7817,7414
202011,45140,전라북도,익산시,15-19세,15171,7796,7375
202012,45140,전라북도,익산시,15-19세,15055,7731,7324
202101,45140,전라북도,익산시,15-19세,14873,7620,7253
202102,45140,전라북도,익산시,15-19세,14702,7549,7153
202103,45140,전라북도,익산시,15-19세,14724,7590,7134
202104,45140,전라북도,익산시,15-19세,14716,7642,7074
202105,45140,전라북도,익산시,15-19세,14647,7590,7057
202106,45140,전라북도,익산시,15-19세,14603,7542,7061
202007,45140,전라북도,익산시,20-24세,19682,10650,9032
202008,45140,전라북도,익산시,20-24세,19629,10602,9027
202009,45140,전라북도,익산시,20-24세,19619,10620,8999
202010,45140,전라북도,익산시,20-24세,19632,10623,9009
202011,45140,전라북도,익산시,20-24세,19624,10607,9017
202012,45140,전라북도,익산시,20-24세,19528,10549,8979
202101,45140,전라북도,익산시,20-24세,19340,10448,8892
202102,45140,전라북도,익산시,20-24세,19222,10392,8830
202103,45140,전라북도,익산시,20-24세,19219,10401,8818
202104,45140,전라북도,익산시,20-24세,19123,10333,8790
202105,45140,전라북도,익산시,20-24세,19111,10296,8815
202106,45140,전라북도,익산시,20-24세,19076,10278,8798
202007,45140,전라북도,익산시,25-29세,16695,9159,7536
202008,45140,전라북도,익산시,25-29세,16682,9173,7509
202009,45140,전라북도,익산시,25-29세,16679,9156,7523
202010,45140,전라북도,익산시,25-29세,16724,9192,7532
202011,45140,전라북도,익산시,25-29세,16698,9171,7527
202012,45140,전라북도,익산시,25-29세,16674,9164,7510
202101,45140,전라북도,익산시,25-29세,16598,9112,7486
202102,45140,전라북도,익산시,25-29세,16443,9023,7420
202103,45140,전라북도,익산시,25-29세,16559,9090,7469
202104,45140,전라북도,익산시,25-29세,16570,9106,7464
202105,45140,전라북도,익산시,25-29세,16563,9136,7427
202106,45140,전라북도,익산시,25-29세,16586,9151,7435
202007,45140,전라북도,익산시,30-34세,12908,6857,6051
202008,45140,전라북도,익산시,30-34세,12880,6873,6007
202009,45140,전라북도,익산시,30-34세,12833,6861,5972
202010,45140,전라북도,익산시,30-34세,12806,6853,5953
202011,45140,전라북도,익산시,30-34세,12742,6836,5906
202012,45140,전라북도,익산시,30-34세,12688,6816,5872
202101,45140,전라북도,익산시,30-34세,12637,6794,5843
202102,45140,전라북도,익산시,30-34세,12619,6783,5836
202103,45140,전라북도,익산시,30-34세,12554,6744,5810
202104,45140,전라북도,익산시,30-34세,12579,6761,5818
202105,45140,전라북도,익산시,30-34세,12604,6751,5853
202106,45140,전라북도,익산시,30-34세,12642,6783,5859
202007,45140,전라북도,익산시,35-39세,16283,8428,7855
202008,45140,전라북도,익산시,35-39세,16199,8371,7828
202009,45140,전라북도,익산시,35-39세,16033,8283,7750
202010,45140,전라북도,익산시,35-39세,15879,8184,7695
202011,45140,전라북도,익산시,35-39세,15815,8143,7672
202012,45140,전라북도,익산시,35-39세,15779,8115,7664
202101,45140,전라북도,익산시,35-39세,15679,8042,7637
202102,45140,전라북도,익산시,35-39세,15537,7980,7557
202103,45140,전라북도,익산시,35-39세,15415,7927,7488
202104,45140,전라북도,익산시,35-39세,15298,7861,7437
202105,45140,전라북도,익산시,35-39세,15200,7796,7404
202106,45140,전라북도,익산시,35-39세,15149,7753,7396
202007,45140,전라북도,익산시,40-44세,18823,9663,9160
202008,45140,전라북도,익산시,40-44세,18770,9628,9142
202009,45140,전라북도,익산시,40-44세,18778,9615,9163
202010,45140,전라북도,익산시,40-44세,18835,9641,9194
202011,45140,전라북도,익산시,40-44세,18828,9652,9176
202012,45140,전라북도,익산시,40-44세,18675,9576,9099
202101,45140,전라북도,익산시,40-44세,18614,9547,9067
202102,45140,전라북도,익산시,40-44세,18556,9514,9042
202103,45140,전라북도,익산시,40-44세,18500,9467,9033
202104,45140,전라북도,익산시,40-44세,18481,9467,9014
202105,45140,전라북도,익산시,40-44세,18484,9494,8990
202106,45140,전라북도,익산시,40-44세,18538,9524,9014
202007,45140,전라북도,익산시,45-49세,23702,12055,11647
202008,45140,전라북도,익산시,45-49세,23657,12056,11601
202009,45140,전라북도,익산시,45-49세,23501,11973,11528
202010,45140,전라북도,익산시,45-49세,23355,11894,11461
202011,45140,전라북도,익산시,45-49세,23238,11836,11402
202012,45140,전라북도,익산시,45-49세,23260,11838,11422
202101,45140,전라북도,익산시,45-49세,23156,11773,11383
202102,45140,전라북도,익산시,45-49세,23080,11729,11351
202103,45140,전라북도,익산시,45-49세,22931,11666,11265
202104,45140,전라북도,익산시,45-49세,22904,11666,11238
202105,45140,전라북도,익산시,45-49세,22624,11488,11136
202106,45140,전라북도,익산시,45-49세,22501,11450,11051
202007,45140,전라북도,익산시,50-54세,24804,12548,12256
202008,45140,전라북도,익산시,50-54세,24749,12520,12229
202009,45140,전라북도,익산시,50-54세,24735,12538,12197
202010,45140,전라북도,익산시,50-54세,24722,12539,12183
202011,45140,전라북도,익산시,50-54세,24730,12527,12203
202012,45140,전라북도,익산시,50-54세,24685,12510,12175
202101,45140,전라북도,익산시,50-54세,24752,12569,12183
202102,45140,전라북도,익산시,50-54세,24713,12545,12168
202103,45140,전라북도,익산시,50-54세,24652,12488,12164
202104,45140,전라북도,익산시,50-54세,24630,12467,12163
202105,45140,전라북도,익산시,50-54세,24783,12569,12214
202106,45140,전라북도,익산시,50-54세,24843,12583,12260
202007,45140,전라북도,익산시,55-59세,24650,12559,12091
202008,45140,전라북도,익산시,55-59세,24552,12471,12081
202009,45140,전라북도,익산시,55-59세,24463,12417,12046
202010,45140,전라북도,익산시,55-59세,24382,12393,11989
202011,45140,전라북도,익산시,55-59세,24326,12378,11948
202012,45140,전라북도,익산시,55-59세,24311,12353,11958
202101,45140,전라북도,익산시,55-59세,24135,12256,11879
202102,45140,전라북도,익산시,55-59세,24068,12240,11828
202103,45140,전라북도,익산시,55-59세,23980,12224,11756
202104,45140,전라북도,익산시,55-59세,23900,12200,11700
202105,45140,전라북도,익산시,55-59세,23758,12176,11582
202106,45140,전라북도,익산시,55-59세,23591,12092,11499
202007,45140,전라북도,익산시,60-64세,22810,11459,11351
202008,45140,전라북도,익산시,60-64세,22959,11548,11411
202009,45140,전라북도,익산시,60-64세,23093,11606,11487
202010,45140,전라북도,익산시,60-64세,23207,11655,11552
202011,45140,전라북도,익산시,60-64세,23283,11695,11588
202012,45140,전라북도,익산시,60-64세,23435,11781,11654
202101,45140,전라북도,익산시,60-64세,23603,11860,11743
202102,45140,전라북도,익산시,60-64세,23722,11911,11811
202103,45140,전라북도,익산시,60-64세,23862,11983,11879
202104,45140,전라북도,익산시,60-64세,23958,11998,11960
202105,45140,전라북도,익산시,60-64세,24081,12028,12053
202106,45140,전라북도,익산시,60-64세,24295,12135,12160
202007,45140,전라북도,익산시,65-69세,16623,8077,8546
202008,45140,전라북도,익산시,65-69세,16707,8124,8583
202009,45140,전라북도,익산시,65-69세,16781,8177,8604
202010,45140,전라북도,익산시,65-69세,16859,8203,8656
202011,45140,전라북도,익산시,65-69세,16954,8259,8695
202012,45140,전라북도,익산시,65-69세,17049,8303,8746
202101,45140,전라북도,익산시,65-69세,17086,8329,8757
202102,45140,전라북도,익산시,65-69세,17174,8373,8801
202103,45140,전라북도,익산시,65-69세,17294,8436,8858
202104,45140,전라북도,익산시,65-69세,17401,8481,8920
202105,45140,전라북도,익산시,65-69세,17519,8544,8975
202106,45140,전라북도,익산시,65-69세,17546,8574,8972
202007,45140,전라북도,익산시,70-74세,13339,6238,7101
202008,45140,전라북도,익산시,70-74세,13406,6269,7137
202009,45140,전라북도,익산시,70-74세,13528,6332,7196
202010,45140,전라북도,익산시,70-74세,13654,6404,7250
202011,45140,전라북도,익산시,70-74세,13751,6449,7302
202012,45140,전라북도,익산시,70-74세,13837,6494,7343
202101,45140,전라북도,익산시,70-74세,13949,6543,7406
202102,45140,전라북도,익산시,70-74세,14027,6587,7440
202103,45140,전라북도,익산시,70-74세,14071,6606,7465
202104,45140,전라북도,익산시,70-74세,14082,6631,7451
202105,45140,전라북도,익산시,70-74세,14116,6629,7487
202106,45140,전라북도,익산시,70-74세,14123,6650,7473
202007,45140,전라북도,익산시,75-79세,10809,4470,6339
202008,45140,전라북도,익산시,75-79세,10833,4487,6346
202009,45140,전라북도,익산시,75-79세,10801,4483,6318
202010,45140,전라북도,익산시,75-79세,10777,4479,6298
202011,45140,전라북도,익산시,75-79세,10748,4480,6268
202012,45140,전라북도,익산시,75-79세,10684,4451,6233
202101,45140,전라북도,익산시,75-79세,10644,4450,6194
202102,45140,전라북도,익산시,75-79세,10608,4443,6165
202103,45140,전라북도,익산시,75-79세,10616,4463,6153
202104,45140,전라북도,익산시,75-79세,10637,4477,6160
202105,45140,전라북도,익산시,75-79세,10628,4493,6135
202106,45140,전라북도,익산시,75-79세,10669,4490,6179
202007,45140,전라북도,익산시,80-84세,7943,2750,5193
202008,45140,전라북도,익산시,80-84세,7915,2743,5172
202009,45140,전라북도,익산시,80-84세,7889,2735,5154
202010,45140,전라북도,익산시,80-84세,7889,2720,5169
202011,45140,전라북도,익산시,80-84세,7886,2715,5171
202012,45140,전라북도,익산시,80-84세,7891,2732,5159
202101,45140,전라북도,익산시,80-84세,7906,2736,5170
202102,45140,전라북도,익산시,80-84세,7943,2752,5191
202103,45140,전라북도,익산시,80-84세,7899,2740,5159
202104,45140,전라북도,익산시,80-84세,7883,2754,5129
202105,45140,전라북도,익산시,80-84세,7911,2755,5156
202106,45140,전라북도,익산시,80-84세,7935,2778,5157
202007,45140,전라북도,익산시,85-89세,4451,1268,3183
202008,45140,전라북도,익산시,85-89세,4482,1280,3202
202009,45140,전라북도,익산시,85-89세,4529,1297,3232
202010,45140,전라북도,익산시,85-89세,4558,1318,3240
202011,45140,전라북도,익산시,85-89세,4580,1321,3259
202012,45140,전라북도,익산시,85-89세,4615,1338,3277
202101,45140,전라북도,익산시,85-89세,4617,1344,3273
202102,45140,전라북도,익산시,85-89세,4641,1351,3290
202103,45140,전라북도,익산시,85-89세,4686,1368,3318
202104,45140,전라북도,익산시,85-89세,4716,1377,3339
202105,45140,전라북도,익산시,85-89세,4739,1391,3348
202106,45140,전라북도,익산시,85-89세,4710,1375,3335
202007,45140,전라북도,익산시,90-94세,1565,374,1191
202008,45140,전라북도,익산시,90-94세,1581,378,1203
202009,45140,전라북도,익산시,90-94세,1602,380,1222
202010,45140,전라북도,익산시,90-94세,1607,383,1224
202011,45140,전라북도,익산시,90-94세,1624,392,1232
202012,45140,전라북도,익산시,90-94세,1646,395,1251
202101,45140,전라북도,익산시,90-94세,1689,400,1289
202102,45140,전라북도,익산시,90-94세,1708,400,1308
202103,45140,전라북도,익산시,90-94세,1720,396,1324
202104,45140,전라북도,익산시,90-94세,1732,393,1339
202105,45140,전라북도,익산시,90-94세,1727,389,1338
202106,45140,전라북도,익산시,90-94세,1738,392,1346
202007,45140,전라북도,익산시,95-99세,319,66,253
202008,45140,전라북도,익산시,95-99세,326,67,259
202009,45140,전라북도,익산시,95-99세,331,67,264
202010,45140,전라북도,익산시,95-99세,339,66,273
202011,45140,전라북도,익산시,95-99세,338,62,276
202012,45140,전라북도,익산시,95-99세,339,66,273
202101,45140,전라북도,익산시,95-99세,341,68,273
202102,45140,전라북도,익산시,95-99세,346,70,276
202103,45140,전라북도,익산시,95-99세,346,71,275
202104,45140,전라북도,익산시,95-99세,355,71,284
202105,45140,전라북도,익산시,95-99세,347,72,275
202106,45140,전라북도,익산시,95-99세,334,65,269
202007,45140,전라북도,익산시,100+,106,23,83
202008,45140,전라북도,익산시,100+,106,23,83
202009,45140,전라북도,익산시,100+,106,23,83
202010,45140,전라북도,익산시,100+,107,25,82
202011,45140,전라북도,익산시,100+,108,25,83
202012,45140,전라북도,익산시,100+,106,24,82
202101,45140,전라북도,익산시,100+,109,25,84
202102,45140,전라북도,익산시,100+,108,25,83
202103,45140,전라북도,익산시,100+,94,22,72
202104,45140,전라북도,익산시,100+,94,23,71
202105,45140,전라북도,익산시,100+,90,20,70
202106,45140,전라북도,익산시,100+,76,15,61
202007,45180,전라북도,정읍시,0-4세,2625,1327,1298
202008,45180,전라북도,정읍시,0-4세,2590,1304,1286
202009,45180,전라북도,정읍시,0-4세,2565,1283,1282
202010,45180,전라북도,정읍시,0-4세,2533,1277,1256
202011,45180,전라북도,정읍시,0-4세,2505,1259,1246
202012,45180,전라북도,정읍시,0-4세,2479,1248,1231
202101,45180,전라북도,정읍시,0-4세,2438,1227,1211
202102,45180,전라북도,정읍시,0-4세,2416,1218,1198
202103,45180,전라북도,정읍시,0-4세,2412,1217,1195
202104,45180,전라북도,정읍시,0-4세,2376,1201,1175
202105,45180,전라북도,정읍시,0-4세,2347,1180,1167
202106,45180,전라북도,정읍시,0-4세,2317,1176,1141
202007,45180,전라북도,정읍시,5-9세,3999,2057,1942
202008,45180,전라북도,정읍시,5-9세,3982,2054,1928
202009,45180,전라북도,정읍시,5-9세,3970,2055,1915
202010,45180,전라북도,정읍시,5-9세,3932,2030,1902
202011,45180,전라북도,정읍시,5-9세,3905,2021,1884
202012,45180,전라북도,정읍시,5-9세,3891,2018,1873
202101,45180,전라북도,정읍시,5-9세,3856,2002,1854
202102,45180,전라북도,정읍시,5-9세,3828,1985,1843
202103,45180,전라북도,정읍시,5-9세,3815,1977,1838
202104,45180,전라북도,정읍시,5-9세,3798,1964,1834
202105,45180,전라북도,정읍시,5-9세,3777,1953,1824
202106,45180,전라북도,정읍시,5-9세,3736,1919,1817
202007,45180,전라북도,정읍시,10-14세,4432,2353,2079
202008,45180,전라북도,정읍시,10-14세,4435,2357,2078
202009,45180,전라북도,정읍시,10-14세,4427,2361,2066
202010,45180,전라북도,정읍시,10-14세,4430,2362,2068
202011,45180,전라북도,정읍시,10-14세,4431,2370,2061
202012,45180,전라북도,정읍시,10-14세,4426,2350,2076
202101,45180,전라북도,정읍시,10-14세,4450,2356,2094
202102,45180,전라북도,정읍시,10-14세,4457,2359,2098
202103,45180,전라북도,정읍시,10-14세,4450,2344,2106
202104,45180,전라북도,정읍시,10-14세,4447,2339,2108
202105,45180,전라북도,정읍시,10-14세,4447,2341,2106
202106,45180,전라북도,정읍시,10-14세,4471,2353,2118
202007,45180,전라북도,정읍시,15-19세,5400,2879,2521
202008,45180,전라북도,정읍시,15-19세,5370,2861,2509
202009,45180,전라북도,정읍시,15-19세,5326,2829,2497
202010,45180,전라북도,정읍시,15-19세,5302,2815,2487
202011,45180,전라북도,정읍시,15-19세,5264,2785,2479
202012,45180,전라북도,정읍시,15-19세,5238,2781,2457
202101,45180,전라북도,정읍시,15-19세,5192,2757,2435
202102,45180,전라북도,정읍시,15-19세,5144,2736,2408
202103,45180,전라북도,정읍시,15-19세,5111,2724,2387
202104,45180,전라북도,정읍시,15-19세,5052,2701,2351
202105,45180,전라북도,정읍시,15-19세,5016,2688,2328
202106,45180,전라북도,정읍시,15-19세,4978,2664,2314
202007,45180,전라북도,정읍시,20-24세,6117,3304,2813
202008,45180,전라북도,정읍시,20-24세,6103,3302,2801
202009,45180,전라북도,정읍시,20-24세,6075,3304,2771
202010,45180,전라북도,정읍시,20-24세,6073,3309,2764
202011,45180,전라북도,정읍시,20-24세,6042,3298,2744
202012,45180,전라북도,정읍시,20-24세,5976,3266,2710
202101,45180,전라북도,정읍시,20-24세,5980,3259,2721
202102,45180,전라북도,정읍시,20-24세,5900,3220,2680
202103,45180,전라북도,정읍시,20-24세,5815,3196,2619
202104,45180,전라북도,정읍시,20-24세,5756,3168,2588
202105,45180,전라북도,정읍시,20-24세,5762,3170,2592
202106,45180,전라북도,정읍시,20-24세,5780,3176,2604
202007,45180,전라북도,정읍시,25-29세,4603,2571,2032
202008,45180,전라북도,정읍시,25-29세,4582,2568,2014
202009,45180,전라북도,정읍시,25-29세,4564,2548,2016
202010,45180,전라북도,정읍시,25-29세,4593,2557,2036
202011,45180,전라북도,정읍시,25-29세,4624,2577,2047
202012,45180,전라북도,정읍시,25-29세,4628,2582,2046
202101,45180,전라북도,정읍시,25-29세,4650,2596,2054
202102,45180,전라북도,정읍시,25-29세,4636,2593,2043
202103,45180,전라북도,정읍시,25-29세,4642,2606,2036
202104,45180,전라북도,정읍시,25-29세,4666,2614,2052
202105,45180,전라북도,정읍시,25-29세,4668,2610,2058
202106,45180,전라북도,정읍시,25-29세,4660,2616,2044
202007,45180,전라북도,정읍시,30-34세,3959,2132,1827
202008,45180,전라북도,정읍시,30-34세,3956,2129,1827
202009,45180,전라북도,정읍시,30-34세,3936,2112,1824
202010,45180,전라북도,정읍시,30-34세,3935,2113,1822
202011,45180,전라북도,정읍시,30-34세,3924,2108,1816
202012,45180,전라북도,정읍시,30-34세,3897,2096,1801
202101,45180,전라북도,정읍시,30-34세,3894,2098,1796
202102,45180,전라북도,정읍시,30-34세,3887,2093,1794
202103,45180,전라북도,정읍시,30-34세,3858,2083,1775
202104,45180,전라북도,정읍시,30-34세,3867,2084,1783
202105,45180,전라북도,정읍시,30-34세,3873,2090,1783
202106,45180,전라북도,정읍시,30-34세,3870,2089,1781
202007,45180,전라북도,정읍시,35-39세,5172,2711,2461
202008,45180,전라북도,정읍시,35-39세,5123,2686,2437
202009,45180,전라북도,정읍시,35-39세,5068,2664,2404
202010,45180,전라북도,정읍시,35-39세,4999,2644,2355
202011,45180,전라북도,정읍시,35-39세,4961,2610,2351
202012,45180,전라북도,정읍시,35-39세,4970,2620,2350
202101,45180,전라북도,정읍시,35-39세,4957,2608,2349
202102,45180,전라북도,정읍시,35-39세,4904,2572,2332
202103,45180,전라북도,정읍시,35-39세,4846,2556,2290
202104,45180,전라북도,정읍시,35-39세,4800,2530,2270
202105,45180,전라북도,정읍시,35-39세,4779,2520,2259
202106,45180,전라북도,정읍시,35-39세,4749,2512,2237
202007,45180,전라북도,정읍시,40-44세,6575,3411,3164
202008,45180,전라북도,정읍시,40-44세,6562,3411,3151
202009,45180,전라북도,정읍시,40-44세,6549,3405,3144
202010,45180,전라북도,정읍시,40-44세,6528,3377,3151
202011,45180,전라북도,정읍시,40-44세,6498,3386,3112
202012,45180,전라북도,정읍시,40-44세,6443,3342,3101
202101,45180,전라북도,정읍시,40-44세,6383,3302,3081
202102,45180,전라북도,정읍시,40-44세,6397,3312,3085
202103,45180,전라북도,정읍시,40-44세,6320,3269,3051
202104,45180,전라북도,정읍시,40-44세,6317,3262,3055
202105,45180,전라북도,정읍시,40-44세,6297,3253,3044
202106,45180,전라북도,정읍시,40-44세,6312,3258,3054
202007,45180,전라북도,정읍시,45-49세,8544,4560,3984
202008,45180,전라북도,정읍시,45-49세,8524,4542,3982
202009,45180,전라북도,정읍시,45-49세,8475,4505,3970
202010,45180,전라북도,정읍시,45-49세,8441,4492,3949
202011,45180,전라북도,정읍시,45-49세,8399,4453,3946
202012,45180,전라북도,정읍시,45-49세,8381,4452,3929
202101,45180,전라북도,정읍시,45-49세,8372,4446,3926
202102,45180,전라북도,정읍시,45-49세,8340,4430,3910
202103,45180,전라북도,정읍시,45-49세,8295,4420,3875
202104,45180,전라북도,정읍시,45-49세,8254,4397,3857
202105,45180,전라북도,정읍시,45-49세,8166,4357,3809
202106,45180,전라북도,정읍시,45-49세,8120,4339,3781
202007,45180,전라북도,정읍시,50-54세,9185,5020,4165
202008,45180,전라북도,정읍시,50-54세,9133,4991,4142
202009,45180,전라북도,정읍시,50-54세,9130,5001,4129
202010,45180,전라북도,정읍시,50-54세,9114,4989,4125
202011,45180,전라북도,정읍시,50-54세,9097,4963,4134
202012,45180,전라북도,정읍시,50-54세,9039,4924,4115
202101,45180,전라북도,정읍시,50-54세,9081,4933,4148
202102,45180,전라북도,정읍시,50-54세,9115,4953,4162
202103,45180,전라북도,정읍시,50-54세,9026,4902,4124
202104,45180,전라북도,정읍시,50-54세,9027,4919,4108
202105,45180,전라북도,정읍시,50-54세,9094,4947,4147
202106,45180,전라북도,정읍시,50-54세,9118,4959,4159
202007,45180,전라북도,정읍시,55-59세,9479,4989,4490
202008,45180,전라북도,정읍시,55-59세,9464,4973,4491
202009,45180,전라북도,정읍시,55-59세,9441,4965,4476
202010,45180,전라북도,정읍시,55-59세,9427,4979,4448
202011,45180,전라북도,정읍시,55-59세,9358,4967,4391
202012,45180,전라북도,정읍시,55-59세,9355,4974,4381
202101,45180,전라북도,정읍시,55-59세,9283,4955,4328
202102,45180,전라북도,정읍시,55-59세,9249,4939,4310
202103,45180,전라북도,정읍시,55-59세,9193,4916,4277
202104,45180,전라북도,정읍시,55-59세,9165,4913,4252
202105,45180,전라북도,정읍시,55-59세,9134,4899,4235
202106,45180,전라북도,정읍시,55-59세,9061,4850,4211
202007,45180,전라북도,정읍시,60-64세,9224,4770,4454
202008,45180,전라북도,정읍시,60-64세,9301,4815,4486
202009,45180,전라북도,정읍시,60-64세,9337,4834,4503
202010,45180,전라북도,정읍시,60-64세,9364,4843,4521
202011,45180,전라북도,정읍시,60-64세,9459,4885,4574
202012,45180,전라북도,정읍시,60-64세,9527,4917,4610
202101,45180,전라북도,정읍시,60-64세,9607,4954,4653
202102,45180,전라북도,정읍시,60-64세,9691,4993,4698
202103,45180,전라북도,정읍시,60-64세,9725,5013,4712
202104,45180,전라북도,정읍시,60-64세,9813,5056,4757
202105,45180,전라북도,정읍시,60-64세,9879,5094,4785
202106,45180,전라북도,정읍시,60-64세,9951,5149,4802
202007,45180,전라북도,정읍시,65-69세,7287,3407,3880
202008,45180,전라북도,정읍시,65-69세,7271,3411,3860
202009,45180,전라북도,정읍시,65-69세,7324,3437,3887
202010,45180,전라북도,정읍시,65-69세,7371,3458,3913
202011,45180,전라북도,정읍시,65-69세,7380,3465,3915
202012,45180,전라북도,정읍시,65-69세,7396,3477,3919
202101,45180,전라북도,정읍시,65-69세,7418,3488,3930
202102,45180,전라북도,정읍시,65-69세,7453,3516,3937
202103,45180,전라북도,정읍시,65-69세,7482,3542,3940
202104,45180,전라북도,정읍시,65-69세,7492,3553,3939
202105,45180,전라북도,정읍시,65-69세,7503,3545,3958
202106,45180,전라북도,정읍시,65-69세,7516,3552,3964
202007,45180,전라북도,정읍시,70-74세,6936,3271,3665
202008,45180,전라북도,정읍시,70-74세,6951,3271,3680
202009,45180,전라북도,정읍시,70-74세,6976,3289,3687
202010,45180,전라북도,정읍시,70-74세,7016,3311,3705
202011,45180,전라북도,정읍시,70-74세,7072,3334,3738
202012,45180,전라북도,정읍시,70-74세,7130,3355,3775
202101,45180,전라북도,정읍시,70-74세,7173,3381,3792
202102,45180,전라북도,정읍시,70-74세,7177,3372,3805
202103,45180,전라북도,정읍시,70-74세,7136,3363,3773
202104,45180,전라북도,정읍시,70-74세,7140,3362,3778
202105,45180,전라북도,정읍시,70-74세,7126,3365,3761
202106,45180,전라북도,정읍시,70-74세,7118,3355,3763
202007,45180,전라북도,정읍시,75-79세,6419,2495,3924
202008,45180,전라북도,정읍시,75-79세,6413,2486,3927
202009,45180,전라북도,정읍시,75-79세,6394,2484,3910
202010,45180,전라북도,정읍시,75-79세,6370,2461,3909
202011,45180,전라북도,정읍시,75-79세,6322,2438,3884
202012,45180,전라북도,정읍시,75-79세,6273,2422,3851
202101,45180,전라북도,정읍시,75-79세,6243,2408,3835
202102,45180,전라북도,정읍시,75-79세,6194,2397,3797
202103,45180,전라북도,정읍시,75-79세,6120,2390,3730
202104,45180,전라북도,정읍시,75-79세,6103,2397,3706
202105,45180,전라북도,정읍시,75-79세,6082,2392,3690
202106,45180,전라북도,정읍시,75-79세,6086,2397,3689
202007,45180,전라북도,정읍시,80-84세,5240,1851,3389
202008,45180,전라북도,정읍시,80-84세,5218,1847,3371
202009,45180,전라북도,정읍시,80-84세,5160,1822,3338
202010,45180,전라북도,정읍시,80-84세,5146,1832,3314
202011,45180,전라북도,정읍시,80-84세,5138,1843,3295
202012,45180,전라북도,정읍시,80-84세,5120,1833,3287
202101,45180,전라북도,정읍시,80-84세,5120,1834,3286
202102,45180,전라북도,정읍시,80-84세,5138,1843,3295
202103,45180,전라북도,정읍시,80-84세,5104,1819,3285
202104,45180,전라북도,정읍시,80-84세,5086,1815,3271
202105,45180,전라북도,정읍시,80-84세,5120,1823,3297
202106,45180,전라북도,정읍시,80-84세,5151,1841,3310
202007,45180,전라북도,정읍시,85-89세,2905,797,2108
202008,45180,전라북도,정읍시,85-89세,2933,808,2125
202009,45180,전라북도,정읍시,85-89세,2973,826,2147
202010,45180,전라북도,정읍시,85-89세,3009,833,2176
202011,45180,전라북도,정읍시,85-89세,3019,833,2186
202012,45180,전라북도,정읍시,85-89세,3064,858,2206
202101,45180,전라북도,정읍시,85-89세,3088,868,2220
202102,45180,전라북도,정읍시,85-89세,3119,880,2239
202103,45180,전라북도,정읍시,85-89세,3131,894,2237
202104,45180,전라북도,정읍시,85-89세,3160,897,2263
202105,45180,전라북도,정읍시,85-89세,3166,899,2267
202106,45180,전라북도,정읍시,85-89세,3174,904,2270
202007,45180,전라북도,정읍시,90-94세,949,216,733
202008,45180,전라북도,정읍시,90-94세,950,210,740
202009,45180,전라북도,정읍시,90-94세,960,211,749
202010,45180,전라북도,정읍시,90-94세,967,216,751
202011,45180,전라북도,정읍시,90-94세,970,213,757
202012,45180,전라북도,정읍시,90-94세,960,211,749
202101,45180,전라북도,정읍시,90-94세,974,214,760
202102,45180,전라북도,정읍시,90-94세,993,218,775
202103,45180,전라북도,정읍시,90-94세,982,215,767
202104,45180,전라북도,정읍시,90-94세,989,225,764
202105,45180,전라북도,정읍시,90-94세,1010,226,784
202106,45180,전라북도,정읍시,90-94세,1008,223,785
202007,45180,전라북도,정읍시,95-99세,198,44,154
202008,45180,전라북도,정읍시,95-99세,199,42,157
202009,45180,전라북도,정읍시,95-99세,202,41,161
202010,45180,전라북도,정읍시,95-99세,199,41,158
202011,45180,전라북도,정읍시,95-99세,203,43,160
202012,45180,전라북도,정읍시,95-99세,202,43,159
202101,45180,전라북도,정읍시,95-99세,195,40,155
202102,45180,전라북도,정읍시,95-99세,189,39,150
202103,45180,전라북도,정읍시,95-99세,183,34,149
202104,45180,전라북도,정읍시,95-99세,183,33,150
202105,45180,전라북도,정읍시,95-99세,181,33,148
202106,45180,전라북도,정읍시,95-99세,184,33,151
202007,45180,전라북도,정읍시,100+,107,21,86
202008,45180,전라북도,정읍시,100+,107,20,87
202009,45180,전라북도,정읍시,100+,111,21,90
202010,45180,전라북도,정읍시,100+,112,21,91
202011,45180,전라북도,정읍시,100+,110,21,89
202012,45180,전라북도,정읍시,100+,113,22,91
202101,45180,전라북도,정읍시,100+,116,22,94
202102,45180,전라북도,정읍시,100+,117,22,95
202103,45180,전라북도,정읍시,100+,64,10,54
202104,45180,전라북도,정읍시,100+,64,9,55
202105,45180,전라북도,정읍시,100+,62,9,53
202106,45180,전라북도,정읍시,100+,62,9,53
202007,45190,전라북도,남원시,0-4세,2207,1184,1023
202008,45190,전라북도,남원시,0-4세,2210,1181,1029
202009,45190,전라북도,남원시,0-4세,2188,1158,1030
202010,45190,전라북도,남원시,0-4세,2186,1156,1030
202011,45190,전라북도,남원시,0-4세,2174,1151,1023
202012,45190,전라북도,남원시,0-4세,2164,1151,1013
202101,45190,전라북도,남원시,0-4세,2126,1116,1010
202102,45190,전라북도,남원시,0-4세,2096,1094,1002
202103,45190,전라북도,남원시,0-4세,2058,1077,981
202104,45190,전라북도,남원시,0-4세,2026,1062,964
202105,45190,전라북도,남원시,0-4세,2013,1056,957
202106,45190,전라북도,남원시,0-4세,2025,1066,959
202007,45190,전라북도,남원시,5-9세,2954,1558,1396
202008,45190,전라북도,남원시,5-9세,2949,1559,1390
202009,45190,전라북도,남원시,5-9세,2917,1540,1377
202010,45190,전라북도,남원시,5-9세,2884,1525,1359
202011,45190,전라북도,남원시,5-9세,2856,1515,1341
202012,45190,전라북도,남원시,5-9세,2847,1506,1341
202101,45190,전라북도,남원시,5-9세,2834,1511,1323
202102,45190,전라북도,남원시,5-9세,2820,1508,1312
202103,45190,전라북도,남원시,5-9세,2819,1511,1308
202104,45190,전라북도,남원시,5-9세,2813,1505,1308
202105,45190,전라북도,남원시,5-9세,2801,1495,1306
202106,45190,전라북도,남원시,5-9세,2774,1477,1297
202007,45190,전라북도,남원시,10-14세,3369,1744,1625
202008,45190,전라북도,남원시,10-14세,3368,1743,1625
202009,45190,전라북도,남원시,10-14세,3365,1746,1619
202010,45190,전라북도,남원시,10-14세,3374,1751,1623
202011,45190,전라북도,남원시,10-14세,3388,1754,1634
202012,45190,전라북도,남원시,10-14세,3386,1758,1628
202101,45190,전라북도,남원시,10-14세,3407,1768,1639
202102,45190,전라북도,남원시,10-14세,3388,1760,1628
202103,45190,전라북도,남원시,10-14세,3388,1759,1629
202104,45190,전라북도,남원시,10-14세,3383,1753,1630
202105,45190,전라북도,남원시,10-14세,3388,1757,1631
202106,45190,전라북도,남원시,10-14세,3397,1765,1632
202007,45190,전라북도,남원시,15-19세,4073,2097,1976
202008,45190,전라북도,남원시,15-19세,4048,2093,1955
202009,45190,전라북도,남원시,15-19세,4020,2076,1944
202010,45190,전라북도,남원시,15-19세,4019,2062,1957
202011,45190,전라북도,남원시,15-19세,3975,2045,1930
202012,45190,전라북도,남원시,15-19세,3945,2017,1928
202101,45190,전라북도,남원시,15-19세,3876,1985,1891
202102,45190,전라북도,남원시,15-19세,3837,1972,1865
202103,45190,전라북도,남원시,15-19세,3786,1931,1855
202104,45190,전라북도,남원시,15-19세,3771,1929,1842
202105,45190,전라북도,남원시,15-19세,3774,1933,1841
202106,45190,전라북도,남원시,15-19세,3747,1925,1822
202007,45190,전라북도,남원시,20-24세,4286,2423,1863
202008,45190,전라북도,남원시,20-24세,4294,2419,1875
202009,45190,전라북도,남원시,20-24세,4286,2419,1867
202010,45190,전라북도,남원시,20-24세,4278,2427,1851
202011,45190,전라북도,남원시,20-24세,4275,2421,1854
202012,45190,전라북도,남원시,20-24세,4223,2396,1827
202101,45190,전라북도,남원시,20-24세,4238,2402,1836
202102,45190,전라북도,남원시,20-24세,4201,2380,1821
202103,45190,전라북도,남원시,20-24세,4163,2383,1780
202104,45190,전라북도,남원시,20-24세,4152,2372,1780
202105,45190,전라북도,남원시,20-24세,4140,2356,1784
202106,45190,전라북도,남원시,20-24세,4113,2346,1767
202007,45190,전라북도,남원시,25-29세,3334,1820,1514
202008,45190,전라북도,남원시,25-29세,3329,1831,1498
202009,45190,전라북도,남원시,25-29세,3335,1837,1498
202010,45190,전라북도,남원시,25-29세,3340,1835,1505
202011,45190,전라북도,남원시,25-29세,3340,1834,1506
202012,45190,전라북도,남원시,25-29세,3346,1844,1502
202101,45190,전라북도,남원시,25-29세,3351,1839,1512
202102,45190,전라북도,남원시,25-29세,3335,1828,1507
202103,45190,전라북도,남원시,25-29세,3351,1821,1530
202104,45190,전라북도,남원시,25-29세,3344,1825,1519
202105,45190,전라북도,남원시,25-29세,3358,1835,1523
202106,45190,전라북도,남원시,25-29세,3380,1856,1524
202007,45190,전라북도,남원시,30-34세,2891,1484,1407
202008,45190,전라북도,남원시,30-34세,2883,1473,1410
202009,45190,전라북도,남원시,30-34세,2856,1461,1395
202010,45190,전라북도,남원시,30-34세,2857,1468,1389
202011,45190,전라북도,남원시,30-34세,2838,1458,1380
202012,45190,전라북도,남원시,30-34세,2812,1446,1366
202101,45190,전라북도,남원시,30-34세,2799,1441,1358
202102,45190,전라북도,남원시,30-34세,2782,1424,1358
202103,45190,전라북도,남원시,30-34세,2771,1403,1368
202104,45190,전라북도,남원시,30-34세,2772,1412,1360
202105,45190,전라북도,남원시,30-34세,2766,1407,1359
202106,45190,전라북도,남원시,30-34세,2774,1406,1368
202007,45190,전라북도,남원시,35-39세,3710,1874,1836
202008,45190,전라북도,남원시,35-39세,3683,1861,1822
202009,45190,전라북도,남원시,35-39세,3647,1850,1797
202010,45190,전라북도,남원시,35-39세,3622,1844,1778
202011,45190,전라북도,남원시,35-39세,3608,1831,1777
202012,45190,전라북도,남원시,35-39세,3605,1834,1771
202101,45190,전라북도,남원시,35-39세,3593,1829,1764
202102,45190,전라북도,남원시,35-39세,3554,1817,1737
202103,45190,전라북도,남원시,35-39세,3532,1812,1720
202104,45190,전라북도,남원시,35-39세,3497,1786,1711
202105,45190,전라북도,남원시,35-39세,3468,1774,1694
202106,45190,전라북도,남원시,35-39세,3450,1767,1683
202007,45190,전라북도,남원시,40-44세,4628,2270,2358
202008,45190,전라북도,남원시,40-44세,4624,2271,2353
202009,45190,전라북도,남원시,40-44세,4616,2274,2342
202010,45190,전라북도,남원시,40-44세,4597,2262,2335
202011,45190,전라북도,남원시,40-44세,4602,2271,2331
202012,45190,전라북도,남원시,40-44세,4552,2243,2309
202101,45190,전라북도,남원시,40-44세,4501,2209,2292
202102,45190,전라북도,남원시,40-44세,4469,2186,2283
202103,45190,전라북도,남원시,40-44세,4433,2172,2261
202104,45190,전라북도,남원시,40-44세,4411,2161,2250
202105,45190,전라북도,남원시,40-44세,4381,2153,2228
202106,45190,전라북도,남원시,40-44세,4396,2160,2236
202007,45190,전라북도,남원시,45-49세,6307,3349,2958
202008,45190,전라북도,남원시,45-49세,6288,3331,2957
202009,45190,전라북도,남원시,45-49세,6246,3301,2945
202010,45190,전라북도,남원시,45-49세,6198,3254,2944
202011,45190,전라북도,남원시,45-49세,6174,3233,2941
202012,45190,전라북도,남원시,45-49세,6195,3247,2948
202101,45190,전라북도,남원시,45-49세,6199,3254,2945
202102,45190,전라북도,남원시,45-49세,6186,3252,2934
202103,45190,전라북도,남원시,45-49세,6148,3240,2908
202104,45190,전라북도,남원시,45-49세,6132,3245,2887
202105,45190,전라북도,남원시,45-49세,6053,3203,2850
202106,45190,전라북도,남원시,45-49세,6023,3179,2844
202007,45190,전라북도,남원시,50-54세,6847,3610,3237
202008,45190,전라북도,남원시,50-54세,6875,3629,3246
202009,45190,전라북도,남원시,50-54세,6880,3646,3234
202010,45190,전라북도,남원시,50-54세,6927,3687,3240
202011,45190,전라북도,남원시,50-54세,6901,3682,3219
202012,45190,전라북도,남원시,50-54세,6847,3654,3193
202101,45190,전라북도,남원시,50-54세,6852,3658,3194
202102,45190,전라북도,남원시,50-54세,6852,3660,3192
202103,45190,전라북도,남원시,50-54세,6823,3637,3186
202104,45190,전라북도,남원시,50-54세,6846,3647,3199
202105,45190,전라북도,남원시,50-54세,6849,3648,3201
202106,45190,전라북도,남원시,50-54세,6846,3652,3194
202007,45190,전라북도,남원시,55-59세,6933,3692,3241
202008,45190,전라북도,남원시,55-59세,6901,3674,3227
202009,45190,전라북도,남원시,55-59세,6886,3650,3236
202010,45190,전라북도,남원시,55-59세,6854,3628,3226
202011,45190,전라북도,남원시,55-59세,6851,3636,3215
202012,45190,전라북도,남원시,55-59세,6857,3655,3202
202101,45190,전라북도,남원시,55-59세,6843,3659,3184
202102,45190,전라북도,남원시,55-59세,6801,3640,3161
202103,45190,전라북도,남원시,55-59세,6797,3642,3155
202104,45190,전라북도,남원시,55-59세,6774,3633,3141
202105,45190,전라북도,남원시,55-59세,6733,3602,3131
202106,45190,전라북도,남원시,55-59세,6680,3574,3106
202007,45190,전라북도,남원시,60-64세,7043,3525,3518
202008,45190,전라북도,남원시,60-64세,7073,3544,3529
202009,45190,전라북도,남원시,60-64세,7088,3564,3524
202010,45190,전라북도,남원시,60-64세,7116,3585,3531
202011,45190,전라북도,남원시,60-64세,7139,3590,3549
202012,45190,전라북도,남원시,60-64세,7189,3608,3581
202101,45190,전라북도,남원시,60-64세,7224,3618,3606
202102,45190,전라북도,남원시,60-64세,7259,3630,3629
202103,45190,전라북도,남원시,60-64세,7320,3673,3647
202104,45190,전라북도,남원시,60-64세,7376,3705,3671
202105,45190,전라북도,남원시,60-64세,7440,3745,3695
202106,45190,전라북도,남원시,60-64세,7459,3761,3698
202007,45190,전라북도,남원시,65-69세,5657,2815,2842
202008,45190,전라북도,남원시,65-69세,5699,2837,2862
202009,45190,전라북도,남원시,65-69세,5722,2846,2876
202010,45190,전라북도,남원시,65-69세,5740,2855,2885
202011,45190,전라북도,남원시,65-69세,5749,2856,2893
202012,45190,전라북도,남원시,65-69세,5756,2849,2907
202101,45190,전라북도,남원시,65-69세,5783,2863,2920
202102,45190,전라북도,남원시,65-69세,5812,2879,2933
202103,45190,전라북도,남원시,65-69세,5850,2895,2955
202104,45190,전라북도,남원시,65-69세,5893,2904,2989
202105,45190,전라북도,남원시,65-69세,5903,2916,2987
202106,45190,전라북도,남원시,65-69세,5927,2919,3008
202007,45190,전라북도,남원시,70-74세,5169,2340,2829
202008,45190,전라북도,남원시,70-74세,5203,2353,2850
202009,45190,전라북도,남원시,70-74세,5217,2363,2854
202010,45190,전라북도,남원시,70-74세,5233,2371,2862
202011,45190,전라북도,남원시,70-74세,5289,2402,2887
202012,45190,전라북도,남원시,70-74세,5328,2423,2905
202101,45190,전라북도,남원시,70-74세,5342,2427,2915
202102,45190,전라북도,남원시,70-74세,5356,2442,2914
202103,45190,전라북도,남원시,70-74세,5373,2458,2915
202104,45190,전라북도,남원시,70-74세,5377,2465,2912
202105,45190,전라북도,남원시,70-74세,5372,2468,2904
202106,45190,전라북도,남원시,70-74세,5366,2462,2904
202007,45190,전라북도,남원시,75-79세,4605,1749,2856
202008,45190,전라북도,남원시,75-79세,4594,1747,2847
202009,45190,전라북도,남원시,75-79세,4585,1745,2840
202010,45190,전라북도,남원시,75-79세,4579,1744,2835
202011,45190,전라북도,남원시,75-79세,4533,1720,2813
202012,45190,전라북도,남원시,75-79세,4499,1709,2790
202101,45190,전라북도,남원시,75-79세,4447,1700,2747
202102,45190,전라북도,남원시,75-79세,4442,1710,2732
202103,45190,전라북도,남원시,75-79세,4405,1692,2713
202104,45190,전라북도,남원시,75-79세,4388,1689,2699
202105,45190,전라북도,남원시,75-79세,4386,1684,2702
202106,45190,전라북도,남원시,75-79세,4364,1673,2691
202007,45190,전라북도,남원시,80-84세,3841,1335,2506
202008,45190,전라북도,남원시,80-84세,3836,1345,2491
202009,45190,전라북도,남원시,80-84세,3817,1338,2479
202010,45190,전라북도,남원시,80-84세,3829,1344,2485
202011,45190,전라북도,남원시,80-84세,3847,1358,2489
202012,45190,전라북도,남원시,80-84세,3846,1353,2493
202101,45190,전라북도,남원시,80-84세,3866,1355,2511
202102,45190,전라북도,남원시,80-84세,3845,1333,2512
202103,45190,전라북도,남원시,80-84세,3869,1345,2524
202104,45190,전라북도,남원시,80-84세,3873,1348,2525
202105,45190,전라북도,남원시,80-84세,3871,1352,2519
202106,45190,전라북도,남원시,80-84세,3898,1374,2524
202007,45190,전라북도,남원시,85-89세,2194,604,1590
202008,45190,전라북도,남원시,85-89세,2220,603,1617
202009,45190,전라북도,남원시,85-89세,2247,616,1631
202010,45190,전라북도,남원시,85-89세,2237,615,1622
202011,45190,전라북도,남원시,85-89세,2255,627,1628
202012,45190,전라북도,남원시,85-89세,2275,639,1636
202101,45190,전라북도,남원시,85-89세,2294,643,1651
202102,45190,전라북도,남원시,85-89세,2347,664,1683
202103,45190,전라북도,남원시,85-89세,2341,659,1682
202104,45190,전라북도,남원시,85-89세,2359,663,1696
202105,45190,전라북도,남원시,85-89세,2379,675,1704
202106,45190,전라북도,남원시,85-89세,2393,684,1709
202007,45190,전라북도,남원시,90-94세,759,175,584
202008,45190,전라북도,남원시,90-94세,763,180,583
202009,45190,전라북도,남원시,90-94세,765,182,583
202010,45190,전라북도,남원시,90-94세,767,179,588
202011,45190,전라북도,남원시,90-94세,765,178,587
202012,45190,전라북도,남원시,90-94세,765,175,590
202101,45190,전라북도,남원시,90-94세,768,177,591
202102,45190,전라북도,남원시,90-94세,767,176,591
202103,45190,전라북도,남원시,90-94세,783,175,608
202104,45190,전라북도,남원시,90-94세,792,179,613
202105,45190,전라북도,남원시,90-94세,791,182,609
202106,45190,전라북도,남원시,90-94세,800,183,617
202007,45190,전라북도,남원시,95-99세,178,43,135
202008,45190,전라북도,남원시,95-99세,180,43,137
202009,45190,전라북도,남원시,95-99세,180,42,138
202010,45190,전라북도,남원시,95-99세,184,43,141
202011,45190,전라북도,남원시,95-99세,185,43,142
202012,45190,전라북도,남원시,95-99세,184,42,142
202101,45190,전라북도,남원시,95-99세,185,42,143
202102,45190,전라북도,남원시,95-99세,185,43,142
202103,45190,전라북도,남원시,95-99세,184,43,141
202104,45190,전라북도,남원시,95-99세,186,42,144
202105,45190,전라북도,남원시,95-99세,190,43,147
202106,45190,전라북도,남원시,95-99세,188,42,146
202007,45190,전라북도,남원시,100+,43,11,32
202008,45190,전라북도,남원시,100+,42,11,31
202009,45190,전라북도,남원시,100+,42,11,31
202010,45190,전라북도,남원시,100+,42,11,31
202011,45190,전라북도,남원시,100+,40,11,29
202012,45190,전라북도,남원시,100+,41,11,30
202101,45190,전라북도,남원시,100+,42,11,31
202102,45190,전라북도,남원시,100+,41,11,30
202103,45190,전라북도,남원시,100+,33,6,27
202104,45190,전라북도,남원시,100+,31,6,25
202105,45190,전라북도,남원시,100+,30,6,24
202106,45190,전라북도,남원시,100+,32,6,26
202007,45210,전라북도,김제시,0-4세,1747,915,832
202008,45210,전라북도,김제시,0-4세,1743,911,832
202009,45210,전라북도,김제시,0-4세,1720,893,827
202010,45210,전라북도,김제시,0-4세,1692,881,811
202011,45210,전라북도,김제시,0-4세,1672,868,804
202012,45210,전라북도,김제시,0-4세,1653,859,794
202101,45210,전라북도,김제시,0-4세,1630,843,787
202102,45210,전라북도,김제시,0-4세,1614,832,782
202103,45210,전라북도,김제시,0-4세,1602,826,776
202104,45210,전라북도,김제시,0-4세,1592,818,774
202105,45210,전라북도,김제시,0-4세,1581,813,768
202106,45210,전라북도,김제시,0-4세,1566,795,771
202007,45210,전라북도,김제시,5-9세,2741,1413,1328
202008,45210,전라북도,김제시,5-9세,2728,1408,1320
202009,45210,전라북도,김제시,5-9세,2710,1400,1310
202010,45210,전라북도,김제시,5-9세,2671,1373,1298
202011,45210,전라북도,김제시,5-9세,2658,1373,1285
202012,45210,전라북도,김제시,5-9세,2654,1369,1285
202101,45210,전라북도,김제시,5-9세,2637,1373,1264
202102,45210,전라북도,김제시,5-9세,2621,1372,1249
202103,45210,전라북도,김제시,5-9세,2615,1367,1248
202104,45210,전라북도,김제시,5-9세,2580,1354,1226
202105,45210,전라북도,김제시,5-9세,2558,1341,1217
202106,45210,전라북도,김제시,5-9세,2541,1342,1199
202007,45210,전라북도,김제시,10-14세,2948,1509,1439
202008,45210,전라북도,김제시,10-14세,2937,1515,1422
202009,45210,전라북도,김제시,10-14세,2936,1511,1425
202010,45210,전라북도,김제시,10-14세,2953,1517,1436
202011,45210,전라북도,김제시,10-14세,2941,1513,1428
202012,45210,전라북도,김제시,10-14세,2931,1507,1424
202101,45210,전라북도,김제시,10-14세,2954,1517,1437
202102,45210,전라북도,김제시,10-14세,2956,1514,1442
202103,45210,전라북도,김제시,10-14세,2952,1499,1453
202104,45210,전라북도,김제시,10-14세,2942,1485,1457
202105,45210,전라북도,김제시,10-14세,2947,1484,1463
202106,45210,전라북도,김제시,10-14세,2968,1496,1472
202007,45210,전라북도,김제시,15-19세,3350,1720,1630
202008,45210,전라북도,김제시,15-19세,3339,1713,1626
202009,45210,전라북도,김제시,15-19세,3316,1707,1609
202010,45210,전라북도,김제시,15-19세,3329,1725,1604
202011,45210,전라북도,김제시,15-19세,3298,1695,1603
202012,45210,전라북도,김제시,15-19세,3235,1658,1577
202101,45210,전라북도,김제시,15-19세,3202,1645,1557
202102,45210,전라북도,김제시,15-19세,3173,1639,1534
202103,45210,전라북도,김제시,15-19세,3156,1630,1526
202104,45210,전라북도,김제시,15-19세,3160,1630,1530
202105,45210,전라북도,김제시,15-19세,3139,1621,1518
202106,45210,전라북도,김제시,15-19세,3112,1606,1506
202007,45210,전라북도,김제시,20-24세,3914,2159,1755
202008,45210,전라북도,김제시,20-24세,3883,2152,1731
202009,45210,전라북도,김제시,20-24세,3865,2148,1717
202010,45210,전라북도,김제시,20-24세,3820,2124,1696
202011,45210,전라북도,김제시,20-24세,3833,2156,1677
202012,45210,전라북도,김제시,20-24세,3828,2160,1668
202101,45210,전라북도,김제시,20-24세,3817,2150,1667
202102,45210,전라북도,김제시,20-24세,3797,2137,1660
202103,45210,전라북도,김제시,20-24세,3753,2114,1639
202104,45210,전라북도,김제시,20-24세,3736,2108,1628
202105,45210,전라북도,김제시,20-24세,3719,2105,1614
202106,45210,전라북도,김제시,20-24세,3730,2109,1621
202007,45210,전라북도,김제시,25-29세,3414,1900,1514
202008,45210,전라북도,김제시,25-29세,3400,1889,1511
202009,45210,전라북도,김제시,25-29세,3417,1885,1532
202010,45210,전라북도,김제시,25-29세,3426,1894,1532
202011,45210,전라북도,김제시,25-29세,3402,1892,1510
202012,45210,전라북도,김제시,25-29세,3403,1874,1529
202101,45210,전라북도,김제시,25-29세,3382,1862,1520
202102,45210,전라북도,김제시,25-29세,3340,1855,1485
202103,45210,전라북도,김제시,25-29세,3342,1852,1490
202104,45210,전라북도,김제시,25-29세,3344,1855,1489
202105,45210,전라북도,김제시,25-29세,3317,1844,1473
202106,45210,전라북도,김제시,25-29세,3322,1836,1486
202007,45210,전라북도,김제시,30-34세,2939,1572,1367
202008,45210,전라북도,김제시,30-34세,2932,1554,1378
202009,45210,전라북도,김제시,30-34세,2919,1536,1383
202010,45210,전라북도,김제시,30-34세,2906,1538,1368
202011,45210,전라북도,김제시,30-34세,2875,1509,1366
202012,45210,전라북도,김제시,30-34세,2835,1492,1343
202101,45210,전라북도,김제시,30-34세,2851,1513,1338
202102,45210,전라북도,김제시,30-34세,2812,1495,1317
202103,45210,전라북도,김제시,30-34세,2828,1507,1321
202104,45210,전라북도,김제시,30-34세,2809,1486,1323
202105,45210,전라북도,김제시,30-34세,2805,1496,1309
202106,45210,전라북도,김제시,30-34세,2795,1495,1300
202007,45210,전라북도,김제시,35-39세,3884,2063,1821
202008,45210,전라북도,김제시,35-39세,3863,2063,1800
202009,45210,전라북도,김제시,35-39세,3843,2066,1777
202010,45210,전라북도,김제시,35-39세,3832,2044,1788
202011,45210,전라북도,김제시,35-39세,3805,2037,1768
202012,45210,전라북도,김제시,35-39세,3810,2047,1763
202101,45210,전라북도,김제시,35-39세,3742,2010,1732
202102,45210,전라북도,김제시,35-39세,3710,1981,1729
202103,45210,전라북도,김제시,35-39세,3687,1971,1716
202104,45210,전라북도,김제시,35-39세,3677,1962,1715
202105,45210,전라북도,김제시,35-39세,3627,1945,1682
202106,45210,전라북도,김제시,35-39세,3604,1925,1679
202007,45210,전라북도,김제시,40-44세,4445,2475,1970
202008,45210,전라북도,김제시,40-44세,4429,2460,1969
202009,45210,전라북도,김제시,40-44세,4406,2431,1975
202010,45210,전라북도,김제시,40-44세,4425,2439,1986
202011,45210,전라북도,김제시,40-44세,4409,2420,1989
202012,45210,전라북도,김제시,40-44세,4380,2403,1977
202101,45210,전라북도,김제시,40-44세,4372,2394,1978
202102,45210,전라북도,김제시,40-44세,4373,2404,1969
202103,45210,전라북도,김제시,40-44세,4338,2387,1951
202104,45210,전라북도,김제시,40-44세,4311,2386,1925
202105,45210,전라북도,김제시,40-44세,4278,2376,1902
202106,45210,전라북도,김제시,40-44세,4276,2370,1906
202007,45210,전라북도,김제시,45-49세,5751,3262,2489
202008,45210,전라북도,김제시,45-49세,5745,3258,2487
202009,45210,전라북도,김제시,45-49세,5698,3239,2459
202010,45210,전라북도,김제시,45-49세,5649,3217,2432
202011,45210,전라북도,김제시,45-49세,5622,3207,2415
202012,45210,전라북도,김제시,45-49세,5611,3206,2405
202101,45210,전라북도,김제시,45-49세,5611,3192,2419
202102,45210,전라북도,김제시,45-49세,5604,3178,2426
202103,45210,전라북도,김제시,45-49세,5588,3157,2431
202104,45210,전라북도,김제시,45-49세,5593,3162,2431
202105,45210,전라북도,김제시,45-49세,5489,3113,2376
202106,45210,전라북도,김제시,45-49세,5455,3100,2355
202007,45210,전라북도,김제시,50-54세,6513,3659,2854
202008,45210,전라북도,김제시,50-54세,6474,3642,2832
202009,45210,전라북도,김제시,50-54세,6502,3641,2861
202010,45210,전라북도,김제시,50-54세,6498,3644,2854
202011,45210,전라북도,김제시,50-54세,6500,3642,2858
202012,45210,전라북도,김제시,50-54세,6469,3626,2843
202101,45210,전라북도,김제시,50-54세,6466,3645,2821
202102,45210,전라북도,김제시,50-54세,6462,3639,2823
202103,45210,전라북도,김제시,50-54세,6416,3618,2798
202104,45210,전라북도,김제시,50-54세,6392,3607,2785
202105,45210,전라북도,김제시,50-54세,6383,3610,2773
202106,45210,전라북도,김제시,50-54세,6374,3595,2779
202007,45210,전라북도,김제시,55-59세,7512,3951,3561
202008,45210,전라북도,김제시,55-59세,7460,3942,3518
202009,45210,전라북도,김제시,55-59세,7399,3920,3479
202010,45210,전라북도,김제시,55-59세,7318,3876,3442
202011,45210,전라북도,김제시,55-59세,7270,3845,3425
202012,45210,전라북도,김제시,55-59세,7235,3820,3415
202101,45210,전라북도,김제시,55-59세,7185,3799,3386
202102,45210,전라북도,김제시,55-59세,7149,3780,3369
202103,45210,전라북도,김제시,55-59세,7129,3778,3351
202104,45210,전라북도,김제시,55-59세,7115,3771,3344
202105,45210,전라북도,김제시,55-59세,7025,3750,3275
202106,45210,전라북도,김제시,55-59세,6941,3718,3223
202007,45210,전라북도,김제시,60-64세,7893,4049,3844
202008,45210,전라북도,김제시,60-64세,7928,4059,3869
202009,45210,전라북도,김제시,60-64세,7959,4085,3874
202010,45210,전라북도,김제시,60-64세,8008,4105,3903
202011,45210,전라북도,김제시,60-64세,8055,4133,3922
202012,45210,전라북도,김제시,60-64세,8084,4153,3931
202101,45210,전라북도,김제시,60-64세,8114,4173,3941
202102,45210,전라북도,김제시,60-64세,8171,4206,3965
202103,45210,전라북도,김제시,60-64세,8221,4222,3999
202104,45210,전라북도,김제시,60-64세,8286,4257,4029
202105,45210,전라북도,김제시,60-64세,8285,4243,4042
202106,45210,전라북도,김제시,60-64세,8316,4276,4040
202007,45210,전라북도,김제시,65-69세,6411,3117,3294
202008,45210,전라북도,김제시,65-69세,6435,3119,3316
202009,45210,전라북도,김제시,65-69세,6443,3115,3328
202010,45210,전라북도,김제시,65-69세,6464,3151,3313
202011,45210,전라북도,김제시,65-69세,6467,3152,3315
202012,45210,전라북도,김제시,65-69세,6478,3141,3337
202101,45210,전라북도,김제시,65-69세,6505,3166,3339
202102,45210,전라북도,김제시,65-69세,6502,3180,3322
202103,45210,전라북도,김제시,65-69세,6568,3218,3350
202104,45210,전라북도,김제시,65-69세,6590,3234,3356
202105,45210,전라북도,김제시,65-69세,6590,3266,3324
202106,45210,전라북도,김제시,65-69세,6605,3266,3339
202007,45210,전라북도,김제시,70-74세,5887,2733,3154
202008,45210,전라북도,김제시,70-74세,5904,2751,3153
202009,45210,전라북도,김제시,70-74세,5949,2769,3180
202010,45210,전라북도,김제시,70-74세,5959,2764,3195
202011,45210,전라북도,김제시,70-74세,6008,2792,3216
202012,45210,전라북도,김제시,70-74세,6066,2839,3227
202101,45210,전라북도,김제시,70-74세,6096,2845,3251
202102,45210,전라북도,김제시,70-74세,6140,2858,3282
202103,45210,전라북도,김제시,70-74세,6164,2867,3297
202104,45210,전라북도,김제시,70-74세,6175,2869,3306
202105,45210,전라북도,김제시,70-74세,6159,2855,3304
202106,45210,전라북도,김제시,70-74세,6139,2852,3287
202007,45210,전라북도,김제시,75-79세,5434,2176,3258
202008,45210,전라북도,김제시,75-79세,5440,2176,3264
202009,45210,전라북도,김제시,75-79세,5413,2169,3244
202010,45210,전라북도,김제시,75-79세,5393,2159,3234
202011,45210,전라북도,김제시,75-79세,5371,2166,3205
202012,45210,전라북도,김제시,75-79세,5336,2144,3192
202101,45210,전라북도,김제시,75-79세,5314,2141,3173
202102,45210,전라북도,김제시,75-79세,5278,2125,3153
202103,45210,전라북도,김제시,75-79세,5259,2123,3136
202104,45210,전라북도,김제시,75-79세,5239,2120,3119
202105,45210,전라북도,김제시,75-79세,5214,2114,3100
202106,45210,전라북도,김제시,75-79세,5211,2121,3090
202007,45210,전라북도,김제시,80-84세,4482,1486,2996
202008,45210,전라북도,김제시,80-84세,4485,1494,2991
202009,45210,전라북도,김제시,80-84세,4444,1479,2965
202010,45210,전라북도,김제시,80-84세,4437,1477,2960
202011,45210,전라북도,김제시,80-84세,4420,1479,2941
202012,45210,전라북도,김제시,80-84세,4382,1482,2900
202101,45210,전라북도,김제시,80-84세,4362,1486,2876
202102,45210,전라북도,김제시,80-84세,4366,1494,2872
202103,45210,전라북도,김제시,80-84세,4351,1492,2859
202104,45210,전라북도,김제시,80-84세,4360,1488,2872
202105,45210,전라북도,김제시,80-84세,4353,1482,2871
202106,45210,전라북도,김제시,80-84세,4384,1488,2896
202007,45210,전라북도,김제시,85-89세,2675,755,1920
202008,45210,전라북도,김제시,85-89세,2686,762,1924
202009,45210,전라북도,김제시,85-89세,2716,774,1942
202010,45210,전라북도,김제시,85-89세,2729,779,1950
202011,45210,전라북도,김제시,85-89세,2736,770,1966
202012,45210,전라북도,김제시,85-89세,2784,779,2005
202101,45210,전라북도,김제시,85-89세,2802,774,2028
202102,45210,전라북도,김제시,85-89세,2834,789,2045
202103,45210,전라북도,김제시,85-89세,2842,787,2055
202104,45210,전라북도,김제시,85-89세,2858,797,2061
202105,45210,전라북도,김제시,85-89세,2862,788,2074
202106,45210,전라북도,김제시,85-89세,2856,785,2071
202007,45210,전라북도,김제시,90-94세,956,213,743
202008,45210,전라북도,김제시,90-94세,970,209,761
202009,45210,전라북도,김제시,90-94세,972,214,758
202010,45210,전라북도,김제시,90-94세,991,220,771
202011,45210,전라북도,김제시,90-94세,997,220,777
202012,45210,전라북도,김제시,90-94세,992,219,773
202101,45210,전라북도,김제시,90-94세,1001,217,784
202102,45210,전라북도,김제시,90-94세,1008,215,793
202103,45210,전라북도,김제시,90-94세,1017,217,800
202104,45210,전라북도,김제시,90-94세,1017,217,800
202105,45210,전라북도,김제시,90-94세,1019,224,795
202106,45210,전라북도,김제시,90-94세,1028,227,801
202007,45210,전라북도,김제시,95-99세,208,49,159
202008,45210,전라북도,김제시,95-99세,206,49,157
202009,45210,전라북도,김제시,95-99세,212,50,162
202010,45210,전라북도,김제시,95-99세,212,50,162
202011,45210,전라북도,김제시,95-99세,210,51,159
202012,45210,전라북도,김제시,95-99세,208,51,157
202101,45210,전라북도,김제시,95-99세,208,48,160
202102,45210,전라북도,김제시,95-99세,209,48,161
202103,45210,전라북도,김제시,95-99세,213,49,164
202104,45210,전라북도,김제시,95-99세,214,47,167
202105,45210,전라북도,김제시,95-99세,204,42,162
202106,45210,전라북도,김제시,95-99세,198,41,157
202007,45210,전라북도,김제시,100+,73,13,60
202008,45210,전라북도,김제시,100+,74,14,60
202009,45210,전라북도,김제시,100+,75,14,61
202010,45210,전라북도,김제시,100+,74,14,60
202011,45210,전라북도,김제시,100+,74,14,60
202012,45210,전라북도,김제시,100+,76,15,61
202101,45210,전라북도,김제시,100+,75,15,60
202102,45210,전라북도,김제시,100+,74,15,59
202103,45210,전라북도,김제시,100+,38,7,31
202104,45210,전라북도,김제시,100+,41,8,33
202105,45210,전라북도,김제시,100+,39,6,33
202106,45210,전라북도,김제시,100+,41,6,35
202007,45710,전라북도,완주군,0-4세,2879,1418,1461
202008,45710,전라북도,완주군,0-4세,2850,1403,1447
202009,45710,전라북도,완주군,0-4세,2818,1375,1443
202010,45710,전라북도,완주군,0-4세,2764,1356,1408
202011,45710,전라북도,완주군,0-4세,2736,1341,1395
202012,45710,전라북도,완주군,0-4세,2732,1340,1392
202101,45710,전라북도,완주군,0-4세,2700,1320,1380
202102,45710,전라북도,완주군,0-4세,2666,1298,1368
202103,45710,전라북도,완주군,0-4세,2631,1274,1357
202104,45710,전라북도,완주군,0-4세,2617,1263,1354
202105,45710,전라북도,완주군,0-4세,2563,1245,1318
202106,45710,전라북도,완주군,0-4세,2520,1226,1294
202007,45710,전라북도,완주군,5-9세,4334,2212,2122
202008,45710,전라북도,완주군,5-9세,4302,2200,2102
202009,45710,전라북도,완주군,5-9세,4272,2187,2085
202010,45710,전라북도,완주군,5-9세,4227,2164,2063
202011,45710,전라북도,완주군,5-9세,4173,2138,2035
202012,45710,전라북도,완주군,5-9세,4179,2136,2043
202101,45710,전라북도,완주군,5-9세,4124,2101,2023
202102,45710,전라북도,완주군,5-9세,4094,2086,2008
202103,45710,전라북도,완주군,5-9세,4079,2074,2005
202104,45710,전라북도,완주군,5-9세,4058,2068,1990
202105,45710,전라북도,완주군,5-9세,4059,2056,2003
202106,45710,전라북도,완주군,5-9세,4047,2047,2000
202007,45710,전라북도,완주군,10-14세,4228,2181,2047
202008,45710,전라북도,완주군,10-14세,4214,2170,2044
202009,45710,전라북도,완주군,10-14세,4250,2183,2067
202010,45710,전라북도,완주군,10-14세,4262,2192,2070
202011,45710,전라북도,완주군,10-14세,4265,2189,2076
202012,45710,전라북도,완주군,10-14세,4276,2210,2066
202101,45710,전라북도,완주군,10-14세,4262,2198,2064
202102,45710,전라북도,완주군,10-14세,4254,2197,2057
202103,45710,전라북도,완주군,10-14세,4244,2187,2057
202104,45710,전라북도,완주군,10-14세,4247,2195,2052
202105,45710,전라북도,완주군,10-14세,4262,2200,2062
202106,45710,전라북도,완주군,10-14세,4265,2208,2057
202007,45710,전라북도,완주군,15-19세,4124,2190,1934
202008,45710,전라북도,완주군,15-19세,4104,2179,1925
202009,45710,전라북도,완주군,15-19세,4089,2166,1923
202010,45710,전라북도,완주군,15-19세,4090,2160,1930
202011,45710,전라북도,완주군,15-19세,4074,2144,1930
202012,45710,전라북도,완주군,15-19세,4035,2129,1906
202101,45710,전라북도,완주군,15-19세,4014,2125,1889
202102,45710,전라북도,완주군,15-19세,3997,2117,1880
202103,45710,전라북도,완주군,15-19세,3958,2097,1861
202104,45710,전라북도,완주군,15-19세,3928,2075,1853
202105,45710,전라북도,완주군,15-19세,3918,2078,1840
202106,45710,전라북도,완주군,15-19세,3919,2069,1850
202007,45710,전라북도,완주군,20-24세,4685,2621,2064
202008,45710,전라북도,완주군,20-24세,4653,2612,2041
202009,45710,전라북도,완주군,20-24세,4639,2618,2021
202010,45710,전라북도,완주군,20-24세,4607,2601,2006
202011,45710,전라북도,완주군,20-24세,4577,2579,1998
202012,45710,전라북도,완주군,20-24세,4588,2584,2004
202101,45710,전라북도,완주군,20-24세,4562,2558,2004
202102,45710,전라북도,완주군,20-24세,4549,2554,1995
202103,45710,전라북도,완주군,20-24세,4507,2534,1973
202104,45710,전라북도,완주군,20-24세,4483,2522,1961
202105,45710,전라북도,완주군,20-24세,4487,2525,1962
202106,45710,전라북도,완주군,20-24세,4488,2531,1957
202007,45710,전라북도,완주군,25-29세,4292,2365,1927
202008,45710,전라북도,완주군,25-29세,4305,2367,1938
202009,45710,전라북도,완주군,25-29세,4347,2392,1955
202010,45710,전라북도,완주군,25-29세,4326,2382,1944
202011,45710,전라북도,완주군,25-29세,4324,2388,1936
202012,45710,전라북도,완주군,25-29세,4368,2415,1953
202101,45710,전라북도,완주군,25-29세,4359,2403,1956
202102,45710,전라북도,완주군,25-29세,4346,2395,1951
202103,45710,전라북도,완주군,25-29세,4335,2394,1941
202104,45710,전라북도,완주군,25-29세,4361,2407,1954
202105,45710,전라북도,완주군,25-29세,4357,2417,1940
202106,45710,전라북도,완주군,25-29세,4331,2413,1918
202007,45710,전라북도,완주군,30-34세,3998,2073,1925
202008,45710,전라북도,완주군,30-34세,3981,2069,1912
202009,45710,전라북도,완주군,30-34세,3964,2054,1910
202010,45710,전라북도,완주군,30-34세,3913,2029,1884
202011,45710,전라북도,완주군,30-34세,3897,2036,1861
202012,45710,전라북도,완주군,30-34세,3898,2036,1862
202101,45710,전라북도,완주군,30-34세,3890,2034,1856
202102,45710,전라북도,완주군,30-34세,3884,2052,1832
202103,45710,전라북도,완주군,30-34세,3864,2053,1811
202104,45710,전라북도,완주군,30-34세,3858,2058,1800
202105,45710,전라북도,완주군,30-34세,3845,2037,1808
202106,45710,전라북도,완주군,30-34세,3851,2022,1829
202007,45710,전라북도,완주군,35-39세,5677,2897,2780
202008,45710,전라북도,완주군,35-39세,5645,2879,2766
202009,45710,전라북도,완주군,35-39세,5613,2885,2728
202010,45710,전라북도,완주군,35-39세,5515,2833,2682
202011,45710,전라북도,완주군,35-39세,5484,2797,2687
202012,45710,전라북도,완주군,35-39세,5510,2805,2705
202101,45710,전라북도,완주군,35-39세,5398,2740,2658
202102,45710,전라북도,완주군,35-39세,5362,2725,2637
202103,45710,전라북도,완주군,35-39세,5305,2691,2614
202104,45710,전라북도,완주군,35-39세,5272,2678,2594
202105,45710,전라북도,완주군,35-39세,5242,2672,2570
202106,45710,전라북도,완주군,35-39세,5208,2667,2541
202007,45710,전라북도,완주군,40-44세,6394,3482,2912
202008,45710,전라북도,완주군,40-44세,6372,3469,2903
202009,45710,전라북도,완주군,40-44세,6388,3475,2913
202010,45710,전라북도,완주군,40-44세,6390,3458,2932
202011,45710,전라북도,완주군,40-44세,6385,3461,2924
202012,45710,전라북도,완주군,40-44세,6362,3452,2910
202101,45710,전라북도,완주군,40-44세,6386,3467,2919
202102,45710,전라북도,완주군,40-44세,6386,3451,2935
202103,45710,전라북도,완주군,40-44세,6341,3436,2905
202104,45710,전라북도,완주군,40-44세,6322,3416,2906
202105,45710,전라북도,완주군,40-44세,6316,3402,2914
202106,45710,전라북도,완주군,40-44세,6306,3372,2934
202007,45710,전라북도,완주군,45-49세,7229,4081,3148
202008,45710,전라북도,완주군,45-49세,7235,4088,3147
202009,45710,전라북도,완주군,45-49세,7208,4073,3135
202010,45710,전라북도,완주군,45-49세,7173,4057,3116
202011,45710,전라북도,완주군,45-49세,7143,4029,3114
202012,45710,전라북도,완주군,45-49세,7186,4062,3124
202101,45710,전라북도,완주군,45-49세,7177,4044,3133
202102,45710,전라북도,완주군,45-49세,7158,4030,3128
202103,45710,전라북도,완주군,45-49세,7134,4009,3125
202104,45710,전라북도,완주군,45-49세,7095,3974,3121
202105,45710,전라북도,완주군,45-49세,7040,3949,3091
202106,45710,전라북도,완주군,45-49세,6994,3934,3060
202007,45710,전라북도,완주군,50-54세,7506,4287,3219
202008,45710,전라북도,완주군,50-54세,7524,4284,3240
202009,45710,전라북도,완주군,50-54세,7535,4286,3249
202010,45710,전라북도,완주군,50-54세,7520,4271,3249
202011,45710,전라북도,완주군,50-54세,7511,4261,3250
202012,45710,전라북도,완주군,50-54세,7505,4260,3245
202101,45710,전라북도,완주군,50-54세,7499,4254,3245
202102,45710,전라북도,완주군,50-54세,7492,4255,3237
202103,45710,전라북도,완주군,50-54세,7393,4200,3193
202104,45710,전라북도,완주군,50-54세,7421,4216,3205
202105,45710,전라북도,완주군,50-54세,7499,4238,3261
202106,45710,전라북도,완주군,50-54세,7563,4272,3291
202007,45710,전라북도,완주군,55-59세,7825,4254,3571
202008,45710,전라북도,완주군,55-59세,7804,4249,3555
202009,45710,전라북도,완주군,55-59세,7795,4234,3561
202010,45710,전라북도,완주군,55-59세,7762,4239,3523
202011,45710,전라북도,완주군,55-59세,7761,4241,3520
202012,45710,전라북도,완주군,55-59세,7749,4230,3519
202101,45710,전라북도,완주군,55-59세,7697,4211,3486
202102,45710,전라북도,완주군,55-59세,7670,4183,3487
202103,45710,전라북도,완주군,55-59세,7680,4217,3463
202104,45710,전라북도,완주군,55-59세,7699,4240,3459
202105,45710,전라북도,완주군,55-59세,7667,4220,3447
202106,45710,전라북도,완주군,55-59세,7554,4161,3393
202007,45710,전라북도,완주군,60-64세,7616,3947,3669
202008,45710,전라북도,완주군,60-64세,7670,3979,3691
202009,45710,전라북도,완주군,60-64세,7676,3984,3692
202010,45710,전라북도,완주군,60-64세,7727,3999,3728
202011,45710,전라북도,완주군,60-64세,7765,4035,3730
202012,45710,전라북도,완주군,60-64세,7811,4055,3756
202101,45710,전라북도,완주군,60-64세,7875,4086,3789
202102,45710,전라북도,완주군,60-64세,7926,4120,3806
202103,45710,전라북도,완주군,60-64세,7974,4158,3816
202104,45710,전라북도,완주군,60-64세,8019,4171,3848
202105,45710,전라북도,완주군,60-64세,8048,4206,3842
202106,45710,전라북도,완주군,60-64세,8139,4261,3878
202007,45710,전라북도,완주군,65-69세,5904,3047,2857
202008,45710,전라북도,완주군,65-69세,5907,3044,2863
202009,45710,전라북도,완주군,65-69세,5984,3086,2898
202010,45710,전라북도,완주군,65-69세,6002,3107,2895
202011,45710,전라북도,완주군,65-69세,6045,3128,2917
202012,45710,전라북도,완주군,65-69세,6047,3129,2918
202101,45710,전라북도,완주군,65-69세,6088,3149,2939
202102,45710,전라북도,완주군,65-69세,6143,3185,2958
202103,45710,전라북도,완주군,65-69세,6195,3206,2989
202104,45710,전라북도,완주군,65-69세,6252,3235,3017
202105,45710,전라북도,완주군,65-69세,6279,3254,3025
202106,45710,전라북도,완주군,65-69세,6288,3258,3030
202007,45710,전라북도,완주군,70-74세,4948,2462,2486
202008,45710,전라북도,완주군,70-74세,4971,2486,2485
202009,45710,전라북도,완주군,70-74세,5001,2506,2495
202010,45710,전라북도,완주군,70-74세,5052,2528,2524
202011,45710,전라북도,완주군,70-74세,5072,2546,2526
202012,45710,전라북도,완주군,70-74세,5119,2568,2551
202101,45710,전라북도,완주군,70-74세,5153,2589,2564
202102,45710,전라북도,완주군,70-74세,5163,2593,2570
202103,45710,전라북도,완주군,70-74세,5173,2591,2582
202104,45710,전라북도,완주군,70-74세,5166,2598,2568
202105,45710,전라북도,완주군,70-74세,5183,2594,2589
202106,45710,전라북도,완주군,70-74세,5179,2588,2591
202007,45710,전라북도,완주군,75-79세,4146,1698,2448
202008,45710,전라북도,완주군,75-79세,4152,1698,2454
202009,45710,전라북도,완주군,75-79세,4151,1707,2444
202010,45710,전라북도,완주군,75-79세,4144,1706,2438
202011,45710,전라북도,완주군,75-79세,4160,1715,2445
202012,45710,전라북도,완주군,75-79세,4148,1718,2430
202101,45710,전라북도,완주군,75-79세,4146,1721,2425
202102,45710,전라북도,완주군,75-79세,4146,1726,2420
202103,45710,전라북도,완주군,75-79세,4120,1722,2398
202104,45710,전라북도,완주군,75-79세,4122,1729,2393
202105,45710,전라북도,완주군,75-79세,4114,1734,2380
202106,45710,전라북도,완주군,75-79세,4109,1740,2369
202007,45710,전라북도,완주군,80-84세,3391,1190,2201
202008,45710,전라북도,완주군,80-84세,3387,1196,2191
202009,45710,전라북도,완주군,80-84세,3386,1191,2195
202010,45710,전라북도,완주군,80-84세,3367,1184,2183
202011,45710,전라북도,완주군,80-84세,3345,1181,2164
202012,45710,전라북도,완주군,80-84세,3327,1174,2153
202101,45710,전라북도,완주군,80-84세,3326,1173,2153
202102,45710,전라북도,완주군,80-84세,3348,1187,2161
202103,45710,전라북도,완주군,80-84세,3342,1191,2151
202104,45710,전라북도,완주군,80-84세,3336,1190,2146
202105,45710,전라북도,완주군,80-84세,3348,1202,2146
202106,45710,전라북도,완주군,80-84세,3355,1209,2146
202007,45710,전라북도,완주군,85-89세,1840,563,1277
202008,45710,전라북도,완주군,85-89세,1853,565,1288
202009,45710,전라북도,완주군,85-89세,1865,569,1296
202010,45710,전라북도,완주군,85-89세,1881,576,1305
202011,45710,전라북도,완주군,85-89세,1900,584,1316
202012,45710,전라북도,완주군,85-89세,1932,598,1334
202101,45710,전라북도,완주군,85-89세,1943,606,1337
202102,45710,전라북도,완주군,85-89세,1968,611,1357
202103,45710,전라북도,완주군,85-89세,2000,616,1384
202104,45710,전라북도,완주군,85-89세,2021,622,1399
202105,45710,전라북도,완주군,85-89세,2045,629,1416
202106,45710,전라북도,완주군,85-89세,2042,616,1426
202007,45710,전라북도,완주군,90-94세,636,143,493
202008,45710,전라북도,완주군,90-94세,634,143,491
202009,45710,전라북도,완주군,90-94세,644,148,496
202010,45710,전라북도,완주군,90-94세,654,151,503
202011,45710,전라북도,완주군,90-94세,648,145,503
202012,45710,전라북도,완주군,90-94세,655,145,510
202101,45710,전라북도,완주군,90-94세,670,150,520
202102,45710,전라북도,완주군,90-94세,689,155,534
202103,45710,전라북도,완주군,90-94세,689,156,533
202104,45710,전라북도,완주군,90-94세,689,159,530
202105,45710,전라북도,완주군,90-94세,692,155,537
202106,45710,전라북도,완주군,90-94세,699,160,539
202007,45710,전라북도,완주군,95-99세,132,18,114
202008,45710,전라북도,완주군,95-99세,134,19,115
202009,45710,전라북도,완주군,95-99세,137,20,117
202010,45710,전라북도,완주군,95-99세,133,20,113
202011,45710,전라북도,완주군,95-99세,135,22,113
202012,45710,전라북도,완주군,95-99세,139,23,116
202101,45710,전라북도,완주군,95-99세,137,23,114
202102,45710,전라북도,완주군,95-99세,135,23,112
202103,45710,전라북도,완주군,95-99세,130,21,109
202104,45710,전라북도,완주군,95-99세,128,20,108
202105,45710,전라북도,완주군,95-99세,132,22,110
202106,45710,전라북도,완주군,95-99세,137,22,115
202007,45710,전라북도,완주군,100+,44,10,34
202008,45710,전라북도,완주군,100+,44,10,34
202009,45710,전라북도,완주군,100+,44,10,34
202010,45710,전라북도,완주군,100+,44,10,34
202011,45710,전라북도,완주군,100+,45,10,35
202012,45710,전라북도,완주군,100+,43,8,35
202101,45710,전라북도,완주군,100+,44,8,36
202102,45710,전라북도,완주군,100+,46,8,38
202103,45710,전라북도,완주군,100+,33,6,27
202104,45710,전라북도,완주군,100+,33,6,27
202105,45710,전라북도,완주군,100+,30,6,24
202106,45710,전라북도,완주군,100+,30,6,24
202007,45720,전라북도,진안군,0-4세,634,330,304
202008,45720,전라북도,진안군,0-4세,634,325,309
202009,45720,전라북도,진안군,0-4세,635,323,312
202010,45720,전라북도,진안군,0-4세,622,315,307
202011,45720,전라북도,진안군,0-4세,621,315,306
202012,45720,전라북도,진안군,0-4세,614,314,300
202101,45720,전라북도,진안군,0-4세,605,312,293
202102,45720,전라북도,진안군,0-4세,594,309,285
202103,45720,전라북도,진안군,0-4세,594,305,289
202104,45720,전라북도,진안군,0-4세,592,306,286
202105,45720,전라북도,진안군,0-4세,594,308,286
202106,45720,전라북도,진안군,0-4세,593,308,285
202007,45720,전라북도,진안군,5-9세,707,338,369
202008,45720,전라북도,진안군,5-9세,690,327,363
202009,45720,전라북도,진안군,5-9세,685,327,358
202010,45720,전라북도,진안군,5-9세,667,318,349
202011,45720,전라북도,진안군,5-9세,660,312,348
202012,45720,전라북도,진안군,5-9세,662,312,350
202101,45720,전라북도,진안군,5-9세,656,304,352
202102,45720,전라북도,진안군,5-9세,654,305,349
202103,45720,전라북도,진안군,5-9세,647,301,346
202104,45720,전라북도,진안군,5-9세,637,292,345
202105,45720,전라북도,진안군,5-9세,627,282,345
202106,45720,전라북도,진안군,5-9세,622,281,341
202007,45720,전라북도,진안군,10-14세,781,409,372
202008,45720,전라북도,진안군,10-14세,781,414,367
202009,45720,전라북도,진안군,10-14세,773,407,366
202010,45720,전라북도,진안군,10-14세,785,407,378
202011,45720,전라북도,진안군,10-14세,780,405,375
202012,45720,전라북도,진안군,10-14세,786,407,379
202101,45720,전라북도,진안군,10-14세,784,416,368
202102,45720,전라북도,진안군,10-14세,787,412,375
202103,45720,전라북도,진안군,10-14세,785,410,375
202104,45720,전라북도,진안군,10-14세,792,412,380
202105,45720,전라북도,진안군,10-14세,788,413,375
202106,45720,전라북도,진안군,10-14세,791,417,374
202007,45720,전라북도,진안군,15-19세,889,481,408
202008,45720,전라북도,진안군,15-19세,894,483,411
202009,45720,전라북도,진안군,15-19세,897,487,410
202010,45720,전라북도,진안군,15-19세,899,488,411
202011,45720,전라북도,진안군,15-19세,896,485,411
202012,45720,전라북도,진안군,15-19세,894,481,413
202101,45720,전라북도,진안군,15-19세,879,471,408
202102,45720,전라북도,진안군,15-19세,871,466,405
202103,45720,전라북도,진안군,15-19세,863,463,400
202104,45720,전라북도,진안군,15-19세,855,463,392
202105,45720,전라북도,진안군,15-19세,849,457,392
202106,45720,전라북도,진안군,15-19세,849,455,394
202007,45720,전라북도,진안군,20-24세,1080,619,461
202008,45720,전라북도,진안군,20-24세,1076,612,464
202009,45720,전라북도,진안군,20-24세,1076,609,467
202010,45720,전라북도,진안군,20-24세,1069,603,466
202011,45720,전라북도,진안군,20-24세,1054,591,463
202012,45720,전라북도,진안군,20-24세,1064,600,464
202101,45720,전라북도,진안군,20-24세,1060,597,463
202102,45720,전라북도,진안군,20-24세,1038,590,448
202103,45720,전라북도,진안군,20-24세,1030,591,439
202104,45720,전라북도,진안군,20-24세,1025,585,440
202105,45720,전라북도,진안군,20-24세,1022,585,437
202106,45720,전라북도,진안군,20-24세,1011,579,432
202007,45720,전라북도,진안군,25-29세,889,497,392
202008,45720,전라북도,진안군,25-29세,893,501,392
202009,45720,전라북도,진안군,25-29세,889,504,385
202010,45720,전라북도,진안군,25-29세,890,505,385
202011,45720,전라북도,진안군,25-29세,889,508,381
202012,45720,전라북도,진안군,25-29세,905,527,378
202101,45720,전라북도,진안군,25-29세,879,509,370
202102,45720,전라북도,진안군,25-29세,875,509,366
202103,45720,전라북도,진안군,25-29세,883,513,370
202104,45720,전라북도,진안군,25-29세,885,508,377
202105,45720,전라북도,진안군,25-29세,879,502,377
202106,45720,전라북도,진안군,25-29세,881,498,383
202007,45720,전라북도,진안군,30-34세,768,366,402
202008,45720,전라북도,진안군,30-34세,752,358,394
202009,45720,전라북도,진안군,30-34세,746,361,385
202010,45720,전라북도,진안군,30-34세,733,350,383
202011,45720,전라북도,진안군,30-34세,733,354,379
202012,45720,전라북도,진안군,30-34세,718,347,371
202101,45720,전라북도,진안군,30-34세,726,352,374
202102,45720,전라북도,진안군,30-34세,721,353,368
202103,45720,전라북도,진안군,30-34세,709,341,368
202104,45720,전라북도,진안군,30-34세,704,344,360
202105,45720,전라북도,진안군,30-34세,714,353,361
202106,45720,전라북도,진안군,30-34세,702,347,355
202007,45720,전라북도,진안군,35-39세,964,472,492
202008,45720,전라북도,진안군,35-39세,960,468,492
202009,45720,전라북도,진안군,35-39세,948,464,484
202010,45720,전라북도,진안군,35-39세,926,453,473
202011,45720,전라북도,진안군,35-39세,909,444,465
202012,45720,전라북도,진안군,35-39세,917,444,473
202101,45720,전라북도,진안군,35-39세,909,438,471
202102,45720,전라북도,진안군,35-39세,894,429,465
202103,45720,전라북도,진안군,35-39세,886,423,463
202104,45720,전라북도,진안군,35-39세,877,422,455
202105,45720,전라북도,진안군,35-39세,867,413,454
202106,45720,전라북도,진안군,35-39세,860,409,451
202007,45720,전라북도,진안군,40-44세,1194,701,493
202008,45720,전라북도,진안군,40-44세,1187,696,491
202009,45720,전라북도,진안군,40-44세,1185,689,496
202010,45720,전라북도,진안군,40-44세,1181,686,495
202011,45720,전라북도,진안군,40-44세,1177,679,498
202012,45720,전라북도,진안군,40-44세,1164,675,489
202101,45720,전라북도,진안군,40-44세,1152,666,486
202102,45720,전라북도,진안군,40-44세,1146,654,492
202103,45720,전라북도,진안군,40-44세,1140,650,490
202104,45720,전라북도,진안군,40-44세,1128,650,478
202105,45720,전라북도,진안군,40-44세,1114,641,473
202106,45720,전라북도,진안군,40-44세,1114,648,466
202007,45720,전라북도,진안군,45-49세,1639,958,681
202008,45720,전라북도,진안군,45-49세,1628,949,679
202009,45720,전라북도,진안군,45-49세,1612,939,673
202010,45720,전라북도,진안군,45-49세,1602,934,668
202011,45720,전라북도,진안군,45-49세,1584,926,658
202012,45720,전라북도,진안군,45-49세,1584,926,658
202101,45720,전라북도,진안군,45-49세,1571,914,657
202102,45720,전라북도,진안군,45-49세,1570,919,651
202103,45720,전라북도,진안군,45-49세,1538,908,630
202104,45720,전라북도,진안군,45-49세,1537,902,635
202105,45720,전라북도,진안군,45-49세,1526,899,627
202106,45720,전라북도,진안군,45-49세,1507,885,622
202007,45720,전라북도,진안군,50-54세,2058,1187,871
202008,45720,전라북도,진안군,50-54세,2072,1198,874
202009,45720,전라북도,진안군,50-54세,2072,1204,868
202010,45720,전라북도,진안군,50-54세,2075,1200,875
202011,45720,전라북도,진안군,50-54세,2064,1190,874
202012,45720,전라북도,진안군,50-54세,2058,1189,869
202101,45720,전라북도,진안군,50-54세,2063,1193,870
202102,45720,전라북도,진안군,50-54세,2044,1175,869
202103,45720,전라북도,진안군,50-54세,2027,1171,856
202104,45720,전라북도,진안군,50-54세,2028,1173,855
202105,45720,전라북도,진안군,50-54세,2028,1171,857
202106,45720,전라북도,진안군,50-54세,2023,1162,861
202007,45720,전라북도,진안군,55-59세,2516,1394,1122
202008,45720,전라북도,진안군,55-59세,2498,1379,1119
202009,45720,전라북도,진안군,55-59세,2486,1373,1113
202010,45720,전라북도,진안군,55-59세,2473,1365,1108
202011,45720,전라북도,진안군,55-59세,2457,1357,1100
202012,45720,전라북도,진안군,55-59세,2458,1362,1096
202101,45720,전라북도,진안군,55-59세,2453,1358,1095
202102,45720,전라북도,진안군,55-59세,2444,1348,1096
202103,45720,전라북도,진안군,55-59세,2435,1348,1087
202104,45720,전라북도,진안군,55-59세,2427,1345,1082
202105,45720,전라북도,진안군,55-59세,2430,1350,1080
202106,45720,전라북도,진안군,55-59세,2412,1347,1065
202007,45720,전라북도,진안군,60-64세,2568,1372,1196
202008,45720,전라북도,진안군,60-64세,2587,1380,1207
202009,45720,전라북도,진안군,60-64세,2610,1400,1210
202010,45720,전라북도,진안군,60-64세,2640,1416,1224
202011,45720,전라북도,진안군,60-64세,2655,1425,1230
202012,45720,전라북도,진안군,60-64세,2672,1439,1233
202101,45720,전라북도,진안군,60-64세,2678,1441,1237
202102,45720,전라북도,진안군,60-64세,2716,1465,1251
202103,45720,전라북도,진안군,60-64세,2758,1490,1268
202104,45720,전라북도,진안군,60-64세,2797,1515,1282
202105,45720,전라북도,진안군,60-64세,2818,1527,1291
202106,45720,전라북도,진안군,60-64세,2850,1545,1305
202007,45720,전라북도,진안군,65-69세,2143,1107,1036
202008,45720,전라북도,진안군,65-69세,2152,1112,1040
202009,45720,전라북도,진안군,65-69세,2158,1110,1048
202010,45720,전라북도,진안군,65-69세,2153,1110,1043
202011,45720,전라북도,진안군,65-69세,2165,1121,1044
202012,45720,전라북도,진안군,65-69세,2183,1134,1049
202101,45720,전라북도,진안군,65-69세,2209,1151,1058
202102,45720,전라북도,진안군,65-69세,2218,1156,1062
202103,45720,전라북도,진안군,65-69세,2230,1160,1070
202104,45720,전라북도,진안군,65-69세,2237,1161,1076
202105,45720,전라북도,진안군,65-69세,2221,1154,1067
202106,45720,전라북도,진안군,65-69세,2225,1162,1063
202007,45720,전라북도,진안군,70-74세,1966,953,1013
202008,45720,전라북도,진안군,70-74세,1967,945,1022
202009,45720,전라북도,진안군,70-74세,1969,945,1024
202010,45720,전라북도,진안군,70-74세,1988,960,1028
202011,45720,전라북도,진안군,70-74세,2000,963,1037
202012,45720,전라북도,진안군,70-74세,2010,969,1041
202101,45720,전라북도,진안군,70-74세,2017,970,1047
202102,45720,전라북도,진안군,70-74세,2014,965,1049
202103,45720,전라북도,진안군,70-74세,2031,973,1058
202104,45720,전라북도,진안군,70-74세,2025,972,1053
202105,45720,전라북도,진안군,70-74세,2035,978,1057
202106,45720,전라북도,진안군,70-74세,2035,975,1060
202007,45720,전라북도,진안군,75-79세,1869,797,1072
202008,45720,전라북도,진안군,75-79세,1855,795,1060
202009,45720,전라북도,진안군,75-79세,1853,799,1054
202010,45720,전라북도,진안군,75-79세,1840,794,1046
202011,45720,전라북도,진안군,75-79세,1833,801,1032
202012,45720,전라북도,진안군,75-79세,1819,793,1026
202101,45720,전라북도,진안군,75-79세,1808,793,1015
202102,45720,전라북도,진안군,75-79세,1797,798,999
202103,45720,전라북도,진안군,75-79세,1776,785,991
202104,45720,전라북도,진안군,75-79세,1771,782,989
202105,45720,전라북도,진안군,75-79세,1771,785,986
202106,45720,전라북도,진안군,75-79세,1759,776,983
202007,45720,전라북도,진안군,80-84세,1564,545,1019
202008,45720,전라북도,진안군,80-84세,1579,551,1028
202009,45720,전라북도,진안군,80-84세,1571,543,1028
202010,45720,전라북도,진안군,80-84세,1579,546,1033
202011,45720,전라북도,진안군,80-84세,1578,540,1038
202012,45720,전라북도,진안군,80-84세,1594,546,1048
202101,45720,전라북도,진안군,80-84세,1595,543,1052
202102,45720,전라북도,진안군,80-84세,1605,547,1058
202103,45720,전라북도,진안군,80-84세,1597,543,1054
202104,45720,전라북도,진안군,80-84세,1583,542,1041
202105,45720,전라북도,진안군,80-84세,1593,545,1048
202106,45720,전라북도,진안군,80-84세,1585,541,1044
202007,45720,전라북도,진안군,85-89세,859,248,611
202008,45720,전라북도,진안군,85-89세,870,252,618
202009,45720,전라북도,진안군,85-89세,884,261,623
202010,45720,전라북도,진안군,85-89세,890,264,626
202011,45720,전라북도,진안군,85-89세,898,268,630
202012,45720,전라북도,진안군,85-89세,897,268,629
202101,45720,전라북도,진안군,85-89세,902,272,630
202102,45720,전라북도,진안군,85-89세,920,277,643
202103,45720,전라북도,진안군,85-89세,934,287,647
202104,45720,전라북도,진안군,85-89세,950,289,661
202105,45720,전라북도,진안군,85-89세,954,291,663
202106,45720,전라북도,진안군,85-89세,964,299,665
202007,45720,전라북도,진안군,90-94세,294,75,219
202008,45720,전라북도,진안군,90-94세,295,75,220
202009,45720,전라북도,진안군,90-94세,300,75,225
202010,45720,전라북도,진안군,90-94세,304,75,229
202011,45720,전라북도,진안군,90-94세,303,75,228
202012,45720,전라북도,진안군,90-94세,299,73,226
202101,45720,전라북도,진안군,90-94세,299,72,227
202102,45720,전라북도,진안군,90-94세,297,71,226
202103,45720,전라북도,진안군,90-94세,304,71,233
202104,45720,전라북도,진안군,90-94세,310,74,236
202105,45720,전라북도,진안군,90-94세,318,75,243
202106,45720,전라북도,진안군,90-94세,317,72,245
202007,45720,전라북도,진안군,95-99세,68,15,53
202008,45720,전라북도,진안군,95-99세,68,16,52
202009,45720,전라북도,진안군,95-99세,68,16,52
202010,45720,전라북도,진안군,95-99세,68,17,51
202011,45720,전라북도,진안군,95-99세,68,16,52
202012,45720,전라북도,진안군,95-99세,68,17,51
202101,45720,전라북도,진안군,95-99세,71,17,54
202102,45720,전라북도,진안군,95-99세,70,16,54
202103,45720,전라북도,진안군,95-99세,68,15,53
202104,45720,전라북도,진안군,95-99세,67,14,53
202105,45720,전라북도,진안군,95-99세,68,14,54
202106,45720,전라북도,진안군,95-99세,65,13,52
202007,45720,전라북도,진안군,100+,27,9,18
202008,45720,전라북도,진안군,100+,28,9,19
202009,45720,전라북도,진안군,100+,27,9,18
202010,45720,전라북도,진안군,100+,27,9,18
202011,45720,전라북도,진안군,100+,27,9,18
202012,45720,전라북도,진안군,100+,28,9,19
202101,45720,전라북도,진안군,100+,28,9,19
202102,45720,전라북도,진안군,100+,27,9,18
202103,45720,전라북도,진안군,100+,17,5,12
202104,45720,전라북도,진안군,100+,17,5,12
202105,45720,전라북도,진안군,100+,17,5,12
202106,45720,전라북도,진안군,100+,16,5,11
202007,45730,전라북도,무주군,0-4세,470,237,233
202008,45730,전라북도,무주군,0-4세,469,237,232
202009,45730,전라북도,무주군,0-4세,464,235,229
202010,45730,전라북도,무주군,0-4세,458,233,225
202011,45730,전라북도,무주군,0-4세,461,234,227
202012,45730,전라북도,무주군,0-4세,458,232,226
202101,45730,전라북도,무주군,0-4세,454,236,218
202102,45730,전라북도,무주군,0-4세,444,233,211
202103,45730,전라북도,무주군,0-4세,442,233,209
202104,45730,전라북도,무주군,0-4세,432,224,208
202105,45730,전라북도,무주군,0-4세,422,220,202
202106,45730,전라북도,무주군,0-4세,420,216,204
202007,45730,전라북도,무주군,5-9세,775,435,340
202008,45730,전라북도,무주군,5-9세,776,434,342
202009,45730,전라북도,무주군,5-9세,763,424,339
202010,45730,전라북도,무주군,5-9세,766,424,342
202011,45730,전라북도,무주군,5-9세,754,413,341
202012,45730,전라북도,무주군,5-9세,754,407,347
202101,45730,전라북도,무주군,5-9세,745,403,342
202102,45730,전라북도,무주군,5-9세,733,397,336
202103,45730,전라북도,무주군,5-9세,728,396,332
202104,45730,전라북도,무주군,5-9세,720,393,327
202105,45730,전라북도,무주군,5-9세,715,386,329
202106,45730,전라북도,무주군,5-9세,706,385,321
202007,45730,전라북도,무주군,10-14세,881,437,444
202008,45730,전라북도,무주군,10-14세,893,446,447
202009,45730,전라북도,무주군,10-14세,894,446,448
202010,45730,전라북도,무주군,10-14세,892,448,444
202011,45730,전라북도,무주군,10-14세,900,457,443
202012,45730,전라북도,무주군,10-14세,905,464,441
202101,45730,전라북도,무주군,10-14세,902,460,442
202102,45730,전라북도,무주군,10-14세,898,457,441
202103,45730,전라북도,무주군,10-14세,911,459,452
202104,45730,전라북도,무주군,10-14세,916,464,452
202105,45730,전라북도,무주군,10-14세,912,464,448
202106,45730,전라북도,무주군,10-14세,907,462,445
202007,45730,전라북도,무주군,15-19세,927,475,452
202008,45730,전라북도,무주군,15-19세,920,475,445
202009,45730,전라북도,무주군,15-19세,926,477,449
202010,45730,전라북도,무주군,15-19세,920,474,446
202011,45730,전라북도,무주군,15-19세,910,470,440
202012,45730,전라북도,무주군,15-19세,915,469,446
202101,45730,전라북도,무주군,15-19세,926,476,450
202102,45730,전라북도,무주군,15-19세,928,476,452
202103,45730,전라북도,무주군,15-19세,914,470,444
202104,45730,전라북도,무주군,15-19세,896,459,437
202105,45730,전라북도,무주군,15-19세,890,456,434
202106,45730,전라북도,무주군,15-19세,887,452,435
202007,45730,전라북도,무주군,20-24세,937,540,397
202008,45730,전라북도,무주군,20-24세,935,533,402
202009,45730,전라북도,무주군,20-24세,924,523,401
202010,45730,전라북도,무주군,20-24세,937,527,410
202011,45730,전라북도,무주군,20-24세,947,535,412
202012,45730,전라북도,무주군,20-24세,931,524,407
202101,45730,전라북도,무주군,20-24세,926,519,407
202102,45730,전라북도,무주군,20-24세,916,518,398
202103,45730,전라북도,무주군,20-24세,901,505,396
202104,45730,전라북도,무주군,20-24세,913,509,404
202105,45730,전라북도,무주군,20-24세,922,515,407
202106,45730,전라북도,무주군,20-24세,916,514,402
202007,45730,전라북도,무주군,25-29세,845,452,393
202008,45730,전라북도,무주군,25-29세,840,452,388
202009,45730,전라북도,무주군,25-29세,847,457,390
202010,45730,전라북도,무주군,25-29세,846,458,388
202011,45730,전라북도,무주군,25-29세,840,450,390
202012,45730,전라북도,무주군,25-29세,851,462,389
202101,45730,전라북도,무주군,25-29세,845,466,379
202102,45730,전라북도,무주군,25-29세,828,459,369
202103,45730,전라북도,무주군,25-29세,832,464,368
202104,45730,전라북도,무주군,25-29세,823,457,366
202105,45730,전라북도,무주군,25-29세,820,447,373
202106,45730,전라북도,무주군,25-29세,818,445,373
202007,45730,전라북도,무주군,30-34세,782,444,338
202008,45730,전라북도,무주군,30-34세,782,439,343
202009,45730,전라북도,무주군,30-34세,779,435,344
202010,45730,전라북도,무주군,30-34세,781,436,345
202011,45730,전라북도,무주군,30-34세,780,433,347
202012,45730,전라북도,무주군,30-34세,770,430,340
202101,45730,전라북도,무주군,30-34세,783,443,340
202102,45730,전라북도,무주군,30-34세,783,439,344
202103,45730,전라북도,무주군,30-34세,775,434,341
202104,45730,전라북도,무주군,30-34세,769,430,339
202105,45730,전라북도,무주군,30-34세,765,425,340
202106,45730,전라북도,무주군,30-34세,757,420,337
202007,45730,전라북도,무주군,35-39세,971,521,450
202008,45730,전라북도,무주군,35-39세,969,518,451
202009,45730,전라북도,무주군,35-39세,960,519,441
202010,45730,전라북도,무주군,35-39세,940,507,433
202011,45730,전라북도,무주군,35-39세,934,503,431
202012,45730,전라북도,무주군,35-39세,930,504,426
202101,45730,전라북도,무주군,35-39세,919,490,429
202102,45730,전라북도,무주군,35-39세,915,492,423
202103,45730,전라북도,무주군,35-39세,904,490,414
202104,45730,전라북도,무주군,35-39세,907,491,416
202105,45730,전라북도,무주군,35-39세,904,487,417
202106,45730,전라북도,무주군,35-39세,899,487,412
202007,45730,전라북도,무주군,40-44세,1250,677,573
202008,45730,전라북도,무주군,40-44세,1241,674,567
202009,45730,전라북도,무주군,40-44세,1243,674,569
202010,45730,전라북도,무주군,40-44세,1256,678,578
202011,45730,전라북도,무주군,40-44세,1255,686,569
202012,45730,전라북도,무주군,40-44세,1257,689,568
202101,45730,전라북도,무주군,40-44세,1258,692,566
202102,45730,전라북도,무주군,40-44세,1233,677,556
202103,45730,전라북도,무주군,40-44세,1220,665,555
202104,45730,전라북도,무주군,40-44세,1213,661,552
202105,45730,전라북도,무주군,40-44세,1204,649,555
202106,45730,전라북도,무주군,40-44세,1198,648,550
202007,45730,전라북도,무주군,45-49세,1661,938,723
202008,45730,전라북도,무주군,45-49세,1658,940,718
202009,45730,전라북도,무주군,45-49세,1655,935,720
202010,45730,전라북도,무주군,45-49세,1634,926,708
202011,45730,전라북도,무주군,45-49세,1622,912,710
202012,45730,전라북도,무주군,45-49세,1618,909,709
202101,45730,전라북도,무주군,45-49세,1613,906,707
202102,45730,전라북도,무주군,45-49세,1622,913,709
202103,45730,전라북도,무주군,45-49세,1604,906,698
202104,45730,전라북도,무주군,45-49세,1600,903,697
202105,45730,전라북도,무주군,45-49세,1594,905,689
202106,45730,전라북도,무주군,45-49세,1592,906,686
202007,45730,전라북도,무주군,50-54세,1974,1117,857
202008,45730,전라북도,무주군,50-54세,1977,1114,863
202009,45730,전라북도,무주군,50-54세,1987,1123,864
202010,45730,전라북도,무주군,50-54세,1994,1122,872
202011,45730,전라북도,무주군,50-54세,2000,1130,870
202012,45730,전라북도,무주군,50-54세,1984,1123,861
202101,45730,전라북도,무주군,50-54세,1983,1116,867
202102,45730,전라북도,무주군,50-54세,1980,1115,865
202103,45730,전라북도,무주군,50-54세,1965,1106,859
202104,45730,전라북도,무주군,50-54세,1960,1102,858
202105,45730,전라북도,무주군,50-54세,1980,1116,864
202106,45730,전라북도,무주군,50-54세,1983,1110,873
202007,45730,전라북도,무주군,55-59세,2240,1208,1032
202008,45730,전라북도,무주군,55-59세,2238,1209,1029
202009,45730,전라북도,무주군,55-59세,2245,1205,1040
202010,45730,전라북도,무주군,55-59세,2236,1204,1032
202011,45730,전라북도,무주군,55-59세,2239,1206,1033
202012,45730,전라북도,무주군,55-59세,2221,1197,1024
202101,45730,전라북도,무주군,55-59세,2197,1189,1008
202102,45730,전라북도,무주군,55-59세,2179,1181,998
202103,45730,전라북도,무주군,55-59세,2180,1186,994
202104,45730,전라북도,무주군,55-59세,2183,1194,989
202105,45730,전라북도,무주군,55-59세,2176,1195,981
202106,45730,전라북도,무주군,55-59세,2155,1184,971
202007,45730,전라북도,무주군,60-64세,2310,1210,1100
202008,45730,전라북도,무주군,60-64세,2312,1210,1102
202009,45730,전라북도,무주군,60-64세,2323,1220,1103
202010,45730,전라북도,무주군,60-64세,2346,1232,1114
202011,45730,전라북도,무주군,60-64세,2338,1227,1111
202012,45730,전라북도,무주군,60-64세,2367,1244,1123
202101,45730,전라북도,무주군,60-64세,2408,1272,1136
202102,45730,전라북도,무주군,60-64세,2439,1290,1149
202103,45730,전라북도,무주군,60-64세,2477,1310,1167
202104,45730,전라북도,무주군,60-64세,2502,1318,1184
202105,45730,전라북도,무주군,60-64세,2522,1314,1208
202106,45730,전라북도,무주군,60-64세,2542,1325,1217
202007,45730,전라북도,무주군,65-69세,1950,951,999
202008,45730,전라북도,무주군,65-69세,1957,962,995
202009,45730,전라북도,무주군,65-69세,1970,974,996
202010,45730,전라북도,무주군,65-69세,1988,988,1000
202011,45730,전라북도,무주군,65-69세,2014,1008,1006
202012,45730,전라북도,무주군,65-69세,2025,1009,1016
202101,45730,전라북도,무주군,65-69세,2013,1008,1005
202102,45730,전라북도,무주군,65-69세,2019,1016,1003
202103,45730,전라북도,무주군,65-69세,2020,1018,1002
202104,45730,전라북도,무주군,65-69세,2016,1009,1007
202105,45730,전라북도,무주군,65-69세,2017,1017,1000
202106,45730,전라북도,무주군,65-69세,2022,1025,997
202007,45730,전라북도,무주군,70-74세,1660,751,909
202008,45730,전라북도,무주군,70-74세,1674,753,921
202009,45730,전라북도,무주군,70-74세,1677,753,924
202010,45730,전라북도,무주군,70-74세,1674,750,924
202011,45730,전라북도,무주군,70-74세,1670,741,929
202012,45730,전라북도,무주군,70-74세,1685,754,931
202101,45730,전라북도,무주군,70-74세,1696,758,938
202102,45730,전라북도,무주군,70-74세,1690,758,932
202103,45730,전라북도,무주군,70-74세,1697,757,940
202104,45730,전라북도,무주군,70-74세,1687,762,925
202105,45730,전라북도,무주군,70-74세,1690,760,930
202106,45730,전라북도,무주군,70-74세,1687,755,932
202007,45730,전라북도,무주군,75-79세,1749,672,1077
202008,45730,전라북도,무주군,75-79세,1747,678,1069
202009,45730,전라북도,무주군,75-79세,1731,674,1057
202010,45730,전라북도,무주군,75-79세,1723,672,1051
202011,45730,전라북도,무주군,75-79세,1716,672,1044
202012,45730,전라북도,무주군,75-79세,1695,663,1032
202101,45730,전라북도,무주군,75-79세,1696,661,1035
202102,45730,전라북도,무주군,75-79세,1672,649,1023
202103,45730,전라북도,무주군,75-79세,1657,641,1016
202104,45730,전라북도,무주군,75-79세,1645,633,1012
202105,45730,전라북도,무주군,75-79세,1646,643,1003
202106,45730,전라북도,무주군,75-79세,1637,646,991
202007,45730,전라북도,무주군,80-84세,1497,552,945
202008,45730,전라북도,무주군,80-84세,1493,550,943
202009,45730,전라북도,무주군,80-84세,1491,545,946
202010,45730,전라북도,무주군,80-84세,1487,538,949
202011,45730,전라북도,무주군,80-84세,1498,545,953
202012,45730,전라북도,무주군,80-84세,1505,548,957
202101,45730,전라북도,무주군,80-84세,1499,549,950
202102,45730,전라북도,무주군,80-84세,1513,557,956
202103,45730,전라북도,무주군,80-84세,1513,559,954
202104,45730,전라북도,무주군,80-84세,1517,560,957
202105,45730,전라북도,무주군,80-84세,1513,557,956
202106,45730,전라북도,무주군,80-84세,1516,555,961
202007,45730,전라북도,무주군,85-89세,791,241,550
202008,45730,전라북도,무주군,85-89세,797,244,553
202009,45730,전라북도,무주군,85-89세,804,251,553
202010,45730,전라북도,무주군,85-89세,810,255,555
202011,45730,전라북도,무주군,85-89세,803,249,554
202012,45730,전라북도,무주군,85-89세,812,251,561
202101,45730,전라북도,무주군,85-89세,826,254,572
202102,45730,전라북도,무주군,85-89세,839,258,581
202103,45730,전라북도,무주군,85-89세,854,264,590
202104,45730,전라북도,무주군,85-89세,857,266,591
202105,45730,전라북도,무주군,85-89세,865,270,595
202106,45730,전라북도,무주군,85-89세,875,275,600
202007,45730,전라북도,무주군,90-94세,262,53,209
202008,45730,전라북도,무주군,90-94세,265,52,213
202009,45730,전라북도,무주군,90-94세,267,52,215
202010,45730,전라북도,무주군,90-94세,264,54,210
202011,45730,전라북도,무주군,90-94세,267,59,208
202012,45730,전라북도,무주군,90-94세,269,61,208
202101,45730,전라북도,무주군,90-94세,270,62,208
202102,45730,전라북도,무주군,90-94세,266,63,203
202103,45730,전라북도,무주군,90-94세,257,63,194
202104,45730,전라북도,무주군,90-94세,266,63,203
202105,45730,전라북도,무주군,90-94세,269,66,203
202106,45730,전라북도,무주군,90-94세,267,61,206
202007,45730,전라북도,무주군,95-99세,63,14,49
202008,45730,전라북도,무주군,95-99세,59,14,45
202009,45730,전라북도,무주군,95-99세,60,14,46
202010,45730,전라북도,무주군,95-99세,61,13,48
202011,45730,전라북도,무주군,95-99세,63,14,49
202012,45730,전라북도,무주군,95-99세,62,14,48
202101,45730,전라북도,무주군,95-99세,65,14,51
202102,45730,전라북도,무주군,95-99세,70,15,55
202103,45730,전라북도,무주군,95-99세,67,13,54
202104,45730,전라북도,무주군,95-99세,68,13,55
202105,45730,전라북도,무주군,95-99세,69,13,56
202106,45730,전라북도,무주군,95-99세,69,14,55
202007,45730,전라북도,무주군,100+,19,4,15
202008,45730,전라북도,무주군,100+,22,4,18
202009,45730,전라북도,무주군,100+,22,4,18
202010,45730,전라북도,무주군,100+,21,4,17
202011,45730,전라북도,무주군,100+,20,4,16
202012,45730,전라북도,무주군,100+,22,5,17
202101,45730,전라북도,무주군,100+,22,5,17
202102,45730,전라북도,무주군,100+,23,5,18
202103,45730,전라북도,무주군,100+,22,5,17
202104,45730,전라북도,무주군,100+,22,4,18
202105,45730,전라북도,무주군,100+,22,4,18
202106,45730,전라북도,무주군,100+,22,4,18
202007,45740,전라북도,장수군,0-4세,454,237,217
202008,45740,전라북도,장수군,0-4세,457,238,219
202009,45740,전라북도,장수군,0-4세,456,244,212
202010,45740,전라북도,장수군,0-4세,454,241,213
202011,45740,전라북도,장수군,0-4세,446,241,205
202012,45740,전라북도,장수군,0-4세,446,240,206
202101,45740,전라북도,장수군,0-4세,447,238,209
202102,45740,전라북도,장수군,0-4세,451,240,211
202103,45740,전라북도,장수군,0-4세,446,234,212
202104,45740,전라북도,장수군,0-4세,436,232,204
202105,45740,전라북도,장수군,0-4세,428,228,200
202106,45740,전라북도,장수군,0-4세,420,220,200
202007,45740,전라북도,장수군,5-9세,735,376,359
202008,45740,전라북도,장수군,5-9세,726,373,353
202009,45740,전라북도,장수군,5-9세,720,363,357
202010,45740,전라북도,장수군,5-9세,708,358,350
202011,45740,전라북도,장수군,5-9세,710,359,351
202012,45740,전라북도,장수군,5-9세,710,359,351
202101,45740,전라북도,장수군,5-9세,700,360,340
202102,45740,전라북도,장수군,5-9세,679,352,327
202103,45740,전라북도,장수군,5-9세,676,351,325
202104,45740,전라북도,장수군,5-9세,669,346,323
202105,45740,전라북도,장수군,5-9세,661,340,321
202106,45740,전라북도,장수군,5-9세,655,342,313
202007,45740,전라북도,장수군,10-14세,823,419,404
202008,45740,전라북도,장수군,10-14세,811,408,403
202009,45740,전라북도,장수군,10-14세,819,416,403
202010,45740,전라북도,장수군,10-14세,826,420,406
202011,45740,전라북도,장수군,10-14세,818,416,402
202012,45740,전라북도,장수군,10-14세,820,417,403
202101,45740,전라북도,장수군,10-14세,822,417,405
202102,45740,전라북도,장수군,10-14세,824,419,405
202103,45740,전라북도,장수군,10-14세,830,423,407
202104,45740,전라북도,장수군,10-14세,831,427,404
202105,45740,전라북도,장수군,10-14세,837,430,407
202106,45740,전라북도,장수군,10-14세,841,433,408
202007,45740,전라북도,장수군,15-19세,839,417,422
202008,45740,전라북도,장수군,15-19세,852,425,427
202009,45740,전라북도,장수군,15-19세,851,425,426
202010,45740,전라북도,장수군,15-19세,845,426,419
202011,45740,전라북도,장수군,15-19세,840,432,408
202012,45740,전라북도,장수군,15-19세,838,430,408
202101,45740,전라북도,장수군,15-19세,832,432,400
202102,45740,전라북도,장수군,15-19세,826,425,401
202103,45740,전라북도,장수군,15-19세,811,407,404
202104,45740,전라북도,장수군,15-19세,809,403,406
202105,45740,전라북도,장수군,15-19세,804,401,403
202106,45740,전라북도,장수군,15-19세,806,404,402
202007,45740,전라북도,장수군,20-24세,939,519,420
202008,45740,전라북도,장수군,20-24세,928,512,416
202009,45740,전라북도,장수군,20-24세,922,507,415
202010,45740,전라북도,장수군,20-24세,912,498,414
202011,45740,전라북도,장수군,20-24세,902,490,412
202012,45740,전라북도,장수군,20-24세,902,489,413
202101,45740,전라북도,장수군,20-24세,899,486,413
202102,45740,전라북도,장수군,20-24세,886,487,399
202103,45740,전라북도,장수군,20-24세,884,487,397
202104,45740,전라북도,장수군,20-24세,875,485,390
202105,45740,전라북도,장수군,20-24세,881,487,394
202106,45740,전라북도,장수군,20-24세,883,492,391
202007,45740,전라북도,장수군,25-29세,753,441,312
202008,45740,전라북도,장수군,25-29세,751,442,309
202009,45740,전라북도,장수군,25-29세,750,450,300
202010,45740,전라북도,장수군,25-29세,762,455,307
202011,45740,전라북도,장수군,25-29세,767,451,316
202012,45740,전라북도,장수군,25-29세,767,449,318
202101,45740,전라북도,장수군,25-29세,750,440,310
202102,45740,전라북도,장수군,25-29세,747,438,309
202103,45740,전라북도,장수군,25-29세,741,433,308
202104,45740,전라북도,장수군,25-29세,742,431,311
202105,45740,전라북도,장수군,25-29세,737,426,311
202106,45740,전라북도,장수군,25-29세,728,421,307
202007,45740,전라북도,장수군,30-34세,719,364,355
202008,45740,전라북도,장수군,30-34세,711,360,351
202009,45740,전라북도,장수군,30-34세,718,362,356
202010,45740,전라북도,장수군,30-34세,722,364,358
202011,45740,전라북도,장수군,30-34세,716,367,349
202012,45740,전라북도,장수군,30-34세,708,362,346
202101,45740,전라북도,장수군,30-34세,716,365,351
202102,45740,전라북도,장수군,30-34세,704,360,344
202103,45740,전라북도,장수군,30-34세,696,356,340
202104,45740,전라북도,장수군,30-34세,691,352,339
202105,45740,전라북도,장수군,30-34세,686,354,332
202106,45740,전라북도,장수군,30-34세,677,349,328
202007,45740,전라북도,장수군,35-39세,882,474,408
202008,45740,전라북도,장수군,35-39세,877,471,406
202009,45740,전라북도,장수군,35-39세,860,460,400
202010,45740,전라북도,장수군,35-39세,848,452,396
202011,45740,전라북도,장수군,35-39세,839,443,396
202012,45740,전라북도,장수군,35-39세,845,446,399
202101,45740,전라북도,장수군,35-39세,839,443,396
202102,45740,전라북도,장수군,35-39세,831,444,387
202103,45740,전라북도,장수군,35-39세,813,431,382
202104,45740,전라북도,장수군,35-39세,816,432,384
202105,45740,전라북도,장수군,35-39세,809,428,381
202106,45740,전라북도,장수군,35-39세,803,424,379
202007,45740,전라북도,장수군,40-44세,1157,663,494
202008,45740,전라북도,장수군,40-44세,1126,646,480
202009,45740,전라북도,장수군,40-44세,1136,648,488
202010,45740,전라북도,장수군,40-44세,1141,656,485
202011,45740,전라북도,장수군,40-44세,1139,656,483
202012,45740,전라북도,장수군,40-44세,1121,647,474
202101,45740,전라북도,장수군,40-44세,1107,638,469
202102,45740,전라북도,장수군,40-44세,1104,638,466
202103,45740,전라북도,장수군,40-44세,1107,644,463
202104,45740,전라북도,장수군,40-44세,1092,639,453
202105,45740,전라북도,장수군,40-44세,1093,635,458
202106,45740,전라북도,장수군,40-44세,1099,631,468
202007,45740,전라북도,장수군,45-49세,1475,833,642
202008,45740,전라북도,장수군,45-49세,1495,841,654
202009,45740,전라북도,장수군,45-49세,1476,829,647
202010,45740,전라북도,장수군,45-49세,1462,820,642
202011,45740,전라북도,장수군,45-49세,1452,811,641
202012,45740,전라북도,장수군,45-49세,1461,817,644
202101,45740,전라북도,장수군,45-49세,1461,811,650
202102,45740,전라북도,장수군,45-49세,1448,800,648
202103,45740,전라북도,장수군,45-49세,1425,792,633
202104,45740,전라북도,장수군,45-49세,1425,787,638
202105,45740,전라북도,장수군,45-49세,1398,772,626
202106,45740,전라북도,장수군,45-49세,1382,768,614
202007,45740,전라북도,장수군,50-54세,1719,987,732
202008,45740,전라북도,장수군,50-54세,1707,981,726
202009,45740,전라북도,장수군,50-54세,1711,988,723
202010,45740,전라북도,장수군,50-54세,1720,984,736
202011,45740,전라북도,장수군,50-54세,1721,987,734
202012,45740,전라북도,장수군,50-54세,1691,969,722
202101,45740,전라북도,장수군,50-54세,1706,978,728
202102,45740,전라북도,장수군,50-54세,1701,976,725
202103,45740,전라북도,장수군,50-54세,1686,965,721
202104,45740,전라북도,장수군,50-54세,1683,963,720
202105,45740,전라북도,장수군,50-54세,1689,968,721
202106,45740,전라북도,장수군,50-54세,1703,971,732
202007,45740,전라북도,장수군,55-59세,1992,1103,889
202008,45740,전라북도,장수군,55-59세,2002,1109,893
202009,45740,전라북도,장수군,55-59세,1991,1105,886
202010,45740,전라북도,장수군,55-59세,1976,1092,884
202011,45740,전라북도,장수군,55-59세,1983,1095,888
202012,45740,전라북도,장수군,55-59세,1991,1098,893
202101,45740,전라북도,장수군,55-59세,1974,1089,885
202102,45740,전라북도,장수군,55-59세,1974,1091,883
202103,45740,전라북도,장수군,55-59세,1963,1091,872
202104,45740,전라북도,장수군,55-59세,1946,1083,863
202105,45740,전라북도,장수군,55-59세,1946,1089,857
202106,45740,전라북도,장수군,55-59세,1931,1078,853
202007,45740,전라북도,장수군,60-64세,2233,1138,1095
202008,45740,전라북도,장수군,60-64세,2228,1136,1092
202009,45740,전라북도,장수군,60-64세,2235,1139,1096
202010,45740,전라북도,장수군,60-64세,2241,1146,1095
202011,45740,전라북도,장수군,60-64세,2234,1148,1086
202012,45740,전라북도,장수군,60-64세,2228,1152,1076
202101,45740,전라북도,장수군,60-64세,2254,1171,1083
202102,45740,전라북도,장수군,60-64세,2259,1174,1085
202103,45740,전라북도,장수군,60-64세,2283,1189,1094
202104,45740,전라북도,장수군,60-64세,2310,1203,1107
202105,45740,전라북도,장수군,60-64세,2325,1200,1125
202106,45740,전라북도,장수군,60-64세,2341,1219,1122
202007,45740,전라북도,장수군,65-69세,1939,960,979
202008,45740,전라북도,장수군,65-69세,1946,965,981
202009,45740,전라북도,장수군,65-69세,1951,972,979
202010,45740,전라북도,장수군,65-69세,1963,979,984
202011,45740,전라북도,장수군,65-69세,1968,984,984
202012,45740,전라북도,장수군,65-69세,1988,991,997
202101,45740,전라북도,장수군,65-69세,1984,993,991
202102,45740,전라북도,장수군,65-69세,1994,994,1000
202103,45740,전라북도,장수군,65-69세,2001,997,1004
202104,45740,전라북도,장수군,65-69세,1999,1001,998
202105,45740,전라북도,장수군,65-69세,1999,1009,990
202106,45740,전라북도,장수군,65-69세,2001,1008,993
202007,45740,전라북도,장수군,70-74세,1565,769,796
202008,45740,전라북도,장수군,70-74세,1571,771,800
202009,45740,전라북도,장수군,70-74세,1576,771,805
202010,45740,전라북도,장수군,70-74세,1589,783,806
202011,45740,전라북도,장수군,70-74세,1595,779,816
202012,45740,전라북도,장수군,70-74세,1612,787,825
202101,45740,전라북도,장수군,70-74세,1627,792,835
202102,45740,전라북도,장수군,70-74세,1647,808,839
202103,45740,전라북도,장수군,70-74세,1647,806,841
202104,45740,전라북도,장수군,70-74세,1643,802,841
202105,45740,전라북도,장수군,70-74세,1656,809,847
202106,45740,전라북도,장수군,70-74세,1654,811,843
202007,45740,전라북도,장수군,75-79세,1579,593,986
202008,45740,전라북도,장수군,75-79세,1561,586,975
202009,45740,전라북도,장수군,75-79세,1555,584,971
202010,45740,전라북도,장수군,75-79세,1551,575,976
202011,45740,전라북도,장수군,75-79세,1537,580,957
202012,45740,전라북도,장수군,75-79세,1524,579,945
202101,45740,전라북도,장수군,75-79세,1504,573,931
202102,45740,전라북도,장수군,75-79세,1477,560,917
202103,45740,전라북도,장수군,75-79세,1461,559,902
202104,45740,전라북도,장수군,75-79세,1455,558,897
202105,45740,전라북도,장수군,75-79세,1444,554,890
202106,45740,전라북도,장수군,75-79세,1442,558,884
202007,45740,전라북도,장수군,80-84세,1358,451,907
202008,45740,전라북도,장수군,80-84세,1360,450,910
202009,45740,전라북도,장수군,80-84세,1360,452,908
202010,45740,전라북도,장수군,80-84세,1350,454,896
202011,45740,전라북도,장수군,80-84세,1361,455,906
202012,45740,전라북도,장수군,80-84세,1353,451,902
202101,45740,전라북도,장수군,80-84세,1342,446,896
202102,45740,전라북도,장수군,80-84세,1344,444,900
202103,45740,전라북도,장수군,80-84세,1337,445,892
202104,45740,전라북도,장수군,80-84세,1345,450,895
202105,45740,전라북도,장수군,80-84세,1354,455,899
202106,45740,전라북도,장수군,80-84세,1355,450,905
202007,45740,전라북도,장수군,85-89세,741,242,499
202008,45740,전라북도,장수군,85-89세,748,244,504
202009,45740,전라북도,장수군,85-89세,753,245,508
202010,45740,전라북도,장수군,85-89세,761,248,513
202011,45740,전라북도,장수군,85-89세,759,244,515
202012,45740,전라북도,장수군,85-89세,768,246,522
202101,45740,전라북도,장수군,85-89세,799,258,541
202102,45740,전라북도,장수군,85-89세,815,262,553
202103,45740,전라북도,장수군,85-89세,829,264,565
202104,45740,전라북도,장수군,85-89세,829,268,561
202105,45740,전라북도,장수군,85-89세,839,266,573
202106,45740,전라북도,장수군,85-89세,845,268,577
202007,45740,전라북도,장수군,90-94세,229,49,180
202008,45740,전라북도,장수군,90-94세,230,49,181
202009,45740,전라북도,장수군,90-94세,237,51,186
202010,45740,전라북도,장수군,90-94세,235,51,184
202011,45740,전라북도,장수군,90-94세,239,52,187
202012,45740,전라북도,장수군,90-94세,241,54,187
202101,45740,전라북도,장수군,90-94세,243,53,190
202102,45740,전라북도,장수군,90-94세,249,57,192
202103,45740,전라북도,장수군,90-94세,246,57,189
202104,45740,전라북도,장수군,90-94세,249,58,191
202105,45740,전라북도,장수군,90-94세,253,61,192
202106,45740,전라북도,장수군,90-94세,251,62,189
202007,45740,전라북도,장수군,95-99세,52,12,40
202008,45740,전라북도,장수군,95-99세,50,12,38
202009,45740,전라북도,장수군,95-99세,50,12,38
202010,45740,전라북도,장수군,95-99세,52,12,40
202011,45740,전라북도,장수군,95-99세,51,12,39
202012,45740,전라북도,장수군,95-99세,50,13,37
202101,45740,전라북도,장수군,95-99세,53,15,38
202102,45740,전라북도,장수군,95-99세,52,13,39
202103,45740,전라북도,장수군,95-99세,53,13,40
202104,45740,전라북도,장수군,95-99세,54,13,41
202105,45740,전라북도,장수군,95-99세,52,12,40
202106,45740,전라북도,장수군,95-99세,52,12,40
202007,45740,전라북도,장수군,100+,22,4,18
202008,45740,전라북도,장수군,100+,22,4,18
202009,45740,전라북도,장수군,100+,22,4,18
202010,45740,전라북도,장수군,100+,22,4,18
202011,45740,전라북도,장수군,100+,22,4,18
202012,45740,전라북도,장수군,100+,21,4,17
202101,45740,전라북도,장수군,100+,22,4,18
202102,45740,전라북도,장수군,100+,23,5,18
202103,45740,전라북도,장수군,100+,11,2,9
202104,45740,전라북도,장수군,100+,11,2,9
202105,45740,전라북도,장수군,100+,11,1,10
202106,45740,전라북도,장수군,100+,11,1,10
202007,45750,전라북도,임실군,0-4세,689,374,315
202008,45750,전라북도,임실군,0-4세,690,374,316
202009,45750,전라북도,임실군,0-4세,682,377,305
202010,45750,전라북도,임실군,0-4세,674,372,302
202011,45750,전라북도,임실군,0-4세,675,367,308
202012,45750,전라북도,임실군,0-4세,671,367,304
202101,45750,전라북도,임실군,0-4세,665,364,301
202102,45750,전라북도,임실군,0-4세,670,368,302
202103,45750,전라북도,임실군,0-4세,674,377,297
202104,45750,전라북도,임실군,0-4세,671,375,296
202105,45750,전라북도,임실군,0-4세,674,375,299
202106,45750,전라북도,임실군,0-4세,668,371,297
202007,45750,전라북도,임실군,5-9세,710,357,353
202008,45750,전라북도,임실군,5-9세,712,362,350
202009,45750,전라북도,임실군,5-9세,700,357,343
202010,45750,전라북도,임실군,5-9세,690,353,337
202011,45750,전라북도,임실군,5-9세,680,349,331
202012,45750,전라북도,임실군,5-9세,672,348,324
202101,45750,전라북도,임실군,5-9세,674,351,323
202102,45750,전라북도,임실군,5-9세,671,348,323
202103,45750,전라북도,임실군,5-9세,659,338,321
202104,45750,전라북도,임실군,5-9세,659,339,320
202105,45750,전라북도,임실군,5-9세,652,335,317
202106,45750,전라북도,임실군,5-9세,650,330,320
202007,45750,전라북도,임실군,10-14세,830,426,404
202008,45750,전라북도,임실군,10-14세,829,419,410
202009,45750,전라북도,임실군,10-14세,825,416,409
202010,45750,전라북도,임실군,10-14세,826,419,407
202011,45750,전라북도,임실군,10-14세,825,417,408
202012,45750,전라북도,임실군,10-14세,814,411,403
202101,45750,전라북도,임실군,10-14세,825,418,407
202102,45750,전라북도,임실군,10-14세,815,418,397
202103,45750,전라북도,임실군,10-14세,815,420,395
202104,45750,전라북도,임실군,10-14세,818,422,396
202105,45750,전라북도,임실군,10-14세,821,421,400
202106,45750,전라북도,임실군,10-14세,823,425,398
202007,45750,전라북도,임실군,15-19세,911,504,407
202008,45750,전라북도,임실군,15-19세,899,502,397
202009,45750,전라북도,임실군,15-19세,904,504,400
202010,45750,전라북도,임실군,15-19세,883,488,395
202011,45750,전라북도,임실군,15-19세,872,484,388
202012,45750,전라북도,임실군,15-19세,866,475,391
202101,45750,전라북도,임실군,15-19세,851,464,387
202102,45750,전라북도,임실군,15-19세,839,457,382
202103,45750,전라북도,임실군,15-19세,824,450,374
202104,45750,전라북도,임실군,15-19세,826,444,382
202105,45750,전라북도,임실군,15-19세,825,446,379
202106,45750,전라북도,임실군,15-19세,816,445,371
202007,45750,전라북도,임실군,20-24세,1113,666,447
202008,45750,전라북도,임실군,20-24세,1114,665,449
202009,45750,전라북도,임실군,20-24세,1100,654,446
202010,45750,전라북도,임실군,20-24세,1096,651,445
202011,45750,전라북도,임실군,20-24세,1082,641,441
202012,45750,전라북도,임실군,20-24세,1075,635,440
202101,45750,전라북도,임실군,20-24세,1071,635,436
202102,45750,전라북도,임실군,20-24세,1054,623,431
202103,45750,전라북도,임실군,20-24세,1038,614,424
202104,45750,전라북도,임실군,20-24세,1024,606,418
202105,45750,전라북도,임실군,20-24세,1016,603,413
202106,45750,전라북도,임실군,20-24세,1009,598,411
202007,45750,전라북도,임실군,25-29세,1065,614,451
202008,45750,전라북도,임실군,25-29세,1048,608,440
202009,45750,전라북도,임실군,25-29세,1030,602,428
202010,45750,전라북도,임실군,25-29세,1039,607,432
202011,45750,전라북도,임실군,25-29세,1037,610,427
202012,45750,전라북도,임실군,25-29세,1026,600,426
202101,45750,전라북도,임실군,25-29세,998,589,409
202102,45750,전라북도,임실군,25-29세,977,577,400
202103,45750,전라북도,임실군,25-29세,980,574,406
202104,45750,전라북도,임실군,25-29세,993,581,412
202105,45750,전라북도,임실군,25-29세,993,585,408
202106,45750,전라북도,임실군,25-29세,999,587,412
202007,45750,전라북도,임실군,30-34세,976,529,447
202008,45750,전라북도,임실군,30-34세,965,522,443
202009,45750,전라북도,임실군,30-34세,951,513,438
202010,45750,전라북도,임실군,30-34세,942,510,432
202011,45750,전라북도,임실군,30-34세,932,506,426
202012,45750,전라북도,임실군,30-34세,919,509,410
202101,45750,전라북도,임실군,30-34세,908,507,401
202102,45750,전라북도,임실군,30-34세,899,502,397
202103,45750,전라북도,임실군,30-34세,883,496,387
202104,45750,전라북도,임실군,30-34세,888,496,392
202105,45750,전라북도,임실군,30-34세,878,486,392
202106,45750,전라북도,임실군,30-34세,875,480,395
202007,45750,전라북도,임실군,35-39세,1074,592,482
202008,45750,전라북도,임실군,35-39세,1051,585,466
202009,45750,전라북도,임실군,35-39세,1040,578,462
202010,45750,전라북도,임실군,35-39세,1042,579,463
202011,45750,전라북도,임실군,35-39세,1035,570,465
202012,45750,전라북도,임실군,35-39세,1022,557,465
202101,45750,전라북도,임실군,35-39세,1026,563,463
202102,45750,전라북도,임실군,35-39세,1018,563,455
202103,45750,전라북도,임실군,35-39세,998,553,445
202104,45750,전라북도,임실군,35-39세,974,536,438
202105,45750,전라북도,임실군,35-39세,969,533,436
202106,45750,전라북도,임실군,35-39세,961,529,432
202007,45750,전라북도,임실군,40-44세,1272,790,482
202008,45750,전라북도,임실군,40-44세,1275,786,489
202009,45750,전라북도,임실군,40-44세,1268,782,486
202010,45750,전라북도,임실군,40-44세,1269,778,491
202011,45750,전라북도,임실군,40-44세,1250,770,480
202012,45750,전라북도,임실군,40-44세,1227,758,469
202101,45750,전라북도,임실군,40-44세,1215,743,472
202102,45750,전라북도,임실군,40-44세,1213,744,469
202103,45750,전라북도,임실군,40-44세,1192,735,457
202104,45750,전라북도,임실군,40-44세,1199,744,455
202105,45750,전라북도,임실군,40-44세,1195,737,458
202106,45750,전라북도,임실군,40-44세,1198,732,466
202007,45750,전라북도,임실군,45-49세,1680,1012,668
202008,45750,전라북도,임실군,45-49세,1683,1021,662
202009,45750,전라북도,임실군,45-49세,1660,1007,653
202010,45750,전라북도,임실군,45-49세,1631,997,634
202011,45750,전라북도,임실군,45-49세,1620,987,633
202012,45750,전라북도,임실군,45-49세,1617,978,639
202101,45750,전라북도,임실군,45-49세,1608,972,636
202102,45750,전라북도,임실군,45-49세,1598,961,637
202103,45750,전라북도,임실군,45-49세,1578,951,627
202104,45750,전라북도,임실군,45-49세,1562,938,624
202105,45750,전라북도,임실군,45-49세,1531,919,612
202106,45750,전라북도,임실군,45-49세,1513,914,599
202007,45750,전라북도,임실군,50-54세,2227,1255,972
202008,45750,전라북도,임실군,50-54세,2215,1252,963
202009,45750,전라북도,임실군,50-54세,2202,1245,957
202010,45750,전라북도,임실군,50-54세,2203,1235,968
202011,45750,전라북도,임실군,50-54세,2205,1239,966
202012,45750,전라북도,임실군,50-54세,2180,1231,949
202101,45750,전라북도,임실군,50-54세,2191,1238,953
202102,45750,전라북도,임실군,50-54세,2169,1222,947
202103,45750,전라북도,임실군,50-54세,2142,1210,932
202104,45750,전라북도,임실군,50-54세,2144,1217,927
202105,45750,전라북도,임실군,50-54세,2151,1219,932
202106,45750,전라북도,임실군,50-54세,2146,1212,934
202007,45750,전라북도,임실군,55-59세,2543,1438,1105
202008,45750,전라북도,임실군,55-59세,2550,1450,1100
202009,45750,전라북도,임실군,55-59세,2544,1453,1091
202010,45750,전라북도,임실군,55-59세,2526,1451,1075
202011,45750,전라북도,임실군,55-59세,2515,1442,1073
202012,45750,전라북도,임실군,55-59세,2508,1438,1070
202101,45750,전라북도,임실군,55-59세,2483,1420,1063
202102,45750,전라북도,임실군,55-59세,2479,1421,1058
202103,45750,전라북도,임실군,55-59세,2469,1420,1049
202104,45750,전라북도,임실군,55-59세,2461,1415,1046
202105,45750,전라북도,임실군,55-59세,2446,1399,1047
202106,45750,전라북도,임실군,55-59세,2444,1392,1052
202007,45750,전라북도,임실군,60-64세,2687,1463,1224
202008,45750,전라북도,임실군,60-64세,2700,1470,1230
202009,45750,전라북도,임실군,60-64세,2719,1472,1247
202010,45750,전라북도,임실군,60-64세,2742,1487,1255
202011,45750,전라북도,임실군,60-64세,2744,1493,1251
202012,45750,전라북도,임실군,60-64세,2765,1503,1262
202101,45750,전라북도,임실군,60-64세,2768,1517,1251
202102,45750,전라북도,임실군,60-64세,2804,1538,1266
202103,45750,전라북도,임실군,60-64세,2804,1535,1269
202104,45750,전라북도,임실군,60-64세,2818,1541,1277
202105,45750,전라북도,임실군,60-64세,2853,1566,1287
202106,45750,전라북도,임실군,60-64세,2867,1585,1282
202007,45750,전라북도,임실군,65-69세,2219,1147,1072
202008,45750,전라북도,임실군,65-69세,2220,1148,1072
202009,45750,전라북도,임실군,65-69세,2209,1149,1060
202010,45750,전라북도,임실군,65-69세,2209,1151,1058
202011,45750,전라북도,임실군,65-69세,2207,1154,1053
202012,45750,전라북도,임실군,65-69세,2229,1166,1063
202101,45750,전라북도,임실군,65-69세,2232,1171,1061
202102,45750,전라북도,임실군,65-69세,2223,1173,1050
202103,45750,전라북도,임실군,65-69세,2252,1200,1052
202104,45750,전라북도,임실군,65-69세,2263,1214,1049
202105,45750,전라북도,임실군,65-69세,2268,1219,1049
202106,45750,전라북도,임실군,65-69세,2295,1235,1060
202007,45750,전라북도,임실군,70-74세,2176,1038,1138
202008,45750,전라북도,임실군,70-74세,2182,1040,1142
202009,45750,전라북도,임실군,70-74세,2197,1049,1148
202010,45750,전라북도,임실군,70-74세,2212,1062,1150
202011,45750,전라북도,임실군,70-74세,2234,1065,1169
202012,45750,전라북도,임실군,70-74세,2242,1065,1177
202101,45750,전라북도,임실군,70-74세,2250,1069,1181
202102,45750,전라북도,임실군,70-74세,2265,1071,1194
202103,45750,전라북도,임실군,70-74세,2270,1073,1197
202104,45750,전라북도,임실군,70-74세,2273,1070,1203
202105,45750,전라북도,임실군,70-74세,2280,1078,1202
202106,45750,전라북도,임실군,70-74세,2265,1064,1201
202007,45750,전라북도,임실군,75-79세,2122,849,1273
202008,45750,전라북도,임실군,75-79세,2122,856,1266
202009,45750,전라북도,임실군,75-79세,2109,845,1264
202010,45750,전라북도,임실군,75-79세,2096,839,1257
202011,45750,전라북도,임실군,75-79세,2080,839,1241
202012,45750,전라북도,임실군,75-79세,2056,834,1222
202101,45750,전라북도,임실군,75-79세,2034,817,1217
202102,45750,전라북도,임실군,75-79세,2012,806,1206
202103,45750,전라북도,임실군,75-79세,1987,805,1182
202104,45750,전라북도,임실군,75-79세,1973,791,1182
202105,45750,전라북도,임실군,75-79세,1957,786,1171
202106,45750,전라북도,임실군,75-79세,1969,791,1178
202007,45750,전라북도,임실군,80-84세,1938,673,1265
202008,45750,전라북도,임실군,80-84세,1934,666,1268
202009,45750,전라북도,임실군,80-84세,1935,674,1261
202010,45750,전라북도,임실군,80-84세,1926,669,1257
202011,45750,전라북도,임실군,80-84세,1923,667,1256
202012,45750,전라북도,임실군,80-84세,1911,659,1252
202101,45750,전라북도,임실군,80-84세,1900,659,1241
202102,45750,전라북도,임실군,80-84세,1914,672,1242
202103,45750,전라북도,임실군,80-84세,1916,675,1241
202104,45750,전라북도,임실군,80-84세,1919,685,1234
202105,45750,전라북도,임실군,80-84세,1926,686,1240
202106,45750,전라북도,임실군,80-84세,1926,689,1237
202007,45750,전라북도,임실군,85-89세,1021,312,709
202008,45750,전라북도,임실군,85-89세,1028,316,712
202009,45750,전라북도,임실군,85-89세,1039,318,721
202010,45750,전라북도,임실군,85-89세,1052,316,736
202011,45750,전라북도,임실군,85-89세,1057,316,741
202012,45750,전라북도,임실군,85-89세,1073,325,748
202101,45750,전라북도,임실군,85-89세,1095,331,764
202102,45750,전라북도,임실군,85-89세,1103,336,767
202103,45750,전라북도,임실군,85-89세,1111,329,782
202104,45750,전라북도,임실군,85-89세,1120,329,791
202105,45750,전라북도,임실군,85-89세,1125,334,791
202106,45750,전라북도,임실군,85-89세,1124,337,787
202007,45750,전라북도,임실군,90-94세,374,91,283
202008,45750,전라북도,임실군,90-94세,369,88,281
202009,45750,전라북도,임실군,90-94세,372,88,284
202010,45750,전라북도,임실군,90-94세,371,92,279
202011,45750,전라북도,임실군,90-94세,371,93,278
202012,45750,전라북도,임실군,90-94세,362,92,270
202101,45750,전라북도,임실군,90-94세,373,95,278
202102,45750,전라북도,임실군,90-94세,375,95,280
202103,45750,전라북도,임실군,90-94세,375,95,280
202104,45750,전라북도,임실군,90-94세,375,96,279
202105,45750,전라북도,임실군,90-94세,379,95,284
202106,45750,전라북도,임실군,90-94세,380,95,285
202007,45750,전라북도,임실군,95-99세,57,8,49
202008,45750,전라북도,임실군,95-99세,54,7,47
202009,45750,전라북도,임실군,95-99세,57,7,50
202010,45750,전라북도,임실군,95-99세,57,8,49
202011,45750,전라북도,임실군,95-99세,57,9,48
202012,45750,전라북도,임실군,95-99세,57,9,48
202101,45750,전라북도,임실군,95-99세,59,9,50
202102,45750,전라북도,임실군,95-99세,58,9,49
202103,45750,전라북도,임실군,95-99세,59,10,49
202104,45750,전라북도,임실군,95-99세,61,13,48
202105,45750,전라북도,임실군,95-99세,63,13,50
202106,45750,전라북도,임실군,95-99세,65,13,52
202007,45750,전라북도,임실군,100+,22,7,15
202008,45750,전라북도,임실군,100+,23,7,16
202009,45750,전라북도,임실군,100+,23,7,16
202010,45750,전라북도,임실군,100+,22,6,16
202011,45750,전라북도,임실군,100+,23,6,17
202012,45750,전라북도,임실군,100+,22,6,16
202101,45750,전라북도,임실군,100+,22,6,16
202102,45750,전라북도,임실군,100+,23,6,17
202103,45750,전라북도,임실군,100+,18,4,14
202104,45750,전라북도,임실군,100+,17,4,13
202105,45750,전라북도,임실군,100+,17,4,13
202106,45750,전라북도,임실군,100+,16,4,12
202007,45770,전라북도,순창군,0-4세,814,409,405
202008,45770,전라북도,순창군,0-4세,809,407,402
202009,45770,전라북도,순창군,0-4세,799,399,400
202010,45770,전라북도,순창군,0-4세,796,394,402
202011,45770,전라북도,순창군,0-4세,782,380,402
202012,45770,전라북도,순창군,0-4세,778,377,401
202101,45770,전라북도,순창군,0-4세,760,365,395
202102,45770,전라북도,순창군,0-4세,753,364,389
202103,45770,전라북도,순창군,0-4세,727,356,371
202104,45770,전라북도,순창군,0-4세,688,336,352
202105,45770,전라북도,순창군,0-4세,668,326,342
202106,45770,전라북도,순창군,0-4세,651,313,338
202007,45770,전라북도,순창군,5-9세,773,412,361
202008,45770,전라북도,순창군,5-9세,765,405,360
202009,45770,전라북도,순창군,5-9세,762,405,357
202010,45770,전라북도,순창군,5-9세,759,407,352
202011,45770,전라북도,순창군,5-9세,738,398,340
202012,45770,전라북도,순창군,5-9세,743,400,343
202101,45770,전라북도,순창군,5-9세,736,398,338
202102,45770,전라북도,순창군,5-9세,726,391,335
202103,45770,전라북도,순창군,5-9세,723,392,331
202104,45770,전라북도,순창군,5-9세,725,396,329
202105,45770,전라북도,순창군,5-9세,727,401,326
202106,45770,전라북도,순창군,5-9세,732,407,325
202007,45770,전라북도,순창군,10-14세,1062,548,514
202008,45770,전라북도,순창군,10-14세,1060,546,514
202009,45770,전라북도,순창군,10-14세,1059,548,511
202010,45770,전라북도,순창군,10-14세,1057,547,510
202011,45770,전라북도,순창군,10-14세,1062,553,509
202012,45770,전라북도,순창군,10-14세,1064,553,511
202101,45770,전라북도,순창군,10-14세,1052,548,504
202102,45770,전라북도,순창군,10-14세,1062,556,506
202103,45770,전라북도,순창군,10-14세,1056,548,508
202104,45770,전라북도,순창군,10-14세,1050,542,508
202105,45770,전라북도,순창군,10-14세,1038,533,505
202106,45770,전라북도,순창군,10-14세,1039,534,505
202007,45770,전라북도,순창군,15-19세,1189,603,586
202008,45770,전라북도,순창군,15-19세,1183,604,579
202009,45770,전라북도,순창군,15-19세,1161,597,564
202010,45770,전라북도,순창군,15-19세,1164,599,565
202011,45770,전라북도,순창군,15-19세,1159,596,563
202012,45770,전라북도,순창군,15-19세,1155,597,558
202101,45770,전라북도,순창군,15-19세,1150,594,556
202102,45770,전라북도,순창군,15-19세,1150,589,561
202103,45770,전라북도,순창군,15-19세,1135,579,556
202104,45770,전라북도,순창군,15-19세,1127,581,546
202105,45770,전라북도,순창군,15-19세,1123,581,542
202106,45770,전라북도,순창군,15-19세,1123,577,546
202007,45770,전라북도,순창군,20-24세,1191,666,525
202008,45770,전라북도,순창군,20-24세,1178,655,523
202009,45770,전라북도,순창군,20-24세,1191,659,532
202010,45770,전라북도,순창군,20-24세,1175,647,528
202011,45770,전라북도,순창군,20-24세,1177,649,528
202012,45770,전라북도,순창군,20-24세,1168,642,526
202101,45770,전라북도,순창군,20-24세,1144,634,510
202102,45770,전라북도,순창군,20-24세,1140,632,508
202103,45770,전라북도,순창군,20-24세,1138,639,499
202104,45770,전라북도,순창군,20-24세,1138,637,501
202105,45770,전라북도,순창군,20-24세,1132,631,501
202106,45770,전라북도,순창군,20-24세,1130,629,501
202007,45770,전라북도,순창군,25-29세,925,495,430
202008,45770,전라북도,순창군,25-29세,907,487,420
202009,45770,전라북도,순창군,25-29세,904,485,419
202010,45770,전라북도,순창군,25-29세,915,495,420
202011,45770,전라북도,순창군,25-29세,908,494,414
202012,45770,전라북도,순창군,25-29세,908,500,408
202101,45770,전라북도,순창군,25-29세,915,509,406
202102,45770,전라북도,순창군,25-29세,903,507,396
202103,45770,전라북도,순창군,25-29세,883,497,386
202104,45770,전라북도,순창군,25-29세,880,497,383
202105,45770,전라북도,순창군,25-29세,895,510,385
202106,45770,전라북도,순창군,25-29세,891,506,385
202007,45770,전라북도,순창군,30-34세,924,434,490
202008,45770,전라북도,순창군,30-34세,919,435,484
202009,45770,전라북도,순창군,30-34세,908,427,481
202010,45770,전라북도,순창군,30-34세,903,420,483
202011,45770,전라북도,순창군,30-34세,877,411,466
202012,45770,전라북도,순창군,30-34세,879,405,474
202101,45770,전라북도,순창군,30-34세,863,401,462
202102,45770,전라북도,순창군,30-34세,849,395,454
202103,45770,전라북도,순창군,30-34세,852,404,448
202104,45770,전라북도,순창군,30-34세,836,402,434
202105,45770,전라북도,순창군,30-34세,825,401,424
202106,45770,전라북도,순창군,30-34세,822,401,421
202007,45770,전라북도,순창군,35-39세,1154,579,575
202008,45770,전라북도,순창군,35-39세,1148,577,571
202009,45770,전라북도,순창군,35-39세,1136,572,564
202010,45770,전라북도,순창군,35-39세,1128,568,560
202011,45770,전라북도,순창군,35-39세,1123,566,557
202012,45770,전라북도,순창군,35-39세,1122,561,561
202101,45770,전라북도,순창군,35-39세,1107,556,551
202102,45770,전라북도,순창군,35-39세,1097,548,549
202103,45770,전라북도,순창군,35-39세,1066,533,533
202104,45770,전라북도,순창군,35-39세,1053,519,534
202105,45770,전라북도,순창군,35-39세,1048,511,537
202106,45770,전라북도,순창군,35-39세,1031,501,530
202007,45770,전라북도,순창군,40-44세,1431,786,645
202008,45770,전라북도,순창군,40-44세,1437,793,644
202009,45770,전라북도,순창군,40-44세,1434,788,646
202010,45770,전라북도,순창군,40-44세,1422,785,637
202011,45770,전라북도,순창군,40-44세,1424,784,640
202012,45770,전라북도,순창군,40-44세,1419,779,640
202101,45770,전라북도,순창군,40-44세,1397,758,639
202102,45770,전라북도,순창군,40-44세,1395,750,645
202103,45770,전라북도,순창군,40-44세,1380,740,640
202104,45770,전라북도,순창군,40-44세,1371,734,637
202105,45770,전라북도,순창군,40-44세,1365,730,635
202106,45770,전라북도,순창군,40-44세,1377,736,641
202007,45770,전라북도,순창군,45-49세,1962,1141,821
202008,45770,전라북도,순창군,45-49세,1941,1133,808
202009,45770,전라북도,순창군,45-49세,1925,1125,800
202010,45770,전라북도,순창군,45-49세,1928,1125,803
202011,45770,전라북도,순창군,45-49세,1922,1119,803
202012,45770,전라북도,순창군,45-49세,1905,1103,802
202101,45770,전라북도,순창군,45-49세,1892,1106,786
202102,45770,전라북도,순창군,45-49세,1882,1104,778
202103,45770,전라북도,순창군,45-49세,1868,1103,765
202104,45770,전라북도,순창군,45-49세,1859,1095,764
202105,45770,전라북도,순창군,45-49세,1843,1085,758
202106,45770,전라북도,순창군,45-49세,1838,1083,755
202007,45770,전라북도,순창군,50-54세,2157,1190,967
202008,45770,전라북도,순창군,50-54세,2154,1188,966
202009,45770,전라북도,순창군,50-54세,2164,1198,966
202010,45770,전라북도,순창군,50-54세,2161,1195,966
202011,45770,전라북도,순창군,50-54세,2156,1204,952
202012,45770,전라북도,순창군,50-54세,2169,1212,957
202101,45770,전라북도,순창군,50-54세,2158,1199,959
202102,45770,전라북도,순창군,50-54세,2163,1194,969
202103,45770,전라북도,순창군,50-54세,2162,1188,974
202104,45770,전라북도,순창군,50-54세,2150,1192,958
202105,45770,전라북도,순창군,50-54세,2155,1204,951
202106,45770,전라북도,순창군,50-54세,2145,1200,945
202007,45770,전라북도,순창군,55-59세,2394,1274,1120
202008,45770,전라북도,순창군,55-59세,2381,1275,1106
202009,45770,전라북도,순창군,55-59세,2339,1240,1099
202010,45770,전라북도,순창군,55-59세,2328,1235,1093
202011,45770,전라북도,순창군,55-59세,2341,1240,1101
202012,45770,전라북도,순창군,55-59세,2336,1242,1094
202101,45770,전라북도,순창군,55-59세,2325,1236,1089
202102,45770,전라북도,순창군,55-59세,2317,1233,1084
202103,45770,전라북도,순창군,55-59세,2303,1229,1074
202104,45770,전라북도,순창군,55-59세,2292,1216,1076
202105,45770,전라북도,순창군,55-59세,2260,1195,1065
202106,45770,전라북도,순창군,55-59세,2252,1197,1055
202007,45770,전라북도,순창군,60-64세,2623,1367,1256
202008,45770,전라북도,순창군,60-64세,2634,1371,1263
202009,45770,전라북도,순창군,60-64세,2658,1396,1262
202010,45770,전라북도,순창군,60-64세,2684,1411,1273
202011,45770,전라북도,순창군,60-64세,2694,1416,1278
202012,45770,전라북도,순창군,60-64세,2709,1420,1289
202101,45770,전라북도,순창군,60-64세,2726,1429,1297
202102,45770,전라북도,순창군,60-64세,2756,1450,1306
202103,45770,전라북도,순창군,60-64세,2756,1455,1301
202104,45770,전라북도,순창군,60-64세,2765,1467,1298
202105,45770,전라북도,순창군,60-64세,2783,1486,1297
202106,45770,전라북도,순창군,60-64세,2796,1480,1316
202007,45770,전라북도,순창군,65-69세,2098,1013,1085
202008,45770,전라북도,순창군,65-69세,2097,1011,1086
202009,45770,전라북도,순창군,65-69세,2102,1013,1089
202010,45770,전라북도,순창군,65-69세,2105,1020,1085
202011,45770,전라북도,순창군,65-69세,2100,1018,1082
202012,45770,전라북도,순창군,65-69세,2123,1034,1089
202101,45770,전라북도,순창군,65-69세,2117,1033,1084
202102,45770,전라북도,순창군,65-69세,2108,1028,1080
202103,45770,전라북도,순창군,65-69세,2137,1049,1088
202104,45770,전라북도,순창군,65-69세,2159,1059,1100
202105,45770,전라북도,순창군,65-69세,2157,1055,1102
202106,45770,전라북도,순창군,65-69세,2164,1056,1108
202007,45770,전라북도,순창군,70-74세,2071,931,1140
202008,45770,전라북도,순창군,70-74세,2080,933,1147
202009,45770,전라북도,순창군,70-74세,2081,933,1148
202010,45770,전라북도,순창군,70-74세,2078,933,1145
202011,45770,전라북도,순창군,70-74세,2084,938,1146
202012,45770,전라북도,순창군,70-74세,2092,940,1152
202101,45770,전라북도,순창군,70-74세,2108,945,1163
202102,45770,전라북도,순창군,70-74세,2113,953,1160
202103,45770,전라북도,순창군,70-74세,2101,949,1152
202104,45770,전라북도,순창군,70-74세,2097,953,1144
202105,45770,전라북도,순창군,70-74세,2104,959,1145
202106,45770,전라북도,순창군,70-74세,2097,959,1138
202007,45770,전라북도,순창군,75-79세,2132,763,1369
202008,45770,전라북도,순창군,75-79세,2126,765,1361
202009,45770,전라북도,순창군,75-79세,2119,770,1349
202010,45770,전라북도,순창군,75-79세,2117,767,1350
202011,45770,전라북도,순창군,75-79세,2107,769,1338
202012,45770,전라북도,순창군,75-79세,2092,768,1324
202101,45770,전라북도,순창군,75-79세,2064,764,1300
202102,45770,전라북도,순창군,75-79세,2051,758,1293
202103,45770,전라북도,순창군,75-79세,2031,749,1282
202104,45770,전라북도,순창군,75-79세,2026,746,1280
202105,45770,전라북도,순창군,75-79세,2013,743,1270
202106,45770,전라북도,순창군,75-79세,2001,738,1263
202007,45770,전라북도,순창군,80-84세,1831,623,1208
202008,45770,전라북도,순창군,80-84세,1833,623,1210
202009,45770,전라북도,순창군,80-84세,1825,616,1209
202010,45770,전라북도,순창군,80-84세,1825,616,1209
202011,45770,전라북도,순창군,80-84세,1828,617,1211
202012,45770,전라북도,순창군,80-84세,1822,616,1206
202101,45770,전라북도,순창군,80-84세,1817,612,1205
202102,45770,전라북도,순창군,80-84세,1802,606,1196
202103,45770,전라북도,순창군,80-84세,1806,606,1200
202104,45770,전라북도,순창군,80-84세,1795,604,1191
202105,45770,전라북도,순창군,80-84세,1796,604,1192
202106,45770,전라북도,순창군,80-84세,1799,605,1194
202007,45770,전라북도,순창군,85-89세,895,266,629
202008,45770,전라북도,순창군,85-89세,896,265,631
202009,45770,전라북도,순창군,85-89세,904,270,634
202010,45770,전라북도,순창군,85-89세,911,269,642
202011,45770,전라북도,순창군,85-89세,921,271,650
202012,45770,전라북도,순창군,85-89세,925,276,649
202101,45770,전라북도,순창군,85-89세,927,271,656
202102,45770,전라북도,순창군,85-89세,951,279,672
202103,45770,전라북도,순창군,85-89세,955,287,668
202104,45770,전라북도,순창군,85-89세,973,293,680
202105,45770,전라북도,순창군,85-89세,987,302,685
202106,45770,전라북도,순창군,85-89세,992,305,687
202007,45770,전라북도,순창군,90-94세,289,81,208
202008,45770,전라북도,순창군,90-94세,288,81,207
202009,45770,전라북도,순창군,90-94세,294,81,213
202010,45770,전라북도,순창군,90-94세,297,82,215
202011,45770,전라북도,순창군,90-94세,299,83,216
202012,45770,전라북도,순창군,90-94세,298,80,218
202101,45770,전라북도,순창군,90-94세,301,83,218
202102,45770,전라북도,순창군,90-94세,301,84,217
202103,45770,전라북도,순창군,90-94세,301,81,220
202104,45770,전라북도,순창군,90-94세,302,81,221
202105,45770,전라북도,순창군,90-94세,311,83,228
202106,45770,전라북도,순창군,90-94세,313,85,228
202007,45770,전라북도,순창군,95-99세,70,13,57
202008,45770,전라북도,순창군,95-99세,75,14,61
202009,45770,전라북도,순창군,95-99세,75,15,60
202010,45770,전라북도,순창군,95-99세,76,15,61
202011,45770,전라북도,순창군,95-99세,75,14,61
202012,45770,전라북도,순창군,95-99세,75,15,60
202101,45770,전라북도,순창군,95-99세,79,16,63
202102,45770,전라북도,순창군,95-99세,77,16,61
202103,45770,전라북도,순창군,95-99세,73,16,57
202104,45770,전라북도,순창군,95-99세,70,15,55
202105,45770,전라북도,순창군,95-99세,70,15,55
202106,45770,전라북도,순창군,95-99세,69,13,56
202007,45770,전라북도,순창군,100+,31,1,30
202008,45770,전라북도,순창군,100+,31,1,30
202009,45770,전라북도,순창군,100+,31,1,30
202010,45770,전라북도,순창군,100+,28,0,28
202011,45770,전라북도,순창군,100+,28,0,28
202012,45770,전라북도,순창군,100+,28,0,28
202101,45770,전라북도,순창군,100+,27,0,27
202102,45770,전라북도,순창군,100+,28,0,28
202103,45770,전라북도,순창군,100+,21,1,20
202104,45770,전라북도,순창군,100+,22,1,21
202105,45770,전라북도,순창군,100+,21,1,20
202106,45770,전라북도,순창군,100+,21,1,20
202007,45790,전라북도,고창군,0-4세,1103,582,521
202008,45790,전라북도,고창군,0-4세,1094,578,516
202009,45790,전라북도,고창군,0-4세,1085,570,515
202010,45790,전라북도,고창군,0-4세,1083,568,515
202011,45790,전라북도,고창군,0-4세,1063,560,503
202012,45790,전라북도,고창군,0-4세,1062,564,498
202101,45790,전라북도,고창군,0-4세,1064,561,503
202102,45790,전라북도,고창군,0-4세,1052,551,501
202103,45790,전라북도,고창군,0-4세,1043,550,493
202104,45790,전라북도,고창군,0-4세,1049,552,497
202105,45790,전라북도,고창군,0-4세,1039,544,495
202106,45790,전라북도,고창군,0-4세,1027,540,487
202007,45790,전라북도,고창군,5-9세,1666,880,786
202008,45790,전라북도,고창군,5-9세,1661,876,785
202009,45790,전라북도,고창군,5-9세,1654,870,784
202010,45790,전라북도,고창군,5-9세,1641,864,777
202011,45790,전라북도,고창군,5-9세,1637,868,769
202012,45790,전라북도,고창군,5-9세,1628,856,772
202101,45790,전라북도,고창군,5-9세,1619,855,764
202102,45790,전라북도,고창군,5-9세,1604,855,749
202103,45790,전라북도,고창군,5-9세,1583,839,744
202104,45790,전라북도,고창군,5-9세,1565,834,731
202105,45790,전라북도,고창군,5-9세,1554,824,730
202106,45790,전라북도,고창군,5-9세,1542,821,721
202007,45790,전라북도,고창군,10-14세,1863,979,884
202008,45790,전라북도,고창군,10-14세,1871,980,891
202009,45790,전라북도,고창군,10-14세,1881,993,888
202010,45790,전라북도,고창군,10-14세,1890,998,892
202011,45790,전라북도,고창군,10-14세,1887,998,889
202012,45790,전라북도,고창군,10-14세,1884,996,888
202101,45790,전라북도,고창군,10-14세,1948,1032,916
202102,45790,전라북도,고창군,10-14세,1939,1020,919
202103,45790,전라북도,고창군,10-14세,1912,1014,898
202104,45790,전라북도,고창군,10-14세,1919,1017,902
202105,45790,전라북도,고창군,10-14세,1928,1023,905
202106,45790,전라북도,고창군,10-14세,1912,1012,900
202007,45790,전라북도,고창군,15-19세,2359,1300,1059
202008,45790,전라북도,고창군,15-19세,2335,1290,1045
202009,45790,전라북도,고창군,15-19세,2306,1276,1030
202010,45790,전라북도,고창군,15-19세,2280,1256,1024
202011,45790,전라북도,고창군,15-19세,2264,1243,1021
202012,45790,전라북도,고창군,15-19세,2353,1326,1027
202101,45790,전라북도,고창군,15-19세,2330,1305,1025
202102,45790,전라북도,고창군,15-19세,2299,1292,1007
202103,45790,전라북도,고창군,15-19세,2244,1258,986
202104,45790,전라북도,고창군,15-19세,2242,1255,987
202105,45790,전라북도,고창군,15-19세,2280,1296,984
202106,45790,전라북도,고창군,15-19세,2260,1281,979
202007,45790,전라북도,고창군,20-24세,2419,1372,1047
202008,45790,전라북도,고창군,20-24세,2409,1374,1035
202009,45790,전라북도,고창군,20-24세,2409,1368,1041
202010,45790,전라북도,고창군,20-24세,2409,1375,1034
202011,45790,전라북도,고창군,20-24세,2395,1367,1028
202012,45790,전라북도,고창군,20-24세,2375,1362,1013
202101,45790,전라북도,고창군,20-24세,2372,1357,1015
202102,45790,전라북도,고창군,20-24세,2348,1356,992
202103,45790,전라북도,고창군,20-24세,2333,1350,983
202104,45790,전라북도,고창군,20-24세,2324,1332,992
202105,45790,전라북도,고창군,20-24세,2315,1342,973
202106,45790,전라북도,고창군,20-24세,2299,1334,965
202007,45790,전라북도,고창군,25-29세,1931,1084,847
202008,45790,전라북도,고창군,25-29세,1935,1083,852
202009,45790,전라북도,고창군,25-29세,1940,1094,846
202010,45790,전라북도,고창군,25-29세,1948,1084,864
202011,45790,전라북도,고창군,25-29세,1935,1081,854
202012,45790,전라북도,고창군,25-29세,1933,1085,848
202101,45790,전라북도,고창군,25-29세,1896,1074,822
202102,45790,전라북도,고창군,25-29세,1856,1057,799
202103,45790,전라북도,고창군,25-29세,1862,1051,811
202104,45790,전라북도,고창군,25-29세,1838,1039,799
202105,45790,전라북도,고창군,25-29세,1831,1035,796
202106,45790,전라북도,고창군,25-29세,1821,1028,793
202007,45790,전라북도,고창군,30-34세,1740,912,828
202008,45790,전라북도,고창군,30-34세,1727,908,819
202009,45790,전라북도,고창군,30-34세,1711,906,805
202010,45790,전라북도,고창군,30-34세,1683,886,797
202011,45790,전라북도,고창군,30-34세,1666,873,793
202012,45790,전라북도,고창군,30-34세,1668,881,787
202101,45790,전라북도,고창군,30-34세,1659,875,784
202102,45790,전라북도,고창군,30-34세,1647,866,781
202103,45790,전라북도,고창군,30-34세,1644,869,775
202104,45790,전라북도,고창군,30-34세,1646,869,777
202105,45790,전라북도,고창군,30-34세,1626,866,760
202106,45790,전라북도,고창군,30-34세,1625,867,758
202007,45790,전라북도,고창군,35-39세,2256,1216,1040
202008,45790,전라북도,고창군,35-39세,2245,1220,1025
202009,45790,전라북도,고창군,35-39세,2234,1222,1012
202010,45790,전라북도,고창군,35-39세,2213,1204,1009
202011,45790,전라북도,고창군,35-39세,2202,1199,1003
202012,45790,전라북도,고창군,35-39세,2192,1198,994
202101,45790,전라북도,고창군,35-39세,2180,1189,991
202102,45790,전라북도,고창군,35-39세,2163,1177,986
202103,45790,전라북도,고창군,35-39세,2151,1172,979
202104,45790,전라북도,고창군,35-39세,2128,1158,970
202105,45790,전라북도,고창군,35-39세,2101,1144,957
202106,45790,전라북도,고창군,35-39세,2086,1135,951
202007,45790,전라북도,고창군,40-44세,2624,1474,1150
202008,45790,전라북도,고창군,40-44세,2617,1465,1152
202009,45790,전라북도,고창군,40-44세,2610,1450,1160
202010,45790,전라북도,고창군,40-44세,2610,1456,1154
202011,45790,전라북도,고창군,40-44세,2612,1464,1148
202012,45790,전라북도,고창군,40-44세,2575,1441,1134
202101,45790,전라북도,고창군,40-44세,2601,1444,1157
202102,45790,전라북도,고창군,40-44세,2619,1445,1174
202103,45790,전라북도,고창군,40-44세,2582,1432,1150
202104,45790,전라북도,고창군,40-44세,2587,1436,1151
202105,45790,전라북도,고창군,40-44세,2573,1437,1136
202106,45790,전라북도,고창군,40-44세,2572,1437,1135
202007,45790,전라북도,고창군,45-49세,3722,2157,1565
202008,45790,전라북도,고창군,45-49세,3669,2130,1539
202009,45790,전라북도,고창군,45-49세,3638,2115,1523
202010,45790,전라북도,고창군,45-49세,3619,2096,1523
202011,45790,전라북도,고창군,45-49세,3583,2074,1509
202012,45790,전라북도,고창군,45-49세,3589,2072,1517
202101,45790,전라북도,고창군,45-49세,3589,2068,1521
202102,45790,전라북도,고창군,45-49세,3569,2061,1508
202103,45790,전라북도,고창군,45-49세,3532,2027,1505
202104,45790,전라북도,고창군,45-49세,3533,2030,1503
202105,45790,전라북도,고창군,45-49세,3469,1988,1481
202106,45790,전라북도,고창군,45-49세,3451,1977,1474
202007,45790,전라북도,고창군,50-54세,4362,2440,1922
202008,45790,전라북도,고창군,50-54세,4362,2437,1925
202009,45790,전라북도,고창군,50-54세,4356,2434,1922
202010,45790,전라북도,고창군,50-54세,4334,2426,1908
202011,45790,전라북도,고창군,50-54세,4351,2425,1926
202012,45790,전라북도,고창군,50-54세,4306,2402,1904
202101,45790,전라북도,고창군,50-54세,4297,2403,1894
202102,45790,전라북도,고창군,50-54세,4310,2405,1905
202103,45790,전라북도,고창군,50-54세,4279,2406,1873
202104,45790,전라북도,고창군,50-54세,4267,2396,1871
202105,45790,전라북도,고창군,50-54세,4266,2406,1860
202106,45790,전라북도,고창군,50-54세,4232,2378,1854
202007,45790,전라북도,고창군,55-59세,4853,2586,2267
202008,45790,전라북도,고창군,55-59세,4838,2589,2249
202009,45790,전라북도,고창군,55-59세,4801,2555,2246
202010,45790,전라북도,고창군,55-59세,4798,2549,2249
202011,45790,전라북도,고창군,55-59세,4760,2537,2223
202012,45790,전라북도,고창군,55-59세,4762,2533,2229
202101,45790,전라북도,고창군,55-59세,4707,2518,2189
202102,45790,전라북도,고창군,55-59세,4683,2511,2172
202103,45790,전라북도,고창군,55-59세,4688,2507,2181
202104,45790,전라북도,고창군,55-59세,4645,2496,2149
202105,45790,전라북도,고창군,55-59세,4607,2483,2124
202106,45790,전라북도,고창군,55-59세,4585,2481,2104
202007,45790,전라북도,고창군,60-64세,5291,2647,2644
202008,45790,전라북도,고창군,60-64세,5310,2654,2656
202009,45790,전라북도,고창군,60-64세,5340,2679,2661
202010,45790,전라북도,고창군,60-64세,5363,2707,2656
202011,45790,전라북도,고창군,60-64세,5379,2724,2655
202012,45790,전라북도,고창군,60-64세,5420,2752,2668
202101,45790,전라북도,고창군,60-64세,5445,2755,2690
202102,45790,전라북도,고창군,60-64세,5487,2772,2715
202103,45790,전라북도,고창군,60-64세,5499,2776,2723
202104,45790,전라북도,고창군,60-64세,5551,2799,2752
202105,45790,전라북도,고창군,60-64세,5558,2810,2748
202106,45790,전라북도,고창군,60-64세,5582,2821,2761
202007,45790,전라북도,고창군,65-69세,4206,2045,2161
202008,45790,전라북도,고창군,65-69세,4235,2049,2186
202009,45790,전라북도,고창군,65-69세,4251,2061,2190
202010,45790,전라북도,고창군,65-69세,4243,2060,2183
202011,45790,전라북도,고창군,65-69세,4273,2062,2211
202012,45790,전라북도,고창군,65-69세,4269,2051,2218
202101,45790,전라북도,고창군,65-69세,4268,2060,2208
202102,45790,전라북도,고창군,65-69세,4308,2095,2213
202103,45790,전라북도,고창군,65-69세,4348,2123,2225
202104,45790,전라북도,고창군,65-69세,4376,2134,2242
202105,45790,전라북도,고창군,65-69세,4346,2129,2217
202106,45790,전라북도,고창군,65-69세,4352,2132,2220
202007,45790,전라북도,고창군,70-74세,4202,1954,2248
202008,45790,전라북도,고창군,70-74세,4198,1955,2243
202009,45790,전라북도,고창군,70-74세,4209,1963,2246
202010,45790,전라북도,고창군,70-74세,4229,1974,2255
202011,45790,전라북도,고창군,70-74세,4243,1986,2257
202012,45790,전라북도,고창군,70-74세,4269,1996,2273
202101,45790,전라북도,고창군,70-74세,4301,2016,2285
202102,45790,전라북도,고창군,70-74세,4293,2013,2280
202103,45790,전라북도,고창군,70-74세,4284,2018,2266
202104,45790,전라북도,고창군,70-74세,4283,2029,2254
202105,45790,전라북도,고창군,70-74세,4291,2032,2259
202106,45790,전라북도,고창군,70-74세,4293,2043,2250
202007,45790,전라북도,고창군,75-79세,4196,1626,2570
202008,45790,전라북도,고창군,75-79세,4195,1629,2566
202009,45790,전라북도,고창군,75-79세,4177,1621,2556
202010,45790,전라북도,고창군,75-79세,4169,1628,2541
202011,45790,전라북도,고창군,75-79세,4142,1620,2522
202012,45790,전라북도,고창군,75-79세,4118,1613,2505
202101,45790,전라북도,고창군,75-79세,4076,1602,2474
202102,45790,전라북도,고창군,75-79세,4061,1604,2457
202103,45790,전라북도,고창군,75-79세,4054,1607,2447
202104,45790,전라북도,고창군,75-79세,4032,1599,2433
202105,45790,전라북도,고창군,75-79세,3995,1584,2411
202106,45790,전라북도,고창군,75-79세,3965,1572,2393
202007,45790,전라북도,고창군,80-84세,3415,1144,2271
202008,45790,전라북도,고창군,80-84세,3400,1143,2257
202009,45790,전라북도,고창군,80-84세,3372,1131,2241
202010,45790,전라북도,고창군,80-84세,3366,1126,2240
202011,45790,전라북도,고창군,80-84세,3366,1136,2230
202012,45790,전라북도,고창군,80-84세,3380,1144,2236
202101,45790,전라북도,고창군,80-84세,3404,1152,2252
202102,45790,전라북도,고창군,80-84세,3403,1153,2250
202103,45790,전라북도,고창군,80-84세,3397,1139,2258
202104,45790,전라북도,고창군,80-84세,3393,1142,2251
202105,45790,전라북도,고창군,80-84세,3389,1153,2236
202106,45790,전라북도,고창군,80-84세,3406,1158,2248
202007,45790,전라북도,고창군,85-89세,1793,513,1280
202008,45790,전라북도,고창군,85-89세,1806,517,1289
202009,45790,전라북도,고창군,85-89세,1854,539,1315
202010,45790,전라북도,고창군,85-89세,1877,546,1331
202011,45790,전라북도,고창군,85-89세,1886,547,1339
202012,45790,전라북도,고창군,85-89세,1900,551,1349
202101,45790,전라북도,고창군,85-89세,1894,543,1351
202102,45790,전라북도,고창군,85-89세,1925,548,1377
202103,45790,전라북도,고창군,85-89세,1929,551,1378
202104,45790,전라북도,고창군,85-89세,1966,566,1400
202105,45790,전라북도,고창군,85-89세,1973,561,1412
202106,45790,전라북도,고창군,85-89세,1975,556,1419
202007,45790,전라북도,고창군,90-94세,636,120,516
202008,45790,전라북도,고창군,90-94세,644,122,522
202009,45790,전라북도,고창군,90-94세,649,121,528
202010,45790,전라북도,고창군,90-94세,654,123,531
202011,45790,전라북도,고창군,90-94세,663,123,540
202012,45790,전라북도,고창군,90-94세,672,120,552
202101,45790,전라북도,고창군,90-94세,688,124,564
202102,45790,전라북도,고창군,90-94세,691,122,569
202103,45790,전라북도,고창군,90-94세,705,123,582
202104,45790,전라북도,고창군,90-94세,704,120,584
202105,45790,전라북도,고창군,90-94세,706,124,582
202106,45790,전라북도,고창군,90-94세,711,123,588
202007,45790,전라북도,고창군,95-99세,141,19,122
202008,45790,전라북도,고창군,95-99세,141,19,122
202009,45790,전라북도,고창군,95-99세,142,20,122
202010,45790,전라북도,고창군,95-99세,143,21,122
202011,45790,전라북도,고창군,95-99세,143,21,122
202012,45790,전라북도,고창군,95-99세,138,20,118
202101,45790,전라북도,고창군,95-99세,137,19,118
202102,45790,전라북도,고창군,95-99세,139,18,121
202103,45790,전라북도,고창군,95-99세,141,18,123
202104,45790,전라북도,고창군,95-99세,140,16,124
202105,45790,전라북도,고창군,95-99세,139,17,122
202106,45790,전라북도,고창군,95-99세,142,18,124
202007,45790,전라북도,고창군,100+,33,1,32
202008,45790,전라북도,고창군,100+,35,1,34
202009,45790,전라북도,고창군,100+,37,1,36
202010,45790,전라북도,고창군,100+,36,1,35
202011,45790,전라북도,고창군,100+,36,1,35
202012,45790,전라북도,고창군,100+,36,1,35
202101,45790,전라북도,고창군,100+,37,1,36
202102,45790,전라북도,고창군,100+,39,3,36
202103,45790,전라북도,고창군,100+,33,2,31
202104,45790,전라북도,고창군,100+,34,2,32
202105,45790,전라북도,고창군,100+,32,2,30
202106,45790,전라북도,고창군,100+,31,2,29
202007,45800,전라북도,부안군,0-4세,1077,564,513
202008,45800,전라북도,부안군,0-4세,1072,561,511
202009,45800,전라북도,부안군,0-4세,1065,557,508
202010,45800,전라북도,부안군,0-4세,1054,553,501
202011,45800,전라북도,부안군,0-4세,1048,548,500
202012,45800,전라북도,부안군,0-4세,1037,539,498
202101,45800,전라북도,부안군,0-4세,1035,537,498
202102,45800,전라북도,부안군,0-4세,1036,537,499
202103,45800,전라북도,부안군,0-4세,1033,540,493
202104,45800,전라북도,부안군,0-4세,1015,530,485
202105,45800,전라북도,부안군,0-4세,1004,520,484
202106,45800,전라북도,부안군,0-4세,996,514,482
202007,45800,전라북도,부안군,5-9세,1572,823,749
202008,45800,전라북도,부안군,5-9세,1553,814,739
202009,45800,전라북도,부안군,5-9세,1550,808,742
202010,45800,전라북도,부안군,5-9세,1544,805,739
202011,45800,전라북도,부안군,5-9세,1524,800,724
202012,45800,전라북도,부안군,5-9세,1524,802,722
202101,45800,전라북도,부안군,5-9세,1501,793,708
202102,45800,전라북도,부안군,5-9세,1495,791,704
202103,45800,전라북도,부안군,5-9세,1496,790,706
202104,45800,전라북도,부안군,5-9세,1499,791,708
202105,45800,전라북도,부안군,5-9세,1479,783,696
202106,45800,전라북도,부안군,5-9세,1476,783,693
202007,45800,전라북도,부안군,10-14세,1657,833,824
202008,45800,전라북도,부안군,10-14세,1669,838,831
202009,45800,전라북도,부안군,10-14세,1667,840,827
202010,45800,전라북도,부안군,10-14세,1658,840,818
202011,45800,전라북도,부안군,10-14세,1661,842,819
202012,45800,전라북도,부안군,10-14세,1666,840,826
202101,45800,전라북도,부안군,10-14세,1678,842,836
202102,45800,전라북도,부안군,10-14세,1671,836,835
202103,45800,전라북도,부안군,10-14세,1652,828,824
202104,45800,전라북도,부안군,10-14세,1654,830,824
202105,45800,전라북도,부안군,10-14세,1675,849,826
202106,45800,전라북도,부안군,10-14세,1670,846,824
202007,45800,전라북도,부안군,15-19세,2169,1195,974
202008,45800,전라북도,부안군,15-19세,2149,1185,964
202009,45800,전라북도,부안군,15-19세,2103,1158,945
202010,45800,전라북도,부안군,15-19세,2082,1142,940
202011,45800,전라북도,부안군,15-19세,2065,1125,940
202012,45800,전라북도,부안군,15-19세,2057,1121,936
202101,45800,전라북도,부안군,15-19세,2054,1122,932
202102,45800,전라북도,부안군,15-19세,2034,1109,925
202103,45800,전라북도,부안군,15-19세,2015,1094,921
202104,45800,전라북도,부안군,15-19세,1989,1081,908
202105,45800,전라북도,부안군,15-19세,1971,1063,908
202106,45800,전라북도,부안군,15-19세,1951,1053,898
202007,45800,전라북도,부안군,20-24세,2416,1307,1109
202008,45800,전라북도,부안군,20-24세,2397,1306,1091
202009,45800,전라북도,부안군,20-24세,2399,1314,1085
202010,45800,전라북도,부안군,20-24세,2409,1324,1085
202011,45800,전라북도,부안군,20-24세,2406,1331,1075
202012,45800,전라북도,부안군,20-24세,2383,1330,1053
202101,45800,전라북도,부안군,20-24세,2370,1322,1048
202102,45800,전라북도,부안군,20-24세,2342,1318,1024
202103,45800,전라북도,부안군,20-24세,2322,1304,1018
202104,45800,전라북도,부안군,20-24세,2320,1305,1015
202105,45800,전라북도,부안군,20-24세,2311,1312,999
202106,45800,전라북도,부안군,20-24세,2314,1308,1006
202007,45800,전라북도,부안군,25-29세,1919,1101,818
202008,45800,전라북도,부안군,25-29세,1922,1105,817
202009,45800,전라북도,부안군,25-29세,1908,1088,820
202010,45800,전라북도,부안군,25-29세,1921,1094,827
202011,45800,전라북도,부안군,25-29세,1924,1091,833
202012,45800,전라북도,부안군,25-29세,1922,1090,832
202101,45800,전라북도,부안군,25-29세,1893,1077,816
202102,45800,전라북도,부안군,25-29세,1876,1065,811
202103,45800,전라북도,부안군,25-29세,1859,1046,813
202104,45800,전라북도,부안군,25-29세,1860,1049,811
202105,45800,전라북도,부안군,25-29세,1861,1051,810
202106,45800,전라북도,부안군,25-29세,1853,1044,809
202007,45800,전라북도,부안군,30-34세,1734,972,762
202008,45800,전라북도,부안군,30-34세,1717,962,755
202009,45800,전라북도,부안군,30-34세,1719,962,757
202010,45800,전라북도,부안군,30-34세,1719,963,756
202011,45800,전라북도,부안군,30-34세,1690,949,741
202012,45800,전라북도,부안군,30-34세,1675,936,739
202101,45800,전라북도,부안군,30-34세,1656,933,723
202102,45800,전라북도,부안군,30-34세,1654,929,725
202103,45800,전라북도,부안군,30-34세,1665,929,736
202104,45800,전라북도,부안군,30-34세,1646,925,721
202105,45800,전라북도,부안군,30-34세,1629,919,710
202106,45800,전라북도,부안군,30-34세,1620,915,705
202007,45800,전라북도,부안군,35-39세,2283,1207,1076
202008,45800,전라북도,부안군,35-39세,2264,1195,1069
202009,45800,전라북도,부안군,35-39세,2247,1190,1057
202010,45800,전라북도,부안군,35-39세,2228,1180,1048
202011,45800,전라북도,부안군,35-39세,2220,1174,1046
202012,45800,전라북도,부안군,35-39세,2228,1173,1055
202101,45800,전라북도,부안군,35-39세,2220,1167,1053
202102,45800,전라북도,부안군,35-39세,2202,1160,1042
202103,45800,전라북도,부안군,35-39세,2188,1159,1029
202104,45800,전라북도,부안군,35-39세,2171,1141,1030
202105,45800,전라북도,부안군,35-39세,2137,1115,1022
202106,45800,전라북도,부안군,35-39세,2122,1109,1013
202007,45800,전라북도,부안군,40-44세,2692,1507,1185
202008,45800,전라북도,부안군,40-44세,2700,1509,1191
202009,45800,전라북도,부안군,40-44세,2709,1511,1198
202010,45800,전라북도,부안군,40-44세,2710,1507,1203
202011,45800,전라북도,부안군,40-44세,2693,1496,1197
202012,45800,전라북도,부안군,40-44세,2681,1492,1189
202101,45800,전라북도,부안군,40-44세,2661,1480,1181
202102,45800,전라북도,부안군,40-44세,2666,1480,1186
202103,45800,전라북도,부안군,40-44세,2644,1474,1170
202104,45800,전라북도,부안군,40-44세,2626,1464,1162
202105,45800,전라북도,부안군,40-44세,2599,1444,1155
202106,45800,전라북도,부안군,40-44세,2594,1444,1150
202007,45800,전라북도,부안군,45-49세,3560,2002,1558
202008,45800,전라북도,부안군,45-49세,3543,1993,1550
202009,45800,전라북도,부안군,45-49세,3510,1980,1530
202010,45800,전라북도,부안군,45-49세,3491,1968,1523
202011,45800,전라북도,부안군,45-49세,3491,1967,1524
202012,45800,전라북도,부안군,45-49세,3464,1951,1513
202101,45800,전라북도,부안군,45-49세,3455,1946,1509
202102,45800,전라북도,부안군,45-49세,3447,1950,1497
202103,45800,전라북도,부안군,45-49세,3429,1935,1494
202104,45800,전라북도,부안군,45-49세,3417,1921,1496
202105,45800,전라북도,부안군,45-49세,3381,1902,1479
202106,45800,전라북도,부안군,45-49세,3349,1876,1473
202007,45800,전라북도,부안군,50-54세,4180,2372,1808
202008,45800,전라북도,부안군,50-54세,4181,2367,1814
202009,45800,전라북도,부안군,50-54세,4163,2348,1815
202010,45800,전라북도,부안군,50-54세,4169,2350,1819
202011,45800,전라북도,부안군,50-54세,4137,2334,1803
202012,45800,전라북도,부안군,50-54세,4109,2323,1786
202101,45800,전라북도,부안군,50-54세,4093,2300,1793
202102,45800,전라북도,부안군,50-54세,4106,2302,1804
202103,45800,전라북도,부안군,50-54세,4077,2291,1786
202104,45800,전라북도,부안군,50-54세,4072,2284,1788
202105,45800,전라북도,부안군,50-54세,4089,2302,1787
202106,45800,전라북도,부안군,50-54세,4085,2308,1777
202007,45800,전라북도,부안군,55-59세,4819,2516,2303
202008,45800,전라북도,부안군,55-59세,4791,2507,2284
202009,45800,전라북도,부안군,55-59세,4774,2503,2271
202010,45800,전라북도,부안군,55-59세,4727,2492,2235
202011,45800,전라북도,부안군,55-59세,4735,2494,2241
202012,45800,전라북도,부안군,55-59세,4736,2504,2232
202101,45800,전라북도,부안군,55-59세,4722,2511,2211
202102,45800,전라북도,부안군,55-59세,4692,2500,2192
202103,45800,전라북도,부안군,55-59세,4653,2484,2169
202104,45800,전라북도,부안군,55-59세,4633,2489,2144
202105,45800,전라북도,부안군,55-59세,4610,2483,2127
202106,45800,전라북도,부안군,55-59세,4570,2467,2103
202007,45800,전라북도,부안군,60-64세,5226,2685,2541
202008,45800,전라북도,부안군,60-64세,5228,2689,2539
202009,45800,전라북도,부안군,60-64세,5240,2695,2545
202010,45800,전라북도,부안군,60-64세,5280,2707,2573
202011,45800,전라북도,부안군,60-64세,5301,2715,2586
202012,45800,전라북도,부안군,60-64세,5287,2695,2592
202101,45800,전라북도,부안군,60-64세,5320,2713,2607
202102,45800,전라북도,부안군,60-64세,5336,2723,2613
202103,45800,전라북도,부안군,60-64세,5373,2734,2639
202104,45800,전라북도,부안군,60-64세,5398,2743,2655
202105,45800,전라북도,부안군,60-64세,5426,2759,2667
202106,45800,전라북도,부안군,60-64세,5452,2769,2683
202007,45800,전라북도,부안군,65-69세,4251,2061,2190
202008,45800,전라북도,부안군,65-69세,4268,2070,2198
202009,45800,전라북도,부안군,65-69세,4296,2087,2209
202010,45800,전라북도,부안군,65-69세,4305,2090,2215
202011,45800,전라북도,부안군,65-69세,4315,2097,2218
202012,45800,전라북도,부안군,65-69세,4342,2125,2217
202101,45800,전라북도,부안군,65-69세,4340,2129,2211
202102,45800,전라북도,부안군,65-69세,4348,2133,2215
202103,45800,전라북도,부안군,65-69세,4368,2153,2215
202104,45800,전라북도,부안군,65-69세,4365,2149,2216
202105,45800,전라북도,부안군,65-69세,4344,2134,2210
202106,45800,전라북도,부안군,65-69세,4324,2127,2197
202007,45800,전라북도,부안군,70-74세,3995,1852,2143
202008,45800,전라북도,부안군,70-74세,4014,1863,2151
202009,45800,전라북도,부안군,70-74세,4042,1875,2167
202010,45800,전라북도,부안군,70-74세,4066,1891,2175
202011,45800,전라북도,부안군,70-74세,4101,1909,2192
202012,45800,전라북도,부안군,70-74세,4112,1903,2209
202101,45800,전라북도,부안군,70-74세,4133,1911,2222
202102,45800,전라북도,부안군,70-74세,4144,1908,2236
202103,45800,전라북도,부안군,70-74세,4139,1902,2237
202104,45800,전라북도,부안군,70-74세,4144,1911,2233
202105,45800,전라북도,부안군,70-74세,4138,1907,2231
202106,45800,전라북도,부안군,70-74세,4136,1912,2224
202007,45800,전라북도,부안군,75-79세,3705,1475,2230
202008,45800,전라북도,부안군,75-79세,3697,1466,2231
202009,45800,전라북도,부안군,75-79세,3678,1459,2219
202010,45800,전라북도,부안군,75-79세,3649,1449,2200
202011,45800,전라북도,부안군,75-79세,3617,1436,2181
202012,45800,전라북도,부안군,75-79세,3596,1441,2155
202101,45800,전라북도,부안군,75-79세,3582,1447,2135
202102,45800,전라북도,부안군,75-79세,3563,1448,2115
202103,45800,전라북도,부안군,75-79세,3545,1440,2105
202104,45800,전라북도,부안군,75-79세,3551,1441,2110
202105,45800,전라북도,부안군,75-79세,3567,1452,2115
202106,45800,전라북도,부안군,75-79세,3554,1450,2104
202007,45800,전라북도,부안군,80-84세,3010,1044,1966
202008,45800,전라북도,부안군,80-84세,3002,1054,1948
202009,45800,전라북도,부안군,80-84세,2970,1049,1921
202010,45800,전라북도,부안군,80-84세,2962,1046,1916
202011,45800,전라북도,부안군,80-84세,2962,1045,1917
202012,45800,전라북도,부안군,80-84세,2951,1045,1906
202101,45800,전라북도,부안군,80-84세,2939,1035,1904
202102,45800,전라북도,부안군,80-84세,2943,1041,1902
202103,45800,전라북도,부안군,80-84세,2930,1029,1901
202104,45800,전라북도,부안군,80-84세,2919,1018,1901
202105,45800,전라북도,부안군,80-84세,2927,1016,1911
202106,45800,전라북도,부안군,80-84세,2945,1025,1920
202007,45800,전라북도,부안군,85-89세,1644,449,1195
202008,45800,전라북도,부안군,85-89세,1646,448,1198
202009,45800,전라북도,부안군,85-89세,1668,454,1214
202010,45800,전라북도,부안군,85-89세,1684,463,1221
202011,45800,전라북도,부안군,85-89세,1691,463,1228
202012,45800,전라북도,부안군,85-89세,1716,468,1248
202101,45800,전라북도,부안군,85-89세,1732,473,1259
202102,45800,전라북도,부안군,85-89세,1745,464,1281
202103,45800,전라북도,부안군,85-89세,1758,469,1289
202104,45800,전라북도,부안군,85-89세,1757,473,1284
202105,45800,전라북도,부안군,85-89세,1747,475,1272
202106,45800,전라북도,부안군,85-89세,1753,471,1282
202007,45800,전라북도,부안군,90-94세,500,103,397
202008,45800,전라북도,부안군,90-94세,509,103,406
202009,45800,전라북도,부안군,90-94세,516,106,410
202010,45800,전라북도,부안군,90-94세,526,112,414
202011,45800,전라북도,부안군,90-94세,527,114,413
202012,45800,전라북도,부안군,90-94세,525,113,412
202101,45800,전라북도,부안군,90-94세,525,111,414
202102,45800,전라북도,부안군,90-94세,535,120,415
202103,45800,전라북도,부안군,90-94세,541,119,422
202104,45800,전라북도,부안군,90-94세,540,118,422
202105,45800,전라북도,부안군,90-94세,539,120,419
202106,45800,전라북도,부안군,90-94세,544,119,425
202007,45800,전라북도,부안군,95-99세,100,23,77
202008,45800,전라북도,부안군,95-99세,97,22,75
202009,45800,전라북도,부안군,95-99세,97,22,75
202010,45800,전라북도,부안군,95-99세,98,22,76
202011,45800,전라북도,부안군,95-99세,96,20,76
202012,45800,전라북도,부안군,95-99세,94,19,75
202101,45800,전라북도,부안군,95-99세,91,18,73
202102,45800,전라북도,부안군,95-99세,90,18,72
202103,45800,전라북도,부안군,95-99세,90,20,70
202104,45800,전라북도,부안군,95-99세,88,20,68
202105,45800,전라북도,부안군,95-99세,91,21,70
202106,45800,전라북도,부안군,95-99세,89,21,68
202007,45800,전라북도,부안군,100+,38,4,34
202008,45800,전라북도,부안군,100+,36,3,33
202009,45800,전라북도,부안군,100+,37,3,34
202010,45800,전라북도,부안군,100+,35,3,32
202011,45800,전라북도,부안군,100+,33,3,30
202012,45800,전라북도,부안군,100+,35,4,31
202101,45800,전라북도,부안군,100+,38,6,32
202102,45800,전라북도,부안군,100+,38,6,32
202103,45800,전라북도,부안군,100+,23,2,21
202104,45800,전라북도,부안군,100+,22,2,20
202105,45800,전라북도,부안군,100+,22,2,20
202106,45800,전라북도,부안군,100+,22,2,20
202007,46110,전라남도,목포시,0-4세,7498,3912,3586
202008,46110,전라남도,목포시,0-4세,7322,3816,3506
202009,46110,전라남도,목포시,0-4세,7163,3736,3427
202010,46110,전라남도,목포시,0-4세,7033,3674,3359
202011,46110,전라남도,목포시,0-4세,6914,3612,3302
202012,46110,전라남도,목포시,0-4세,6836,3569,3267
202101,46110,전라남도,목포시,0-4세,6708,3495,3213
202102,46110,전라남도,목포시,0-4세,6584,3442,3142
202103,46110,전라남도,목포시,0-4세,6447,3366,3081
202104,46110,전라남도,목포시,0-4세,6352,3330,3022
202105,46110,전라남도,목포시,0-4세,6286,3275,3011
202106,46110,전라남도,목포시,0-4세,6195,3233,2962
202007,46110,전라남도,목포시,5-9세,11992,6106,5886
202008,46110,전라남도,목포시,5-9세,11829,6017,5812
202009,46110,전라남도,목포시,5-9세,11659,5917,5742
202010,46110,전라남도,목포시,5-9세,11635,5903,5732
202011,46110,전라남도,목포시,5-9세,11587,5893,5694
202012,46110,전라남도,목포시,5-9세,11459,5856,5603
202101,46110,전라남도,목포시,5-9세,11333,5804,5529
202102,46110,전라남도,목포시,5-9세,11253,5760,5493
202103,46110,전라남도,목포시,5-9세,11167,5716,5451
202104,46110,전라남도,목포시,5-9세,11108,5692,5416
202105,46110,전라남도,목포시,5-9세,11069,5688,5381
202106,46110,전라남도,목포시,5-9세,11032,5664,5368
202007,46110,전라남도,목포시,10-14세,12070,6174,5896
202008,46110,전라남도,목포시,10-14세,12031,6157,5874
202009,46110,전라남도,목포시,10-14세,12013,6148,5865
202010,46110,전라남도,목포시,10-14세,12009,6152,5857
202011,46110,전라남도,목포시,10-14세,12054,6174,5880
202012,46110,전라남도,목포시,10-14세,12037,6162,5875
202101,46110,전라남도,목포시,10-14세,12032,6153,5879
202102,46110,전라남도,목포시,10-14세,12018,6152,5866
202103,46110,전라남도,목포시,10-14세,12028,6175,5853
202104,46110,전라남도,목포시,10-14세,12047,6190,5857
202105,46110,전라남도,목포시,10-14세,12036,6177,5859
202106,46110,전라남도,목포시,10-14세,12047,6179,5868
202007,46110,전라남도,목포시,15-19세,13130,6748,6382
202008,46110,전라남도,목포시,15-19세,12954,6665,6289
202009,46110,전라남도,목포시,15-19세,12824,6588,6236
202010,46110,전라남도,목포시,15-19세,12712,6534,6178
202011,46110,전라남도,목포시,15-19세,12577,6446,6131
202012,46110,전라남도,목포시,15-19세,12474,6390,6084
202101,46110,전라남도,목포시,15-19세,12381,6332,6049
202102,46110,전라남도,목포시,15-19세,12254,6290,5964
202103,46110,전라남도,목포시,15-19세,12117,6216,5901
202104,46110,전라남도,목포시,15-19세,12045,6160,5885
202105,46110,전라남도,목포시,15-19세,12006,6129,5877
202106,46110,전라남도,목포시,15-19세,11966,6106,5860
202007,46110,전라남도,목포시,20-24세,15306,8356,6950
202008,46110,전라남도,목포시,20-24세,15205,8278,6927
202009,46110,전라남도,목포시,20-24세,15104,8247,6857
202010,46110,전라남도,목포시,20-24세,15073,8216,6857
202011,46110,전라남도,목포시,20-24세,15044,8200,6844
202012,46110,전라남도,목포시,20-24세,14981,8156,6825
202101,46110,전라남도,목포시,20-24세,14891,8099,6792
202102,46110,전라남도,목포시,20-24세,14819,8065,6754
202103,46110,전라남도,목포시,20-24세,14707,8012,6695
202104,46110,전라남도,목포시,20-24세,14627,7974,6653
202105,46110,전라남도,목포시,20-24세,14609,7983,6626
202106,46110,전라남도,목포시,20-24세,14567,7954,6613
202007,46110,전라남도,목포시,25-29세,12201,6466,5735
202008,46110,전라남도,목포시,25-29세,12179,6474,5705
202009,46110,전라남도,목포시,25-29세,12157,6483,5674
202010,46110,전라남도,목포시,25-29세,12165,6496,5669
202011,46110,전라남도,목포시,25-29세,12162,6499,5663
202012,46110,전라남도,목포시,25-29세,12153,6499,5654
202101,46110,전라남도,목포시,25-29세,12138,6515,5623
202102,46110,전라남도,목포시,25-29세,12178,6510,5668
202103,46110,전라남도,목포시,25-29세,12192,6540,5652
202104,46110,전라남도,목포시,25-29세,12269,6582,5687
202105,46110,전라남도,목포시,25-29세,12259,6557,5702
202106,46110,전라남도,목포시,25-29세,12239,6557,5682
202007,46110,전라남도,목포시,30-34세,10889,5549,5340
202008,46110,전라남도,목포시,30-34세,10726,5467,5259
202009,46110,전라남도,목포시,30-34세,10576,5397,5179
202010,46110,전라남도,목포시,30-34세,10491,5353,5138
202011,46110,전라남도,목포시,30-34세,10441,5311,5130
202012,46110,전라남도,목포시,30-34세,10290,5261,5029
202101,46110,전라남도,목포시,30-34세,10213,5229,4984
202102,46110,전라남도,목포시,30-34세,10096,5183,4913
202103,46110,전라남도,목포시,30-34세,10004,5137,4867
202104,46110,전라남도,목포시,30-34세,9961,5136,4825
202105,46110,전라남도,목포시,30-34세,9990,5170,4820
202106,46110,전라남도,목포시,30-34세,9975,5169,4806
202007,46110,전라남도,목포시,35-39세,16376,8498,7878
202008,46110,전라남도,목포시,35-39세,16097,8361,7736
202009,46110,전라남도,목포시,35-39세,15825,8215,7610
202010,46110,전라남도,목포시,35-39세,15700,8126,7574
202011,46110,전라남도,목포시,35-39세,15637,8108,7529
202012,46110,전라남도,목포시,35-39세,15461,8007,7454
202101,46110,전라남도,목포시,35-39세,15239,7883,7356
202102,46110,전라남도,목포시,35-39세,15102,7821,7281
202103,46110,전라남도,목포시,35-39세,14872,7726,7146
202104,46110,전라남도,목포시,35-39세,14780,7655,7125
202105,46110,전라남도,목포시,35-39세,14685,7584,7101
202106,46110,전라남도,목포시,35-39세,14568,7517,7051
202007,46110,전라남도,목포시,40-44세,17969,9268,8701
202008,46110,전라남도,목포시,40-44세,17866,9210,8656
202009,46110,전라남도,목포시,40-44세,17762,9141,8621
202010,46110,전라남도,목포시,40-44세,17786,9165,8621
202011,46110,전라남도,목포시,40-44세,17783,9120,8663
202012,46110,전라남도,목포시,40-44세,17637,9072,8565
202101,46110,전라남도,목포시,40-44세,17554,9053,8501
202102,46110,전라남도,목포시,40-44세,17551,9026,8525
202103,46110,전라남도,목포시,40-44세,17432,8959,8473
202104,46110,전라남도,목포시,40-44세,17416,8961,8455
202105,46110,전라남도,목포시,40-44세,17430,8990,8440
202106,46110,전라남도,목포시,40-44세,17497,9026,8471
202007,46110,전라남도,목포시,45-49세,20218,10406,9812
202008,46110,전라남도,목포시,45-49세,20147,10365,9782
202009,46110,전라남도,목포시,45-49세,20022,10321,9701
202010,46110,전라남도,목포시,45-49세,19911,10272,9639
202011,46110,전라남도,목포시,45-49세,19858,10253,9605
202012,46110,전라남도,목포시,45-49세,19744,10205,9539
202101,46110,전라남도,목포시,45-49세,19706,10154,9552
202102,46110,전라남도,목포시,45-49세,19620,10125,9495
202103,46110,전라남도,목포시,45-49세,19483,10043,9440
202104,46110,전라남도,목포시,45-49세,19462,10047,9415
202105,46110,전라남도,목포시,45-49세,19245,9930,9315
202106,46110,전라남도,목포시,45-49세,19155,9872,9283
202007,46110,전라남도,목포시,50-54세,18899,9779,9120
202008,46110,전라남도,목포시,50-54세,18833,9723,9110
202009,46110,전라남도,목포시,50-54세,18826,9721,9105
202010,46110,전라남도,목포시,50-54세,18775,9683,9092
202011,46110,전라남도,목포시,50-54세,18768,9663,9105
202012,46110,전라남도,목포시,50-54세,18714,9630,9084
202101,46110,전라남도,목포시,50-54세,18753,9660,9093
202102,46110,전라남도,목포시,50-54세,18782,9665,9117
202103,46110,전라남도,목포시,50-54세,18603,9587,9016
202104,46110,전라남도,목포시,50-54세,18572,9578,8994
202105,46110,전라남도,목포시,50-54세,18741,9657,9084
202106,46110,전라남도,목포시,50-54세,18754,9665,9089
202007,46110,전라남도,목포시,55-59세,17836,8670,9166
202008,46110,전라남도,목포시,55-59세,17748,8641,9107
202009,46110,전라남도,목포시,55-59세,17609,8570,9039
202010,46110,전라남도,목포시,55-59세,17607,8573,9034
202011,46110,전라남도,목포시,55-59세,17613,8564,9049
202012,46110,전라남도,목포시,55-59세,17583,8568,9015
202101,46110,전라남도,목포시,55-59세,17535,8574,8961
202102,46110,전라남도,목포시,55-59세,17502,8576,8926
202103,46110,전라남도,목포시,55-59세,17450,8553,8897
202104,46110,전라남도,목포시,55-59세,17367,8522,8845
202105,46110,전라남도,목포시,55-59세,17264,8489,8775
202106,46110,전라남도,목포시,55-59세,17205,8478,8727
202007,46110,전라남도,목포시,60-64세,16578,7951,8627
202008,46110,전라남도,목포시,60-64세,16605,7966,8639
202009,46110,전라남도,목포시,60-64세,16683,8010,8673
202010,46110,전라남도,목포시,60-64세,16774,8035,8739
202011,46110,전라남도,목포시,60-64세,16825,8066,8759
202012,46110,전라남도,목포시,60-64세,16848,8059,8789
202101,46110,전라남도,목포시,60-64세,16970,8116,8854
202102,46110,전라남도,목포시,60-64세,17006,8136,8870
202103,46110,전라남도,목포시,60-64세,17017,8137,8880
202104,46110,전라남도,목포시,60-64세,17092,8170,8922
202105,46110,전라남도,목포시,60-64세,17207,8215,8992
202106,46110,전라남도,목포시,60-64세,17283,8261,9022
202007,46110,전라남도,목포시,65-69세,11816,5594,6222
202008,46110,전라남도,목포시,65-69세,11886,5620,6266
202009,46110,전라남도,목포시,65-69세,11919,5629,6290
202010,46110,전라남도,목포시,65-69세,11978,5667,6311
202011,46110,전라남도,목포시,65-69세,12024,5686,6338
202012,46110,전라남도,목포시,65-69세,12085,5731,6354
202101,46110,전라남도,목포시,65-69세,12092,5727,6365
202102,46110,전라남도,목포시,65-69세,12135,5752,6383
202103,46110,전라남도,목포시,65-69세,12108,5730,6378
202104,46110,전라남도,목포시,65-69세,12177,5765,6412
202105,46110,전라남도,목포시,65-69세,12219,5782,6437
202106,46110,전라남도,목포시,65-69세,12271,5792,6479
202007,46110,전라남도,목포시,70-74세,9792,4464,5328
202008,46110,전라남도,목포시,70-74세,9775,4446,5329
202009,46110,전라남도,목포시,70-74세,9825,4479,5346
202010,46110,전라남도,목포시,70-74세,9893,4514,5379
202011,46110,전라남도,목포시,70-74세,9946,4549,5397
202012,46110,전라남도,목포시,70-74세,9972,4564,5408
202101,46110,전라남도,목포시,70-74세,10003,4580,5423
202102,46110,전라남도,목포시,70-74세,9996,4562,5434
202103,46110,전라남도,목포시,70-74세,9954,4546,5408
202104,46110,전라남도,목포시,70-74세,9936,4511,5425
202105,46110,전라남도,목포시,70-74세,9941,4500,5441
202106,46110,전라남도,목포시,70-74세,9923,4491,5432
202007,46110,전라남도,목포시,75-79세,7689,3294,4395
202008,46110,전라남도,목포시,75-79세,7710,3310,4400
202009,46110,전라남도,목포시,75-79세,7683,3280,4403
202010,46110,전라남도,목포시,75-79세,7667,3264,4403
202011,46110,전라남도,목포시,75-79세,7662,3265,4397
202012,46110,전라남도,목포시,75-79세,7634,3243,4391
202101,46110,전라남도,목포시,75-79세,7622,3241,4381
202102,46110,전라남도,목포시,75-79세,7643,3243,4400
202103,46110,전라남도,목포시,75-79세,7635,3243,4392
202104,46110,전라남도,목포시,75-79세,7656,3272,4384
202105,46110,전라남도,목포시,75-79세,7705,3304,4401
202106,46110,전라남도,목포시,75-79세,7730,3320,4410
202007,46110,전라남도,목포시,80-84세,4768,1700,3068
202008,46110,전라남도,목포시,80-84세,4765,1697,3068
202009,46110,전라남도,목포시,80-84세,4822,1732,3090
202010,46110,전라남도,목포시,80-84세,4858,1750,3108
202011,46110,전라남도,목포시,80-84세,4861,1749,3112
202012,46110,전라남도,목포시,80-84세,4898,1762,3136
202101,46110,전라남도,목포시,80-84세,4930,1774,3156
202102,46110,전라남도,목포시,80-84세,4976,1790,3186
202103,46110,전라남도,목포시,80-84세,4996,1796,3200
202104,46110,전라남도,목포시,80-84세,5002,1801,3201
202105,46110,전라남도,목포시,80-84세,5051,1821,3230
202106,46110,전라남도,목포시,80-84세,5109,1842,3267
202007,46110,전라남도,목포시,85-89세,2148,629,1519
202008,46110,전라남도,목포시,85-89세,2163,624,1539
202009,46110,전라남도,목포시,85-89세,2171,628,1543
202010,46110,전라남도,목포시,85-89세,2167,626,1541
202011,46110,전라남도,목포시,85-89세,2182,629,1553
202012,46110,전라남도,목포시,85-89세,2198,631,1567
202101,46110,전라남도,목포시,85-89세,2220,638,1582
202102,46110,전라남도,목포시,85-89세,2239,646,1593
202103,46110,전라남도,목포시,85-89세,2256,645,1611
202104,46110,전라남도,목포시,85-89세,2279,652,1627
202105,46110,전라남도,목포시,85-89세,2267,652,1615
202106,46110,전라남도,목포시,85-89세,2268,652,1616
202007,46110,전라남도,목포시,90-94세,760,165,595
202008,46110,전라남도,목포시,90-94세,764,169,595
202009,46110,전라남도,목포시,90-94세,765,165,600
202010,46110,전라남도,목포시,90-94세,769,163,606
202011,46110,전라남도,목포시,90-94세,759,159,600
202012,46110,전라남도,목포시,90-94세,768,162,606
202101,46110,전라남도,목포시,90-94세,767,161,606
202102,46110,전라남도,목포시,90-94세,784,175,609
202103,46110,전라남도,목포시,90-94세,785,177,608
202104,46110,전라남도,목포시,90-94세,794,181,613
202105,46110,전라남도,목포시,90-94세,799,178,621
202106,46110,전라남도,목포시,90-94세,795,178,617
202007,46110,전라남도,목포시,95-99세,184,30,154
202008,46110,전라남도,목포시,95-99세,191,31,160
202009,46110,전라남도,목포시,95-99세,196,34,162
202010,46110,전라남도,목포시,95-99세,194,35,159
202011,46110,전라남도,목포시,95-99세,195,37,158
202012,46110,전라남도,목포시,95-99세,190,35,155
202101,46110,전라남도,목포시,95-99세,193,37,156
202102,46110,전라남도,목포시,95-99세,189,37,152
202103,46110,전라남도,목포시,95-99세,174,31,143
202104,46110,전라남도,목포시,95-99세,177,32,145
202105,46110,전라남도,목포시,95-99세,173,34,139
202106,46110,전라남도,목포시,95-99세,176,34,142
202007,46110,전라남도,목포시,100+,79,16,63
202008,46110,전라남도,목포시,100+,79,16,63
202009,46110,전라남도,목포시,100+,80,16,64
202010,46110,전라남도,목포시,100+,81,16,65
202011,46110,전라남도,목포시,100+,81,16,65
202012,46110,전라남도,목포시,100+,82,16,66
202101,46110,전라남도,목포시,100+,82,16,66
202102,46110,전라남도,목포시,100+,82,16,66
202103,46110,전라남도,목포시,100+,36,6,30
202104,46110,전라남도,목포시,100+,37,6,31
202105,46110,전라남도,목포시,100+,38,5,33
202106,46110,전라남도,목포시,100+,39,5,34
202007,46130,전라남도,여수시,0-4세,9205,4700,4505
202008,46130,전라남도,여수시,0-4세,9132,4687,4445
202009,46130,전라남도,여수시,0-4세,9052,4643,4409
202010,46130,전라남도,여수시,0-4세,8950,4596,4354
202011,46130,전라남도,여수시,0-4세,8861,4557,4304
202012,46130,전라남도,여수시,0-4세,8793,4511,4282
202101,46130,전라남도,여수시,0-4세,8713,4469,4244
202102,46130,전라남도,여수시,0-4세,8617,4412,4205
202103,46130,전라남도,여수시,0-4세,8538,4363,4175
202104,46130,전라남도,여수시,0-4세,8436,4312,4124
202105,46130,전라남도,여수시,0-4세,8407,4297,4110
202106,46130,전라남도,여수시,0-4세,8335,4267,4068
202007,46130,전라남도,여수시,5-9세,12313,6223,6090
202008,46130,전라남도,여수시,5-9세,12294,6190,6104
202009,46130,전라남도,여수시,5-9세,12270,6174,6096
202010,46130,전라남도,여수시,5-9세,12233,6168,6065
202011,46130,전라남도,여수시,5-9세,12153,6136,6017
202012,46130,전라남도,여수시,5-9세,12149,6128,6021
202101,46130,전라남도,여수시,5-9세,12083,6077,6006
202102,46130,전라남도,여수시,5-9세,12036,6050,5986
202103,46130,전라남도,여수시,5-9세,11995,6020,5975
202104,46130,전라남도,여수시,5-9세,11963,6012,5951
202105,46130,전라남도,여수시,5-9세,11909,5993,5916
202106,46130,전라남도,여수시,5-9세,11856,5959,5897
202007,46130,전라남도,여수시,10-14세,12287,6318,5969
202008,46130,전라남도,여수시,10-14세,12321,6338,5983
202009,46130,전라남도,여수시,10-14세,12341,6347,5994
202010,46130,전라남도,여수시,10-14세,12366,6344,6022
202011,46130,전라남도,여수시,10-14세,12430,6355,6075
202012,46130,전라남도,여수시,10-14세,12448,6366,6082
202101,46130,전라남도,여수시,10-14세,12481,6390,6091
202102,46130,전라남도,여수시,10-14세,12485,6401,6084
202103,46130,전라남도,여수시,10-14세,12486,6416,6070
202104,46130,전라남도,여수시,10-14세,12531,6423,6108
202105,46130,전라남도,여수시,10-14세,12538,6401,6137
202106,46130,전라남도,여수시,10-14세,12570,6417,6153
202007,46130,전라남도,여수시,15-19세,14529,7667,6862
202008,46130,전라남도,여수시,15-19세,14411,7603,6808
202009,46130,전라남도,여수시,15-19세,14294,7539,6755
202010,46130,전라남도,여수시,15-19세,14191,7494,6697
202011,46130,전라남도,여수시,15-19세,14072,7414,6658
202012,46130,전라남도,여수시,15-19세,13964,7370,6594
202101,46130,전라남도,여수시,15-19세,13910,7321,6589
202102,46130,전라남도,여수시,15-19세,13798,7267,6531
202103,46130,전라남도,여수시,15-19세,13665,7211,6454
202104,46130,전라남도,여수시,15-19세,13555,7137,6418
202105,46130,전라남도,여수시,15-19세,13480,7092,6388
202106,46130,전라남도,여수시,15-19세,13413,7050,6363
202007,46130,전라남도,여수시,20-24세,17855,9918,7937
202008,46130,전라남도,여수시,20-24세,17748,9868,7880
202009,46130,전라남도,여수시,20-24세,17707,9856,7851
202010,46130,전라남도,여수시,20-24세,17703,9842,7861
202011,46130,전라남도,여수시,20-24세,17666,9832,7834
202012,46130,전라남도,여수시,20-24세,17595,9803,7792
202101,46130,전라남도,여수시,20-24세,17598,9789,7809
202102,46130,전라남도,여수시,20-24세,17481,9733,7748
202103,46130,전라남도,여수시,20-24세,17403,9690,7713
202104,46130,전라남도,여수시,20-24세,17304,9630,7674
202105,46130,전라남도,여수시,20-24세,17192,9580,7612
202106,46130,전라남도,여수시,20-24세,17064,9521,7543
202007,46130,전라남도,여수시,25-29세,15904,9143,6761
202008,46130,전라남도,여수시,25-29세,15903,9140,6763
202009,46130,전라남도,여수시,25-29세,15925,9179,6746
202010,46130,전라남도,여수시,25-29세,16055,9263,6792
202011,46130,전라남도,여수시,25-29세,16149,9342,6807
202012,46130,전라남도,여수시,25-29세,16124,9344,6780
202101,46130,전라남도,여수시,25-29세,16194,9380,6814
202102,46130,전라남도,여수시,25-29세,16184,9385,6799
202103,46130,전라남도,여수시,25-29세,16218,9386,6832
202104,46130,전라남도,여수시,25-29세,16268,9418,6850
202105,46130,전라남도,여수시,25-29세,16327,9474,6853
202106,46130,전라남도,여수시,25-29세,16323,9472,6851
202007,46130,전라남도,여수시,30-34세,13687,7474,6213
202008,46130,전라남도,여수시,30-34세,13645,7458,6187
202009,46130,전라남도,여수시,30-34세,13647,7456,6191
202010,46130,전라남도,여수시,30-34세,13599,7426,6173
202011,46130,전라남도,여수시,30-34세,13580,7407,6173
202012,46130,전라남도,여수시,30-34세,13516,7384,6132
202101,46130,전라남도,여수시,30-34세,13528,7384,6144
202102,46130,전라남도,여수시,30-34세,13438,7328,6110
202103,46130,전라남도,여수시,30-34세,13400,7312,6088
202104,46130,전라남도,여수시,30-34세,13393,7314,6079
202105,46130,전라남도,여수시,30-34세,13390,7293,6097
202106,46130,전라남도,여수시,30-34세,13384,7287,6097
202007,46130,전라남도,여수시,35-39세,17893,9520,8373
202008,46130,전라남도,여수시,35-39세,17754,9456,8298
202009,46130,전라남도,여수시,35-39세,17622,9360,8262
202010,46130,전라남도,여수시,35-39세,17584,9350,8234
202011,46130,전라남도,여수시,35-39세,17527,9324,8203
202012,46130,전라남도,여수시,35-39세,17510,9293,8217
202101,46130,전라남도,여수시,35-39세,17417,9227,8190
202102,46130,전라남도,여수시,35-39세,17322,9185,8137
202103,46130,전라남도,여수시,35-39세,17190,9100,8090
202104,46130,전라남도,여수시,35-39세,17118,9056,8062
202105,46130,전라남도,여수시,35-39세,16949,8994,7955
202106,46130,전라남도,여수시,35-39세,16808,8907,7901
202007,46130,전라남도,여수시,40-44세,19300,10140,9160
202008,46130,전라남도,여수시,40-44세,19311,10141,9170
202009,46130,전라남도,여수시,40-44세,19367,10179,9188
202010,46130,전라남도,여수시,40-44세,19378,10190,9188
202011,46130,전라남도,여수시,40-44세,19414,10203,9211
202012,46130,전라남도,여수시,40-44세,19365,10187,9178
202101,46130,전라남도,여수시,40-44세,19366,10202,9164
202102,46130,전라남도,여수시,40-44세,19455,10265,9190
202103,46130,전라남도,여수시,40-44세,19404,10236,9168
202104,46130,전라남도,여수시,40-44세,19365,10216,9149
202105,46130,전라남도,여수시,40-44세,19380,10215,9165
202106,46130,전라남도,여수시,40-44세,19397,10220,9177
202007,46130,전라남도,여수시,45-49세,23111,12228,10883
202008,46130,전라남도,여수시,45-49세,23037,12200,10837
202009,46130,전라남도,여수시,45-49세,22948,12169,10779
202010,46130,전라남도,여수시,45-49세,22807,12078,10729
202011,46130,전라남도,여수시,45-49세,22664,12018,10646
202012,46130,전라남도,여수시,45-49세,22550,11947,10603
202101,46130,전라남도,여수시,45-49세,22536,11925,10611
202102,46130,전라남도,여수시,45-49세,22471,11886,10585
202103,46130,전라남도,여수시,45-49세,22406,11870,10536
202104,46130,전라남도,여수시,45-49세,22337,11826,10511
202105,46130,전라남도,여수시,45-49세,22028,11656,10372
202106,46130,전라남도,여수시,45-49세,21941,11640,10301
202007,46130,전라남도,여수시,50-54세,24186,12743,11443
202008,46130,전라남도,여수시,50-54세,24122,12696,11426
202009,46130,전라남도,여수시,50-54세,24181,12734,11447
202010,46130,전라남도,여수시,50-54세,24182,12763,11419
202011,46130,전라남도,여수시,50-54세,24240,12796,11444
202012,46130,전라남도,여수시,50-54세,24216,12798,11418
202101,46130,전라남도,여수시,50-54세,24315,12868,11447
202102,46130,전라남도,여수시,50-54세,24350,12892,11458
202103,46130,전라남도,여수시,50-54세,24174,12793,11381
202104,46130,전라남도,여수시,50-54세,24164,12797,11367
202105,46130,전라남도,여수시,50-54세,24283,12853,11430
202106,46130,전라남도,여수시,50-54세,24244,12838,11406
202007,46130,전라남도,여수시,55-59세,24400,12598,11802
202008,46130,전라남도,여수시,55-59세,24335,12570,11765
202009,46130,전라남도,여수시,55-59세,24285,12577,11708
202010,46130,전라남도,여수시,55-59세,24324,12589,11735
202011,46130,전라남도,여수시,55-59세,24331,12608,11723
202012,46130,전라남도,여수시,55-59세,24305,12608,11697
202101,46130,전라남도,여수시,55-59세,24216,12569,11647
202102,46130,전라남도,여수시,55-59세,24190,12597,11593
202103,46130,전라남도,여수시,55-59세,24273,12641,11632
202104,46130,전라남도,여수시,55-59세,24232,12666,11566
202105,46130,전라남도,여수시,55-59세,24100,12646,11454
202106,46130,전라남도,여수시,55-59세,23984,12580,11404
202007,46130,전라남도,여수시,60-64세,22650,11271,11379
202008,46130,전라남도,여수시,60-64세,22804,11346,11458
202009,46130,전라남도,여수시,60-64세,22899,11371,11528
202010,46130,전라남도,여수시,60-64세,23004,11432,11572
202011,46130,전라남도,여수시,60-64세,23057,11440,11617
202012,46130,전라남도,여수시,60-64세,23120,11475,11645
202101,46130,전라남도,여수시,60-64세,23310,11577,11733
202102,46130,전라남도,여수시,60-64세,23401,11599,11802
202103,46130,전라남도,여수시,60-64세,23499,11651,11848
202104,46130,전라남도,여수시,60-64세,23630,11688,11942
202105,46130,전라남도,여수시,60-64세,23742,11730,12012
202106,46130,전라남도,여수시,60-64세,23865,11787,12078
202007,46130,전라남도,여수시,65-69세,17261,8531,8730
202008,46130,전라남도,여수시,65-69세,17326,8573,8753
202009,46130,전라남도,여수시,65-69세,17437,8648,8789
202010,46130,전라남도,여수시,65-69세,17517,8671,8846
202011,46130,전라남도,여수시,65-69세,17612,8728,8884
202012,46130,전라남도,여수시,65-69세,17672,8749,8923
202101,46130,전라남도,여수시,65-69세,17742,8780,8962
202102,46130,전라남도,여수시,65-69세,17756,8777,8979
202103,46130,전라남도,여수시,65-69세,17812,8798,9014
202104,46130,전라남도,여수시,65-69세,17877,8816,9061
202105,46130,전라남도,여수시,65-69세,17789,8791,8998
202106,46130,전라남도,여수시,65-69세,17796,8799,8997
202007,46130,전라남도,여수시,70-74세,13660,6519,7141
202008,46130,전라남도,여수시,70-74세,13734,6551,7183
202009,46130,전라남도,여수시,70-74세,13848,6610,7238
202010,46130,전라남도,여수시,70-74세,13977,6684,7293
202011,46130,전라남도,여수시,70-74세,14101,6747,7354
202012,46130,전라남도,여수시,70-74세,14242,6826,7416
202101,46130,전라남도,여수시,70-74세,14386,6891,7495
202102,46130,전라남도,여수시,70-74세,14495,6953,7542
202103,46130,전라남도,여수시,70-74세,14536,6988,7548
202104,46130,전라남도,여수시,70-74세,14521,6975,7546
202105,46130,전라남도,여수시,70-74세,14584,7011,7573
202106,46130,전라남도,여수시,70-74세,14580,7008,7572
202007,46130,전라남도,여수시,75-79세,10503,4404,6099
202008,46130,전라남도,여수시,75-79세,10516,4428,6088
202009,46130,전라남도,여수시,75-79세,10455,4403,6052
202010,46130,전라남도,여수시,75-79세,10389,4364,6025
202011,46130,전라남도,여수시,75-79세,10357,4353,6004
202012,46130,전라남도,여수시,75-79세,10292,4338,5954
202101,46130,전라남도,여수시,75-79세,10248,4337,5911
202102,46130,전라남도,여수시,75-79세,10167,4309,5858
202103,46130,전라남도,여수시,75-79세,10209,4337,5872
202104,46130,전라남도,여수시,75-79세,10194,4359,5835
202105,46130,전라남도,여수시,75-79세,10172,4347,5825
202106,46130,전라남도,여수시,75-79세,10177,4370,5807
202007,46130,전라남도,여수시,80-84세,6966,2512,4454
202008,46130,전라남도,여수시,80-84세,6998,2522,4476
202009,46130,전라남도,여수시,80-84세,7026,2536,4490
202010,46130,전라남도,여수시,80-84세,7064,2565,4499
202011,46130,전라남도,여수시,80-84세,7069,2571,4498
202012,46130,전라남도,여수시,80-84세,7103,2579,4524
202101,46130,전라남도,여수시,80-84세,7159,2600,4559
202102,46130,전라남도,여수시,80-84세,7225,2638,4587
202103,46130,전라남도,여수시,80-84세,7244,2656,4588
202104,46130,전라남도,여수시,80-84세,7296,2666,4630
202105,46130,전라남도,여수시,80-84세,7313,2681,4632
202106,46130,전라남도,여수시,80-84세,7344,2686,4658
202007,46130,전라남도,여수시,85-89세,3530,981,2549
202008,46130,전라남도,여수시,85-89세,3528,978,2550
202009,46130,전라남도,여수시,85-89세,3545,983,2562
202010,46130,전라남도,여수시,85-89세,3558,985,2573
202011,46130,전라남도,여수시,85-89세,3560,983,2577
202012,46130,전라남도,여수시,85-89세,3566,987,2579
202101,46130,전라남도,여수시,85-89세,3553,989,2564
202102,46130,전라남도,여수시,85-89세,3573,987,2586
202103,46130,전라남도,여수시,85-89세,3604,1001,2603
202104,46130,전라남도,여수시,85-89세,3627,1006,2621
202105,46130,전라남도,여수시,85-89세,3652,1017,2635
202106,46130,전라남도,여수시,85-89세,3650,1020,2630
202007,46130,전라남도,여수시,90-94세,1275,242,1033
202008,46130,전라남도,여수시,90-94세,1276,240,1036
202009,46130,전라남도,여수시,90-94세,1282,237,1045
202010,46130,전라남도,여수시,90-94세,1289,238,1051
202011,46130,전라남도,여수시,90-94세,1296,236,1060
202012,46130,전라남도,여수시,90-94세,1302,236,1066
202101,46130,전라남도,여수시,90-94세,1332,242,1090
202102,46130,전라남도,여수시,90-94세,1355,251,1104
202103,46130,전라남도,여수시,90-94세,1382,254,1128
202104,46130,전라남도,여수시,90-94세,1398,258,1140
202105,46130,전라남도,여수시,90-94세,1410,256,1154
202106,46130,전라남도,여수시,90-94세,1415,261,1154
202007,46130,전라남도,여수시,95-99세,305,47,258
202008,46130,전라남도,여수시,95-99세,304,46,258
202009,46130,전라남도,여수시,95-99세,308,47,261
202010,46130,전라남도,여수시,95-99세,305,47,258
202011,46130,전라남도,여수시,95-99세,303,49,254
202012,46130,전라남도,여수시,95-99세,305,49,256
202101,46130,전라남도,여수시,95-99세,303,49,254
202102,46130,전라남도,여수시,95-99세,307,47,260
202103,46130,전라남도,여수시,95-99세,304,45,259
202104,46130,전라남도,여수시,95-99세,302,46,256
202105,46130,전라남도,여수시,95-99세,284,42,242
202106,46130,전라남도,여수시,95-99세,284,41,243
202007,46130,전라남도,여수시,100+,105,15,90
202008,46130,전라남도,여수시,100+,104,15,89
202009,46130,전라남도,여수시,100+,106,16,90
202010,46130,전라남도,여수시,100+,109,17,92
202011,46130,전라남도,여수시,100+,107,17,90
202012,46130,전라남도,여수시,100+,105,17,88
202101,46130,전라남도,여수시,100+,107,17,90
202102,46130,전라남도,여수시,100+,107,17,90
202103,46130,전라남도,여수시,100+,102,17,85
202104,46130,전라남도,여수시,100+,102,17,85
202105,46130,전라남도,여수시,100+,70,10,60
202106,46130,전라남도,여수시,100+,51,7,44
202007,46150,전라남도,순천시,0-4세,10079,5237,4842
202008,46150,전라남도,순천시,0-4세,10047,5212,4835
202009,46150,전라남도,순천시,0-4세,9994,5183,4811
202010,46150,전라남도,순천시,0-4세,9926,5118,4808
202011,46150,전라남도,순천시,0-4세,9885,5087,4798
202012,46150,전라남도,순천시,0-4세,9832,5053,4779
202101,46150,전라남도,순천시,0-4세,9748,5021,4727
202102,46150,전라남도,순천시,0-4세,9703,5007,4696
202103,46150,전라남도,순천시,0-4세,9628,4969,4659
202104,46150,전라남도,순천시,0-4세,9544,4927,4617
202105,46150,전라남도,순천시,0-4세,9498,4898,4600
202106,46150,전라남도,순천시,0-4세,9458,4879,4579
202007,46150,전라남도,순천시,5-9세,13730,7018,6712
202008,46150,전라남도,순천시,5-9세,13731,7010,6721
202009,46150,전라남도,순천시,5-9세,13725,6994,6731
202010,46150,전라남도,순천시,5-9세,13737,7015,6722
202011,46150,전라남도,순천시,5-9세,13703,7008,6695
202012,46150,전라남도,순천시,5-9세,13696,7014,6682
202101,46150,전라남도,순천시,5-9세,13624,6976,6648
202102,46150,전라남도,순천시,5-9세,13612,6936,6676
202103,46150,전라남도,순천시,5-9세,13594,6920,6674
202104,46150,전라남도,순천시,5-9세,13600,6912,6688
202105,46150,전라남도,순천시,5-9세,13552,6896,6656
202106,46150,전라남도,순천시,5-9세,13542,6880,6662
202007,46150,전라남도,순천시,10-14세,14411,7414,6997
202008,46150,전라남도,순천시,10-14세,14408,7419,6989
202009,46150,전라남도,순천시,10-14세,14442,7450,6992
202010,46150,전라남도,순천시,10-14세,14488,7483,7005
202011,46150,전라남도,순천시,10-14세,14510,7490,7020
202012,46150,전라남도,순천시,10-14세,14489,7493,6996
202101,46150,전라남도,순천시,10-14세,14599,7530,7069
202102,46150,전라남도,순천시,10-14세,14567,7541,7026
202103,46150,전라남도,순천시,10-14세,14568,7543,7025
202104,46150,전라남도,순천시,10-14세,14550,7549,7001
202105,46150,전라남도,순천시,10-14세,14534,7534,7000
202106,46150,전라남도,순천시,10-14세,14504,7515,6989
202007,46150,전라남도,순천시,15-19세,16317,8653,7664
202008,46150,전라남도,순천시,15-19세,16233,8598,7635
202009,46150,전라남도,순천시,15-19세,16090,8530,7560
202010,46150,전라남도,순천시,15-19세,15972,8447,7525
202011,46150,전라남도,순천시,15-19세,15878,8393,7485
202012,46150,전라남도,순천시,15-19세,15779,8303,7476
202101,46150,전라남도,순천시,15-19세,15635,8225,7410
202102,46150,전라남도,순천시,15-19세,15523,8162,7361
202103,46150,전라남도,순천시,15-19세,15381,8072,7309
202104,46150,전라남도,순천시,15-19세,15289,8015,7274
202105,46150,전라남도,순천시,15-19세,15271,8011,7260
202106,46150,전라남도,순천시,15-19세,15179,7959,7220
202007,46150,전라남도,순천시,20-24세,19844,10716,9128
202008,46150,전라남도,순천시,20-24세,19800,10713,9087
202009,46150,전라남도,순천시,20-24세,19826,10695,9131
202010,46150,전라남도,순천시,20-24세,19839,10691,9148
202011,46150,전라남도,순천시,20-24세,19750,10677,9073
202012,46150,전라남도,순천시,20-24세,19638,10625,9013
202101,46150,전라남도,순천시,20-24세,19678,10677,9001
202102,46150,전라남도,순천시,20-24세,19443,10573,8870
202103,46150,전라남도,순천시,20-24세,19389,10550,8839
202104,46150,전라남도,순천시,20-24세,19337,10529,8808
202105,46150,전라남도,순천시,20-24세,19279,10472,8807
202106,46150,전라남도,순천시,20-24세,19203,10438,8765
202007,46150,전라남도,순천시,25-29세,17398,9518,7880
202008,46150,전라남도,순천시,25-29세,17550,9564,7986
202009,46150,전라남도,순천시,25-29세,17665,9631,8034
202010,46150,전라남도,순천시,25-29세,17817,9722,8095
202011,46150,전라남도,순천시,25-29세,17900,9733,8167
202012,46150,전라남도,순천시,25-29세,17915,9749,8166
202101,46150,전라남도,순천시,25-29세,17962,9786,8176
202102,46150,전라남도,순천시,25-29세,17919,9774,8145
202103,46150,전라남도,순천시,25-29세,17983,9799,8184
202104,46150,전라남도,순천시,25-29세,17993,9830,8163
202105,46150,전라남도,순천시,25-29세,17972,9844,8128
202106,46150,전라남도,순천시,25-29세,17998,9840,8158
202007,46150,전라남도,순천시,30-34세,14538,7517,7021
202008,46150,전라남도,순천시,30-34세,14702,7636,7066
202009,46150,전라남도,순천시,30-34세,14726,7648,7078
202010,46150,전라남도,순천시,30-34세,14742,7662,7080
202011,46150,전라남도,순천시,30-34세,14699,7640,7059
202012,46150,전라남도,순천시,30-34세,14641,7623,7018
202101,46150,전라남도,순천시,30-34세,14734,7648,7086
202102,46150,전라남도,순천시,30-34세,14743,7682,7061
202103,46150,전라남도,순천시,30-34세,14752,7682,7070
202104,46150,전라남도,순천시,30-34세,14769,7691,7078
202105,46150,전라남도,순천시,30-34세,14817,7718,7099
202106,46150,전라남도,순천시,30-34세,14888,7770,7118
202007,46150,전라남도,순천시,35-39세,18708,9458,9250
202008,46150,전라남도,순천시,35-39세,18703,9501,9202
202009,46150,전라남도,순천시,35-39세,18649,9487,9162
202010,46150,전라남도,순천시,35-39세,18575,9435,9140
202011,46150,전라남도,순천시,35-39세,18545,9428,9117
202012,46150,전라남도,순천시,35-39세,18476,9381,9095
202101,46150,전라남도,순천시,35-39세,18431,9365,9066
202102,46150,전라남도,순천시,35-39세,18368,9306,9062
202103,46150,전라남도,순천시,35-39세,18304,9264,9040
202104,46150,전라남도,순천시,35-39세,18277,9247,9030
202105,46150,전라남도,순천시,35-39세,18163,9188,8975
202106,46150,전라남도,순천시,35-39세,18099,9159,8940
202007,46150,전라남도,순천시,40-44세,19852,9762,10090
202008,46150,전라남도,순천시,40-44세,19941,9775,10166
202009,46150,전라남도,순천시,40-44세,19995,9796,10199
202010,46150,전라남도,순천시,40-44세,20108,9870,10238
202011,46150,전라남도,순천시,40-44세,20100,9867,10233
202012,46150,전라남도,순천시,40-44세,19993,9824,10169
202101,46150,전라남도,순천시,40-44세,19986,9831,10155
202102,46150,전라남도,순천시,40-44세,20033,9886,10147
202103,46150,전라남도,순천시,40-44세,19944,9875,10069
202104,46150,전라남도,순천시,40-44세,19918,9867,10051
202105,46150,전라남도,순천시,40-44세,19929,9876,10053
202106,46150,전라남도,순천시,40-44세,20038,9935,10103
202007,46150,전라남도,순천시,45-49세,23926,11840,12086
202008,46150,전라남도,순천시,45-49세,23905,11840,12065
202009,46150,전라남도,순천시,45-49세,23754,11759,11995
202010,46150,전라남도,순천시,45-49세,23659,11701,11958
202011,46150,전라남도,순천시,45-49세,23559,11639,11920
202012,46150,전라남도,순천시,45-49세,23461,11561,11900
202101,46150,전라남도,순천시,45-49세,23411,11498,11913
202102,46150,전라남도,순천시,45-49세,23297,11435,11862
202103,46150,전라남도,순천시,45-49세,23246,11397,11849
202104,46150,전라남도,순천시,45-49세,23195,11398,11797
202105,46150,전라남도,순천시,45-49세,22948,11267,11681
202106,46150,전라남도,순천시,45-49세,22827,11217,11610
202007,46150,전라남도,순천시,50-54세,25329,12698,12631
202008,46150,전라남도,순천시,50-54세,25345,12694,12651
202009,46150,전라남도,순천시,50-54세,25386,12694,12692
202010,46150,전라남도,순천시,50-54세,25409,12707,12702
202011,46150,전라남도,순천시,50-54세,25409,12725,12684
202012,46150,전라남도,순천시,50-54세,25383,12748,12635
202101,46150,전라남도,순천시,50-54세,25513,12831,12682
202102,46150,전라남도,순천시,50-54세,25550,12824,12726
202103,46150,전라남도,순천시,50-54세,25432,12754,12678
202104,46150,전라남도,순천시,50-54세,25422,12723,12699
202105,46150,전라남도,순천시,50-54세,25481,12745,12736
202106,46150,전라남도,순천시,50-54세,25551,12768,12783
202007,46150,전라남도,순천시,55-59세,23818,12157,11661
202008,46150,전라남도,순천시,55-59세,23834,12150,11684
202009,46150,전라남도,순천시,55-59세,23801,12162,11639
202010,46150,전라남도,순천시,55-59세,23840,12150,11690
202011,46150,전라남도,순천시,55-59세,23806,12092,11714
202012,46150,전라남도,순천시,55-59세,23741,12041,11700
202101,46150,전라남도,순천시,55-59세,23729,12070,11659
202102,46150,전라남도,순천시,55-59세,23677,12041,11636
202103,46150,전라남도,순천시,55-59세,23775,12093,11682
202104,46150,전라남도,순천시,55-59세,23791,12097,11694
202105,46150,전라남도,순천시,55-59세,23733,12094,11639
202106,46150,전라남도,순천시,55-59세,23592,12032,11560
202007,46150,전라남도,순천시,60-64세,19781,9944,9837
202008,46150,전라남도,순천시,60-64세,20004,10047,9957
202009,46150,전라남도,순천시,60-64세,20217,10140,10077
202010,46150,전라남도,순천시,60-64세,20417,10249,10168
202011,46150,전라남도,순천시,60-64세,20587,10353,10234
202012,46150,전라남도,순천시,60-64세,20700,10398,10302
202101,46150,전라남도,순천시,60-64세,20942,10473,10469
202102,46150,전라남도,순천시,60-64세,21109,10553,10556
202103,46150,전라남도,순천시,60-64세,21195,10595,10600
202104,46150,전라남도,순천시,60-64세,21335,10662,10673
202105,46150,전라남도,순천시,60-64세,21475,10765,10710
202106,46150,전라남도,순천시,60-64세,21690,10870,10820
202007,46150,전라남도,순천시,65-69세,13227,6614,6613
202008,46150,전라남도,순천시,65-69세,13307,6666,6641
202009,46150,전라남도,순천시,65-69세,13364,6693,6671
202010,46150,전라남도,순천시,65-69세,13498,6761,6737
202011,46150,전라남도,순천시,65-69세,13552,6795,6757
202012,46150,전라남도,순천시,65-69세,13637,6852,6785
202101,46150,전라남도,순천시,65-69세,13714,6908,6806
202102,46150,전라남도,순천시,65-69세,13780,6927,6853
202103,46150,전라남도,순천시,65-69세,13869,6970,6899
202104,46150,전라남도,순천시,65-69세,13918,6991,6927
202105,46150,전라남도,순천시,65-69세,13907,6961,6946
202106,46150,전라남도,순천시,65-69세,13992,7007,6985
202007,46150,전라남도,순천시,70-74세,10301,4886,5415
202008,46150,전라남도,순천시,70-74세,10357,4921,5436
202009,46150,전라남도,순천시,70-74세,10434,4962,5472
202010,46150,전라남도,순천시,70-74세,10539,5016,5523
202011,46150,전라남도,순천시,70-74세,10643,5062,5581
202012,46150,전라남도,순천시,70-74세,10710,5091,5619
202101,46150,전라남도,순천시,70-74세,10788,5123,5665
202102,46150,전라남도,순천시,70-74세,10859,5177,5682
202103,46150,전라남도,순천시,70-74세,10891,5211,5680
202104,46150,전라남도,순천시,70-74세,10942,5238,5704
202105,46150,전라남도,순천시,70-74세,10972,5266,5706
202106,46150,전라남도,순천시,70-74세,10990,5257,5733
202007,46150,전라남도,순천시,75-79세,8503,3485,5018
202008,46150,전라남도,순천시,75-79세,8492,3487,5005
202009,46150,전라남도,순천시,75-79세,8457,3475,4982
202010,46150,전라남도,순천시,75-79세,8411,3448,4963
202011,46150,전라남도,순천시,75-79세,8375,3425,4950
202012,46150,전라남도,순천시,75-79세,8319,3399,4920
202101,46150,전라남도,순천시,75-79세,8276,3409,4867
202102,46150,전라남도,순천시,75-79세,8201,3374,4827
202103,46150,전라남도,순천시,75-79세,8135,3357,4778
202104,46150,전라남도,순천시,75-79세,8096,3337,4759
202105,46150,전라남도,순천시,75-79세,8098,3338,4760
202106,46150,전라남도,순천시,75-79세,8106,3357,4749
202007,46150,전라남도,순천시,80-84세,6492,2260,4232
202008,46150,전라남도,순천시,80-84세,6511,2262,4249
202009,46150,전라남도,순천시,80-84세,6504,2264,4240
202010,46150,전라남도,순천시,80-84세,6502,2265,4237
202011,46150,전라남도,순천시,80-84세,6502,2269,4233
202012,46150,전라남도,순천시,80-84세,6510,2295,4215
202101,46150,전라남도,순천시,80-84세,6526,2293,4233
202102,46150,전라남도,순천시,80-84세,6550,2325,4225
202103,46150,전라남도,순천시,80-84세,6572,2343,4229
202104,46150,전라남도,순천시,80-84세,6586,2361,4225
202105,46150,전라남도,순천시,80-84세,6576,2373,4203
202106,46150,전라남도,순천시,80-84세,6604,2381,4223
202007,46150,전라남도,순천시,85-89세,3502,971,2531
202008,46150,전라남도,순천시,85-89세,3511,983,2528
202009,46150,전라남도,순천시,85-89세,3529,988,2541
202010,46150,전라남도,순천시,85-89세,3554,988,2566
202011,46150,전라남도,순천시,85-89세,3564,997,2567
202012,46150,전라남도,순천시,85-89세,3609,1001,2608
202101,46150,전라남도,순천시,85-89세,3639,1012,2627
202102,46150,전라남도,순천시,85-89세,3711,1029,2682
202103,46150,전라남도,순천시,85-89세,3759,1038,2721
202104,46150,전라남도,순천시,85-89세,3819,1060,2759
202105,46150,전라남도,순천시,85-89세,3852,1066,2786
202106,46150,전라남도,순천시,85-89세,3856,1068,2788
202007,46150,전라남도,순천시,90-94세,1256,270,986
202008,46150,전라남도,순천시,90-94세,1263,266,997
202009,46150,전라남도,순천시,90-94세,1278,274,1004
202010,46150,전라남도,순천시,90-94세,1281,277,1004
202011,46150,전라남도,순천시,90-94세,1287,274,1013
202012,46150,전라남도,순천시,90-94세,1291,272,1019
202101,46150,전라남도,순천시,90-94세,1305,275,1030
202102,46150,전라남도,순천시,90-94세,1317,276,1041
202103,46150,전라남도,순천시,90-94세,1306,270,1036
202104,46150,전라남도,순천시,90-94세,1310,268,1042
202105,46150,전라남도,순천시,90-94세,1324,272,1052
202106,46150,전라남도,순천시,90-94세,1328,277,1051
202007,46150,전라남도,순천시,95-99세,289,40,249
202008,46150,전라남도,순천시,95-99세,291,42,249
202009,46150,전라남도,순천시,95-99세,301,43,258
202010,46150,전라남도,순천시,95-99세,299,40,259
202011,46150,전라남도,순천시,95-99세,299,39,260
202012,46150,전라남도,순천시,95-99세,300,41,259
202101,46150,전라남도,순천시,95-99세,305,44,261
202102,46150,전라남도,순천시,95-99세,298,44,254
202103,46150,전라남도,순천시,95-99세,308,46,262
202104,46150,전라남도,순천시,95-99세,305,47,258
202105,46150,전라남도,순천시,95-99세,302,47,255
202106,46150,전라남도,순천시,95-99세,308,49,259
202007,46150,전라남도,순천시,100+,65,8,57
202008,46150,전라남도,순천시,100+,64,8,56
202009,46150,전라남도,순천시,100+,63,8,55
202010,46150,전라남도,순천시,100+,63,8,55
202011,46150,전라남도,순천시,100+,65,8,57
202012,46150,전라남도,순천시,100+,69,8,61
202101,46150,전라남도,순천시,100+,73,8,65
202102,46150,전라남도,순천시,100+,76,8,68
202103,46150,전라남도,순천시,100+,73,7,66
202104,46150,전라남도,순천시,100+,73,7,66
202105,46150,전라남도,순천시,100+,62,6,56
202106,46150,전라남도,순천시,100+,63,6,57
202007,46170,전라남도,나주시,0-4세,4687,2399,2288
202008,46170,전라남도,나주시,0-4세,4660,2388,2272
202009,46170,전라남도,나주시,0-4세,4624,2390,2234
202010,46170,전라남도,나주시,0-4세,4596,2363,2233
202011,46170,전라남도,나주시,0-4세,4589,2356,2233
202012,46170,전라남도,나주시,0-4세,4589,2349,2240
202101,46170,전라남도,나주시,0-4세,4522,2311,2211
202102,46170,전라남도,나주시,0-4세,4486,2291,2195
202103,46170,전라남도,나주시,0-4세,4463,2291,2172
202104,46170,전라남도,나주시,0-4세,4467,2300,2167
202105,46170,전라남도,나주시,0-4세,4446,2299,2147
202106,46170,전라남도,나주시,0-4세,4418,2289,2129
202007,46170,전라남도,나주시,5-9세,5426,2776,2650
202008,46170,전라남도,나주시,5-9세,5424,2765,2659
202009,46170,전라남도,나주시,5-9세,5450,2760,2690
202010,46170,전라남도,나주시,5-9세,5478,2782,2696
202011,46170,전라남도,나주시,5-9세,5512,2795,2717
202012,46170,전라남도,나주시,5-9세,5544,2806,2738
202101,46170,전라남도,나주시,5-9세,5557,2815,2742
202102,46170,전라남도,나주시,5-9세,5642,2867,2775
202103,46170,전라남도,나주시,5-9세,5638,2857,2781
202104,46170,전라남도,나주시,5-9세,5639,2863,2776
202105,46170,전라남도,나주시,5-9세,5651,2866,2785
202106,46170,전라남도,나주시,5-9세,5652,2873,2779
202007,46170,전라남도,나주시,10-14세,4723,2440,2283
202008,46170,전라남도,나주시,10-14세,4749,2456,2293
202009,46170,전라남도,나주시,10-14세,4772,2474,2298
202010,46170,전라남도,나주시,10-14세,4825,2504,2321
202011,46170,전라남도,나주시,10-14세,4846,2524,2322
202012,46170,전라남도,나주시,10-14세,4863,2523,2340
202101,46170,전라남도,나주시,10-14세,4937,2545,2392
202102,46170,전라남도,나주시,10-14세,4982,2577,2405
202103,46170,전라남도,나주시,10-14세,4997,2590,2407
202104,46170,전라남도,나주시,10-14세,5031,2586,2445
202105,46170,전라남도,나주시,10-14세,5050,2593,2457
202106,46170,전라남도,나주시,10-14세,5077,2608,2469
202007,46170,전라남도,나주시,15-19세,4632,2371,2261
202008,46170,전라남도,나주시,15-19세,4602,2366,2236
202009,46170,전라남도,나주시,15-19세,4566,2349,2217
202010,46170,전라남도,나주시,15-19세,4567,2354,2213
202011,46170,전라남도,나주시,15-19세,4533,2326,2207
202012,46170,전라남도,나주시,15-19세,4526,2333,2193
202101,46170,전라남도,나주시,15-19세,4559,2349,2210
202102,46170,전라남도,나주시,15-19세,4563,2347,2216
202103,46170,전라남도,나주시,15-19세,4577,2364,2213
202104,46170,전라남도,나주시,15-19세,4548,2358,2190
202105,46170,전라남도,나주시,15-19세,4552,2353,2199
202106,46170,전라남도,나주시,15-19세,4547,2342,2205
202007,46170,전라남도,나주시,20-24세,5637,2991,2646
202008,46170,전라남도,나주시,20-24세,5646,2986,2660
202009,46170,전라남도,나주시,20-24세,5640,2998,2642
202010,46170,전라남도,나주시,20-24세,5666,3000,2666
202011,46170,전라남도,나주시,20-24세,5685,3019,2666
202012,46170,전라남도,나주시,20-24세,5722,3048,2674
202101,46170,전라남도,나주시,20-24세,5702,3034,2668
202102,46170,전라남도,나주시,20-24세,5703,3032,2671
202103,46170,전라남도,나주시,20-24세,5650,2998,2652
202104,46170,전라남도,나주시,20-24세,5664,2999,2665
202105,46170,전라남도,나주시,20-24세,5638,3000,2638
202106,46170,전라남도,나주시,20-24세,5609,2997,2612
202007,46170,전라남도,나주시,25-29세,6509,3426,3083
202008,46170,전라남도,나주시,25-29세,6495,3414,3081
202009,46170,전라남도,나주시,25-29세,6512,3412,3100
202010,46170,전라남도,나주시,25-29세,6546,3446,3100
202011,46170,전라남도,나주시,25-29세,6597,3486,3111
202012,46170,전라남도,나주시,25-29세,6692,3532,3160
202101,46170,전라남도,나주시,25-29세,6673,3528,3145
202102,46170,전라남도,나주시,25-29세,6707,3553,3154
202103,46170,전라남도,나주시,25-29세,6779,3587,3192
202104,46170,전라남도,나주시,25-29세,6774,3568,3206
202105,46170,전라남도,나주시,25-29세,6786,3559,3227
202106,46170,전라남도,나주시,25-29세,6764,3543,3221
202007,46170,전라남도,나주시,30-34세,6462,3302,3160
202008,46170,전라남도,나주시,30-34세,6490,3326,3164
202009,46170,전라남도,나주시,30-34세,6529,3359,3170
202010,46170,전라남도,나주시,30-34세,6529,3356,3173
202011,46170,전라남도,나주시,30-34세,6525,3347,3178
202012,46170,전라남도,나주시,30-34세,6568,3384,3184
202101,46170,전라남도,나주시,30-34세,6567,3389,3178
202102,46170,전라남도,나주시,30-34세,6551,3366,3185
202103,46170,전라남도,나주시,30-34세,6555,3376,3179
202104,46170,전라남도,나주시,30-34세,6622,3399,3223
202105,46170,전라남도,나주시,30-34세,6650,3429,3221
202106,46170,전라남도,나주시,30-34세,6662,3450,3212
202007,46170,전라남도,나주시,35-39세,8083,4268,3815
202008,46170,전라남도,나주시,35-39세,8005,4216,3789
202009,46170,전라남도,나주시,35-39세,7987,4210,3777
202010,46170,전라남도,나주시,35-39세,7995,4219,3776
202011,46170,전라남도,나주시,35-39세,8009,4229,3780
202012,46170,전라남도,나주시,35-39세,8023,4216,3807
202101,46170,전라남도,나주시,35-39세,7965,4184,3781
202102,46170,전라남도,나주시,35-39세,7999,4217,3782
202103,46170,전라남도,나주시,35-39세,7961,4201,3760
202104,46170,전라남도,나주시,35-39세,7969,4209,3760
202105,46170,전라남도,나주시,35-39세,7935,4194,3741
202106,46170,전라남도,나주시,35-39세,7879,4165,3714
202007,46170,전라남도,나주시,40-44세,8060,4419,3641
202008,46170,전라남도,나주시,40-44세,8094,4430,3664
202009,46170,전라남도,나주시,40-44세,8140,4445,3695
202010,46170,전라남도,나주시,40-44세,8203,4460,3743
202011,46170,전라남도,나주시,40-44세,8223,4475,3748
202012,46170,전라남도,나주시,40-44세,8264,4480,3784
202101,46170,전라남도,나주시,40-44세,8329,4515,3814
202102,46170,전라남도,나주시,40-44세,8419,4534,3885
202103,46170,전라남도,나주시,40-44세,8371,4519,3852
202104,46170,전라남도,나주시,40-44세,8367,4512,3855
202105,46170,전라남도,나주시,40-44세,8384,4505,3879
202106,46170,전라남도,나주시,40-44세,8436,4535,3901
202007,46170,전라남도,나주시,45-49세,8191,4705,3486
202008,46170,전라남도,나주시,45-49세,8169,4679,3490
202009,46170,전라남도,나주시,45-49세,8132,4653,3479
202010,46170,전라남도,나주시,45-49세,8172,4683,3489
202011,46170,전라남도,나주시,45-49세,8165,4662,3503
202012,46170,전라남도,나주시,45-49세,8197,4683,3514
202101,46170,전라남도,나주시,45-49세,8230,4701,3529
202102,46170,전라남도,나주시,45-49세,8297,4736,3561
202103,46170,전라남도,나주시,45-49세,8266,4718,3548
202104,46170,전라남도,나주시,45-49세,8263,4718,3545
202105,46170,전라남도,나주시,45-49세,8231,4713,3518
202106,46170,전라남도,나주시,45-49세,8190,4684,3506
202007,46170,전라남도,나주시,50-54세,8331,4608,3723
202008,46170,전라남도,나주시,50-54세,8330,4592,3738
202009,46170,전라남도,나주시,50-54세,8340,4607,3733
202010,46170,전라남도,나주시,50-54세,8362,4605,3757
202011,46170,전라남도,나주시,50-54세,8374,4629,3745
202012,46170,전라남도,나주시,50-54세,8373,4622,3751
202101,46170,전라남도,나주시,50-54세,8403,4636,3767
202102,46170,전라남도,나주시,50-54세,8423,4642,3781
202103,46170,전라남도,나주시,50-54세,8358,4597,3761
202104,46170,전라남도,나주시,50-54세,8384,4617,3767
202105,46170,전라남도,나주시,50-54세,8455,4668,3787
202106,46170,전라남도,나주시,50-54세,8468,4683,3785
202007,46170,전라남도,나주시,55-59세,8900,4802,4098
202008,46170,전라남도,나주시,55-59세,8871,4792,4079
202009,46170,전라남도,나주시,55-59세,8856,4784,4072
202010,46170,전라남도,나주시,55-59세,8867,4786,4081
202011,46170,전라남도,나주시,55-59세,8847,4766,4081
202012,46170,전라남도,나주시,55-59세,8883,4795,4088
202101,46170,전라남도,나주시,55-59세,8880,4795,4085
202102,46170,전라남도,나주시,55-59세,8895,4806,4089
202103,46170,전라남도,나주시,55-59세,8936,4848,4088
202104,46170,전라남도,나주시,55-59세,8959,4860,4099
202105,46170,전라남도,나주시,55-59세,8914,4845,4069
202106,46170,전라남도,나주시,55-59세,8871,4839,4032
202007,46170,전라남도,나주시,60-64세,9014,4660,4354
202008,46170,전라남도,나주시,60-64세,9081,4696,4385
202009,46170,전라남도,나주시,60-64세,9132,4706,4426
202010,46170,전라남도,나주시,60-64세,9217,4747,4470
202011,46170,전라남도,나주시,60-64세,9298,4791,4507
202012,46170,전라남도,나주시,60-64세,9383,4826,4557
202101,46170,전라남도,나주시,60-64세,9418,4841,4577
202102,46170,전라남도,나주시,60-64세,9492,4871,4621
202103,46170,전라남도,나주시,60-64세,9427,4849,4578
202104,46170,전라남도,나주시,60-64세,9438,4863,4575
202105,46170,전라남도,나주시,60-64세,9497,4888,4609
202106,46170,전라남도,나주시,60-64세,9586,4931,4655
202007,46170,전라남도,나주시,65-69세,6662,3298,3364
202008,46170,전라남도,나주시,65-69세,6701,3312,3389
202009,46170,전라남도,나주시,65-69세,6720,3324,3396
202010,46170,전라남도,나주시,65-69세,6730,3342,3388
202011,46170,전라남도,나주시,65-69세,6760,3365,3395
202012,46170,전라남도,나주시,65-69세,6784,3381,3403
202101,46170,전라남도,나주시,65-69세,6849,3414,3435
202102,46170,전라남도,나주시,65-69세,6870,3427,3443
202103,46170,전라남도,나주시,65-69세,6901,3452,3449
202104,46170,전라남도,나주시,65-69세,6926,3471,3455
202105,46170,전라남도,나주시,65-69세,6956,3483,3473
202106,46170,전라남도,나주시,65-69세,6994,3497,3497
202007,46170,전라남도,나주시,70-74세,5834,2723,3111
202008,46170,전라남도,나주시,70-74세,5830,2730,3100
202009,46170,전라남도,나주시,70-74세,5869,2750,3119
202010,46170,전라남도,나주시,70-74세,5895,2758,3137
202011,46170,전라남도,나주시,70-74세,5926,2773,3153
202012,46170,전라남도,나주시,70-74세,5978,2808,3170
202101,46170,전라남도,나주시,70-74세,5995,2824,3171
202102,46170,전라남도,나주시,70-74세,6041,2850,3191
202103,46170,전라남도,나주시,70-74세,6038,2861,3177
202104,46170,전라남도,나주시,70-74세,6076,2877,3199
202105,46170,전라남도,나주시,70-74세,6090,2882,3208
202106,46170,전라남도,나주시,70-74세,6091,2883,3208
202007,46170,전라남도,나주시,75-79세,5693,2264,3429
202008,46170,전라남도,나주시,75-79세,5688,2256,3432
202009,46170,전라남도,나주시,75-79세,5642,2238,3404
202010,46170,전라남도,나주시,75-79세,5641,2243,3398
202011,46170,전라남도,나주시,75-79세,5628,2230,3398
202012,46170,전라남도,나주시,75-79세,5572,2206,3366
202101,46170,전라남도,나주시,75-79세,5547,2204,3343
202102,46170,전라남도,나주시,75-79세,5510,2190,3320
202103,46170,전라남도,나주시,75-79세,5421,2157,3264
202104,46170,전라남도,나주시,75-79세,5390,2150,3240
202105,46170,전라남도,나주시,75-79세,5377,2167,3210
202106,46170,전라남도,나주시,75-79세,5366,2159,3207
202007,46170,전라남도,나주시,80-84세,4270,1338,2932
202008,46170,전라남도,나주시,80-84세,4285,1345,2940
202009,46170,전라남도,나주시,80-84세,4314,1369,2945
202010,46170,전라남도,나주시,80-84세,4320,1369,2951
202011,46170,전라남도,나주시,80-84세,4290,1364,2926
202012,46170,전라남도,나주시,80-84세,4286,1366,2920
202101,46170,전라남도,나주시,80-84세,4326,1380,2946
202102,46170,전라남도,나주시,80-84세,4343,1394,2949
202103,46170,전라남도,나주시,80-84세,4376,1407,2969
202104,46170,전라남도,나주시,80-84세,4389,1420,2969
202105,46170,전라남도,나주시,80-84세,4419,1430,2989
202106,46170,전라남도,나주시,80-84세,4447,1446,3001
202007,46170,전라남도,나주시,85-89세,2221,568,1653
202008,46170,전라남도,나주시,85-89세,2229,581,1648
202009,46170,전라남도,나주시,85-89세,2243,582,1661
202010,46170,전라남도,나주시,85-89세,2268,594,1674
202011,46170,전라남도,나주시,85-89세,2285,604,1681
202012,46170,전라남도,나주시,85-89세,2310,615,1695
202101,46170,전라남도,나주시,85-89세,2322,618,1704
202102,46170,전라남도,나주시,85-89세,2339,614,1725
202103,46170,전라남도,나주시,85-89세,2349,625,1724
202104,46170,전라남도,나주시,85-89세,2366,618,1748
202105,46170,전라남도,나주시,85-89세,2394,625,1769
202106,46170,전라남도,나주시,85-89세,2393,625,1768
202007,46170,전라남도,나주시,90-94세,805,162,643
202008,46170,전라남도,나주시,90-94세,812,162,650
202009,46170,전라남도,나주시,90-94세,819,167,652
202010,46170,전라남도,나주시,90-94세,817,166,651
202011,46170,전라남도,나주시,90-94세,820,168,652
202012,46170,전라남도,나주시,90-94세,816,165,651
202101,46170,전라남도,나주시,90-94세,828,167,661
202102,46170,전라남도,나주시,90-94세,835,169,666
202103,46170,전라남도,나주시,90-94세,838,167,671
202104,46170,전라남도,나주시,90-94세,845,162,683
202105,46170,전라남도,나주시,90-94세,843,160,683
202106,46170,전라남도,나주시,90-94세,851,158,693
202007,46170,전라남도,나주시,95-99세,170,43,127
202008,46170,전라남도,나주시,95-99세,173,45,128
202009,46170,전라남도,나주시,95-99세,176,46,130
202010,46170,전라남도,나주시,95-99세,175,43,132
202011,46170,전라남도,나주시,95-99세,177,44,133
202012,46170,전라남도,나주시,95-99세,175,45,130
202101,46170,전라남도,나주시,95-99세,178,46,132
202102,46170,전라남도,나주시,95-99세,184,48,136
202103,46170,전라남도,나주시,95-99세,180,47,133
202104,46170,전라남도,나주시,95-99세,184,50,134
202105,46170,전라남도,나주시,95-99세,188,50,138
202106,46170,전라남도,나주시,95-99세,182,50,132
202007,46170,전라남도,나주시,100+,59,10,49
202008,46170,전라남도,나주시,100+,58,9,49
202009,46170,전라남도,나주시,100+,59,9,50
202010,46170,전라남도,나주시,100+,62,10,52
202011,46170,전라남도,나주시,100+,64,10,54
202012,46170,전라남도,나주시,100+,65,11,54
202101,46170,전라남도,나주시,100+,68,11,57
202102,46170,전라남도,나주시,100+,67,11,56
202103,46170,전라남도,나주시,100+,32,5,27
202104,46170,전라남도,나주시,100+,31,5,26
202105,46170,전라남도,나주시,100+,30,5,25
202106,46170,전라남도,나주시,100+,30,5,25
202007,46230,전라남도,광양시,0-4세,5967,3069,2898
202008,46230,전라남도,광양시,0-4세,5922,3043,2879
202009,46230,전라남도,광양시,0-4세,5869,3016,2853
202010,46230,전라남도,광양시,0-4세,5824,2991,2833
202011,46230,전라남도,광양시,0-4세,5775,2959,2816
202012,46230,전라남도,광양시,0-4세,5751,2950,2801
202101,46230,전라남도,광양시,0-4세,5668,2897,2771
202102,46230,전라남도,광양시,0-4세,5631,2871,2760
202103,46230,전라남도,광양시,0-4세,5597,2853,2744
202104,46230,전라남도,광양시,0-4세,5549,2828,2721
202105,46230,전라남도,광양시,0-4세,5527,2812,2715
202106,46230,전라남도,광양시,0-4세,5505,2809,2696
202007,46230,전라남도,광양시,5-9세,7814,3924,3890
202008,46230,전라남도,광양시,5-9세,7759,3906,3853
202009,46230,전라남도,광양시,5-9세,7738,3896,3842
202010,46230,전라남도,광양시,5-9세,7676,3876,3800
202011,46230,전라남도,광양시,5-9세,7626,3841,3785
202012,46230,전라남도,광양시,5-9세,7637,3847,3790
202101,46230,전라남도,광양시,5-9세,7583,3836,3747
202102,46230,전라남도,광양시,5-9세,7529,3803,3726
202103,46230,전라남도,광양시,5-9세,7512,3799,3713
202104,46230,전라남도,광양시,5-9세,7500,3798,3702
202105,46230,전라남도,광양시,5-9세,7495,3804,3691
202106,46230,전라남도,광양시,5-9세,7464,3781,3683
202007,46230,전라남도,광양시,10-14세,7624,3955,3669
202008,46230,전라남도,광양시,10-14세,7638,3959,3679
202009,46230,전라남도,광양시,10-14세,7680,3979,3701
202010,46230,전라남도,광양시,10-14세,7703,3998,3705
202011,46230,전라남도,광양시,10-14세,7735,4018,3717
202012,46230,전라남도,광양시,10-14세,7781,4036,3745
202101,46230,전라남도,광양시,10-14세,7806,4047,3759
202102,46230,전라남도,광양시,10-14세,7775,4032,3743
202103,46230,전라남도,광양시,10-14세,7759,4017,3742
202104,46230,전라남도,광양시,10-14세,7757,4004,3753
202105,46230,전라남도,광양시,10-14세,7769,4010,3759
202106,46230,전라남도,광양시,10-14세,7804,4027,3777
202007,46230,전라남도,광양시,15-19세,8561,4422,4139
202008,46230,전라남도,광양시,15-19세,8453,4378,4075
202009,46230,전라남도,광양시,15-19세,8368,4324,4044
202010,46230,전라남도,광양시,15-19세,8292,4273,4019
202011,46230,전라남도,광양시,15-19세,8270,4259,4011
202012,46230,전라남도,광양시,15-19세,8265,4263,4002
202101,46230,전라남도,광양시,15-19세,8159,4205,3954
202102,46230,전라남도,광양시,15-19세,8074,4171,3903
202103,46230,전라남도,광양시,15-19세,8025,4160,3865
202104,46230,전라남도,광양시,15-19세,8043,4169,3874
202105,46230,전라남도,광양시,15-19세,8001,4156,3845
202106,46230,전라남도,광양시,15-19세,7972,4154,3818
202007,46230,전라남도,광양시,20-24세,10684,6122,4562
202008,46230,전라남도,광양시,20-24세,10613,6057,4556
202009,46230,전라남도,광양시,20-24세,10532,6038,4494
202010,46230,전라남도,광양시,20-24세,10475,6002,4473
202011,46230,전라남도,광양시,20-24세,10506,6023,4483
202012,46230,전라남도,광양시,20-24세,10618,6101,4517
202101,46230,전라남도,광양시,20-24세,10487,6028,4459
202102,46230,전라남도,광양시,20-24세,10451,5988,4463
202103,46230,전라남도,광양시,20-24세,10371,5953,4418
202104,46230,전라남도,광양시,20-24세,10306,5919,4387
202105,46230,전라남도,광양시,20-24세,10232,5869,4363
202106,46230,전라남도,광양시,20-24세,10181,5824,4357
202007,46230,전라남도,광양시,25-29세,9555,5640,3915
202008,46230,전라남도,광양시,25-29세,9459,5580,3879
202009,46230,전라남도,광양시,25-29세,9382,5522,3860
202010,46230,전라남도,광양시,25-29세,9344,5507,3837
202011,46230,전라남도,광양시,25-29세,9398,5561,3837
202012,46230,전라남도,광양시,25-29세,9586,5685,3901
202101,46230,전라남도,광양시,25-29세,9478,5628,3850
202102,46230,전라남도,광양시,25-29세,9499,5645,3854
202103,46230,전라남도,광양시,25-29세,9576,5667,3909
202104,46230,전라남도,광양시,25-29세,9579,5664,3915
202105,46230,전라남도,광양시,25-29세,9598,5675,3923
202106,46230,전라남도,광양시,25-29세,9574,5689,3885
202007,46230,전라남도,광양시,30-34세,8278,4442,3836
202008,46230,전라남도,광양시,30-34세,8226,4414,3812
202009,46230,전라남도,광양시,30-34세,8222,4418,3804
202010,46230,전라남도,광양시,30-34세,8190,4391,3799
202011,46230,전라남도,광양시,30-34세,8176,4383,3793
202012,46230,전라남도,광양시,30-34세,8190,4407,3783
202101,46230,전라남도,광양시,30-34세,8159,4410,3749
202102,46230,전라남도,광양시,30-34세,8131,4389,3742
202103,46230,전라남도,광양시,30-34세,8112,4391,3721
202104,46230,전라남도,광양시,30-34세,8108,4394,3714
202105,46230,전라남도,광양시,30-34세,8134,4411,3723
202106,46230,전라남도,광양시,30-34세,8136,4399,3737
202007,46230,전라남도,광양시,35-39세,10617,5673,4944
202008,46230,전라남도,광양시,35-39세,10507,5600,4907
202009,46230,전라남도,광양시,35-39세,10414,5555,4859
202010,46230,전라남도,광양시,35-39세,10311,5508,4803
202011,46230,전라남도,광양시,35-39세,10282,5504,4778
202012,46230,전라남도,광양시,35-39세,10347,5528,4819
202101,46230,전라남도,광양시,35-39세,10218,5456,4762
202102,46230,전라남도,광양시,35-39세,10184,5431,4753
202103,46230,전라남도,광양시,35-39세,10128,5398,4730
202104,46230,전라남도,광양시,35-39세,10071,5371,4700
202105,46230,전라남도,광양시,35-39세,10029,5342,4687
202106,46230,전라남도,광양시,35-39세,9963,5303,4660
202007,46230,전라남도,광양시,40-44세,11032,5708,5324
202008,46230,전라남도,광양시,40-44세,10995,5692,5303
202009,46230,전라남도,광양시,40-44세,11034,5709,5325
202010,46230,전라남도,광양시,40-44세,11036,5715,5321
202011,46230,전라남도,광양시,40-44세,11049,5733,5316
202012,46230,전라남도,광양시,40-44세,11138,5802,5336
202101,46230,전라남도,광양시,40-44세,11094,5790,5304
202102,46230,전라남도,광양시,40-44세,11114,5806,5308
202103,46230,전라남도,광양시,40-44세,11028,5767,5261
202104,46230,전라남도,광양시,40-44세,11018,5761,5257
202105,46230,전라남도,광양시,40-44세,11014,5774,5240
202106,46230,전라남도,광양시,40-44세,11071,5823,5248
202007,46230,전라남도,광양시,45-49세,13072,6556,6516
202008,46230,전라남도,광양시,45-49세,12946,6504,6442
202009,46230,전라남도,광양시,45-49세,12866,6474,6392
202010,46230,전라남도,광양시,45-49세,12745,6436,6309
202011,46230,전라남도,광양시,45-49세,12685,6404,6281
202012,46230,전라남도,광양시,45-49세,12756,6434,6322
202101,46230,전라남도,광양시,45-49세,12667,6412,6255
202102,46230,전라남도,광양시,45-49세,12584,6381,6203
202103,46230,전라남도,광양시,45-49세,12530,6346,6184
202104,46230,전라남도,광양시,45-49세,12489,6330,6159
202105,46230,전라남도,광양시,45-49세,12352,6279,6073
202106,46230,전라남도,광양시,45-49세,12230,6193,6037
202007,46230,전라남도,광양시,50-54세,15903,8723,7180
202008,46230,전라남도,광양시,50-54세,15886,8708,7178
202009,46230,전라남도,광양시,50-54세,15873,8662,7211
202010,46230,전라남도,광양시,50-54세,15839,8620,7219
202011,46230,전라남도,광양시,50-54세,15926,8660,7266
202012,46230,전라남도,광양시,50-54세,15961,8624,7337
202101,46230,전라남도,광양시,50-54세,15941,8574,7367
202102,46230,전라남도,광양시,50-54세,15987,8572,7415
202103,46230,전라남도,광양시,50-54세,15881,8487,7394
202104,46230,전라남도,광양시,50-54세,15845,8447,7398
202105,46230,전라남도,광양시,50-54세,15875,8438,7437
202106,46230,전라남도,광양시,50-54세,15894,8440,7454
202007,46230,전라남도,광양시,55-59세,12909,7093,5816
202008,46230,전라남도,광양시,55-59세,12929,7127,5802
202009,46230,전라남도,광양시,55-59세,12938,7155,5783
202010,46230,전라남도,광양시,55-59세,12939,7167,5772
202011,46230,전라남도,광양시,55-59세,12956,7181,5775
202012,46230,전라남도,광양시,55-59세,13118,7305,5813
202101,46230,전라남도,광양시,55-59세,13053,7286,5767
202102,46230,전라남도,광양시,55-59세,13141,7345,5796
202103,46230,전라남도,광양시,55-59세,13251,7431,5820
202104,46230,전라남도,광양시,55-59세,13263,7458,5805
202105,46230,전라남도,광양시,55-59세,13282,7464,5818
202106,46230,전라남도,광양시,55-59세,13276,7471,5805
202007,46230,전라남도,광양시,60-64세,9919,5259,4660
202008,46230,전라남도,광양시,60-64세,10018,5303,4715
202009,46230,전라남도,광양시,60-64세,10088,5339,4749
202010,46230,전라남도,광양시,60-64세,10179,5382,4797
202011,46230,전라남도,광양시,60-64세,10270,5438,4832
202012,46230,전라남도,광양시,60-64세,10433,5495,4938
202101,46230,전라남도,광양시,60-64세,10524,5554,4970
202102,46230,전라남도,광양시,60-64세,10619,5604,5015
202103,46230,전라남도,광양시,60-64세,10695,5644,5051
202104,46230,전라남도,광양시,60-64세,10801,5690,5111
202105,46230,전라남도,광양시,60-64세,10911,5763,5148
202106,46230,전라남도,광양시,60-64세,11003,5812,5191
202007,46230,전라남도,광양시,65-69세,6340,3310,3030
202008,46230,전라남도,광양시,65-69세,6367,3323,3044
202009,46230,전라남도,광양시,65-69세,6397,3337,3060
202010,46230,전라남도,광양시,65-69세,6422,3352,3070
202011,46230,전라남도,광양시,65-69세,6485,3378,3107
202012,46230,전라남도,광양시,65-69세,6570,3430,3140
202101,46230,전라남도,광양시,65-69세,6555,3426,3129
202102,46230,전라남도,광양시,65-69세,6577,3448,3129
202103,46230,전라남도,광양시,65-69세,6593,3460,3133
202104,46230,전라남도,광양시,65-69세,6616,3478,3138
202105,46230,전라남도,광양시,65-69세,6664,3504,3160
202106,46230,전라남도,광양시,65-69세,6708,3518,3190
202007,46230,전라남도,광양시,70-74세,4482,2168,2314
202008,46230,전라남도,광양시,70-74세,4504,2179,2325
202009,46230,전라남도,광양시,70-74세,4545,2203,2342
202010,46230,전라남도,광양시,70-74세,4619,2241,2378
202011,46230,전라남도,광양시,70-74세,4679,2277,2402
202012,46230,전라남도,광양시,70-74세,4743,2299,2444
202101,46230,전라남도,광양시,70-74세,4807,2341,2466
202102,46230,전라남도,광양시,70-74세,4856,2355,2501
202103,46230,전라남도,광양시,70-74세,4866,2358,2508
202104,46230,전라남도,광양시,70-74세,4891,2370,2521
202105,46230,전라남도,광양시,70-74세,4898,2373,2525
202106,46230,전라남도,광양시,70-74세,4915,2387,2528
202007,46230,전라남도,광양시,75-79세,3545,1367,2178
202008,46230,전라남도,광양시,75-79세,3531,1372,2159
202009,46230,전라남도,광양시,75-79세,3521,1365,2156
202010,46230,전라남도,광양시,75-79세,3472,1341,2131
202011,46230,전라남도,광양시,75-79세,3458,1332,2126
202012,46230,전라남도,광양시,75-79세,3418,1322,2096
202101,46230,전라남도,광양시,75-79세,3388,1319,2069
202102,46230,전라남도,광양시,75-79세,3374,1311,2063
202103,46230,전라남도,광양시,75-79세,3373,1316,2057
202104,46230,전라남도,광양시,75-79세,3360,1319,2041
202105,46230,전라남도,광양시,75-79세,3355,1330,2025
202106,46230,전라남도,광양시,75-79세,3357,1340,2017
202007,46230,전라남도,광양시,80-84세,3046,1053,1993
202008,46230,전라남도,광양시,80-84세,3040,1048,1992
202009,46230,전라남도,광양시,80-84세,3016,1042,1974
202010,46230,전라남도,광양시,80-84세,3018,1048,1970
202011,46230,전라남도,광양시,80-84세,3027,1051,1976
202012,46230,전라남도,광양시,80-84세,3061,1063,1998
202101,46230,전라남도,광양시,80-84세,3041,1048,1993
202102,46230,전라남도,광양시,80-84세,3026,1042,1984
202103,46230,전라남도,광양시,80-84세,3003,1032,1971
202104,46230,전라남도,광양시,80-84세,2987,1021,1966
202105,46230,전라남도,광양시,80-84세,2985,1021,1964
202106,46230,전라남도,광양시,80-84세,2989,1020,1969
202007,46230,전라남도,광양시,85-89세,1560,393,1167
202008,46230,전라남도,광양시,85-89세,1577,398,1179
202009,46230,전라남도,광양시,85-89세,1606,403,1203
202010,46230,전라남도,광양시,85-89세,1620,408,1212
202011,46230,전라남도,광양시,85-89세,1622,415,1207
202012,46230,전라남도,광양시,85-89세,1627,424,1203
202101,46230,전라남도,광양시,85-89세,1645,433,1212
202102,46230,전라남도,광양시,85-89세,1673,446,1227
202103,46230,전라남도,광양시,85-89세,1694,456,1238
202104,46230,전라남도,광양시,85-89세,1720,470,1250
202105,46230,전라남도,광양시,85-89세,1722,467,1255
202106,46230,전라남도,광양시,85-89세,1723,467,1256
202007,46230,전라남도,광양시,90-94세,579,114,465
202008,46230,전라남도,광양시,90-94세,578,112,466
202009,46230,전라남도,광양시,90-94세,581,111,470
202010,46230,전라남도,광양시,90-94세,582,108,474
202011,46230,전라남도,광양시,90-94세,581,110,471
202012,46230,전라남도,광양시,90-94세,597,107,490
202101,46230,전라남도,광양시,90-94세,599,109,490
202102,46230,전라남도,광양시,90-94세,611,114,497
202103,46230,전라남도,광양시,90-94세,618,117,501
202104,46230,전라남도,광양시,90-94세,623,115,508
202105,46230,전라남도,광양시,90-94세,639,117,522
202106,46230,전라남도,광양시,90-94세,648,123,525
202007,46230,전라남도,광양시,95-99세,153,18,135
202008,46230,전라남도,광양시,95-99세,152,18,134
202009,46230,전라남도,광양시,95-99세,155,17,138
202010,46230,전라남도,광양시,95-99세,153,18,135
202011,46230,전라남도,광양시,95-99세,150,18,132
202012,46230,전라남도,광양시,95-99세,148,17,131
202101,46230,전라남도,광양시,95-99세,149,17,132
202102,46230,전라남도,광양시,95-99세,155,19,136
202103,46230,전라남도,광양시,95-99세,152,16,136
202104,46230,전라남도,광양시,95-99세,158,19,139
202105,46230,전라남도,광양시,95-99세,161,20,141
202106,46230,전라남도,광양시,95-99세,160,19,141
202007,46230,전라남도,광양시,100+,22,5,17
202008,46230,전라남도,광양시,100+,22,5,17
202009,46230,전라남도,광양시,100+,23,5,18
202010,46230,전라남도,광양시,100+,22,5,17
202011,46230,전라남도,광양시,100+,24,5,19
202012,46230,전라남도,광양시,100+,24,5,19
202101,46230,전라남도,광양시,100+,24,5,19
202102,46230,전라남도,광양시,100+,25,5,20
202103,46230,전라남도,광양시,100+,15,2,13
202104,46230,전라남도,광양시,100+,17,2,15
202105,46230,전라남도,광양시,100+,17,2,15
202106,46230,전라남도,광양시,100+,18,2,16
202007,46710,전라남도,담양군,0-4세,1099,519,580
202008,46710,전라남도,담양군,0-4세,1090,517,573
202009,46710,전라남도,담양군,0-4세,1097,522,575
202010,46710,전라남도,담양군,0-4세,1108,530,578
202011,46710,전라남도,담양군,0-4세,1123,540,583
202012,46710,전라남도,담양군,0-4세,1125,542,583
202101,46710,전라남도,담양군,0-4세,1106,533,573
202102,46710,전라남도,담양군,0-4세,1099,535,564
202103,46710,전라남도,담양군,0-4세,1070,517,553
202104,46710,전라남도,담양군,0-4세,1056,509,547
202105,46710,전라남도,담양군,0-4세,1038,501,537
202106,46710,전라남도,담양군,0-4세,1030,496,534
202007,46710,전라남도,담양군,5-9세,1226,644,582
202008,46710,전라남도,담양군,5-9세,1232,643,589
202009,46710,전라남도,담양군,5-9세,1234,648,586
202010,46710,전라남도,담양군,5-9세,1227,644,583
202011,46710,전라남도,담양군,5-9세,1214,636,578
202012,46710,전라남도,담양군,5-9세,1220,635,585
202101,46710,전라남도,담양군,5-9세,1251,650,601
202102,46710,전라남도,담양군,5-9세,1271,655,616
202103,46710,전라남도,담양군,5-9세,1271,653,618
202104,46710,전라남도,담양군,5-9세,1275,655,620
202105,46710,전라남도,담양군,5-9세,1282,661,621
202106,46710,전라남도,담양군,5-9세,1275,651,624
202007,46710,전라남도,담양군,10-14세,1325,677,648
202008,46710,전라남도,담양군,10-14세,1321,677,644
202009,46710,전라남도,담양군,10-14세,1319,677,642
202010,46710,전라남도,담양군,10-14세,1327,685,642
202011,46710,전라남도,담양군,10-14세,1337,695,642
202012,46710,전라남도,담양군,10-14세,1354,701,653
202101,46710,전라남도,담양군,10-14세,1361,706,655
202102,46710,전라남도,담양군,10-14세,1376,716,660
202103,46710,전라남도,담양군,10-14세,1395,729,666
202104,46710,전라남도,담양군,10-14세,1394,736,658
202105,46710,전라남도,담양군,10-14세,1392,735,657
202106,46710,전라남도,담양군,10-14세,1384,730,654
202007,46710,전라남도,담양군,15-19세,1722,909,813
202008,46710,전라남도,담양군,15-19세,1709,902,807
202009,46710,전라남도,담양군,15-19세,1685,890,795
202010,46710,전라남도,담양군,15-19세,1661,869,792
202011,46710,전라남도,담양군,15-19세,1648,866,782
202012,46710,전라남도,담양군,15-19세,1675,885,790
202101,46710,전라남도,담양군,15-19세,1650,872,778
202102,46710,전라남도,담양군,15-19세,1626,853,773
202103,46710,전라남도,담양군,15-19세,1589,827,762
202104,46710,전라남도,담양군,15-19세,1587,820,767
202105,46710,전라남도,담양군,15-19세,1596,827,769
202106,46710,전라남도,담양군,15-19세,1637,837,800
202007,46710,전라남도,담양군,20-24세,2661,1648,1013
202008,46710,전라남도,담양군,20-24세,2622,1623,999
202009,46710,전라남도,담양군,20-24세,2597,1605,992
202010,46710,전라남도,담양군,20-24세,2576,1587,989
202011,46710,전라남도,담양군,20-24세,2596,1580,1016
202012,46710,전라남도,담양군,20-24세,2611,1578,1033
202101,46710,전라남도,담양군,20-24세,2622,1576,1046
202102,46710,전라남도,담양군,20-24세,2584,1566,1018
202103,46710,전라남도,담양군,20-24세,2550,1550,1000
202104,46710,전라남도,담양군,20-24세,2536,1540,996
202105,46710,전라남도,담양군,20-24세,2513,1522,991
202106,46710,전라남도,담양군,20-24세,2497,1521,976
202007,46710,전라남도,담양군,25-29세,2157,1236,921
202008,46710,전라남도,담양군,25-29세,2146,1227,919
202009,46710,전라남도,담양군,25-29세,2149,1229,920
202010,46710,전라남도,담양군,25-29세,2171,1245,926
202011,46710,전라남도,담양군,25-29세,2157,1240,917
202012,46710,전라남도,담양군,25-29세,2223,1278,945
202101,46710,전라남도,담양군,25-29세,2221,1283,938
202102,46710,전라남도,담양군,25-29세,2213,1281,932
202103,46710,전라남도,담양군,25-29세,2223,1280,943
202104,46710,전라남도,담양군,25-29세,2234,1285,949
202105,46710,전라남도,담양군,25-29세,2234,1274,960
202106,46710,전라남도,담양군,25-29세,2214,1264,950
202007,46710,전라남도,담양군,30-34세,1698,864,834
202008,46710,전라남도,담양군,30-34세,1694,866,828
202009,46710,전라남도,담양군,30-34세,1669,857,812
202010,46710,전라남도,담양군,30-34세,1654,840,814
202011,46710,전라남도,담양군,30-34세,1651,836,815
202012,46710,전라남도,담양군,30-34세,1661,837,824
202101,46710,전라남도,담양군,30-34세,1684,835,849
202102,46710,전라남도,담양군,30-34세,1665,838,827
202103,46710,전라남도,담양군,30-34세,1657,835,822
202104,46710,전라남도,담양군,30-34세,1662,838,824
202105,46710,전라남도,담양군,30-34세,1670,844,826
202106,46710,전라남도,담양군,30-34세,1683,860,823
202007,46710,전라남도,담양군,35-39세,1989,1085,904
202008,46710,전라남도,담양군,35-39세,1977,1070,907
202009,46710,전라남도,담양군,35-39세,1975,1057,918
202010,46710,전라남도,담양군,35-39세,1973,1054,919
202011,46710,전라남도,담양군,35-39세,1971,1055,916
202012,46710,전라남도,담양군,35-39세,1983,1054,929
202101,46710,전라남도,담양군,35-39세,1998,1061,937
202102,46710,전라남도,담양군,35-39세,2041,1081,960
202103,46710,전라남도,담양군,35-39세,2027,1067,960
202104,46710,전라남도,담양군,35-39세,2014,1054,960
202105,46710,전라남도,담양군,35-39세,2004,1053,951
202106,46710,전라남도,담양군,35-39세,1969,1026,943
202007,46710,전라남도,담양군,40-44세,2129,1191,938
202008,46710,전라남도,담양군,40-44세,2123,1186,937
202009,46710,전라남도,담양군,40-44세,2128,1192,936
202010,46710,전라남도,담양군,40-44세,2124,1199,925
202011,46710,전라남도,담양군,40-44세,2118,1191,927
202012,46710,전라남도,담양군,40-44세,2133,1208,925
202101,46710,전라남도,담양군,40-44세,2159,1217,942
202102,46710,전라남도,담양군,40-44세,2172,1218,954
202103,46710,전라남도,담양군,40-44세,2172,1212,960
202104,46710,전라남도,담양군,40-44세,2198,1221,977
202105,46710,전라남도,담양군,40-44세,2211,1226,985
202106,46710,전라남도,담양군,40-44세,2216,1235,981
202007,46710,전라남도,담양군,45-49세,3122,1856,1266
202008,46710,전라남도,담양군,45-49세,3107,1847,1260
202009,46710,전라남도,담양군,45-49세,3083,1833,1250
202010,46710,전라남도,담양군,45-49세,3054,1826,1228
202011,46710,전라남도,담양군,45-49세,3044,1820,1224
202012,46710,전라남도,담양군,45-49세,3054,1819,1235
202101,46710,전라남도,담양군,45-49세,3062,1815,1247
202102,46710,전라남도,담양군,45-49세,3052,1802,1250
202103,46710,전라남도,담양군,45-49세,3074,1809,1265
202104,46710,전라남도,담양군,45-49세,3071,1800,1271
202105,46710,전라남도,담양군,45-49세,3031,1778,1253
202106,46710,전라남도,담양군,45-49세,3019,1770,1249
202007,46710,전라남도,담양군,50-54세,3750,2116,1634
202008,46710,전라남도,담양군,50-54세,3738,2101,1637
202009,46710,전라남도,담양군,50-54세,3725,2096,1629
202010,46710,전라남도,담양군,50-54세,3715,2088,1627
202011,46710,전라남도,담양군,50-54세,3726,2089,1637
202012,46710,전라남도,담양군,50-54세,3765,2087,1678
202101,46710,전라남도,담양군,50-54세,3792,2106,1686
202102,46710,전라남도,담양군,50-54세,3808,2104,1704
202103,46710,전라남도,담양군,50-54세,3815,2098,1717
202104,46710,전라남도,담양군,50-54세,3824,2104,1720
202105,46710,전라남도,담양군,50-54세,3842,2119,1723
202106,46710,전라남도,담양군,50-54세,3838,2122,1716
202007,46710,전라남도,담양군,55-59세,4388,2388,2000
202008,46710,전라남도,담양군,55-59세,4385,2394,1991
202009,46710,전라남도,담양군,55-59세,4370,2395,1975
202010,46710,전라남도,담양군,55-59세,4343,2372,1971
202011,46710,전라남도,담양군,55-59세,4346,2374,1972
202012,46710,전라남도,담양군,55-59세,4381,2398,1983
202101,46710,전라남도,담양군,55-59세,4398,2395,2003
202102,46710,전라남도,담양군,55-59세,4390,2394,1996
202103,46710,전라남도,담양군,55-59세,4374,2391,1983
202104,46710,전라남도,담양군,55-59세,4388,2388,2000
202105,46710,전라남도,담양군,55-59세,4380,2393,1987
202106,46710,전라남도,담양군,55-59세,4339,2379,1960
202007,46710,전라남도,담양군,60-64세,4534,2410,2124
202008,46710,전라남도,담양군,60-64세,4563,2421,2142
202009,46710,전라남도,담양군,60-64세,4598,2434,2164
202010,46710,전라남도,담양군,60-64세,4621,2450,2171
202011,46710,전라남도,담양군,60-64세,4627,2446,2181
202012,46710,전라남도,담양군,60-64세,4659,2464,2195
202101,46710,전라남도,담양군,60-64세,4700,2492,2208
202102,46710,전라남도,담양군,60-64세,4744,2525,2219
202103,46710,전라남도,담양군,60-64세,4801,2548,2253
202104,46710,전라남도,담양군,60-64세,4841,2583,2258
202105,46710,전라남도,담양군,60-64세,4893,2602,2291
202106,46710,전라남도,담양군,60-64세,4903,2612,2291
202007,46710,전라남도,담양군,65-69세,3501,1740,1761
202008,46710,전라남도,담양군,65-69세,3512,1744,1768
202009,46710,전라남도,담양군,65-69세,3531,1749,1782
202010,46710,전라남도,담양군,65-69세,3560,1765,1795
202011,46710,전라남도,담양군,65-69세,3573,1783,1790
202012,46710,전라남도,담양군,65-69세,3622,1804,1818
202101,46710,전라남도,담양군,65-69세,3635,1811,1824
202102,46710,전라남도,담양군,65-69세,3649,1819,1830
202103,46710,전라남도,담양군,65-69세,3692,1849,1843
202104,46710,전라남도,담양군,65-69세,3693,1852,1841
202105,46710,전라남도,담양군,65-69세,3708,1877,1831
202106,46710,전라남도,담양군,65-69세,3705,1881,1824
202007,46710,전라남도,담양군,70-74세,3210,1553,1657
202008,46710,전라남도,담양군,70-74세,3220,1560,1660
202009,46710,전라남도,담양군,70-74세,3239,1568,1671
202010,46710,전라남도,담양군,70-74세,3264,1577,1687
202011,46710,전라남도,담양군,70-74세,3283,1597,1686
202012,46710,전라남도,담양군,70-74세,3297,1606,1691
202101,46710,전라남도,담양군,70-74세,3332,1623,1709
202102,46710,전라남도,담양군,70-74세,3345,1628,1717
202103,46710,전라남도,담양군,70-74세,3365,1643,1722
202104,46710,전라남도,담양군,70-74세,3370,1645,1725
202105,46710,전라남도,담양군,70-74세,3340,1618,1722
202106,46710,전라남도,담양군,70-74세,3323,1618,1705
202007,46710,전라남도,담양군,75-79세,3121,1246,1875
202008,46710,전라남도,담양군,75-79세,3108,1243,1865
202009,46710,전라남도,담양군,75-79세,3090,1242,1848
202010,46710,전라남도,담양군,75-79세,3064,1227,1837
202011,46710,전라남도,담양군,75-79세,3055,1218,1837
202012,46710,전라남도,담양군,75-79세,3049,1219,1830
202101,46710,전라남도,담양군,75-79세,3016,1210,1806
202102,46710,전라남도,담양군,75-79세,2964,1193,1771
202103,46710,전라남도,담양군,75-79세,2940,1178,1762
202104,46710,전라남도,담양군,75-79세,2931,1179,1752
202105,46710,전라남도,담양군,75-79세,2943,1194,1749
202106,46710,전라남도,담양군,75-79세,2905,1175,1730
202007,46710,전라남도,담양군,80-84세,2529,845,1684
202008,46710,전라남도,담양군,80-84세,2539,858,1681
202009,46710,전라남도,담양군,80-84세,2544,860,1684
202010,46710,전라남도,담양군,80-84세,2554,866,1688
202011,46710,전라남도,담양군,80-84세,2548,867,1681
202012,46710,전라남도,담양군,80-84세,2530,870,1660
202101,46710,전라남도,담양군,80-84세,2536,873,1663
202102,46710,전라남도,담양군,80-84세,2566,892,1674
202103,46710,전라남도,담양군,80-84세,2564,898,1666
202104,46710,전라남도,담양군,80-84세,2564,899,1665
202105,46710,전라남도,담양군,80-84세,2568,901,1667
202106,46710,전라남도,담양군,80-84세,2578,900,1678
202007,46710,전라남도,담양군,85-89세,1253,363,890
202008,46710,전라남도,담양군,85-89세,1267,363,904
202009,46710,전라남도,담양군,85-89세,1271,362,909
202010,46710,전라남도,담양군,85-89세,1275,365,910
202011,46710,전라남도,담양군,85-89세,1287,376,911
202012,46710,전라남도,담양군,85-89세,1305,374,931
202101,46710,전라남도,담양군,85-89세,1320,383,937
202102,46710,전라남도,담양군,85-89세,1340,385,955
202103,46710,전라남도,담양군,85-89세,1337,379,958
202104,46710,전라남도,담양군,85-89세,1359,386,973
202105,46710,전라남도,담양군,85-89세,1375,390,985
202106,46710,전라남도,담양군,85-89세,1380,395,985
202007,46710,전라남도,담양군,90-94세,486,104,382
202008,46710,전라남도,담양군,90-94세,483,102,381
202009,46710,전라남도,담양군,90-94세,492,105,387
202010,46710,전라남도,담양군,90-94세,492,106,386
202011,46710,전라남도,담양군,90-94세,492,105,387
202012,46710,전라남도,담양군,90-94세,492,114,378
202101,46710,전라남도,담양군,90-94세,489,114,375
202102,46710,전라남도,담양군,90-94세,493,114,379
202103,46710,전라남도,담양군,90-94세,489,114,375
202104,46710,전라남도,담양군,90-94세,486,110,376
202105,46710,전라남도,담양군,90-94세,489,110,379
202106,46710,전라남도,담양군,90-94세,489,112,377
202007,46710,전라남도,담양군,95-99세,109,25,84
202008,46710,전라남도,담양군,95-99세,112,26,86
202009,46710,전라남도,담양군,95-99세,109,26,83
202010,46710,전라남도,담양군,95-99세,107,25,82
202011,46710,전라남도,담양군,95-99세,105,25,80
202012,46710,전라남도,담양군,95-99세,106,25,81
202101,46710,전라남도,담양군,95-99세,110,25,85
202102,46710,전라남도,담양군,95-99세,111,25,86
202103,46710,전라남도,담양군,95-99세,110,22,88
202104,46710,전라남도,담양군,95-99세,115,23,92
202105,46710,전라남도,담양군,95-99세,116,23,93
202106,46710,전라남도,담양군,95-99세,114,23,91
202007,46710,전라남도,담양군,100+,31,3,28
202008,46710,전라남도,담양군,100+,32,3,29
202009,46710,전라남도,담양군,100+,33,3,30
202010,46710,전라남도,담양군,100+,33,3,30
202011,46710,전라남도,담양군,100+,35,4,31
202012,46710,전라남도,담양군,100+,35,4,31
202101,46710,전라남도,담양군,100+,33,3,30
202102,46710,전라남도,담양군,100+,36,3,33
202103,46710,전라남도,담양군,100+,26,0,26
202104,46710,전라남도,담양군,100+,26,0,26
202105,46710,전라남도,담양군,100+,25,0,25
202106,46710,전라남도,담양군,100+,24,0,24
202007,46720,전라남도,곡성군,0-4세,442,225,217
202008,46720,전라남도,곡성군,0-4세,436,224,212
202009,46720,전라남도,곡성군,0-4세,441,226,215
202010,46720,전라남도,곡성군,0-4세,435,224,211
202011,46720,전라남도,곡성군,0-4세,427,218,209
202012,46720,전라남도,곡성군,0-4세,423,216,207
202101,46720,전라남도,곡성군,0-4세,415,215,200
202102,46720,전라남도,곡성군,0-4세,407,208,199
202103,46720,전라남도,곡성군,0-4세,403,204,199
202104,46720,전라남도,곡성군,0-4세,395,198,197
202105,46720,전라남도,곡성군,0-4세,388,197,191
202106,46720,전라남도,곡성군,0-4세,385,195,190
202007,46720,전라남도,곡성군,5-9세,682,349,333
202008,46720,전라남도,곡성군,5-9세,681,345,336
202009,46720,전라남도,곡성군,5-9세,674,343,331
202010,46720,전라남도,곡성군,5-9세,666,339,327
202011,46720,전라남도,곡성군,5-9세,664,339,325
202012,46720,전라남도,곡성군,5-9세,662,340,322
202101,46720,전라남도,곡성군,5-9세,657,335,322
202102,46720,전라남도,곡성군,5-9세,662,339,323
202103,46720,전라남도,곡성군,5-9세,652,332,320
202104,46720,전라남도,곡성군,5-9세,652,337,315
202105,46720,전라남도,곡성군,5-9세,642,329,313
202106,46720,전라남도,곡성군,5-9세,634,324,310
202007,46720,전라남도,곡성군,10-14세,841,462,379
202008,46720,전라남도,곡성군,10-14세,844,462,382
202009,46720,전라남도,곡성군,10-14세,840,459,381
202010,46720,전라남도,곡성군,10-14세,834,455,379
202011,46720,전라남도,곡성군,10-14세,827,449,378
202012,46720,전라남도,곡성군,10-14세,823,449,374
202101,46720,전라남도,곡성군,10-14세,829,450,379
202102,46720,전라남도,곡성군,10-14세,831,454,377
202103,46720,전라남도,곡성군,10-14세,828,451,377
202104,46720,전라남도,곡성군,10-14세,826,448,378
202105,46720,전라남도,곡성군,10-14세,828,448,380
202106,46720,전라남도,곡성군,10-14세,829,450,379
202007,46720,전라남도,곡성군,15-19세,1186,601,585
202008,46720,전라남도,곡성군,15-19세,1159,585,574
202009,46720,전라남도,곡성군,15-19세,1143,579,564
202010,46720,전라남도,곡성군,15-19세,1129,572,557
202011,46720,전라남도,곡성군,15-19세,1118,569,549
202012,46720,전라남도,곡성군,15-19세,1105,568,537
202101,46720,전라남도,곡성군,15-19세,1106,571,535
202102,46720,전라남도,곡성군,15-19세,1087,570,517
202103,46720,전라남도,곡성군,15-19세,1078,562,516
202104,46720,전라남도,곡성군,15-19세,1068,559,509
202105,46720,전라남도,곡성군,15-19세,1125,603,522
202106,46720,전라남도,곡성군,15-19세,1128,600,528
202007,46720,전라남도,곡성군,20-24세,1335,712,623
202008,46720,전라남도,곡성군,20-24세,1338,718,620
202009,46720,전라남도,곡성군,20-24세,1326,715,611
202010,46720,전라남도,곡성군,20-24세,1327,702,625
202011,46720,전라남도,곡성군,20-24세,1314,697,617
202012,46720,전라남도,곡성군,20-24세,1300,687,613
202101,46720,전라남도,곡성군,20-24세,1269,671,598
202102,46720,전라남도,곡성군,20-24세,1241,656,585
202103,46720,전라남도,곡성군,20-24세,1212,648,564
202104,46720,전라남도,곡성군,20-24세,1214,652,562
202105,46720,전라남도,곡성군,20-24세,1239,659,580
202106,46720,전라남도,곡성군,20-24세,1222,653,569
202007,46720,전라남도,곡성군,25-29세,1047,580,467
202008,46720,전라남도,곡성군,25-29세,1051,582,469
202009,46720,전라남도,곡성군,25-29세,1048,578,470
202010,46720,전라남도,곡성군,25-29세,1045,586,459
202011,46720,전라남도,곡성군,25-29세,1061,591,470
202012,46720,전라남도,곡성군,25-29세,1087,607,480
202101,46720,전라남도,곡성군,25-29세,1055,596,459
202102,46720,전라남도,곡성군,25-29세,1047,593,454
202103,46720,전라남도,곡성군,25-29세,1048,593,455
202104,46720,전라남도,곡성군,25-29세,1062,602,460
202105,46720,전라남도,곡성군,25-29세,1055,602,453
202106,46720,전라남도,곡성군,25-29세,1071,615,456
202007,46720,전라남도,곡성군,30-34세,760,408,352
202008,46720,전라남도,곡성군,30-34세,759,400,359
202009,46720,전라남도,곡성군,30-34세,757,401,356
202010,46720,전라남도,곡성군,30-34세,752,396,356
202011,46720,전라남도,곡성군,30-34세,750,393,357
202012,46720,전라남도,곡성군,30-34세,744,390,354
202101,46720,전라남도,곡성군,30-34세,761,399,362
202102,46720,전라남도,곡성군,30-34세,773,399,374
202103,46720,전라남도,곡성군,30-34세,773,396,377
202104,46720,전라남도,곡성군,30-34세,771,399,372
202105,46720,전라남도,곡성군,30-34세,769,400,369
202106,46720,전라남도,곡성군,30-34세,754,393,361
202007,46720,전라남도,곡성군,35-39세,1011,551,460
202008,46720,전라남도,곡성군,35-39세,999,541,458
202009,46720,전라남도,곡성군,35-39세,988,533,455
202010,46720,전라남도,곡성군,35-39세,990,538,452
202011,46720,전라남도,곡성군,35-39세,986,533,453
202012,46720,전라남도,곡성군,35-39세,974,528,446
202101,46720,전라남도,곡성군,35-39세,961,522,439
202102,46720,전라남도,곡성군,35-39세,947,520,427
202103,46720,전라남도,곡성군,35-39세,925,506,419
202104,46720,전라남도,곡성군,35-39세,922,502,420
202105,46720,전라남도,곡성군,35-39세,912,492,420
202106,46720,전라남도,곡성군,35-39세,900,481,419
202007,46720,전라남도,곡성군,40-44세,1232,686,546
202008,46720,전라남도,곡성군,40-44세,1218,676,542
202009,46720,전라남도,곡성군,40-44세,1226,684,542
202010,46720,전라남도,곡성군,40-44세,1211,675,536
202011,46720,전라남도,곡성군,40-44세,1182,662,520
202012,46720,전라남도,곡성군,40-44세,1183,664,519
202101,46720,전라남도,곡성군,40-44세,1191,661,530
202102,46720,전라남도,곡성군,40-44세,1202,666,536
202103,46720,전라남도,곡성군,40-44세,1207,663,544
202104,46720,전라남도,곡성군,40-44세,1206,657,549
202105,46720,전라남도,곡성군,40-44세,1189,648,541
202106,46720,전라남도,곡성군,40-44세,1177,645,532
202007,46720,전라남도,곡성군,45-49세,1899,1070,829
202008,46720,전라남도,곡성군,45-49세,1906,1070,836
202009,46720,전라남도,곡성군,45-49세,1884,1057,827
202010,46720,전라남도,곡성군,45-49세,1861,1040,821
202011,46720,전라남도,곡성군,45-49세,1847,1035,812
202012,46720,전라남도,곡성군,45-49세,1842,1035,807
202101,46720,전라남도,곡성군,45-49세,1817,1020,797
202102,46720,전라남도,곡성군,45-49세,1803,1004,799
202103,46720,전라남도,곡성군,45-49세,1787,996,791
202104,46720,전라남도,곡성군,45-49세,1784,999,785
202105,46720,전라남도,곡성군,45-49세,1769,988,781
202106,46720,전라남도,곡성군,45-49세,1769,984,785
202007,46720,전라남도,곡성군,50-54세,2286,1288,998
202008,46720,전라남도,곡성군,50-54세,2294,1295,999
202009,46720,전라남도,곡성군,50-54세,2283,1288,995
202010,46720,전라남도,곡성군,50-54세,2285,1290,995
202011,46720,전라남도,곡성군,50-54세,2291,1288,1003
202012,46720,전라남도,곡성군,50-54세,2291,1283,1008
202101,46720,전라남도,곡성군,50-54세,2311,1298,1013
202102,46720,전라남도,곡성군,50-54세,2302,1297,1005
202103,46720,전라남도,곡성군,50-54세,2272,1289,983
202104,46720,전라남도,곡성군,50-54세,2276,1288,988
202105,46720,전라남도,곡성군,50-54세,2285,1299,986
202106,46720,전라남도,곡성군,50-54세,2276,1292,984
202007,46720,전라남도,곡성군,55-59세,2637,1430,1207
202008,46720,전라남도,곡성군,55-59세,2619,1415,1204
202009,46720,전라남도,곡성군,55-59세,2616,1415,1201
202010,46720,전라남도,곡성군,55-59세,2598,1409,1189
202011,46720,전라남도,곡성군,55-59세,2586,1401,1185
202012,46720,전라남도,곡성군,55-59세,2606,1415,1191
202101,46720,전라남도,곡성군,55-59세,2584,1401,1183
202102,46720,전라남도,곡성군,55-59세,2588,1401,1187
202103,46720,전라남도,곡성군,55-59세,2617,1416,1201
202104,46720,전라남도,곡성군,55-59세,2617,1417,1200
202105,46720,전라남도,곡성군,55-59세,2611,1419,1192
202106,46720,전라남도,곡성군,55-59세,2561,1402,1159
202007,46720,전라남도,곡성군,60-64세,2758,1487,1271
202008,46720,전라남도,곡성군,60-64세,2766,1498,1268
202009,46720,전라남도,곡성군,60-64세,2778,1498,1280
202010,46720,전라남도,곡성군,60-64세,2795,1513,1282
202011,46720,전라남도,곡성군,60-64세,2812,1524,1288
202012,46720,전라남도,곡성군,60-64세,2814,1527,1287
202101,46720,전라남도,곡성군,60-64세,2832,1536,1296
202102,46720,전라남도,곡성군,60-64세,2854,1554,1300
202103,46720,전라남도,곡성군,60-64세,2870,1568,1302
202104,46720,전라남도,곡성군,60-64세,2893,1579,1314
202105,46720,전라남도,곡성군,60-64세,2919,1589,1330
202106,46720,전라남도,곡성군,60-64세,2976,1613,1363
202007,46720,전라남도,곡성군,65-69세,2131,1059,1072
202008,46720,전라남도,곡성군,65-69세,2150,1068,1082
202009,46720,전라남도,곡성군,65-69세,2163,1074,1089
202010,46720,전라남도,곡성군,65-69세,2175,1078,1097
202011,46720,전라남도,곡성군,65-69세,2182,1085,1097
202012,46720,전라남도,곡성군,65-69세,2190,1093,1097
202101,46720,전라남도,곡성군,65-69세,2206,1097,1109
202102,46720,전라남도,곡성군,65-69세,2219,1102,1117
202103,46720,전라남도,곡성군,65-69세,2223,1106,1117
202104,46720,전라남도,곡성군,65-69세,2221,1107,1114
202105,46720,전라남도,곡성군,65-69세,2221,1121,1100
202106,46720,전라남도,곡성군,65-69세,2226,1127,1099
202007,46720,전라남도,곡성군,70-74세,2129,991,1138
202008,46720,전라남도,곡성군,70-74세,2131,996,1135
202009,46720,전라남도,곡성군,70-74세,2146,1004,1142
202010,46720,전라남도,곡성군,70-74세,2152,1008,1144
202011,46720,전라남도,곡성군,70-74세,2151,1007,1144
202012,46720,전라남도,곡성군,70-74세,2172,1010,1162
202101,46720,전라남도,곡성군,70-74세,2178,1014,1164
202102,46720,전라남도,곡성군,70-74세,2182,1023,1159
202103,46720,전라남도,곡성군,70-74세,2179,1027,1152
202104,46720,전라남도,곡성군,70-74세,2195,1035,1160
202105,46720,전라남도,곡성군,70-74세,2184,1024,1160
202106,46720,전라남도,곡성군,70-74세,2168,1017,1151
202007,46720,전라남도,곡성군,75-79세,2195,822,1373
202008,46720,전라남도,곡성군,75-79세,2189,818,1371
202009,46720,전라남도,곡성군,75-79세,2160,803,1357
202010,46720,전라남도,곡성군,75-79세,2145,808,1337
202011,46720,전라남도,곡성군,75-79세,2138,807,1331
202012,46720,전라남도,곡성군,75-79세,2113,803,1310
202101,46720,전라남도,곡성군,75-79세,2084,796,1288
202102,46720,전라남도,곡성군,75-79세,2055,787,1268
202103,46720,전라남도,곡성군,75-79세,2036,782,1254
202104,46720,전라남도,곡성군,75-79세,2020,776,1244
202105,46720,전라남도,곡성군,75-79세,2007,778,1229
202106,46720,전라남도,곡성군,75-79세,2014,786,1228
202007,46720,전라남도,곡성군,80-84세,2068,674,1394
202008,46720,전라남도,곡성군,80-84세,2053,666,1387
202009,46720,전라남도,곡성군,80-84세,2054,671,1383
202010,46720,전라남도,곡성군,80-84세,2055,665,1390
202011,46720,전라남도,곡성군,80-84세,2041,667,1374
202012,46720,전라남도,곡성군,80-84세,2040,668,1372
202101,46720,전라남도,곡성군,80-84세,2038,668,1370
202102,46720,전라남도,곡성군,80-84세,2041,675,1366
202103,46720,전라남도,곡성군,80-84세,2045,677,1368
202104,46720,전라남도,곡성군,80-84세,2027,678,1349
202105,46720,전라남도,곡성군,80-84세,2032,681,1351
202106,46720,전라남도,곡성군,80-84세,2031,676,1355
202007,46720,전라남도,곡성군,85-89세,1101,311,790
202008,46720,전라남도,곡성군,85-89세,1107,316,791
202009,46720,전라남도,곡성군,85-89세,1115,319,796
202010,46720,전라남도,곡성군,85-89세,1127,323,804
202011,46720,전라남도,곡성군,85-89세,1134,322,812
202012,46720,전라남도,곡성군,85-89세,1150,325,825
202101,46720,전라남도,곡성군,85-89세,1157,329,828
202102,46720,전라남도,곡성군,85-89세,1169,326,843
202103,46720,전라남도,곡성군,85-89세,1179,327,852
202104,46720,전라남도,곡성군,85-89세,1208,333,875
202105,46720,전라남도,곡성군,85-89세,1217,335,882
202106,46720,전라남도,곡성군,85-89세,1226,337,889
202007,46720,전라남도,곡성군,90-94세,406,85,321
202008,46720,전라남도,곡성군,90-94세,419,87,332
202009,46720,전라남도,곡성군,90-94세,422,88,334
202010,46720,전라남도,곡성군,90-94세,419,87,332
202011,46720,전라남도,곡성군,90-94세,418,89,329
202012,46720,전라남도,곡성군,90-94세,412,83,329
202101,46720,전라남도,곡성군,90-94세,419,80,339
202102,46720,전라남도,곡성군,90-94세,425,83,342
202103,46720,전라남도,곡성군,90-94세,430,87,343
202104,46720,전라남도,곡성군,90-94세,433,89,344
202105,46720,전라남도,곡성군,90-94세,439,87,352
202106,46720,전라남도,곡성군,90-94세,439,87,352
202007,46720,전라남도,곡성군,95-99세,96,14,82
202008,46720,전라남도,곡성군,95-99세,92,14,78
202009,46720,전라남도,곡성군,95-99세,95,14,81
202010,46720,전라남도,곡성군,95-99세,89,13,76
202011,46720,전라남도,곡성군,95-99세,93,13,80
202012,46720,전라남도,곡성군,95-99세,94,13,81
202101,46720,전라남도,곡성군,95-99세,97,15,82
202102,46720,전라남도,곡성군,95-99세,102,15,87
202103,46720,전라남도,곡성군,95-99세,107,14,93
202104,46720,전라남도,곡성군,95-99세,110,15,95
202105,46720,전라남도,곡성군,95-99세,115,17,98
202106,46720,전라남도,곡성군,95-99세,115,17,98
202007,46720,전라남도,곡성군,100+,12,3,9
202008,46720,전라남도,곡성군,100+,15,3,12
202009,46720,전라남도,곡성군,100+,14,3,11
202010,46720,전라남도,곡성군,100+,16,3,13
202011,46720,전라남도,곡성군,100+,14,3,11
202012,46720,전라남도,곡성군,100+,14,3,11
202101,46720,전라남도,곡성군,100+,15,3,12
202102,46720,전라남도,곡성군,100+,15,3,12
202103,46720,전라남도,곡성군,100+,17,4,13
202104,46720,전라남도,곡성군,100+,16,4,12
202105,46720,전라남도,곡성군,100+,16,4,12
202106,46720,전라남도,곡성군,100+,15,3,12
202007,46730,전라남도,구례군,0-4세,469,240,229
202008,46730,전라남도,구례군,0-4세,463,237,226
202009,46730,전라남도,구례군,0-4세,465,238,227
202010,46730,전라남도,구례군,0-4세,447,223,224
202011,46730,전라남도,구례군,0-4세,447,222,225
202012,46730,전라남도,구례군,0-4세,435,213,222
202101,46730,전라남도,구례군,0-4세,429,204,225
202102,46730,전라남도,구례군,0-4세,424,203,221
202103,46730,전라남도,구례군,0-4세,415,200,215
202104,46730,전라남도,구례군,0-4세,406,195,211
202105,46730,전라남도,구례군,0-4세,401,191,210
202106,46730,전라남도,구례군,0-4세,399,193,206
202007,46730,전라남도,구례군,5-9세,711,349,362
202008,46730,전라남도,구례군,5-9세,710,349,361
202009,46730,전라남도,구례군,5-9세,703,338,365
202010,46730,전라남도,구례군,5-9세,709,348,361
202011,46730,전라남도,구례군,5-9세,712,352,360
202012,46730,전라남도,구례군,5-9세,706,350,356
202101,46730,전라남도,구례군,5-9세,711,359,352
202102,46730,전라남도,구례군,5-9세,704,355,349
202103,46730,전라남도,구례군,5-9세,702,352,350
202104,46730,전라남도,구례군,5-9세,699,348,351
202105,46730,전라남도,구례군,5-9세,691,339,352
202106,46730,전라남도,구례군,5-9세,677,334,343
202007,46730,전라남도,구례군,10-14세,861,454,407
202008,46730,전라남도,구례군,10-14세,853,450,403
202009,46730,전라남도,구례군,10-14세,844,447,397
202010,46730,전라남도,구례군,10-14세,828,433,395
202011,46730,전라남도,구례군,10-14세,830,434,396
202012,46730,전라남도,구례군,10-14세,850,439,411
202101,46730,전라남도,구례군,10-14세,840,434,406
202102,46730,전라남도,구례군,10-14세,839,431,408
202103,46730,전라남도,구례군,10-14세,844,431,413
202104,46730,전라남도,구례군,10-14세,845,436,409
202105,46730,전라남도,구례군,10-14세,849,442,407
202106,46730,전라남도,구례군,10-14세,853,447,406
202007,46730,전라남도,구례군,15-19세,1053,559,494
202008,46730,전라남도,구례군,15-19세,1034,544,490
202009,46730,전라남도,구례군,15-19세,1027,547,480
202010,46730,전라남도,구례군,15-19세,1017,545,472
202011,46730,전라남도,구례군,15-19세,1013,544,469
202012,46730,전라남도,구례군,15-19세,1008,545,463
202101,46730,전라남도,구례군,15-19세,988,531,457
202102,46730,전라남도,구례군,15-19세,967,515,452
202103,46730,전라남도,구례군,15-19세,948,502,446
202104,46730,전라남도,구례군,15-19세,941,496,445
202105,46730,전라남도,구례군,15-19세,925,485,440
202106,46730,전라남도,구례군,15-19세,925,489,436
202007,46730,전라남도,구례군,20-24세,1115,610,505
202008,46730,전라남도,구례군,20-24세,1117,617,500
202009,46730,전라남도,구례군,20-24세,1103,605,498
202010,46730,전라남도,구례군,20-24세,1096,599,497
202011,46730,전라남도,구례군,20-24세,1087,601,486
202012,46730,전라남도,구례군,20-24세,1100,607,493
202101,46730,전라남도,구례군,20-24세,1105,602,503
202102,46730,전라남도,구례군,20-24세,1094,597,497
202103,46730,전라남도,구례군,20-24세,1086,599,487
202104,46730,전라남도,구례군,20-24세,1072,584,488
202105,46730,전라남도,구례군,20-24세,1071,582,489
202106,46730,전라남도,구례군,20-24세,1078,582,496
202007,46730,전라남도,구례군,25-29세,885,455,430
202008,46730,전라남도,구례군,25-29세,871,449,422
202009,46730,전라남도,구례군,25-29세,868,449,419
202010,46730,전라남도,구례군,25-29세,862,448,414
202011,46730,전라남도,구례군,25-29세,866,448,418
202012,46730,전라남도,구례군,25-29세,885,462,423
202101,46730,전라남도,구례군,25-29세,840,447,393
202102,46730,전라남도,구례군,25-29세,830,442,388
202103,46730,전라남도,구례군,25-29세,824,438,386
202104,46730,전라남도,구례군,25-29세,832,451,381
202105,46730,전라남도,구례군,25-29세,827,453,374
202106,46730,전라남도,구례군,25-29세,822,456,366
202007,46730,전라남도,구례군,30-34세,717,351,366
202008,46730,전라남도,구례군,30-34세,713,347,366
202009,46730,전라남도,구례군,30-34세,707,346,361
202010,46730,전라남도,구례군,30-34세,692,343,349
202011,46730,전라남도,구례군,30-34세,698,344,354
202012,46730,전라남도,구례군,30-34세,706,345,361
202101,46730,전라남도,구례군,30-34세,699,344,355
202102,46730,전라남도,구례군,30-34세,699,341,358
202103,46730,전라남도,구례군,30-34세,700,346,354
202104,46730,전라남도,구례군,30-34세,697,346,351
202105,46730,전라남도,구례군,30-34세,686,342,344
202106,46730,전라남도,구례군,30-34세,677,332,345
202007,46730,전라남도,구례군,35-39세,998,564,434
202008,46730,전라남도,구례군,35-39세,980,550,430
202009,46730,전라남도,구례군,35-39세,978,550,428
202010,46730,전라남도,구례군,35-39세,975,546,429
202011,46730,전라남도,구례군,35-39세,977,550,427
202012,46730,전라남도,구례군,35-39세,980,557,423
202101,46730,전라남도,구례군,35-39세,958,543,415
202102,46730,전라남도,구례군,35-39세,951,539,412
202103,46730,전라남도,구례군,35-39세,937,535,402
202104,46730,전라남도,구례군,35-39세,927,527,400
202105,46730,전라남도,구례군,35-39세,910,510,400
202106,46730,전라남도,구례군,35-39세,906,504,402
202007,46730,전라남도,구례군,40-44세,1216,635,581
202008,46730,전라남도,구례군,40-44세,1213,634,579
202009,46730,전라남도,구례군,40-44세,1212,631,581
202010,46730,전라남도,구례군,40-44세,1213,629,584
202011,46730,전라남도,구례군,40-44세,1201,625,576
202012,46730,전라남도,구례군,40-44세,1208,626,582
202101,46730,전라남도,구례군,40-44세,1190,617,573
202102,46730,전라남도,구례군,40-44세,1167,607,560
202103,46730,전라남도,구례군,40-44세,1155,602,553
202104,46730,전라남도,구례군,40-44세,1152,602,550
202105,46730,전라남도,구례군,40-44세,1146,606,540
202106,46730,전라남도,구례군,40-44세,1144,604,540
202007,46730,전라남도,구례군,45-49세,1778,1008,770
202008,46730,전라남도,구례군,45-49세,1764,998,766
202009,46730,전라남도,구례군,45-49세,1736,977,759
202010,46730,전라남도,구례군,45-49세,1718,969,749
202011,46730,전라남도,구례군,45-49세,1694,955,739
202012,46730,전라남도,구례군,45-49세,1718,965,753
202101,46730,전라남도,구례군,45-49세,1700,958,742
202102,46730,전라남도,구례군,45-49세,1694,950,744
202103,46730,전라남도,구례군,45-49세,1680,935,745
202104,46730,전라남도,구례군,45-49세,1666,926,740
202105,46730,전라남도,구례군,45-49세,1633,911,722
202106,46730,전라남도,구례군,45-49세,1620,907,713
202007,46730,전라남도,구례군,50-54세,2200,1243,957
202008,46730,전라남도,구례군,50-54세,2198,1238,960
202009,46730,전라남도,구례군,50-54세,2185,1235,950
202010,46730,전라남도,구례군,50-54세,2156,1226,930
202011,46730,전라남도,구례군,50-54세,2151,1220,931
202012,46730,전라남도,구례군,50-54세,2158,1226,932
202101,46730,전라남도,구례군,50-54세,2153,1218,935
202102,46730,전라남도,구례군,50-54세,2169,1238,931
202103,46730,전라남도,구례군,50-54세,2169,1246,923
202104,46730,전라남도,구례군,50-54세,2161,1240,921
202105,46730,전라남도,구례군,50-54세,2173,1250,923
202106,46730,전라남도,구례군,50-54세,2176,1251,925
202007,46730,전라남도,구례군,55-59세,2448,1325,1123
202008,46730,전라남도,구례군,55-59세,2429,1314,1115
202009,46730,전라남도,구례군,55-59세,2439,1314,1125
202010,46730,전라남도,구례군,55-59세,2444,1317,1127
202011,46730,전라남도,구례군,55-59세,2451,1329,1122
202012,46730,전라남도,구례군,55-59세,2466,1339,1127
202101,46730,전라남도,구례군,55-59세,2424,1325,1099
202102,46730,전라남도,구례군,55-59세,2395,1299,1096
202103,46730,전라남도,구례군,55-59세,2373,1281,1092
202104,46730,전라남도,구례군,55-59세,2367,1282,1085
202105,46730,전라남도,구례군,55-59세,2356,1276,1080
202106,46730,전라남도,구례군,55-59세,2348,1270,1078
202007,46730,전라남도,구례군,60-64세,2504,1247,1257
202008,46730,전라남도,구례군,60-64세,2528,1267,1261
202009,46730,전라남도,구례군,60-64세,2555,1286,1269
202010,46730,전라남도,구례군,60-64세,2566,1299,1267
202011,46730,전라남도,구례군,60-64세,2581,1311,1270
202012,46730,전라남도,구례군,60-64세,2617,1328,1289
202101,46730,전라남도,구례군,60-64세,2658,1350,1308
202102,46730,전라남도,구례군,60-64세,2688,1369,1319
202103,46730,전라남도,구례군,60-64세,2706,1388,1318
202104,46730,전라남도,구례군,60-64세,2737,1401,1336
202105,46730,전라남도,구례군,60-64세,2744,1412,1332
202106,46730,전라남도,구례군,60-64세,2766,1426,1340
202007,46730,전라남도,구례군,65-69세,2049,976,1073
202008,46730,전라남도,구례군,65-69세,2058,980,1078
202009,46730,전라남도,구례군,65-69세,2059,981,1078
202010,46730,전라남도,구례군,65-69세,2074,987,1087
202011,46730,전라남도,구례군,65-69세,2081,989,1092
202012,46730,전라남도,구례군,65-69세,2087,988,1099
202101,46730,전라남도,구례군,65-69세,2085,989,1096
202102,46730,전라남도,구례군,65-69세,2065,975,1090
202103,46730,전라남도,구례군,65-69세,2069,975,1094
202104,46730,전라남도,구례군,65-69세,2075,986,1089
202105,46730,전라남도,구례군,65-69세,2063,979,1084
202106,46730,전라남도,구례군,65-69세,2051,972,1079
202007,46730,전라남도,구례군,70-74세,1887,869,1018
202008,46730,전라남도,구례군,70-74세,1889,865,1024
202009,46730,전라남도,구례군,70-74세,1899,878,1021
202010,46730,전라남도,구례군,70-74세,1919,890,1029
202011,46730,전라남도,구례군,70-74세,1933,896,1037
202012,46730,전라남도,구례군,70-74세,1936,903,1033
202101,46730,전라남도,구례군,70-74세,1941,903,1038
202102,46730,전라남도,구례군,70-74세,1964,917,1047
202103,46730,전라남도,구례군,70-74세,1952,920,1032
202104,46730,전라남도,구례군,70-74세,1950,914,1036
202105,46730,전라남도,구례군,70-74세,1953,915,1038
202106,46730,전라남도,구례군,70-74세,1951,918,1033
202007,46730,전라남도,구례군,75-79세,2026,751,1275
202008,46730,전라남도,구례군,75-79세,2015,757,1258
202009,46730,전라남도,구례군,75-79세,1998,749,1249
202010,46730,전라남도,구례군,75-79세,1979,742,1237
202011,46730,전라남도,구례군,75-79세,1971,737,1234
202012,46730,전라남도,구례군,75-79세,1964,728,1236
202101,46730,전라남도,구례군,75-79세,1954,719,1235
202102,46730,전라남도,구례군,75-79세,1927,713,1214
202103,46730,전라남도,구례군,75-79세,1923,708,1215
202104,46730,전라남도,구례군,75-79세,1895,701,1194
202105,46730,전라남도,구례군,75-79세,1874,698,1176
202106,46730,전라남도,구례군,75-79세,1867,687,1180
202007,46730,전라남도,구례군,80-84세,1658,570,1088
202008,46730,전라남도,구례군,80-84세,1657,568,1089
202009,46730,전라남도,구례군,80-84세,1658,569,1089
202010,46730,전라남도,구례군,80-84세,1673,575,1098
202011,46730,전라남도,구례군,80-84세,1663,566,1097
202012,46730,전라남도,구례군,80-84세,1665,569,1096
202101,46730,전라남도,구례군,80-84세,1663,569,1094
202102,46730,전라남도,구례군,80-84세,1670,573,1097
202103,46730,전라남도,구례군,80-84세,1677,580,1097
202104,46730,전라남도,구례군,80-84세,1687,584,1103
202105,46730,전라남도,구례군,80-84세,1690,581,1109
202106,46730,전라남도,구례군,80-84세,1693,588,1105
202007,46730,전라남도,구례군,85-89세,813,234,579
202008,46730,전라남도,구례군,85-89세,817,234,583
202009,46730,전라남도,구례군,85-89세,820,233,587
202010,46730,전라남도,구례군,85-89세,811,234,577
202011,46730,전라남도,구례군,85-89세,822,238,584
202012,46730,전라남도,구례군,85-89세,831,244,587
202101,46730,전라남도,구례군,85-89세,832,243,589
202102,46730,전라남도,구례군,85-89세,851,249,602
202103,46730,전라남도,구례군,85-89세,869,256,613
202104,46730,전라남도,구례군,85-89세,883,255,628
202105,46730,전라남도,구례군,85-89세,886,254,632
202106,46730,전라남도,구례군,85-89세,892,259,633
202007,46730,전라남도,구례군,90-94세,300,65,235
202008,46730,전라남도,구례군,90-94세,310,65,245
202009,46730,전라남도,구례군,90-94세,312,68,244
202010,46730,전라남도,구례군,90-94세,317,68,249
202011,46730,전라남도,구례군,90-94세,318,71,247
202012,46730,전라남도,구례군,90-94세,320,73,247
202101,46730,전라남도,구례군,90-94세,326,75,251
202102,46730,전라남도,구례군,90-94세,326,72,254
202103,46730,전라남도,구례군,90-94세,332,71,261
202104,46730,전라남도,구례군,90-94세,331,75,256
202105,46730,전라남도,구례군,90-94세,335,74,261
202106,46730,전라남도,구례군,90-94세,335,73,262
202007,46730,전라남도,구례군,95-99세,58,11,47
202008,46730,전라남도,구례군,95-99세,57,11,46
202009,46730,전라남도,구례군,95-99세,60,11,49
202010,46730,전라남도,구례군,95-99세,60,11,49
202011,46730,전라남도,구례군,95-99세,59,11,48
202012,46730,전라남도,구례군,95-99세,57,10,47
202101,46730,전라남도,구례군,95-99세,54,9,45
202102,46730,전라남도,구례군,95-99세,57,9,48
202103,46730,전라남도,구례군,95-99세,57,9,48
202104,46730,전라남도,구례군,95-99세,58,9,49
202105,46730,전라남도,구례군,95-99세,58,9,49
202106,46730,전라남도,구례군,95-99세,59,10,49
202007,46730,전라남도,구례군,100+,20,2,18
202008,46730,전라남도,구례군,100+,20,2,18
202009,46730,전라남도,구례군,100+,22,2,20
202010,46730,전라남도,구례군,100+,22,2,20
202011,46730,전라남도,구례군,100+,22,2,20
202012,46730,전라남도,구례군,100+,22,2,20
202101,46730,전라남도,구례군,100+,23,3,20
202102,46730,전라남도,구례군,100+,24,3,21
202103,46730,전라남도,구례군,100+,19,2,17
202104,46730,전라남도,구례군,100+,19,2,17
202105,46730,전라남도,구례군,100+,16,2,14
202106,46730,전라남도,구례군,100+,16,2,14
202007,46770,전라남도,고흥군,0-4세,1202,583,619
202008,46770,전라남도,고흥군,0-4세,1198,574,624
202009,46770,전라남도,고흥군,0-4세,1193,569,624
202010,46770,전라남도,고흥군,0-4세,1187,575,612
202011,46770,전라남도,고흥군,0-4세,1195,583,612
202012,46770,전라남도,고흥군,0-4세,1197,579,618
202101,46770,전라남도,고흥군,0-4세,1191,576,615
202102,46770,전라남도,고흥군,0-4세,1179,574,605
202103,46770,전라남도,고흥군,0-4세,1163,565,598
202104,46770,전라남도,고흥군,0-4세,1146,556,590
202105,46770,전라남도,고흥군,0-4세,1142,558,584
202106,46770,전라남도,고흥군,0-4세,1123,545,578
202007,46770,전라남도,고흥군,5-9세,1446,743,703
202008,46770,전라남도,고흥군,5-9세,1442,742,700
202009,46770,전라남도,고흥군,5-9세,1431,733,698
202010,46770,전라남도,고흥군,5-9세,1435,727,708
202011,46770,전라남도,고흥군,5-9세,1433,727,706
202012,46770,전라남도,고흥군,5-9세,1422,726,696
202101,46770,전라남도,고흥군,5-9세,1414,715,699
202102,46770,전라남도,고흥군,5-9세,1429,718,711
202103,46770,전라남도,고흥군,5-9세,1414,716,698
202104,46770,전라남도,고흥군,5-9세,1417,718,699
202105,46770,전라남도,고흥군,5-9세,1430,720,710
202106,46770,전라남도,고흥군,5-9세,1422,717,705
202007,46770,전라남도,고흥군,10-14세,1744,908,836
202008,46770,전라남도,고흥군,10-14세,1750,921,829
202009,46770,전라남도,고흥군,10-14세,1741,923,818
202010,46770,전라남도,고흥군,10-14세,1736,920,816
202011,46770,전라남도,고흥군,10-14세,1741,926,815
202012,46770,전라남도,고흥군,10-14세,1737,923,814
202101,46770,전라남도,고흥군,10-14세,1726,922,804
202102,46770,전라남도,고흥군,10-14세,1714,915,799
202103,46770,전라남도,고흥군,10-14세,1714,907,807
202104,46770,전라남도,고흥군,10-14세,1715,908,807
202105,46770,전라남도,고흥군,10-14세,1706,908,798
202106,46770,전라남도,고흥군,10-14세,1709,907,802
202007,46770,전라남도,고흥군,15-19세,2221,1189,1032
202008,46770,전라남도,고흥군,15-19세,2203,1177,1026
202009,46770,전라남도,고흥군,15-19세,2195,1168,1027
202010,46770,전라남도,고흥군,15-19세,2180,1165,1015
202011,46770,전라남도,고흥군,15-19세,2159,1160,999
202012,46770,전라남도,고흥군,15-19세,2123,1145,978
202101,46770,전라남도,고흥군,15-19세,2096,1131,965
202102,46770,전라남도,고흥군,15-19세,2076,1116,960
202103,46770,전라남도,고흥군,15-19세,2056,1114,942
202104,46770,전라남도,고흥군,15-19세,2046,1111,935
202105,46770,전라남도,고흥군,15-19세,2028,1099,929
202106,46770,전라남도,고흥군,15-19세,2025,1100,925
202007,46770,전라남도,고흥군,20-24세,2464,1453,1011
202008,46770,전라남도,고흥군,20-24세,2461,1449,1012
202009,46770,전라남도,고흥군,20-24세,2445,1440,1005
202010,46770,전라남도,고흥군,20-24세,2427,1427,1000
202011,46770,전라남도,고흥군,20-24세,2421,1420,1001
202012,46770,전라남도,고흥군,20-24세,2424,1413,1011
202101,46770,전라남도,고흥군,20-24세,2419,1401,1018
202102,46770,전라남도,고흥군,20-24세,2408,1406,1002
202103,46770,전라남도,고흥군,20-24세,2374,1379,995
202104,46770,전라남도,고흥군,20-24세,2357,1357,1000
202105,46770,전라남도,고흥군,20-24세,2340,1349,991
202106,46770,전라남도,고흥군,20-24세,2328,1339,989
202007,46770,전라남도,고흥군,25-29세,1798,1038,760
202008,46770,전라남도,고흥군,25-29세,1777,1037,740
202009,46770,전라남도,고흥군,25-29세,1753,1029,724
202010,46770,전라남도,고흥군,25-29세,1749,1030,719
202011,46770,전라남도,고흥군,25-29세,1739,1027,712
202012,46770,전라남도,고흥군,25-29세,1748,1035,713
202101,46770,전라남도,고흥군,25-29세,1729,1019,710
202102,46770,전라남도,고흥군,25-29세,1722,1025,697
202103,46770,전라남도,고흥군,25-29세,1710,1010,700
202104,46770,전라남도,고흥군,25-29세,1706,1009,697
202105,46770,전라남도,고흥군,25-29세,1721,1017,704
202106,46770,전라남도,고흥군,25-29세,1719,1022,697
202007,46770,전라남도,고흥군,30-34세,1638,892,746
202008,46770,전라남도,고흥군,30-34세,1634,893,741
202009,46770,전라남도,고흥군,30-34세,1619,884,735
202010,46770,전라남도,고흥군,30-34세,1607,880,727
202011,46770,전라남도,고흥군,30-34세,1596,872,724
202012,46770,전라남도,고흥군,30-34세,1579,859,720
202101,46770,전라남도,고흥군,30-34세,1578,855,723
202102,46770,전라남도,고흥군,30-34세,1561,851,710
202103,46770,전라남도,고흥군,30-34세,1541,843,698
202104,46770,전라남도,고흥군,30-34세,1535,828,707
202105,46770,전라남도,고흥군,30-34세,1518,816,702
202106,46770,전라남도,고흥군,30-34세,1520,823,697
202007,46770,전라남도,고흥군,35-39세,2159,1182,977
202008,46770,전라남도,고흥군,35-39세,2133,1165,968
202009,46770,전라남도,고흥군,35-39세,2127,1159,968
202010,46770,전라남도,고흥군,35-39세,2123,1152,971
202011,46770,전라남도,고흥군,35-39세,2116,1141,975
202012,46770,전라남도,고흥군,35-39세,2104,1147,957
202101,46770,전라남도,고흥군,35-39세,2096,1150,946
202102,46770,전라남도,고흥군,35-39세,2074,1133,941
202103,46770,전라남도,고흥군,35-39세,2053,1115,938
202104,46770,전라남도,고흥군,35-39세,2034,1107,927
202105,46770,전라남도,고흥군,35-39세,2033,1106,927
202106,46770,전라남도,고흥군,35-39세,2018,1101,917
202007,46770,전라남도,고흥군,40-44세,2739,1555,1184
202008,46770,전라남도,고흥군,40-44세,2746,1554,1192
202009,46770,전라남도,고흥군,40-44세,2739,1547,1192
202010,46770,전라남도,고흥군,40-44세,2720,1527,1193
202011,46770,전라남도,고흥군,40-44세,2725,1538,1187
202012,46770,전라남도,고흥군,40-44세,2723,1531,1192
202101,46770,전라남도,고흥군,40-44세,2696,1507,1189
202102,46770,전라남도,고흥군,40-44세,2699,1506,1193
202103,46770,전라남도,고흥군,40-44세,2672,1493,1179
202104,46770,전라남도,고흥군,40-44세,2662,1489,1173
202105,46770,전라남도,고흥군,40-44세,2649,1485,1164
202106,46770,전라남도,고흥군,40-44세,2648,1480,1168
202007,46770,전라남도,고흥군,45-49세,3711,2212,1499
202008,46770,전라남도,고흥군,45-49세,3690,2202,1488
202009,46770,전라남도,고흥군,45-49세,3658,2184,1474
202010,46770,전라남도,고흥군,45-49세,3613,2156,1457
202011,46770,전라남도,고흥군,45-49세,3612,2140,1472
202012,46770,전라남도,고흥군,45-49세,3618,2144,1474
202101,46770,전라남도,고흥군,45-49세,3625,2153,1472
202102,46770,전라남도,고흥군,45-49세,3620,2142,1478
202103,46770,전라남도,고흥군,45-49세,3574,2120,1454
202104,46770,전라남도,고흥군,45-49세,3548,2108,1440
202105,46770,전라남도,고흥군,45-49세,3493,2068,1425
202106,46770,전라남도,고흥군,45-49세,3480,2066,1414
202007,46770,전라남도,고흥군,50-54세,4628,2656,1972
202008,46770,전라남도,고흥군,50-54세,4612,2659,1953
202009,46770,전라남도,고흥군,50-54세,4614,2662,1952
202010,46770,전라남도,고흥군,50-54세,4634,2671,1963
202011,46770,전라남도,고흥군,50-54세,4614,2660,1954
202012,46770,전라남도,고흥군,50-54세,4579,2637,1942
202101,46770,전라남도,고흥군,50-54세,4602,2660,1942
202102,46770,전라남도,고흥군,50-54세,4590,2665,1925
202103,46770,전라남도,고흥군,50-54세,4532,2643,1889
202104,46770,전라남도,고흥군,50-54세,4528,2641,1887
202105,46770,전라남도,고흥군,50-54세,4550,2663,1887
202106,46770,전라남도,고흥군,50-54세,4567,2666,1901
202007,46770,전라남도,고흥군,55-59세,5838,3117,2721
202008,46770,전라남도,고흥군,55-59세,5791,3087,2704
202009,46770,전라남도,고흥군,55-59세,5716,3052,2664
202010,46770,전라남도,고흥군,55-59세,5677,3041,2636
202011,46770,전라남도,고흥군,55-59세,5644,3036,2608
202012,46770,전라남도,고흥군,55-59세,5625,3021,2604
202101,46770,전라남도,고흥군,55-59세,5565,3000,2565
202102,46770,전라남도,고흥군,55-59세,5562,3001,2561
202103,46770,전라남도,고흥군,55-59세,5554,2999,2555
202104,46770,전라남도,고흥군,55-59세,5543,2996,2547
202105,46770,전라남도,고흥군,55-59세,5483,2973,2510
202106,46770,전라남도,고흥군,55-59세,5459,2963,2496
202007,46770,전라남도,고흥군,60-64세,6529,3313,3216
202008,46770,전라남도,고흥군,60-64세,6583,3324,3259
202009,46770,전라남도,고흥군,60-64세,6642,3353,3289
202010,46770,전라남도,고흥군,60-64세,6666,3367,3299
202011,46770,전라남도,고흥군,60-64세,6720,3400,3320
202012,46770,전라남도,고흥군,60-64세,6745,3421,3324
202101,46770,전라남도,고흥군,60-64세,6785,3437,3348
202102,46770,전라남도,고흥군,60-64세,6829,3444,3385
202103,46770,전라남도,고흥군,60-64세,6841,3447,3394
202104,46770,전라남도,고흥군,60-64세,6884,3487,3397
202105,46770,전라남도,고흥군,60-64세,6908,3489,3419
202106,46770,전라남도,고흥군,60-64세,6952,3524,3428
202007,46770,전라남도,고흥군,65-69세,5992,2891,3101
202008,46770,전라남도,고흥군,65-69세,5973,2897,3076
202009,46770,전라남도,고흥군,65-69세,5971,2899,3072
202010,46770,전라남도,고흥군,65-69세,5998,2920,3078
202011,46770,전라남도,고흥군,65-69세,5999,2915,3084
202012,46770,전라남도,고흥군,65-69세,5990,2911,3079
202101,46770,전라남도,고흥군,65-69세,6009,2917,3092
202102,46770,전라남도,고흥군,65-69세,5993,2917,3076
202103,46770,전라남도,고흥군,65-69세,6009,2937,3072
202104,46770,전라남도,고흥군,65-69세,6022,2935,3087
202105,46770,전라남도,고흥군,65-69세,5994,2928,3066
202106,46770,전라남도,고흥군,65-69세,5960,2899,3061
202007,46770,전라남도,고흥군,70-74세,5718,2608,3110
202008,46770,전라남도,고흥군,70-74세,5751,2619,3132
202009,46770,전라남도,고흥군,70-74세,5785,2643,3142
202010,46770,전라남도,고흥군,70-74세,5845,2679,3166
202011,46770,전라남도,고흥군,70-74세,5901,2710,3191
202012,46770,전라남도,고흥군,70-74세,5970,2745,3225
202101,46770,전라남도,고흥군,70-74세,6002,2764,3238
202102,46770,전라남도,고흥군,70-74세,6040,2791,3249
202103,46770,전라남도,고흥군,70-74세,6048,2807,3241
202104,46770,전라남도,고흥군,70-74세,6064,2821,3243
202105,46770,전라남도,고흥군,70-74세,6076,2831,3245
202106,46770,전라남도,고흥군,70-74세,6090,2849,3241
202007,46770,전라남도,고흥군,75-79세,5722,2292,3430
202008,46770,전라남도,고흥군,75-79세,5713,2286,3427
202009,46770,전라남도,고흥군,75-79세,5697,2283,3414
202010,46770,전라남도,고흥군,75-79세,5653,2261,3392
202011,46770,전라남도,고흥군,75-79세,5619,2249,3370
202012,46770,전라남도,고흥군,75-79세,5544,2214,3330
202101,46770,전라남도,고흥군,75-79세,5502,2198,3304
202102,46770,전라남도,고흥군,75-79세,5449,2174,3275
202103,46770,전라남도,고흥군,75-79세,5361,2136,3225
202104,46770,전라남도,고흥군,75-79세,5296,2114,3182
202105,46770,전라남도,고흥군,75-79세,5290,2118,3172
202106,46770,전라남도,고흥군,75-79세,5253,2109,3144
202007,46770,전라남도,고흥군,80-84세,4823,1608,3215
202008,46770,전라남도,고흥군,80-84세,4832,1616,3216
202009,46770,전라남도,고흥군,80-84세,4841,1605,3236
202010,46770,전라남도,고흥군,80-84세,4859,1606,3253
202011,46770,전라남도,고흥군,80-84세,4850,1611,3239
202012,46770,전라남도,고흥군,80-84세,4841,1610,3231
202101,46770,전라남도,고흥군,80-84세,4862,1622,3240
202102,46770,전라남도,고흥군,80-84세,4854,1622,3232
202103,46770,전라남도,고흥군,80-84세,4904,1646,3258
202104,46770,전라남도,고흥군,80-84세,4906,1655,3251
202105,46770,전라남도,고흥군,80-84세,4952,1670,3282
202106,46770,전라남도,고흥군,80-84세,4961,1678,3283
202007,46770,전라남도,고흥군,85-89세,2645,710,1935
202008,46770,전라남도,고흥군,85-89세,2645,710,1935
202009,46770,전라남도,고흥군,85-89세,2636,711,1925
202010,46770,전라남도,고흥군,85-89세,2638,713,1925
202011,46770,전라남도,고흥군,85-89세,2643,712,1931
202012,46770,전라남도,고흥군,85-89세,2661,716,1945
202101,46770,전라남도,고흥군,85-89세,2674,711,1963
202102,46770,전라남도,고흥군,85-89세,2713,727,1986
202103,46770,전라남도,고흥군,85-89세,2735,737,1998
202104,46770,전라남도,고흥군,85-89세,2783,747,2036
202105,46770,전라남도,고흥군,85-89세,2795,743,2052
202106,46770,전라남도,고흥군,85-89세,2810,750,2060
202007,46770,전라남도,고흥군,90-94세,965,224,741
202008,46770,전라남도,고흥군,90-94세,971,225,746
202009,46770,전라남도,고흥군,90-94세,983,229,754
202010,46770,전라남도,고흥군,90-94세,992,232,760
202011,46770,전라남도,고흥군,90-94세,989,229,760
202012,46770,전라남도,고흥군,90-94세,994,231,763
202101,46770,전라남도,고흥군,90-94세,1000,235,765
202102,46770,전라남도,고흥군,90-94세,1010,235,775
202103,46770,전라남도,고흥군,90-94세,1028,241,787
202104,46770,전라남도,고흥군,90-94세,1033,238,795
202105,46770,전라남도,고흥군,90-94세,1039,238,801
202106,46770,전라남도,고흥군,90-94세,1045,235,810
202007,46770,전라남도,고흥군,95-99세,243,32,211
202008,46770,전라남도,고흥군,95-99세,245,35,210
202009,46770,전라남도,고흥군,95-99세,249,37,212
202010,46770,전라남도,고흥군,95-99세,246,35,211
202011,46770,전라남도,고흥군,95-99세,246,36,210
202012,46770,전라남도,고흥군,95-99세,247,36,211
202101,46770,전라남도,고흥군,95-99세,246,36,210
202102,46770,전라남도,고흥군,95-99세,242,36,206
202103,46770,전라남도,고흥군,95-99세,240,37,203
202104,46770,전라남도,고흥군,95-99세,238,36,202
202105,46770,전라남도,고흥군,95-99세,240,34,206
202106,46770,전라남도,고흥군,95-99세,236,35,201
202007,46770,전라남도,고흥군,100+,48,7,41
202008,46770,전라남도,고흥군,100+,48,7,41
202009,46770,전라남도,고흥군,100+,50,7,43
202010,46770,전라남도,고흥군,100+,53,8,45
202011,46770,전라남도,고흥군,100+,51,8,43
202012,46770,전라남도,고흥군,100+,51,7,44
202101,46770,전라남도,고흥군,100+,52,7,45
202102,46770,전라남도,고흥군,100+,50,6,44
202103,46770,전라남도,고흥군,100+,49,6,43
202104,46770,전라남도,고흥군,100+,45,6,39
202105,46770,전라남도,고흥군,100+,47,6,41
202106,46770,전라남도,고흥군,100+,49,5,44
202007,46780,전라남도,보성군,0-4세,799,413,386
202008,46780,전라남도,보성군,0-4세,790,407,383
202009,46780,전라남도,보성군,0-4세,781,405,376
202010,46780,전라남도,보성군,0-4세,772,400,372
202011,46780,전라남도,보성군,0-4세,763,394,369
202012,46780,전라남도,보성군,0-4세,747,381,366
202101,46780,전라남도,보성군,0-4세,744,381,363
202102,46780,전라남도,보성군,0-4세,720,365,355
202103,46780,전라남도,보성군,0-4세,712,360,352
202104,46780,전라남도,보성군,0-4세,705,360,345
202105,46780,전라남도,보성군,0-4세,700,359,341
202106,46780,전라남도,보성군,0-4세,698,362,336
202007,46780,전라남도,보성군,5-9세,1031,546,485
202008,46780,전라남도,보성군,5-9세,1031,551,480
202009,46780,전라남도,보성군,5-9세,1021,546,475
202010,46780,전라남도,보성군,5-9세,1013,545,468
202011,46780,전라남도,보성군,5-9세,997,537,460
202012,46780,전라남도,보성군,5-9세,1012,544,468
202101,46780,전라남도,보성군,5-9세,1003,538,465
202102,46780,전라남도,보성군,5-9세,989,535,454
202103,46780,전라남도,보성군,5-9세,981,529,452
202104,46780,전라남도,보성군,5-9세,967,518,449
202105,46780,전라남도,보성군,5-9세,958,515,443
202106,46780,전라남도,보성군,5-9세,938,501,437
202007,46780,전라남도,보성군,10-14세,1181,573,608
202008,46780,전라남도,보성군,10-14세,1177,573,604
202009,46780,전라남도,보성군,10-14세,1179,574,605
202010,46780,전라남도,보성군,10-14세,1177,572,605
202011,46780,전라남도,보성군,10-14세,1183,574,609
202012,46780,전라남도,보성군,10-14세,1185,573,612
202101,46780,전라남도,보성군,10-14세,1181,573,608
202102,46780,전라남도,보성군,10-14세,1172,571,601
202103,46780,전라남도,보성군,10-14세,1175,569,606
202104,46780,전라남도,보성군,10-14세,1188,577,611
202105,46780,전라남도,보성군,10-14세,1183,576,607
202106,46780,전라남도,보성군,10-14세,1189,580,609
202007,46780,전라남도,보성군,15-19세,1471,778,693
202008,46780,전라남도,보성군,15-19세,1461,769,692
202009,46780,전라남도,보성군,15-19세,1452,769,683
202010,46780,전라남도,보성군,15-19세,1437,763,674
202011,46780,전라남도,보성군,15-19세,1431,763,668
202012,46780,전라남도,보성군,15-19세,1419,756,663
202101,46780,전라남도,보성군,15-19세,1407,746,661
202102,46780,전라남도,보성군,15-19세,1405,744,661
202103,46780,전라남도,보성군,15-19세,1376,734,642
202104,46780,전라남도,보성군,15-19세,1363,724,639
202105,46780,전라남도,보성군,15-19세,1362,723,639
202106,46780,전라남도,보성군,15-19세,1359,724,635
202007,46780,전라남도,보성군,20-24세,1783,1004,779
202008,46780,전라남도,보성군,20-24세,1765,1000,765
202009,46780,전라남도,보성군,20-24세,1753,989,764
202010,46780,전라남도,보성군,20-24세,1757,992,765
202011,46780,전라남도,보성군,20-24세,1738,982,756
202012,46780,전라남도,보성군,20-24세,1728,971,757
202101,46780,전라남도,보성군,20-24세,1714,964,750
202102,46780,전라남도,보성군,20-24세,1703,962,741
202103,46780,전라남도,보성군,20-24세,1680,954,726
202104,46780,전라남도,보성군,20-24세,1673,951,722
202105,46780,전라남도,보성군,20-24세,1649,942,707
202106,46780,전라남도,보성군,20-24세,1631,934,697
202007,46780,전라남도,보성군,25-29세,1253,701,552
202008,46780,전라남도,보성군,25-29세,1240,698,542
202009,46780,전라남도,보성군,25-29세,1239,702,537
202010,46780,전라남도,보성군,25-29세,1228,695,533
202011,46780,전라남도,보성군,25-29세,1241,702,539
202012,46780,전라남도,보성군,25-29세,1260,705,555
202101,46780,전라남도,보성군,25-29세,1245,705,540
202102,46780,전라남도,보성군,25-29세,1233,708,525
202103,46780,전라남도,보성군,25-29세,1231,708,523
202104,46780,전라남도,보성군,25-29세,1249,717,532
202105,46780,전라남도,보성군,25-29세,1237,708,529
202106,46780,전라남도,보성군,25-29세,1229,700,529
202007,46780,전라남도,보성군,30-34세,1172,632,540
202008,46780,전라남도,보성군,30-34세,1164,630,534
202009,46780,전라남도,보성군,30-34세,1157,630,527
202010,46780,전라남도,보성군,30-34세,1162,642,520
202011,46780,전라남도,보성군,30-34세,1140,627,513
202012,46780,전라남도,보성군,30-34세,1127,618,509
202101,46780,전라남도,보성군,30-34세,1107,611,496
202102,46780,전라남도,보성군,30-34세,1074,590,484
202103,46780,전라남도,보성군,30-34세,1067,580,487
202104,46780,전라남도,보성군,30-34세,1060,580,480
202105,46780,전라남도,보성군,30-34세,1050,574,476
202106,46780,전라남도,보성군,30-34세,1047,577,470
202007,46780,전라남도,보성군,35-39세,1452,773,679
202008,46780,전라남도,보성군,35-39세,1435,758,677
202009,46780,전라남도,보성군,35-39세,1419,748,671
202010,46780,전라남도,보성군,35-39세,1408,736,672
202011,46780,전라남도,보성군,35-39세,1398,732,666
202012,46780,전라남도,보성군,35-39세,1412,749,663
202101,46780,전라남도,보성군,35-39세,1397,731,666
202102,46780,전라남도,보성군,35-39세,1384,731,653
202103,46780,전라남도,보성군,35-39세,1369,728,641
202104,46780,전라남도,보성군,35-39세,1366,724,642
202105,46780,전라남도,보성군,35-39세,1348,713,635
202106,46780,전라남도,보성군,35-39세,1339,706,633
202007,46780,전라남도,보성군,40-44세,1832,1004,828
202008,46780,전라남도,보성군,40-44세,1842,1011,831
202009,46780,전라남도,보성군,40-44세,1852,1026,826
202010,46780,전라남도,보성군,40-44세,1850,1027,823
202011,46780,전라남도,보성군,40-44세,1853,1030,823
202012,46780,전라남도,보성군,40-44세,1830,1014,816
202101,46780,전라남도,보성군,40-44세,1823,1006,817
202102,46780,전라남도,보성군,40-44세,1818,1004,814
202103,46780,전라남도,보성군,40-44세,1794,989,805
202104,46780,전라남도,보성군,40-44세,1797,995,802
202105,46780,전라남도,보성군,40-44세,1781,985,796
202106,46780,전라남도,보성군,40-44세,1776,978,798
202007,46780,전라남도,보성군,45-49세,2439,1419,1020
202008,46780,전라남도,보성군,45-49세,2407,1403,1004
202009,46780,전라남도,보성군,45-49세,2382,1387,995
202010,46780,전라남도,보성군,45-49세,2357,1378,979
202011,46780,전라남도,보성군,45-49세,2335,1366,969
202012,46780,전라남도,보성군,45-49세,2328,1374,954
202101,46780,전라남도,보성군,45-49세,2338,1375,963
202102,46780,전라남도,보성군,45-49세,2326,1358,968
202103,46780,전라남도,보성군,45-49세,2331,1366,965
202104,46780,전라남도,보성군,45-49세,2320,1353,967
202105,46780,전라남도,보성군,45-49세,2287,1340,947
202106,46780,전라남도,보성군,45-49세,2274,1330,944
202007,46780,전라남도,보성군,50-54세,3110,1804,1306
202008,46780,전라남도,보성군,50-54세,3101,1797,1304
202009,46780,전라남도,보성군,50-54세,3093,1801,1292
202010,46780,전라남도,보성군,50-54세,3074,1795,1279
202011,46780,전라남도,보성군,50-54세,3049,1778,1271
202012,46780,전라남도,보성군,50-54세,3058,1772,1286
202101,46780,전라남도,보성군,50-54세,3077,1782,1295
202102,46780,전라남도,보성군,50-54세,3061,1769,1292
202103,46780,전라남도,보성군,50-54세,3021,1746,1275
202104,46780,전라남도,보성군,50-54세,3011,1737,1274
202105,46780,전라남도,보성군,50-54세,2992,1736,1256
202106,46780,전라남도,보성군,50-54세,2988,1729,1259
202007,46780,전라남도,보성군,55-59세,3660,1978,1682
202008,46780,전라남도,보성군,55-59세,3655,1966,1689
202009,46780,전라남도,보성군,55-59세,3624,1958,1666
202010,46780,전라남도,보성군,55-59세,3628,1952,1676
202011,46780,전라남도,보성군,55-59세,3621,1948,1673
202012,46780,전라남도,보성군,55-59세,3618,1942,1676
202101,46780,전라남도,보성군,55-59세,3604,1941,1663
202102,46780,전라남도,보성군,55-59세,3609,1954,1655
202103,46780,전라남도,보성군,55-59세,3625,1963,1662
202104,46780,전라남도,보성군,55-59세,3638,1972,1666
202105,46780,전라남도,보성군,55-59세,3588,1950,1638
202106,46780,전라남도,보성군,55-59세,3551,1932,1619
202007,46780,전라남도,보성군,60-64세,4071,2098,1973
202008,46780,전라남도,보성군,60-64세,4082,2114,1968
202009,46780,전라남도,보성군,60-64세,4111,2122,1989
202010,46780,전라남도,보성군,60-64세,4128,2133,1995
202011,46780,전라남도,보성군,60-64세,4151,2145,2006
202012,46780,전라남도,보성군,60-64세,4155,2157,1998
202101,46780,전라남도,보성군,60-64세,4150,2154,1996
202102,46780,전라남도,보성군,60-64세,4182,2171,2011
202103,46780,전라남도,보성군,60-64세,4158,2164,1994
202104,46780,전라남도,보성군,60-64세,4176,2184,1992
202105,46780,전라남도,보성군,60-64세,4165,2187,1978
202106,46780,전라남도,보성군,60-64세,4203,2211,1992
202007,46780,전라남도,보성군,65-69세,3460,1661,1799
202008,46780,전라남도,보성군,65-69세,3467,1667,1800
202009,46780,전라남도,보성군,65-69세,3483,1674,1809
202010,46780,전라남도,보성군,65-69세,3477,1679,1798
202011,46780,전라남도,보성군,65-69세,3459,1681,1778
202012,46780,전라남도,보성군,65-69세,3465,1680,1785
202101,46780,전라남도,보성군,65-69세,3499,1701,1798
202102,46780,전라남도,보성군,65-69세,3487,1702,1785
202103,46780,전라남도,보성군,65-69세,3510,1709,1801
202104,46780,전라남도,보성군,65-69세,3514,1707,1807
202105,46780,전라남도,보성군,65-69세,3488,1702,1786
202106,46780,전라남도,보성군,65-69세,3506,1701,1805
202007,46780,전라남도,보성군,70-74세,3299,1535,1764
202008,46780,전라남도,보성군,70-74세,3302,1542,1760
202009,46780,전라남도,보성군,70-74세,3317,1551,1766
202010,46780,전라남도,보성군,70-74세,3323,1553,1770
202011,46780,전라남도,보성군,70-74세,3342,1566,1776
202012,46780,전라남도,보성군,70-74세,3363,1582,1781
202101,46780,전라남도,보성군,70-74세,3387,1596,1791
202102,46780,전라남도,보성군,70-74세,3408,1595,1813
202103,46780,전라남도,보성군,70-74세,3412,1589,1823
202104,46780,전라남도,보성군,70-74세,3431,1594,1837
202105,46780,전라남도,보성군,70-74세,3417,1600,1817
202106,46780,전라남도,보성군,70-74세,3405,1601,1804
202007,46780,전라남도,보성군,75-79세,3387,1287,2100
202008,46780,전라남도,보성군,75-79세,3375,1279,2096
202009,46780,전라남도,보성군,75-79세,3351,1272,2079
202010,46780,전라남도,보성군,75-79세,3332,1260,2072
202011,46780,전라남도,보성군,75-79세,3313,1261,2052
202012,46780,전라남도,보성군,75-79세,3283,1252,2031
202101,46780,전라남도,보성군,75-79세,3249,1246,2003
202102,46780,전라남도,보성군,75-79세,3212,1234,1978
202103,46780,전라남도,보성군,75-79세,3167,1224,1943
202104,46780,전라남도,보성군,75-79세,3141,1220,1921
202105,46780,전라남도,보성군,75-79세,3114,1214,1900
202106,46780,전라남도,보성군,75-79세,3110,1218,1892
202007,46780,전라남도,보성군,80-84세,3048,1031,2017
202008,46780,전라남도,보성군,80-84세,3062,1038,2024
202009,46780,전라남도,보성군,80-84세,3053,1035,2018
202010,46780,전라남도,보성군,80-84세,3062,1048,2014
202011,46780,전라남도,보성군,80-84세,3058,1040,2018
202012,46780,전라남도,보성군,80-84세,3071,1048,2023
202101,46780,전라남도,보성군,80-84세,3062,1047,2015
202102,46780,전라남도,보성군,80-84세,3061,1045,2016
202103,46780,전라남도,보성군,80-84세,3077,1049,2028
202104,46780,전라남도,보성군,80-84세,3077,1052,2025
202105,46780,전라남도,보성군,80-84세,3068,1044,2024
202106,46780,전라남도,보성군,80-84세,3080,1049,2031
202007,46780,전라남도,보성군,85-89세,1648,442,1206
202008,46780,전라남도,보성군,85-89세,1653,438,1215
202009,46780,전라남도,보성군,85-89세,1667,445,1222
202010,46780,전라남도,보성군,85-89세,1668,443,1225
202011,46780,전라남도,보성군,85-89세,1670,448,1222
202012,46780,전라남도,보성군,85-89세,1668,445,1223
202101,46780,전라남도,보성군,85-89세,1669,442,1227
202102,46780,전라남도,보성군,85-89세,1688,449,1239
202103,46780,전라남도,보성군,85-89세,1703,460,1243
202104,46780,전라남도,보성군,85-89세,1722,466,1256
202105,46780,전라남도,보성군,85-89세,1730,471,1259
202106,46780,전라남도,보성군,85-89세,1730,469,1261
202007,46780,전라남도,보성군,90-94세,571,120,451
202008,46780,전라남도,보성군,90-94세,584,125,459
202009,46780,전라남도,보성군,90-94세,590,127,463
202010,46780,전라남도,보성군,90-94세,588,124,464
202011,46780,전라남도,보성군,90-94세,582,123,459
202012,46780,전라남도,보성군,90-94세,582,125,457
202101,46780,전라남도,보성군,90-94세,603,132,471
202102,46780,전라남도,보성군,90-94세,598,130,468
202103,46780,전라남도,보성군,90-94세,611,131,480
202104,46780,전라남도,보성군,90-94세,613,129,484
202105,46780,전라남도,보성군,90-94세,614,129,485
202106,46780,전라남도,보성군,90-94세,627,134,493
202007,46780,전라남도,보성군,95-99세,120,23,97
202008,46780,전라남도,보성군,95-99세,123,24,99
202009,46780,전라남도,보성군,95-99세,126,24,102
202010,46780,전라남도,보성군,95-99세,130,23,107
202011,46780,전라남도,보성군,95-99세,129,24,105
202012,46780,전라남도,보성군,95-99세,132,25,107
202101,46780,전라남도,보성군,95-99세,132,25,107
202102,46780,전라남도,보성군,95-99세,134,26,108
202103,46780,전라남도,보성군,95-99세,138,27,111
202104,46780,전라남도,보성군,95-99세,137,26,111
202105,46780,전라남도,보성군,95-99세,136,26,110
202106,46780,전라남도,보성군,95-99세,135,23,112
202007,46780,전라남도,보성군,100+,39,6,33
202008,46780,전라남도,보성군,100+,38,6,32
202009,46780,전라남도,보성군,100+,39,6,33
202010,46780,전라남도,보성군,100+,40,6,34
202011,46780,전라남도,보성군,100+,41,6,35
202012,46780,전라남도,보성군,100+,39,6,33
202101,46780,전라남도,보성군,100+,39,6,33
202102,46780,전라남도,보성군,100+,41,7,34
202103,46780,전라남도,보성군,100+,31,6,25
202104,46780,전라남도,보성군,100+,31,6,25
202105,46780,전라남도,보성군,100+,24,4,20
202106,46780,전라남도,보성군,100+,23,3,20
202007,46790,전라남도,화순군,0-4세,1455,733,722
202008,46790,전라남도,화순군,0-4세,1447,732,715
202009,46790,전라남도,화순군,0-4세,1437,722,715
202010,46790,전라남도,화순군,0-4세,1412,716,696
202011,46790,전라남도,화순군,0-4세,1405,705,700
202012,46790,전라남도,화순군,0-4세,1407,707,700
202101,46790,전라남도,화순군,0-4세,1382,699,683
202102,46790,전라남도,화순군,0-4세,1376,691,685
202103,46790,전라남도,화순군,0-4세,1360,684,676
202104,46790,전라남도,화순군,0-4세,1353,685,668
202105,46790,전라남도,화순군,0-4세,1339,674,665
202106,46790,전라남도,화순군,0-4세,1317,665,652
202007,46790,전라남도,화순군,5-9세,2126,1083,1043
202008,46790,전라남도,화순군,5-9세,2117,1083,1034
202009,46790,전라남도,화순군,5-9세,2124,1082,1042
202010,46790,전라남도,화순군,5-9세,2115,1075,1040
202011,46790,전라남도,화순군,5-9세,2098,1073,1025
202012,46790,전라남도,화순군,5-9세,2083,1064,1019
202101,46790,전라남도,화순군,5-9세,2087,1066,1021
202102,46790,전라남도,화순군,5-9세,2063,1060,1003
202103,46790,전라남도,화순군,5-9세,2052,1055,997
202104,46790,전라남도,화순군,5-9세,2055,1052,1003
202105,46790,전라남도,화순군,5-9세,2036,1049,987
202106,46790,전라남도,화순군,5-9세,2021,1039,982
202007,46790,전라남도,화순군,10-14세,2535,1341,1194
202008,46790,전라남도,화순군,10-14세,2533,1336,1197
202009,46790,전라남도,화순군,10-14세,2535,1334,1201
202010,46790,전라남도,화순군,10-14세,2536,1335,1201
202011,46790,전라남도,화순군,10-14세,2532,1327,1205
202012,46790,전라남도,화순군,10-14세,2539,1337,1202
202101,46790,전라남도,화순군,10-14세,2544,1342,1202
202102,46790,전라남도,화순군,10-14세,2555,1345,1210
202103,46790,전라남도,화순군,10-14세,2536,1333,1203
202104,46790,전라남도,화순군,10-14세,2522,1339,1183
202105,46790,전라남도,화순군,10-14세,2509,1317,1192
202106,46790,전라남도,화순군,10-14세,2505,1314,1191
202007,46790,전라남도,화순군,15-19세,3298,1705,1593
202008,46790,전라남도,화순군,15-19세,3272,1693,1579
202009,46790,전라남도,화순군,15-19세,3216,1656,1560
202010,46790,전라남도,화순군,15-19세,3185,1622,1563
202011,46790,전라남도,화순군,15-19세,3160,1616,1544
202012,46790,전라남도,화순군,15-19세,3120,1598,1522
202101,46790,전라남도,화순군,15-19세,3078,1573,1505
202102,46790,전라남도,화순군,15-19세,3123,1599,1524
202103,46790,전라남도,화순군,15-19세,3102,1585,1517
202104,46790,전라남도,화순군,15-19세,3076,1564,1512
202105,46790,전라남도,화순군,15-19세,3044,1560,1484
202106,46790,전라남도,화순군,15-19세,3053,1563,1490
202007,46790,전라남도,화순군,20-24세,3825,2076,1749
202008,46790,전라남도,화순군,20-24세,3818,2071,1747
202009,46790,전라남도,화순군,20-24세,3833,2074,1759
202010,46790,전라남도,화순군,20-24세,3841,2092,1749
202011,46790,전라남도,화순군,20-24세,3839,2102,1737
202012,46790,전라남도,화순군,20-24세,3840,2097,1743
202101,46790,전라남도,화순군,20-24세,3825,2090,1735
202102,46790,전라남도,화순군,20-24세,3806,2077,1729
202103,46790,전라남도,화순군,20-24세,3748,2050,1698
202104,46790,전라남도,화순군,20-24세,3724,2036,1688
202105,46790,전라남도,화순군,20-24세,3707,2030,1677
202106,46790,전라남도,화순군,20-24세,3682,2023,1659
202007,46790,전라남도,화순군,25-29세,2936,1580,1356
202008,46790,전라남도,화순군,25-29세,2942,1587,1355
202009,46790,전라남도,화순군,25-29세,2944,1595,1349
202010,46790,전라남도,화순군,25-29세,2947,1596,1351
202011,46790,전라남도,화순군,25-29세,2962,1589,1373
202012,46790,전라남도,화순군,25-29세,2982,1603,1379
202101,46790,전라남도,화순군,25-29세,2964,1601,1363
202102,46790,전라남도,화순군,25-29세,2953,1596,1357
202103,46790,전라남도,화순군,25-29세,2975,1624,1351
202104,46790,전라남도,화순군,25-29세,3012,1642,1370
202105,46790,전라남도,화순군,25-29세,3001,1632,1369
202106,46790,전라남도,화순군,25-29세,2989,1620,1369
202007,46790,전라남도,화순군,30-34세,2133,1101,1032
202008,46790,전라남도,화순군,30-34세,2138,1095,1043
202009,46790,전라남도,화순군,30-34세,2144,1100,1044
202010,46790,전라남도,화순군,30-34세,2114,1084,1030
202011,46790,전라남도,화순군,30-34세,2098,1084,1014
202012,46790,전라남도,화순군,30-34세,2106,1094,1012
202101,46790,전라남도,화순군,30-34세,2126,1100,1026
202102,46790,전라남도,화순군,30-34세,2119,1095,1024
202103,46790,전라남도,화순군,30-34세,2113,1081,1032
202104,46790,전라남도,화순군,30-34세,2124,1087,1037
202105,46790,전라남도,화순군,30-34세,2119,1079,1040
202106,46790,전라남도,화순군,30-34세,2122,1077,1045
202007,46790,전라남도,화순군,35-39세,2715,1372,1343
202008,46790,전라남도,화순군,35-39세,2677,1348,1329
202009,46790,전라남도,화순군,35-39세,2669,1336,1333
202010,46790,전라남도,화순군,35-39세,2657,1339,1318
202011,46790,전라남도,화순군,35-39세,2646,1327,1319
202012,46790,전라남도,화순군,35-39세,2639,1319,1320
202101,46790,전라남도,화순군,35-39세,2581,1285,1296
202102,46790,전라남도,화순군,35-39세,2562,1270,1292
202103,46790,전라남도,화순군,35-39세,2514,1257,1257
202104,46790,전라남도,화순군,35-39세,2497,1250,1247
202105,46790,전라남도,화순군,35-39세,2483,1248,1235
202106,46790,전라남도,화순군,35-39세,2465,1239,1226
202007,46790,전라남도,화순군,40-44세,3519,1778,1741
202008,46790,전라남도,화순군,40-44세,3525,1774,1751
202009,46790,전라남도,화순군,40-44세,3515,1767,1748
202010,46790,전라남도,화순군,40-44세,3483,1738,1745
202011,46790,전라남도,화순군,40-44세,3480,1739,1741
202012,46790,전라남도,화순군,40-44세,3447,1733,1714
202101,46790,전라남도,화순군,40-44세,3470,1747,1723
202102,46790,전라남도,화순군,40-44세,3457,1737,1720
202103,46790,전라남도,화순군,40-44세,3437,1726,1711
202104,46790,전라남도,화순군,40-44세,3416,1717,1699
202105,46790,전라남도,화순군,40-44세,3412,1716,1696
202106,46790,전라남도,화순군,40-44세,3408,1715,1693
202007,46790,전라남도,화순군,45-49세,4975,2653,2322
202008,46790,전라남도,화순군,45-49세,4937,2643,2294
202009,46790,전라남도,화순군,45-49세,4912,2637,2275
202010,46790,전라남도,화순군,45-49세,4885,2616,2269
202011,46790,전라남도,화순군,45-49세,4849,2594,2255
202012,46790,전라남도,화순군,45-49세,4820,2568,2252
202101,46790,전라남도,화순군,45-49세,4783,2539,2244
202102,46790,전라남도,화순군,45-49세,4752,2515,2237
202103,46790,전라남도,화순군,45-49세,4725,2501,2224
202104,46790,전라남도,화순군,45-49세,4717,2486,2231
202105,46790,전라남도,화순군,45-49세,4650,2439,2211
202106,46790,전라남도,화순군,45-49세,4613,2420,2193
202007,46790,전라남도,화순군,50-54세,5589,3058,2531
202008,46790,전라남도,화순군,50-54세,5577,3044,2533
202009,46790,전라남도,화순군,50-54세,5583,3057,2526
202010,46790,전라남도,화순군,50-54세,5611,3080,2531
202011,46790,전라남도,화순군,50-54세,5600,3071,2529
202012,46790,전라남도,화순군,50-54세,5582,3049,2533
202101,46790,전라남도,화순군,50-54세,5591,3056,2535
202102,46790,전라남도,화순군,50-54세,5597,3055,2542
202103,46790,전라남도,화순군,50-54세,5538,3026,2512
202104,46790,전라남도,화순군,50-54세,5543,3031,2512
202105,46790,전라남도,화순군,50-54세,5565,3053,2512
202106,46790,전라남도,화순군,50-54세,5571,3051,2520
202007,46790,전라남도,화순군,55-59세,5723,3131,2592
202008,46790,전라남도,화순군,55-59세,5723,3130,2593
202009,46790,전라남도,화순군,55-59세,5705,3115,2590
202010,46790,전라남도,화순군,55-59세,5657,3088,2569
202011,46790,전라남도,화순군,55-59세,5651,3083,2568
202012,46790,전라남도,화순군,55-59세,5674,3091,2583
202101,46790,전라남도,화순군,55-59세,5659,3099,2560
202102,46790,전라남도,화순군,55-59세,5676,3112,2564
202103,46790,전라남도,화순군,55-59세,5687,3105,2582
202104,46790,전라남도,화순군,55-59세,5697,3108,2589
202105,46790,전라남도,화순군,55-59세,5683,3105,2578
202106,46790,전라남도,화순군,55-59세,5652,3075,2577
202007,46790,전라남도,화순군,60-64세,5215,2783,2432
202008,46790,전라남도,화순군,60-64세,5265,2802,2463
202009,46790,전라남도,화순군,60-64세,5338,2834,2504
202010,46790,전라남도,화순군,60-64세,5385,2869,2516
202011,46790,전라남도,화순군,60-64세,5433,2895,2538
202012,46790,전라남도,화순군,60-64세,5492,2930,2562
202101,46790,전라남도,화순군,60-64세,5528,2940,2588
202102,46790,전라남도,화순군,60-64세,5577,2960,2617
202103,46790,전라남도,화순군,60-64세,5625,3004,2621
202104,46790,전라남도,화순군,60-64세,5671,3032,2639
202105,46790,전라남도,화순군,60-64세,5714,3044,2670
202106,46790,전라남도,화순군,60-64세,5776,3090,2686
202007,46790,전라남도,화순군,65-69세,3907,1974,1933
202008,46790,전라남도,화순군,65-69세,3920,1988,1932
202009,46790,전라남도,화순군,65-69세,3915,1991,1924
202010,46790,전라남도,화순군,65-69세,3946,2008,1938
202011,46790,전라남도,화순군,65-69세,3947,2003,1944
202012,46790,전라남도,화순군,65-69세,3981,2029,1952
202101,46790,전라남도,화순군,65-69세,3997,2049,1948
202102,46790,전라남도,화순군,65-69세,4005,2072,1933
202103,46790,전라남도,화순군,65-69세,4025,2071,1954
202104,46790,전라남도,화순군,65-69세,4043,2092,1951
202105,46790,전라남도,화순군,65-69세,4056,2104,1952
202106,46790,전라남도,화순군,65-69세,4062,2105,1957
202007,46790,전라남도,화순군,70-74세,3617,1639,1978
202008,46790,전라남도,화순군,70-74세,3636,1666,1970
202009,46790,전라남도,화순군,70-74세,3648,1677,1971
202010,46790,전라남도,화순군,70-74세,3670,1691,1979
202011,46790,전라남도,화순군,70-74세,3702,1711,1991
202012,46790,전라남도,화순군,70-74세,3715,1716,1999
202101,46790,전라남도,화순군,70-74세,3736,1726,2010
202102,46790,전라남도,화순군,70-74세,3749,1723,2026
202103,46790,전라남도,화순군,70-74세,3750,1730,2020
202104,46790,전라남도,화순군,70-74세,3768,1735,2033
202105,46790,전라남도,화순군,70-74세,3799,1747,2052
202106,46790,전라남도,화순군,70-74세,3780,1746,2034
202007,46790,전라남도,화순군,75-79세,3871,1436,2435
202008,46790,전라남도,화순군,75-79세,3872,1439,2433
202009,46790,전라남도,화순군,75-79세,3849,1427,2422
202010,46790,전라남도,화순군,75-79세,3833,1420,2413
202011,46790,전라남도,화순군,75-79세,3798,1405,2393
202012,46790,전라남도,화순군,75-79세,3770,1395,2375
202101,46790,전라남도,화순군,75-79세,3727,1381,2346
202102,46790,전라남도,화순군,75-79세,3682,1377,2305
202103,46790,전라남도,화순군,75-79세,3648,1368,2280
202104,46790,전라남도,화순군,75-79세,3596,1362,2234
202105,46790,전라남도,화순군,75-79세,3559,1353,2206
202106,46790,전라남도,화순군,75-79세,3565,1354,2211
202007,46790,전라남도,화순군,80-84세,3064,1008,2056
202008,46790,전라남도,화순군,80-84세,3075,1011,2064
202009,46790,전라남도,화순군,80-84세,3096,1019,2077
202010,46790,전라남도,화순군,80-84세,3082,1009,2073
202011,46790,전라남도,화순군,80-84세,3096,1016,2080
202012,46790,전라남도,화순군,80-84세,3091,1005,2086
202101,46790,전라남도,화순군,80-84세,3126,1023,2103
202102,46790,전라남도,화순군,80-84세,3117,1017,2100
202103,46790,전라남도,화순군,80-84세,3136,1023,2113
202104,46790,전라남도,화순군,80-84세,3143,1017,2126
202105,46790,전라남도,화순군,80-84세,3163,1026,2137
202106,46790,전라남도,화순군,80-84세,3171,1025,2146
202007,46790,전라남도,화순군,85-89세,1497,399,1098
202008,46790,전라남도,화순군,85-89세,1512,406,1106
202009,46790,전라남도,화순군,85-89세,1516,404,1112
202010,46790,전라남도,화순군,85-89세,1533,414,1119
202011,46790,전라남도,화순군,85-89세,1539,411,1128
202012,46790,전라남도,화순군,85-89세,1554,421,1133
202101,46790,전라남도,화순군,85-89세,1562,425,1137
202102,46790,전라남도,화순군,85-89세,1616,435,1181
202103,46790,전라남도,화순군,85-89세,1633,443,1190
202104,46790,전라남도,화순군,85-89세,1659,447,1212
202105,46790,전라남도,화순군,85-89세,1688,451,1237
202106,46790,전라남도,화순군,85-89세,1709,454,1255
202007,46790,전라남도,화순군,90-94세,512,118,394
202008,46790,전라남도,화순군,90-94세,515,118,397
202009,46790,전라남도,화순군,90-94세,523,120,403
202010,46790,전라남도,화순군,90-94세,516,116,400
202011,46790,전라남도,화순군,90-94세,514,115,399
202012,46790,전라남도,화순군,90-94세,518,119,399
202101,46790,전라남도,화순군,90-94세,528,121,407
202102,46790,전라남도,화순군,90-94세,530,123,407
202103,46790,전라남도,화순군,90-94세,528,125,403
202104,46790,전라남도,화순군,90-94세,528,126,402
202105,46790,전라남도,화순군,90-94세,534,126,408
202106,46790,전라남도,화순군,90-94세,534,126,408
202007,46790,전라남도,화순군,95-99세,117,26,91
202008,46790,전라남도,화순군,95-99세,116,25,91
202009,46790,전라남도,화순군,95-99세,120,26,94
202010,46790,전라남도,화순군,95-99세,120,26,94
202011,46790,전라남도,화순군,95-99세,121,28,93
202012,46790,전라남도,화순군,95-99세,126,28,98
202101,46790,전라남도,화순군,95-99세,124,28,96
202102,46790,전라남도,화순군,95-99세,126,26,100
202103,46790,전라남도,화순군,95-99세,128,26,102
202104,46790,전라남도,화순군,95-99세,136,30,106
202105,46790,전라남도,화순군,95-99세,133,30,103
202106,46790,전라남도,화순군,95-99세,126,29,97
202007,46790,전라남도,화순군,100+,33,2,31
202008,46790,전라남도,화순군,100+,32,2,30
202009,46790,전라남도,화순군,100+,33,2,31
202010,46790,전라남도,화순군,100+,34,2,32
202011,46790,전라남도,화순군,100+,36,2,34
202012,46790,전라남도,화순군,100+,36,3,33
202101,46790,전라남도,화순군,100+,37,3,34
202102,46790,전라남도,화순군,100+,37,3,34
202103,46790,전라남도,화순군,100+,29,3,26
202104,46790,전라남도,화순군,100+,30,3,27
202105,46790,전라남도,화순군,100+,31,3,28
202106,46790,전라남도,화순군,100+,32,3,29
202007,46800,전라남도,장흥군,0-4세,878,461,417
202008,46800,전라남도,장흥군,0-4세,866,456,410
202009,46800,전라남도,장흥군,0-4세,871,459,412
202010,46800,전라남도,장흥군,0-4세,872,461,411
202011,46800,전라남도,장흥군,0-4세,867,460,407
202012,46800,전라남도,장흥군,0-4세,863,458,405
202101,46800,전라남도,장흥군,0-4세,853,448,405
202102,46800,전라남도,장흥군,0-4세,853,440,413
202103,46800,전라남도,장흥군,0-4세,843,432,411
202104,46800,전라남도,장흥군,0-4세,828,422,406
202105,46800,전라남도,장흥군,0-4세,814,413,401
202106,46800,전라남도,장흥군,0-4세,797,406,391
202007,46800,전라남도,장흥군,5-9세,1177,598,579
202008,46800,전라남도,장흥군,5-9세,1176,595,581
202009,46800,전라남도,장흥군,5-9세,1163,587,576
202010,46800,전라남도,장흥군,5-9세,1159,582,577
202011,46800,전라남도,장흥군,5-9세,1149,572,577
202012,46800,전라남도,장흥군,5-9세,1151,575,576
202101,46800,전라남도,장흥군,5-9세,1140,572,568
202102,46800,전라남도,장흥군,5-9세,1115,560,555
202103,46800,전라남도,장흥군,5-9세,1108,548,560
202104,46800,전라남도,장흥군,5-9세,1102,544,558
202105,46800,전라남도,장흥군,5-9세,1100,543,557
202106,46800,전라남도,장흥군,5-9세,1097,543,554
202007,46800,전라남도,장흥군,10-14세,1247,657,590
202008,46800,전라남도,장흥군,10-14세,1253,662,591
202009,46800,전라남도,장흥군,10-14세,1250,657,593
202010,46800,전라남도,장흥군,10-14세,1255,658,597
202011,46800,전라남도,장흥군,10-14세,1260,661,599
202012,46800,전라남도,장흥군,10-14세,1243,652,591
202101,46800,전라남도,장흥군,10-14세,1250,654,596
202102,46800,전라남도,장흥군,10-14세,1244,654,590
202103,46800,전라남도,장흥군,10-14세,1259,661,598
202104,46800,전라남도,장흥군,10-14세,1246,648,598
202105,46800,전라남도,장흥군,10-14세,1250,650,600
202106,46800,전라남도,장흥군,10-14세,1245,644,601
202007,46800,전라남도,장흥군,15-19세,1645,862,783
202008,46800,전라남도,장흥군,15-19세,1616,852,764
202009,46800,전라남도,장흥군,15-19세,1600,840,760
202010,46800,전라남도,장흥군,15-19세,1579,835,744
202011,46800,전라남도,장흥군,15-19세,1573,825,748
202012,46800,전라남도,장흥군,15-19세,1568,817,751
202101,46800,전라남도,장흥군,15-19세,1534,800,734
202102,46800,전라남도,장흥군,15-19세,1514,801,713
202103,46800,전라남도,장흥군,15-19세,1471,787,684
202104,46800,전라남도,장흥군,15-19세,1440,776,664
202105,46800,전라남도,장흥군,15-19세,1432,773,659
202106,46800,전라남도,장흥군,15-19세,1426,768,658
202007,46800,전라남도,장흥군,20-24세,1735,987,748
202008,46800,전라남도,장흥군,20-24세,1724,980,744
202009,46800,전라남도,장흥군,20-24세,1729,982,747
202010,46800,전라남도,장흥군,20-24세,1743,988,755
202011,46800,전라남도,장흥군,20-24세,1729,979,750
202012,46800,전라남도,장흥군,20-24세,1721,985,736
202101,46800,전라남도,장흥군,20-24세,1715,982,733
202102,46800,전라남도,장흥군,20-24세,1687,957,730
202103,46800,전라남도,장흥군,20-24세,1680,948,732
202104,46800,전라남도,장흥군,20-24세,1683,943,740
202105,46800,전라남도,장흥군,20-24세,1669,934,735
202106,46800,전라남도,장흥군,20-24세,1659,933,726
202007,46800,전라남도,장흥군,25-29세,1360,752,608
202008,46800,전라남도,장흥군,25-29세,1352,747,605
202009,46800,전라남도,장흥군,25-29세,1350,748,602
202010,46800,전라남도,장흥군,25-29세,1353,749,604
202011,46800,전라남도,장흥군,25-29세,1360,749,611
202012,46800,전라남도,장흥군,25-29세,1377,761,616
202101,46800,전라남도,장흥군,25-29세,1367,761,606
202102,46800,전라남도,장흥군,25-29세,1354,769,585
202103,46800,전라남도,장흥군,25-29세,1347,767,580
202104,46800,전라남도,장흥군,25-29세,1339,766,573
202105,46800,전라남도,장흥군,25-29세,1329,762,567
202106,46800,전라남도,장흥군,25-29세,1326,760,566
202007,46800,전라남도,장흥군,30-34세,1257,633,624
202008,46800,전라남도,장흥군,30-34세,1247,624,623
202009,46800,전라남도,장흥군,30-34세,1236,618,618
202010,46800,전라남도,장흥군,30-34세,1235,621,614
202011,46800,전라남도,장흥군,30-34세,1227,620,607
202012,46800,전라남도,장흥군,30-34세,1223,626,597
202101,46800,전라남도,장흥군,30-34세,1216,622,594
202102,46800,전라남도,장흥군,30-34세,1198,617,581
202103,46800,전라남도,장흥군,30-34세,1184,608,576
202104,46800,전라남도,장흥군,30-34세,1189,612,577
202105,46800,전라남도,장흥군,30-34세,1180,607,573
202106,46800,전라남도,장흥군,30-34세,1172,607,565
202007,46800,전라남도,장흥군,35-39세,1631,896,735
202008,46800,전라남도,장흥군,35-39세,1600,878,722
202009,46800,전라남도,장흥군,35-39세,1594,868,726
202010,46800,전라남도,장흥군,35-39세,1581,860,721
202011,46800,전라남도,장흥군,35-39세,1584,865,719
202012,46800,전라남도,장흥군,35-39세,1561,854,707
202101,46800,전라남도,장흥군,35-39세,1536,834,702
202102,46800,전라남도,장흥군,35-39세,1508,816,692
202103,46800,전라남도,장흥군,35-39세,1477,800,677
202104,46800,전라남도,장흥군,35-39세,1477,799,678
202105,46800,전라남도,장흥군,35-39세,1457,780,677
202106,46800,전라남도,장흥군,35-39세,1432,764,668
202007,46800,전라남도,장흥군,40-44세,1756,985,771
202008,46800,전라남도,장흥군,40-44세,1769,991,778
202009,46800,전라남도,장흥군,40-44세,1770,991,779
202010,46800,전라남도,장흥군,40-44세,1751,979,772
202011,46800,전라남도,장흥군,40-44세,1759,984,775
202012,46800,전라남도,장흥군,40-44세,1762,979,783
202101,46800,전라남도,장흥군,40-44세,1740,964,776
202102,46800,전라남도,장흥군,40-44세,1750,965,785
202103,46800,전라남도,장흥군,40-44세,1724,947,777
202104,46800,전라남도,장흥군,40-44세,1719,948,771
202105,46800,전라남도,장흥군,40-44세,1722,947,775
202106,46800,전라남도,장흥군,40-44세,1723,951,772
202007,46800,전라남도,장흥군,45-49세,2478,1360,1118
202008,46800,전라남도,장흥군,45-49세,2461,1356,1105
202009,46800,전라남도,장흥군,45-49세,2429,1337,1092
202010,46800,전라남도,장흥군,45-49세,2414,1315,1099
202011,46800,전라남도,장흥군,45-49세,2396,1314,1082
202012,46800,전라남도,장흥군,45-49세,2370,1296,1074
202101,46800,전라남도,장흥군,45-49세,2371,1306,1065
202102,46800,전라남도,장흥군,45-49세,2353,1298,1055
202103,46800,전라남도,장흥군,45-49세,2298,1278,1020
202104,46800,전라남도,장흥군,45-49세,2279,1255,1024
202105,46800,전라남도,장흥군,45-49세,2239,1237,1002
202106,46800,전라남도,장흥군,45-49세,2227,1224,1003
202007,46800,전라남도,장흥군,50-54세,2985,1677,1308
202008,46800,전라남도,장흥군,50-54세,2960,1660,1300
202009,46800,전라남도,장흥군,50-54세,2962,1664,1298
202010,46800,전라남도,장흥군,50-54세,2968,1672,1296
202011,46800,전라남도,장흥군,50-54세,2980,1673,1307
202012,46800,전라남도,장흥군,50-54세,2986,1679,1307
202101,46800,전라남도,장흥군,50-54세,2991,1672,1319
202102,46800,전라남도,장흥군,50-54세,2987,1670,1317
202103,46800,전라남도,장흥군,50-54세,2946,1644,1302
202104,46800,전라남도,장흥군,50-54세,2934,1640,1294
202105,46800,전라남도,장흥군,50-54세,2950,1641,1309
202106,46800,전라남도,장흥군,50-54세,2950,1658,1292
202007,46800,전라남도,장흥군,55-59세,3394,1772,1622
202008,46800,전라남도,장흥군,55-59세,3378,1766,1612
202009,46800,전라남도,장흥군,55-59세,3352,1753,1599
202010,46800,전라남도,장흥군,55-59세,3343,1751,1592
202011,46800,전라남도,장흥군,55-59세,3329,1744,1585
202012,46800,전라남도,장흥군,55-59세,3336,1753,1583
202101,46800,전라남도,장흥군,55-59세,3318,1749,1569
202102,46800,전라남도,장흥군,55-59세,3289,1747,1542
202103,46800,전라남도,장흥군,55-59세,3284,1751,1533
202104,46800,전라남도,장흥군,55-59세,3278,1757,1521
202105,46800,전라남도,장흥군,55-59세,3262,1755,1507
202106,46800,전라남도,장흥군,55-59세,3244,1739,1505
202007,46800,전라남도,장흥군,60-64세,3614,1818,1796
202008,46800,전라남도,장흥군,60-64세,3644,1829,1815
202009,46800,전라남도,장흥군,60-64세,3657,1835,1822
202010,46800,전라남도,장흥군,60-64세,3684,1861,1823
202011,46800,전라남도,장흥군,60-64세,3700,1874,1826
202012,46800,전라남도,장흥군,60-64세,3711,1879,1832
202101,46800,전라남도,장흥군,60-64세,3707,1873,1834
202102,46800,전라남도,장흥군,60-64세,3702,1864,1838
202103,46800,전라남도,장흥군,60-64세,3679,1856,1823
202104,46800,전라남도,장흥군,60-64세,3683,1861,1822
202105,46800,전라남도,장흥군,60-64세,3713,1876,1837
202106,46800,전라남도,장흥군,60-64세,3737,1890,1847
202007,46800,전라남도,장흥군,65-69세,2843,1413,1430
202008,46800,전라남도,장흥군,65-69세,2862,1424,1438
202009,46800,전라남도,장흥군,65-69세,2870,1427,1443
202010,46800,전라남도,장흥군,65-69세,2882,1423,1459
202011,46800,전라남도,장흥군,65-69세,2900,1428,1472
202012,46800,전라남도,장흥군,65-69세,2904,1429,1475
202101,46800,전라남도,장흥군,65-69세,2931,1446,1485
202102,46800,전라남도,장흥군,65-69세,2952,1462,1490
202103,46800,전라남도,장흥군,65-69세,2954,1459,1495
202104,46800,전라남도,장흥군,65-69세,2967,1460,1507
202105,46800,전라남도,장흥군,65-69세,2953,1451,1502
202106,46800,전라남도,장흥군,65-69세,2950,1449,1501
202007,46800,전라남도,장흥군,70-74세,2757,1207,1550
202008,46800,전라남도,장흥군,70-74세,2752,1210,1542
202009,46800,전라남도,장흥군,70-74세,2759,1216,1543
202010,46800,전라남도,장흥군,70-74세,2767,1225,1542
202011,46800,전라남도,장흥군,70-74세,2774,1229,1545
202012,46800,전라남도,장흥군,70-74세,2793,1244,1549
202101,46800,전라남도,장흥군,70-74세,2783,1245,1538
202102,46800,전라남도,장흥군,70-74세,2792,1252,1540
202103,46800,전라남도,장흥군,70-74세,2815,1273,1542
202104,46800,전라남도,장흥군,70-74세,2818,1279,1539
202105,46800,전라남도,장흥군,70-74세,2820,1286,1534
202106,46800,전라남도,장흥군,70-74세,2820,1288,1532
202007,46800,전라남도,장흥군,75-79세,2743,1090,1653
202008,46800,전라남도,장흥군,75-79세,2743,1091,1652
202009,46800,전라남도,장흥군,75-79세,2723,1084,1639
202010,46800,전라남도,장흥군,75-79세,2710,1085,1625
202011,46800,전라남도,장흥군,75-79세,2695,1076,1619
202012,46800,전라남도,장흥군,75-79세,2681,1067,1614
202101,46800,전라남도,장흥군,75-79세,2668,1053,1615
202102,46800,전라남도,장흥군,75-79세,2650,1051,1599
202103,46800,전라남도,장흥군,75-79세,2604,1031,1573
202104,46800,전라남도,장흥군,75-79세,2579,1024,1555
202105,46800,전라남도,장흥군,75-79세,2571,1015,1556
202106,46800,전라남도,장흥군,75-79세,2560,1008,1552
202007,46800,전라남도,장흥군,80-84세,2500,827,1673
202008,46800,전라남도,장흥군,80-84세,2491,821,1670
202009,46800,전라남도,장흥군,80-84세,2491,817,1674
202010,46800,전라남도,장흥군,80-84세,2478,810,1668
202011,46800,전라남도,장흥군,80-84세,2485,818,1667
202012,46800,전라남도,장흥군,80-84세,2475,822,1653
202101,46800,전라남도,장흥군,80-84세,2491,842,1649
202102,46800,전라남도,장흥군,80-84세,2476,829,1647
202103,46800,전라남도,장흥군,80-84세,2480,828,1652
202104,46800,전라남도,장흥군,80-84세,2482,834,1648
202105,46800,전라남도,장흥군,80-84세,2482,841,1641
202106,46800,전라남도,장흥군,80-84세,2489,853,1636
202007,46800,전라남도,장흥군,85-89세,1365,357,1008
202008,46800,전라남도,장흥군,85-89세,1381,362,1019
202009,46800,전라남도,장흥군,85-89세,1398,370,1028
202010,46800,전라남도,장흥군,85-89세,1407,374,1033
202011,46800,전라남도,장흥군,85-89세,1409,370,1039
202012,46800,전라남도,장흥군,85-89세,1427,376,1051
202101,46800,전라남도,장흥군,85-89세,1415,369,1046
202102,46800,전라남도,장흥군,85-89세,1434,384,1050
202103,46800,전라남도,장흥군,85-89세,1450,388,1062
202104,46800,전라남도,장흥군,85-89세,1463,391,1072
202105,46800,전라남도,장흥군,85-89세,1476,392,1084
202106,46800,전라남도,장흥군,85-89세,1491,395,1096
202007,46800,전라남도,장흥군,90-94세,491,93,398
202008,46800,전라남도,장흥군,90-94세,493,98,395
202009,46800,전라남도,장흥군,90-94세,492,95,397
202010,46800,전라남도,장흥군,90-94세,498,100,398
202011,46800,전라남도,장흥군,90-94세,502,103,399
202012,46800,전라남도,장흥군,90-94세,507,104,403
202101,46800,전라남도,장흥군,90-94세,521,106,415
202102,46800,전라남도,장흥군,90-94세,522,107,415
202103,46800,전라남도,장흥군,90-94세,518,105,413
202104,46800,전라남도,장흥군,90-94세,525,106,419
202105,46800,전라남도,장흥군,90-94세,531,106,425
202106,46800,전라남도,장흥군,90-94세,538,106,432
202007,46800,전라남도,장흥군,95-99세,118,22,96
202008,46800,전라남도,장흥군,95-99세,117,20,97
202009,46800,전라남도,장흥군,95-99세,119,20,99
202010,46800,전라남도,장흥군,95-99세,119,20,99
202011,46800,전라남도,장흥군,95-99세,115,19,96
202012,46800,전라남도,장흥군,95-99세,117,21,96
202101,46800,전라남도,장흥군,95-99세,118,21,97
202102,46800,전라남도,장흥군,95-99세,123,23,100
202103,46800,전라남도,장흥군,95-99세,123,20,103
202104,46800,전라남도,장흥군,95-99세,125,20,105
202105,46800,전라남도,장흥군,95-99세,121,20,101
202106,46800,전라남도,장흥군,95-99세,121,20,101
202007,46800,전라남도,장흥군,100+,24,4,20
202008,46800,전라남도,장흥군,100+,24,4,20
202009,46800,전라남도,장흥군,100+,24,4,20
202010,46800,전라남도,장흥군,100+,25,4,21
202011,46800,전라남도,장흥군,100+,26,4,22
202012,46800,전라남도,장흥군,100+,24,4,20
202101,46800,전라남도,장흥군,100+,24,4,20
202102,46800,전라남도,장흥군,100+,25,4,21
202103,46800,전라남도,장흥군,100+,22,3,19
202104,46800,전라남도,장흥군,100+,21,3,18
202105,46800,전라남도,장흥군,100+,24,3,21
202106,46800,전라남도,장흥군,100+,24,3,21
202007,46810,전라남도,강진군,0-4세,798,380,418
202008,46810,전라남도,강진군,0-4세,779,364,415
202009,46810,전라남도,강진군,0-4세,768,357,411
202010,46810,전라남도,강진군,0-4세,766,360,406
202011,46810,전라남도,강진군,0-4세,757,354,403
202012,46810,전라남도,강진군,0-4세,760,354,406
202101,46810,전라남도,강진군,0-4세,749,352,397
202102,46810,전라남도,강진군,0-4세,738,352,386
202103,46810,전라남도,강진군,0-4세,718,339,379
202104,46810,전라남도,강진군,0-4세,709,335,374
202105,46810,전라남도,강진군,0-4세,708,331,377
202106,46810,전라남도,강진군,0-4세,709,335,374
202007,46810,전라남도,강진군,5-9세,1056,544,512
202008,46810,전라남도,강진군,5-9세,1047,541,506
202009,46810,전라남도,강진군,5-9세,1041,544,497
202010,46810,전라남도,강진군,5-9세,1035,536,499
202011,46810,전라남도,강진군,5-9세,1028,532,496
202012,46810,전라남도,강진군,5-9세,1015,521,494
202101,46810,전라남도,강진군,5-9세,990,505,485
202102,46810,전라남도,강진군,5-9세,984,506,478
202103,46810,전라남도,강진군,5-9세,977,504,473
202104,46810,전라남도,강진군,5-9세,978,507,471
202105,46810,전라남도,강진군,5-9세,974,502,472
202106,46810,전라남도,강진군,5-9세,962,498,464
202007,46810,전라남도,강진군,10-14세,1175,597,578
202008,46810,전라남도,강진군,10-14세,1186,599,587
202009,46810,전라남도,강진군,10-14세,1195,601,594
202010,46810,전라남도,강진군,10-14세,1202,610,592
202011,46810,전라남도,강진군,10-14세,1193,602,591
202012,46810,전라남도,강진군,10-14세,1192,608,584
202101,46810,전라남도,강진군,10-14세,1202,612,590
202102,46810,전라남도,강진군,10-14세,1211,612,599
202103,46810,전라남도,강진군,10-14세,1211,618,593
202104,46810,전라남도,강진군,10-14세,1205,617,588
202105,46810,전라남도,강진군,10-14세,1207,624,583
202106,46810,전라남도,강진군,10-14세,1208,622,586
202007,46810,전라남도,강진군,15-19세,1397,732,665
202008,46810,전라남도,강진군,15-19세,1362,719,643
202009,46810,전라남도,강진군,15-19세,1344,703,641
202010,46810,전라남도,강진군,15-19세,1339,698,641
202011,46810,전라남도,강진군,15-19세,1330,696,634
202012,46810,전라남도,강진군,15-19세,1328,692,636
202101,46810,전라남도,강진군,15-19세,1310,686,624
202102,46810,전라남도,강진군,15-19세,1292,677,615
202103,46810,전라남도,강진군,15-19세,1278,662,616
202104,46810,전라남도,강진군,15-19세,1266,651,615
202105,46810,전라남도,강진군,15-19세,1250,644,606
202106,46810,전라남도,강진군,15-19세,1244,642,602
202007,46810,전라남도,강진군,20-24세,1590,894,696
202008,46810,전라남도,강진군,20-24세,1616,905,711
202009,46810,전라남도,강진군,20-24세,1609,902,707
202010,46810,전라남도,강진군,20-24세,1596,894,702
202011,46810,전라남도,강진군,20-24세,1592,891,701
202012,46810,전라남도,강진군,20-24세,1579,883,696
202101,46810,전라남도,강진군,20-24세,1573,870,703
202102,46810,전라남도,강진군,20-24세,1566,869,697
202103,46810,전라남도,강진군,20-24세,1567,861,706
202104,46810,전라남도,강진군,20-24세,1571,875,696
202105,46810,전라남도,강진군,20-24세,1566,882,684
202106,46810,전라남도,강진군,20-24세,1559,882,677
202007,46810,전라남도,강진군,25-29세,1292,713,579
202008,46810,전라남도,강진군,25-29세,1291,712,579
202009,46810,전라남도,강진군,25-29세,1286,717,569
202010,46810,전라남도,강진군,25-29세,1299,737,562
202011,46810,전라남도,강진군,25-29세,1291,728,563
202012,46810,전라남도,강진군,25-29세,1286,728,558
202101,46810,전라남도,강진군,25-29세,1310,745,565
202102,46810,전라남도,강진군,25-29세,1283,736,547
202103,46810,전라남도,강진군,25-29세,1273,734,539
202104,46810,전라남도,강진군,25-29세,1271,728,543
202105,46810,전라남도,강진군,25-29세,1252,712,540
202106,46810,전라남도,강진군,25-29세,1250,710,540
202007,46810,전라남도,강진군,30-34세,1128,568,560
202008,46810,전라남도,강진군,30-34세,1114,557,557
202009,46810,전라남도,강진군,30-34세,1107,556,551
202010,46810,전라남도,강진군,30-34세,1089,545,544
202011,46810,전라남도,강진군,30-34세,1089,554,535
202012,46810,전라남도,강진군,30-34세,1073,548,525
202101,46810,전라남도,강진군,30-34세,1066,544,522
202102,46810,전라남도,강진군,30-34세,1042,525,517
202103,46810,전라남도,강진군,30-34세,1031,518,513
202104,46810,전라남도,강진군,30-34세,1027,517,510
202105,46810,전라남도,강진군,30-34세,1027,520,507
202106,46810,전라남도,강진군,30-34세,1016,516,500
202007,46810,전라남도,강진군,35-39세,1423,733,690
202008,46810,전라남도,강진군,35-39세,1419,732,687
202009,46810,전라남도,강진군,35-39세,1403,728,675
202010,46810,전라남도,강진군,35-39세,1401,728,673
202011,46810,전라남도,강진군,35-39세,1387,721,666
202012,46810,전라남도,강진군,35-39세,1388,721,667
202101,46810,전라남도,강진군,35-39세,1365,708,657
202102,46810,전라남도,강진군,35-39세,1346,698,648
202103,46810,전라남도,강진군,35-39세,1327,697,630
202104,46810,전라남도,강진군,35-39세,1324,696,628
202105,46810,전라남도,강진군,35-39세,1316,681,635
202106,46810,전라남도,강진군,35-39세,1313,677,636
202007,46810,전라남도,강진군,40-44세,1607,883,724
202008,46810,전라남도,강진군,40-44세,1607,875,732
202009,46810,전라남도,강진군,40-44세,1610,879,731
202010,46810,전라남도,강진군,40-44세,1603,870,733
202011,46810,전라남도,강진군,40-44세,1604,870,734
202012,46810,전라남도,강진군,40-44세,1599,873,726
202101,46810,전라남도,강진군,40-44세,1597,872,725
202102,46810,전라남도,강진군,40-44세,1621,881,740
202103,46810,전라남도,강진군,40-44세,1587,860,727
202104,46810,전라남도,강진군,40-44세,1585,854,731
202105,46810,전라남도,강진군,40-44세,1587,858,729
202106,46810,전라남도,강진군,40-44세,1580,849,731
202007,46810,전라남도,강진군,45-49세,2225,1256,969
202008,46810,전라남도,강진군,45-49세,2209,1254,955
202009,46810,전라남도,강진군,45-49세,2199,1245,954
202010,46810,전라남도,강진군,45-49세,2193,1245,948
202011,46810,전라남도,강진군,45-49세,2188,1241,947
202012,46810,전라남도,강진군,45-49세,2174,1218,956
202101,46810,전라남도,강진군,45-49세,2158,1212,946
202102,46810,전라남도,강진군,45-49세,2144,1207,937
202103,46810,전라남도,강진군,45-49세,2120,1206,914
202104,46810,전라남도,강진군,45-49세,2114,1199,915
202105,46810,전라남도,강진군,45-49세,2087,1174,913
202106,46810,전라남도,강진군,45-49세,2069,1166,903
202007,46810,전라남도,강진군,50-54세,2615,1468,1147
202008,46810,전라남도,강진군,50-54세,2611,1463,1148
202009,46810,전라남도,강진군,50-54세,2586,1448,1138
202010,46810,전라남도,강진군,50-54세,2579,1449,1130
202011,46810,전라남도,강진군,50-54세,2562,1437,1125
202012,46810,전라남도,강진군,50-54세,2546,1425,1121
202101,46810,전라남도,강진군,50-54세,2547,1420,1127
202102,46810,전라남도,강진군,50-54세,2552,1419,1133
202103,46810,전라남도,강진군,50-54세,2506,1399,1107
202104,46810,전라남도,강진군,50-54세,2489,1392,1097
202105,46810,전라남도,강진군,50-54세,2501,1402,1099
202106,46810,전라남도,강진군,50-54세,2508,1406,1102
202007,46810,전라남도,강진군,55-59세,3135,1626,1509
202008,46810,전라남도,강진군,55-59세,3121,1618,1503
202009,46810,전라남도,강진군,55-59세,3117,1618,1499
202010,46810,전라남도,강진군,55-59세,3115,1616,1499
202011,46810,전라남도,강진군,55-59세,3111,1622,1489
202012,46810,전라남도,강진군,55-59세,3103,1624,1479
202101,46810,전라남도,강진군,55-59세,3087,1615,1472
202102,46810,전라남도,강진군,55-59세,3064,1604,1460
202103,46810,전라남도,강진군,55-59세,3097,1620,1477
202104,46810,전라남도,강진군,55-59세,3104,1623,1481
202105,46810,전라남도,강진군,55-59세,3105,1628,1477
202106,46810,전라남도,강진군,55-59세,3083,1623,1460
202007,46810,전라남도,강진군,60-64세,3422,1734,1688
202008,46810,전라남도,강진군,60-64세,3437,1739,1698
202009,46810,전라남도,강진군,60-64세,3458,1752,1706
202010,46810,전라남도,강진군,60-64세,3477,1774,1703
202011,46810,전라남도,강진군,60-64세,3499,1778,1721
202012,46810,전라남도,강진군,60-64세,3519,1785,1734
202101,46810,전라남도,강진군,60-64세,3563,1813,1750
202102,46810,전라남도,강진군,60-64세,3580,1830,1750
202103,46810,전라남도,강진군,60-64세,3582,1838,1744
202104,46810,전라남도,강진군,60-64세,3614,1850,1764
202105,46810,전라남도,강진군,60-64세,3617,1849,1768
202106,46810,전라남도,강진군,60-64세,3642,1858,1784
202007,46810,전라남도,강진군,65-69세,2662,1288,1374
202008,46810,전라남도,강진군,65-69세,2673,1295,1378
202009,46810,전라남도,강진군,65-69세,2678,1300,1378
202010,46810,전라남도,강진군,65-69세,2679,1296,1383
202011,46810,전라남도,강진군,65-69세,2679,1297,1382
202012,46810,전라남도,강진군,65-69세,2679,1303,1376
202101,46810,전라남도,강진군,65-69세,2675,1298,1377
202102,46810,전라남도,강진군,65-69세,2682,1297,1385
202103,46810,전라남도,강진군,65-69세,2697,1302,1395
202104,46810,전라남도,강진군,65-69세,2707,1316,1391
202105,46810,전라남도,강진군,65-69세,2721,1331,1390
202106,46810,전라남도,강진군,65-69세,2734,1343,1391
202007,46810,전라남도,강진군,70-74세,2682,1207,1475
202008,46810,전라남도,강진군,70-74세,2665,1205,1460
202009,46810,전라남도,강진군,70-74세,2673,1206,1467
202010,46810,전라남도,강진군,70-74세,2678,1211,1467
202011,46810,전라남도,강진군,70-74세,2690,1219,1471
202012,46810,전라남도,강진군,70-74세,2699,1225,1474
202101,46810,전라남도,강진군,70-74세,2722,1238,1484
202102,46810,전라남도,강진군,70-74세,2711,1236,1475
202103,46810,전라남도,강진군,70-74세,2698,1241,1457
202104,46810,전라남도,강진군,70-74세,2695,1241,1454
202105,46810,전라남도,강진군,70-74세,2688,1244,1444
202106,46810,전라남도,강진군,70-74세,2688,1246,1442
202007,46810,전라남도,강진군,75-79세,2599,1041,1558
202008,46810,전라남도,강진군,75-79세,2596,1042,1554
202009,46810,전라남도,강진군,75-79세,2577,1036,1541
202010,46810,전라남도,강진군,75-79세,2559,1024,1535
202011,46810,전라남도,강진군,75-79세,2555,1028,1527
202012,46810,전라남도,강진군,75-79세,2534,1020,1514
202101,46810,전라남도,강진군,75-79세,2500,1004,1496
202102,46810,전라남도,강진군,75-79세,2504,1008,1496
202103,46810,전라남도,강진군,75-79세,2480,994,1486
202104,46810,전라남도,강진군,75-79세,2456,979,1477
202105,46810,전라남도,강진군,75-79세,2451,973,1478
202106,46810,전라남도,강진군,75-79세,2445,974,1471
202007,46810,전라남도,강진군,80-84세,2340,775,1565
202008,46810,전라남도,강진군,80-84세,2353,781,1572
202009,46810,전라남도,강진군,80-84세,2357,780,1577
202010,46810,전라남도,강진군,80-84세,2370,790,1580
202011,46810,전라남도,강진군,80-84세,2373,790,1583
202012,46810,전라남도,강진군,80-84세,2367,787,1580
202101,46810,전라남도,강진군,80-84세,2371,789,1582
202102,46810,전라남도,강진군,80-84세,2373,801,1572
202103,46810,전라남도,강진군,80-84세,2380,803,1577
202104,46810,전라남도,강진군,80-84세,2380,808,1572
202105,46810,전라남도,강진군,80-84세,2398,815,1583
202106,46810,전라남도,강진군,80-84세,2399,810,1589
202007,46810,전라남도,강진군,85-89세,1193,294,899
202008,46810,전라남도,강진군,85-89세,1198,295,903
202009,46810,전라남도,강진군,85-89세,1198,298,900
202010,46810,전라남도,강진군,85-89세,1204,298,906
202011,46810,전라남도,강진군,85-89세,1199,293,906
202012,46810,전라남도,강진군,85-89세,1199,297,902
202101,46810,전라남도,강진군,85-89세,1211,303,908
202102,46810,전라남도,강진군,85-89세,1217,300,917
202103,46810,전라남도,강진군,85-89세,1206,302,904
202104,46810,전라남도,강진군,85-89세,1222,307,915
202105,46810,전라남도,강진군,85-89세,1212,306,906
202106,46810,전라남도,강진군,85-89세,1231,317,914
202007,46810,전라남도,강진군,90-94세,416,73,343
202008,46810,전라남도,강진군,90-94세,420,76,344
202009,46810,전라남도,강진군,90-94세,433,79,354
202010,46810,전라남도,강진군,90-94세,432,79,353
202011,46810,전라남도,강진군,90-94세,437,79,358
202012,46810,전라남도,강진군,90-94세,453,80,373
202101,46810,전라남도,강진군,90-94세,465,85,380
202102,46810,전라남도,강진군,90-94세,473,87,386
202103,46810,전라남도,강진군,90-94세,491,88,403
202104,46810,전라남도,강진군,90-94세,493,87,406
202105,46810,전라남도,강진군,90-94세,505,87,418
202106,46810,전라남도,강진군,90-94세,502,87,415
202007,46810,전라남도,강진군,95-99세,73,18,55
202008,46810,전라남도,강진군,95-99세,76,18,58
202009,46810,전라남도,강진군,95-99세,81,20,61
202010,46810,전라남도,강진군,95-99세,79,19,60
202011,46810,전라남도,강진군,95-99세,77,20,57
202012,46810,전라남도,강진군,95-99세,75,19,56
202101,46810,전라남도,강진군,95-99세,76,18,58
202102,46810,전라남도,강진군,95-99세,72,17,55
202103,46810,전라남도,강진군,95-99세,73,14,59
202104,46810,전라남도,강진군,95-99세,76,15,61
202105,46810,전라남도,강진군,95-99세,74,13,61
202106,46810,전라남도,강진군,95-99세,78,14,64
202007,46810,전라남도,강진군,100+,30,4,26
202008,46810,전라남도,강진군,100+,29,4,25
202009,46810,전라남도,강진군,100+,29,4,25
202010,46810,전라남도,강진군,100+,29,4,25
202011,46810,전라남도,강진군,100+,29,4,25
202012,46810,전라남도,강진군,100+,29,4,25
202101,46810,전라남도,강진군,100+,31,4,27
202102,46810,전라남도,강진군,100+,32,5,27
202103,46810,전라남도,강진군,100+,28,5,23
202104,46810,전라남도,강진군,100+,28,5,23
202105,46810,전라남도,강진군,100+,29,6,23
202106,46810,전라남도,강진군,100+,28,6,22
202007,46820,전라남도,해남군,0-4세,2056,1084,972
202008,46820,전라남도,해남군,0-4세,2041,1077,964
202009,46820,전라남도,해남군,0-4세,2011,1063,948
202010,46820,전라남도,해남군,0-4세,1990,1051,939
202011,46820,전라남도,해남군,0-4세,1953,1029,924
202012,46820,전라남도,해남군,0-4세,1924,1016,908
202101,46820,전라남도,해남군,0-4세,1903,1010,893
202102,46820,전라남도,해남군,0-4세,1865,979,886
202103,46820,전라남도,해남군,0-4세,1830,962,868
202104,46820,전라남도,해남군,0-4세,1811,960,851
202105,46820,전라남도,해남군,0-4세,1798,949,849
202106,46820,전라남도,해남군,0-4세,1775,937,838
202007,46820,전라남도,해남군,5-9세,2146,1037,1109
202008,46820,전라남도,해남군,5-9세,2133,1023,1110
202009,46820,전라남도,해남군,5-9세,2135,1028,1107
202010,46820,전라남도,해남군,5-9세,2128,1025,1103
202011,46820,전라남도,해남군,5-9세,2105,1014,1091
202012,46820,전라남도,해남군,5-9세,2080,996,1084
202101,46820,전라남도,해남군,5-9세,2059,981,1078
202102,46820,전라남도,해남군,5-9세,2044,983,1061
202103,46820,전라남도,해남군,5-9세,2046,988,1058
202104,46820,전라남도,해남군,5-9세,2034,982,1052
202105,46820,전라남도,해남군,5-9세,2034,988,1046
202106,46820,전라남도,해남군,5-9세,2013,977,1036
202007,46820,전라남도,해남군,10-14세,2442,1272,1170
202008,46820,전라남도,해남군,10-14세,2435,1271,1164
202009,46820,전라남도,해남군,10-14세,2445,1269,1176
202010,46820,전라남도,해남군,10-14세,2460,1276,1184
202011,46820,전라남도,해남군,10-14세,2465,1281,1184
202012,46820,전라남도,해남군,10-14세,2462,1278,1184
202101,46820,전라남도,해남군,10-14세,2455,1271,1184
202102,46820,전라남도,해남군,10-14세,2443,1262,1181
202103,46820,전라남도,해남군,10-14세,2430,1253,1177
202104,46820,전라남도,해남군,10-14세,2424,1249,1175
202105,46820,전라남도,해남군,10-14세,2409,1239,1170
202106,46820,전라남도,해남군,10-14세,2407,1240,1167
202007,46820,전라남도,해남군,15-19세,2932,1517,1415
202008,46820,전라남도,해남군,15-19세,2913,1509,1404
202009,46820,전라남도,해남군,15-19세,2881,1496,1385
202010,46820,전라남도,해남군,15-19세,2859,1479,1380
202011,46820,전라남도,해남군,15-19세,2835,1464,1371
202012,46820,전라남도,해남군,15-19세,2811,1454,1357
202101,46820,전라남도,해남군,15-19세,2808,1447,1361
202102,46820,전라남도,해남군,15-19세,2778,1428,1350
202103,46820,전라남도,해남군,15-19세,2744,1410,1334
202104,46820,전라남도,해남군,15-19세,2719,1402,1317
202105,46820,전라남도,해남군,15-19세,2704,1404,1300
202106,46820,전라남도,해남군,15-19세,2677,1399,1278
202007,46820,전라남도,해남군,20-24세,3193,1797,1396
202008,46820,전라남도,해남군,20-24세,3176,1788,1388
202009,46820,전라남도,해남군,20-24세,3163,1784,1379
202010,46820,전라남도,해남군,20-24세,3140,1774,1366
202011,46820,전라남도,해남군,20-24세,3129,1777,1352
202012,46820,전라남도,해남군,20-24세,3121,1780,1341
202101,46820,전라남도,해남군,20-24세,3111,1778,1333
202102,46820,전라남도,해남군,20-24세,3124,1798,1326
202103,46820,전라남도,해남군,20-24세,3110,1786,1324
202104,46820,전라남도,해남군,20-24세,3096,1773,1323
202105,46820,전라남도,해남군,20-24세,3101,1772,1329
202106,46820,전라남도,해남군,20-24세,3109,1769,1340
202007,46820,전라남도,해남군,25-29세,2398,1349,1049
202008,46820,전라남도,해남군,25-29세,2403,1350,1053
202009,46820,전라남도,해남군,25-29세,2395,1342,1053
202010,46820,전라남도,해남군,25-29세,2416,1353,1063
202011,46820,전라남도,해남군,25-29세,2418,1334,1084
202012,46820,전라남도,해남군,25-29세,2425,1342,1083
202101,46820,전라남도,해남군,25-29세,2425,1338,1087
202102,46820,전라남도,해남군,25-29세,2387,1316,1071
202103,46820,전라남도,해남군,25-29세,2400,1320,1080
202104,46820,전라남도,해남군,25-29세,2403,1325,1078
202105,46820,전라남도,해남군,25-29세,2407,1329,1078
202106,46820,전라남도,해남군,25-29세,2422,1348,1074
202007,46820,전라남도,해남군,30-34세,2298,1194,1104
202008,46820,전라남도,해남군,30-34세,2282,1185,1097
202009,46820,전라남도,해남군,30-34세,2273,1184,1089
202010,46820,전라남도,해남군,30-34세,2266,1186,1080
202011,46820,전라남도,해남군,30-34세,2246,1183,1063
202012,46820,전라남도,해남군,30-34세,2212,1168,1044
202101,46820,전라남도,해남군,30-34세,2173,1147,1026
202102,46820,전라남도,해남군,30-34세,2160,1157,1003
202103,46820,전라남도,해남군,30-34세,2143,1144,999
202104,46820,전라남도,해남군,30-34세,2139,1146,993
202105,46820,전라남도,해남군,30-34세,2124,1140,984
202106,46820,전라남도,해남군,30-34세,2107,1132,975
202007,46820,전라남도,해남군,35-39세,2990,1548,1442
202008,46820,전라남도,해남군,35-39세,2962,1532,1430
202009,46820,전라남도,해남군,35-39세,2948,1532,1416
202010,46820,전라남도,해남군,35-39세,2943,1530,1413
202011,46820,전라남도,해남군,35-39세,2890,1502,1388
202012,46820,전라남도,해남군,35-39세,2864,1492,1372
202101,46820,전라남도,해남군,35-39세,2834,1476,1358
202102,46820,전라남도,해남군,35-39세,2807,1457,1350
202103,46820,전라남도,해남군,35-39세,2773,1447,1326
202104,46820,전라남도,해남군,35-39세,2764,1451,1313
202105,46820,전라남도,해남군,35-39세,2724,1434,1290
202106,46820,전라남도,해남군,35-39세,2697,1428,1269
202007,46820,전라남도,해남군,40-44세,3595,1984,1611
202008,46820,전라남도,해남군,40-44세,3578,1966,1612
202009,46820,전라남도,해남군,40-44세,3565,1958,1607
202010,46820,전라남도,해남군,40-44세,3560,1960,1600
202011,46820,전라남도,해남군,40-44세,3550,1949,1601
202012,46820,전라남도,해남군,40-44세,3522,1932,1590
202101,46820,전라남도,해남군,40-44세,3503,1908,1595
202102,46820,전라남도,해남군,40-44세,3489,1899,1590
202103,46820,전라남도,해남군,40-44세,3469,1889,1580
202104,46820,전라남도,해남군,40-44세,3443,1869,1574
202105,46820,전라남도,해남군,40-44세,3432,1854,1578
202106,46820,전라남도,해남군,40-44세,3443,1863,1580
202007,46820,전라남도,해남군,45-49세,4597,2660,1937
202008,46820,전라남도,해남군,45-49세,4588,2654,1934
202009,46820,전라남도,해남군,45-49세,4557,2631,1926
202010,46820,전라남도,해남군,45-49세,4546,2617,1929
202011,46820,전라남도,해남군,45-49세,4550,2621,1929
202012,46820,전라남도,해남군,45-49세,4535,2600,1935
202101,46820,전라남도,해남군,45-49세,4552,2615,1937
202102,46820,전라남도,해남군,45-49세,4537,2605,1932
202103,46820,전라남도,해남군,45-49세,4505,2586,1919
202104,46820,전라남도,해남군,45-49세,4507,2582,1925
202105,46820,전라남도,해남군,45-49세,4449,2552,1897
202106,46820,전라남도,해남군,45-49세,4404,2523,1881
202007,46820,전라남도,해남군,50-54세,5495,3069,2426
202008,46820,전라남도,해남군,50-54세,5479,3065,2414
202009,46820,전라남도,해남군,50-54세,5498,3074,2424
202010,46820,전라남도,해남군,50-54세,5476,3073,2403
202011,46820,전라남도,해남군,50-54세,5454,3075,2379
202012,46820,전라남도,해남군,50-54세,5428,3073,2355
202101,46820,전라남도,해남군,50-54세,5423,3056,2367
202102,46820,전라남도,해남군,50-54세,5413,3056,2357
202103,46820,전라남도,해남군,50-54세,5334,3012,2322
202104,46820,전라남도,해남군,50-54세,5324,3011,2313
202105,46820,전라남도,해남군,50-54세,5372,3037,2335
202106,46820,전라남도,해남군,50-54세,5390,3049,2341
202007,46820,전라남도,해남군,55-59세,6283,3395,2888
202008,46820,전라남도,해남군,55-59세,6256,3384,2872
202009,46820,전라남도,해남군,55-59세,6196,3354,2842
202010,46820,전라남도,해남군,55-59세,6184,3339,2845
202011,46820,전라남도,해남군,55-59세,6151,3322,2829
202012,46820,전라남도,해남군,55-59세,6154,3336,2818
202101,46820,전라남도,해남군,55-59세,6146,3337,2809
202102,46820,전라남도,해남군,55-59세,6130,3332,2798
202103,46820,전라남도,해남군,55-59세,6120,3339,2781
202104,46820,전라남도,해남군,55-59세,6116,3329,2787
202105,46820,전라남도,해남군,55-59세,6073,3313,2760
202106,46820,전라남도,해남군,55-59세,6033,3282,2751
202007,46820,전라남도,해남군,60-64세,6817,3485,3332
202008,46820,전라남도,해남군,60-64세,6848,3511,3337
202009,46820,전라남도,해남군,60-64세,6867,3519,3348
202010,46820,전라남도,해남군,60-64세,6907,3560,3347
202011,46820,전라남도,해남군,60-64세,6958,3581,3377
202012,46820,전라남도,해남군,60-64세,6975,3575,3400
202101,46820,전라남도,해남군,60-64세,7006,3602,3404
202102,46820,전라남도,해남군,60-64세,7034,3623,3411
202103,46820,전라남도,해남군,60-64세,7019,3629,3390
202104,46820,전라남도,해남군,60-64세,7051,3645,3406
202105,46820,전라남도,해남군,60-64세,7095,3653,3442
202106,46820,전라남도,해남군,60-64세,7111,3674,3437
202007,46820,전라남도,해남군,65-69세,5295,2516,2779
202008,46820,전라남도,해남군,65-69세,5309,2524,2785
202009,46820,전라남도,해남군,65-69세,5344,2552,2792
202010,46820,전라남도,해남군,65-69세,5356,2554,2802
202011,46820,전라남도,해남군,65-69세,5365,2557,2808
202012,46820,전라남도,해남군,65-69세,5381,2566,2815
202101,46820,전라남도,해남군,65-69세,5442,2596,2846
202102,46820,전라남도,해남군,65-69세,5435,2588,2847
202103,46820,전라남도,해남군,65-69세,5466,2615,2851
202104,46820,전라남도,해남군,65-69세,5483,2636,2847
202105,46820,전라남도,해남군,65-69세,5489,2654,2835
202106,46820,전라남도,해남군,65-69세,5516,2665,2851
202007,46820,전라남도,해남군,70-74세,5110,2418,2692
202008,46820,전라남도,해남군,70-74세,5098,2410,2688
202009,46820,전라남도,해남군,70-74세,5092,2406,2686
202010,46820,전라남도,해남군,70-74세,5100,2401,2699
202011,46820,전라남도,해남군,70-74세,5109,2409,2700
202012,46820,전라남도,해남군,70-74세,5131,2422,2709
202101,46820,전라남도,해남군,70-74세,5117,2412,2705
202102,46820,전라남도,해남군,70-74세,5143,2432,2711
202103,46820,전라남도,해남군,70-74세,5126,2431,2695
202104,46820,전라남도,해남군,70-74세,5144,2430,2714
202105,46820,전라남도,해남군,70-74세,5152,2429,2723
202106,46820,전라남도,해남군,70-74세,5152,2423,2729
202007,46820,전라남도,해남군,75-79세,4981,1940,3041
202008,46820,전라남도,해남군,75-79세,4972,1945,3027
202009,46820,전라남도,해남군,75-79세,4970,1949,3021
202010,46820,전라남도,해남군,75-79세,4966,1956,3010
202011,46820,전라남도,해남군,75-79세,4960,1951,3009
202012,46820,전라남도,해남군,75-79세,4926,1932,2994
202101,46820,전라남도,해남군,75-79세,4884,1929,2955
202102,46820,전라남도,해남군,75-79세,4850,1922,2928
202103,46820,전라남도,해남군,75-79세,4817,1903,2914
202104,46820,전라남도,해남군,75-79세,4753,1889,2864
202105,46820,전라남도,해남군,75-79세,4728,1890,2838
202106,46820,전라남도,해남군,75-79세,4730,1907,2823
202007,46820,전라남도,해남군,80-84세,4004,1353,2651
202008,46820,전라남도,해남군,80-84세,4028,1360,2668
202009,46820,전라남도,해남군,80-84세,4028,1361,2667
202010,46820,전라남도,해남군,80-84세,4033,1368,2665
202011,46820,전라남도,해남군,80-84세,4027,1366,2661
202012,46820,전라남도,해남군,80-84세,4039,1382,2657
202101,46820,전라남도,해남군,80-84세,4053,1384,2669
202102,46820,전라남도,해남군,80-84세,4055,1388,2667
202103,46820,전라남도,해남군,80-84세,4049,1391,2658
202104,46820,전라남도,해남군,80-84세,4060,1398,2662
202105,46820,전라남도,해남군,80-84세,4075,1399,2676
202106,46820,전라남도,해남군,80-84세,4077,1398,2679
202007,46820,전라남도,해남군,85-89세,1936,472,1464
202008,46820,전라남도,해남군,85-89세,1934,473,1461
202009,46820,전라남도,해남군,85-89세,1927,476,1451
202010,46820,전라남도,해남군,85-89세,1932,470,1462
202011,46820,전라남도,해남군,85-89세,1931,470,1461
202012,46820,전라남도,해남군,85-89세,1948,476,1472
202101,46820,전라남도,해남군,85-89세,1961,480,1481
202102,46820,전라남도,해남군,85-89세,2000,489,1511
202103,46820,전라남도,해남군,85-89세,2029,497,1532
202104,46820,전라남도,해남군,85-89세,2058,503,1555
202105,46820,전라남도,해남군,85-89세,2072,508,1564
202106,46820,전라남도,해남군,85-89세,2069,510,1559
202007,46820,전라남도,해남군,90-94세,637,131,506
202008,46820,전라남도,해남군,90-94세,645,134,511
202009,46820,전라남도,해남군,90-94세,663,136,527
202010,46820,전라남도,해남군,90-94세,662,131,531
202011,46820,전라남도,해남군,90-94세,676,131,545
202012,46820,전라남도,해남군,90-94세,673,130,543
202101,46820,전라남도,해남군,90-94세,683,130,553
202102,46820,전라남도,해남군,90-94세,697,134,563
202103,46820,전라남도,해남군,90-94세,688,127,561
202104,46820,전라남도,해남군,90-94세,700,128,572
202105,46820,전라남도,해남군,90-94세,714,134,580
202106,46820,전라남도,해남군,90-94세,720,132,588
202007,46820,전라남도,해남군,95-99세,149,21,128
202008,46820,전라남도,해남군,95-99세,149,20,129
202009,46820,전라남도,해남군,95-99세,149,22,127
202010,46820,전라남도,해남군,95-99세,148,23,125
202011,46820,전라남도,해남군,95-99세,148,23,125
202012,46820,전라남도,해남군,95-99세,150,24,126
202101,46820,전라남도,해남군,95-99세,153,26,127
202102,46820,전라남도,해남군,95-99세,152,27,125
202103,46820,전라남도,해남군,95-99세,153,26,127
202104,46820,전라남도,해남군,95-99세,159,27,132
202105,46820,전라남도,해남군,95-99세,160,27,133
202106,46820,전라남도,해남군,95-99세,162,27,135
202007,46820,전라남도,해남군,100+,45,1,44
202008,46820,전라남도,해남군,100+,45,1,44
202009,46820,전라남도,해남군,100+,46,1,45
202010,46820,전라남도,해남군,100+,46,1,45
202011,46820,전라남도,해남군,100+,46,1,45
202012,46820,전라남도,해남군,100+,45,1,44
202101,46820,전라남도,해남군,100+,45,1,44
202102,46820,전라남도,해남군,100+,46,1,45
202103,46820,전라남도,해남군,100+,40,0,40
202104,46820,전라남도,해남군,100+,41,0,41
202105,46820,전라남도,해남군,100+,41,0,41
202106,46820,전라남도,해남군,100+,41,0,41
202007,46830,전라남도,영암군,0-4세,1713,856,857
202008,46830,전라남도,영암군,0-4세,1675,831,844
202009,46830,전라남도,영암군,0-4세,1657,820,837
202010,46830,전라남도,영암군,0-4세,1635,806,829
202011,46830,전라남도,영암군,0-4세,1602,794,808
202012,46830,전라남도,영암군,0-4세,1587,787,800
202101,46830,전라남도,영암군,0-4세,1565,784,781
202102,46830,전라남도,영암군,0-4세,1538,776,762
202103,46830,전라남도,영암군,0-4세,1495,757,738
202104,46830,전라남도,영암군,0-4세,1488,754,734
202105,46830,전라남도,영암군,0-4세,1481,748,733
202106,46830,전라남도,영암군,0-4세,1462,743,719
202007,46830,전라남도,영암군,5-9세,2087,1055,1032
202008,46830,전라남도,영암군,5-9세,2049,1036,1013
202009,46830,전라남도,영암군,5-9세,2023,1023,1000
202010,46830,전라남도,영암군,5-9세,2000,1012,988
202011,46830,전라남도,영암군,5-9세,1986,1002,984
202012,46830,전라남도,영암군,5-9세,1952,982,970
202101,46830,전라남도,영암군,5-9세,1954,990,964
202102,46830,전라남도,영암군,5-9세,1949,977,972
202103,46830,전라남도,영암군,5-9세,1930,972,958
202104,46830,전라남도,영암군,5-9세,1905,956,949
202105,46830,전라남도,영암군,5-9세,1889,948,941
202106,46830,전라남도,영암군,5-9세,1884,942,942
202007,46830,전라남도,영암군,10-14세,2063,1082,981
202008,46830,전라남도,영암군,10-14세,2055,1074,981
202009,46830,전라남도,영암군,10-14세,2065,1078,987
202010,46830,전라남도,영암군,10-14세,2072,1080,992
202011,46830,전라남도,영암군,10-14세,2071,1088,983
202012,46830,전라남도,영암군,10-14세,2079,1091,988
202101,46830,전라남도,영암군,10-14세,2075,1092,983
202102,46830,전라남도,영암군,10-14세,2085,1092,993
202103,46830,전라남도,영암군,10-14세,2097,1094,1003
202104,46830,전라남도,영암군,10-14세,2107,1094,1013
202105,46830,전라남도,영암군,10-14세,2122,1109,1013
202106,46830,전라남도,영암군,10-14세,2118,1109,1009
202007,46830,전라남도,영암군,15-19세,2516,1362,1154
202008,46830,전라남도,영암군,15-19세,2485,1347,1138
202009,46830,전라남도,영암군,15-19세,2467,1336,1131
202010,46830,전라남도,영암군,15-19세,2424,1318,1106
202011,46830,전라남도,영암군,15-19세,2406,1302,1104
202012,46830,전라남도,영암군,15-19세,2364,1278,1086
202101,46830,전라남도,영암군,15-19세,2353,1267,1086
202102,46830,전라남도,영암군,15-19세,2327,1255,1072
202103,46830,전라남도,영암군,15-19세,2309,1241,1068
202104,46830,전라남도,영암군,15-19세,2300,1240,1060
202105,46830,전라남도,영암군,15-19세,2284,1228,1056
202106,46830,전라남도,영암군,15-19세,2260,1211,1049
202007,46830,전라남도,영암군,20-24세,2836,1619,1217
202008,46830,전라남도,영암군,20-24세,2834,1624,1210
202009,46830,전라남도,영암군,20-24세,2844,1644,1200
202010,46830,전라남도,영암군,20-24세,2864,1648,1216
202011,46830,전라남도,영암군,20-24세,2895,1663,1232
202012,46830,전라남도,영암군,20-24세,2908,1673,1235
202101,46830,전라남도,영암군,20-24세,2867,1658,1209
202102,46830,전라남도,영암군,20-24세,2854,1659,1195
202103,46830,전라남도,영암군,20-24세,2849,1673,1176
202104,46830,전라남도,영암군,20-24세,2835,1667,1168
202105,46830,전라남도,영암군,20-24세,2827,1664,1163
202106,46830,전라남도,영암군,20-24세,2807,1657,1150
202007,46830,전라남도,영암군,25-29세,2200,1254,946
202008,46830,전라남도,영암군,25-29세,2183,1251,932
202009,46830,전라남도,영암군,25-29세,2182,1248,934
202010,46830,전라남도,영암군,25-29세,2196,1273,923
202011,46830,전라남도,영암군,25-29세,2188,1273,915
202012,46830,전라남도,영암군,25-29세,2195,1277,918
202101,46830,전라남도,영암군,25-29세,2217,1281,936
202102,46830,전라남도,영암군,25-29세,2209,1284,925
202103,46830,전라남도,영암군,25-29세,2216,1285,931
202104,46830,전라남도,영암군,25-29세,2215,1285,930
202105,46830,전라남도,영암군,25-29세,2201,1285,916
202106,46830,전라남도,영암군,25-29세,2193,1275,918
202007,46830,전라남도,영암군,30-34세,2012,1055,957
202008,46830,전라남도,영암군,30-34세,2016,1050,966
202009,46830,전라남도,영암군,30-34세,1995,1033,962
202010,46830,전라남도,영암군,30-34세,1966,1016,950
202011,46830,전라남도,영암군,30-34세,1939,1006,933
202012,46830,전라남도,영암군,30-34세,1917,998,919
202101,46830,전라남도,영암군,30-34세,1904,994,910
202102,46830,전라남도,영암군,30-34세,1887,984,903
202103,46830,전라남도,영암군,30-34세,1882,993,889
202104,46830,전라남도,영암군,30-34세,1864,988,876
202105,46830,전라남도,영암군,30-34세,1854,990,864
202106,46830,전라남도,영암군,30-34세,1853,988,865
202007,46830,전라남도,영암군,35-39세,3050,1735,1315
202008,46830,전라남도,영암군,35-39세,2991,1692,1299
202009,46830,전라남도,영암군,35-39세,2951,1667,1284
202010,46830,전라남도,영암군,35-39세,2909,1645,1264
202011,46830,전라남도,영암군,35-39세,2868,1598,1270
202012,46830,전라남도,영암군,35-39세,2861,1586,1275
202101,46830,전라남도,영암군,35-39세,2825,1564,1261
202102,46830,전라남도,영암군,35-39세,2812,1564,1248
202103,46830,전라남도,영암군,35-39세,2771,1536,1235
202104,46830,전라남도,영암군,35-39세,2753,1519,1234
202105,46830,전라남도,영암군,35-39세,2720,1496,1224
202106,46830,전라남도,영암군,35-39세,2707,1487,1220
202007,46830,전라남도,영암군,40-44세,3381,2000,1381
202008,46830,전라남도,영암군,40-44세,3360,1987,1373
202009,46830,전라남도,영암군,40-44세,3362,1994,1368
202010,46830,전라남도,영암군,40-44세,3340,1987,1353
202011,46830,전라남도,영암군,40-44세,3325,1988,1337
202012,46830,전라남도,영암군,40-44세,3303,1967,1336
202101,46830,전라남도,영암군,40-44세,3304,1958,1346
202102,46830,전라남도,영암군,40-44세,3302,1952,1350
202103,46830,전라남도,영암군,40-44세,3285,1956,1329
202104,46830,전라남도,영암군,40-44세,3288,1965,1323
202105,46830,전라남도,영암군,40-44세,3288,1974,1314
202106,46830,전라남도,영암군,40-44세,3291,1974,1317
202007,46830,전라남도,영암군,45-49세,4237,2512,1725
202008,46830,전라남도,영암군,45-49세,4206,2499,1707
202009,46830,전라남도,영암군,45-49세,4191,2486,1705
202010,46830,전라남도,영암군,45-49세,4160,2465,1695
202011,46830,전라남도,영암군,45-49세,4132,2451,1681
202012,46830,전라남도,영암군,45-49세,4128,2439,1689
202101,46830,전라남도,영암군,45-49세,4118,2439,1679
202102,46830,전라남도,영암군,45-49세,4113,2432,1681
202103,46830,전라남도,영암군,45-49세,4097,2421,1676
202104,46830,전라남도,영암군,45-49세,4087,2418,1669
202105,46830,전라남도,영암군,45-49세,4048,2381,1667
202106,46830,전라남도,영암군,45-49세,4030,2377,1653
202007,46830,전라남도,영암군,50-54세,4609,2695,1914
202008,46830,전라남도,영암군,50-54세,4607,2690,1917
202009,46830,전라남도,영암군,50-54세,4606,2688,1918
202010,46830,전라남도,영암군,50-54세,4609,2678,1931
202011,46830,전라남도,영암군,50-54세,4605,2671,1934
202012,46830,전라남도,영암군,50-54세,4614,2684,1930
202101,46830,전라남도,영암군,50-54세,4620,2682,1938
202102,46830,전라남도,영암군,50-54세,4629,2685,1944
202103,46830,전라남도,영암군,50-54세,4569,2650,1919
202104,46830,전라남도,영암군,50-54세,4549,2629,1920
202105,46830,전라남도,영암군,50-54세,4599,2682,1917
202106,46830,전라남도,영암군,50-54세,4593,2666,1927
202007,46830,전라남도,영암군,55-59세,4776,2665,2111
202008,46830,전라남도,영암군,55-59세,4798,2685,2113
202009,46830,전라남도,영암군,55-59세,4793,2687,2106
202010,46830,전라남도,영암군,55-59세,4812,2705,2107
202011,46830,전라남도,영암군,55-59세,4786,2686,2100
202012,46830,전라남도,영암군,55-59세,4799,2682,2117
202101,46830,전라남도,영암군,55-59세,4815,2696,2119
202102,46830,전라남도,영암군,55-59세,4819,2704,2115
202103,46830,전라남도,영암군,55-59세,4847,2737,2110
202104,46830,전라남도,영암군,55-59세,4872,2769,2103
202105,46830,전라남도,영암군,55-59세,4840,2760,2080
202106,46830,전라남도,영암군,55-59세,4819,2750,2069
202007,46830,전라남도,영암군,60-64세,4461,2347,2114
202008,46830,전라남도,영암군,60-64세,4489,2368,2121
202009,46830,전라남도,영암군,60-64세,4535,2382,2153
202010,46830,전라남도,영암군,60-64세,4537,2390,2147
202011,46830,전라남도,영암군,60-64세,4559,2421,2138
202012,46830,전라남도,영암군,60-64세,4592,2440,2152
202101,46830,전라남도,영암군,60-64세,4652,2473,2179
202102,46830,전라남도,영암군,60-64세,4695,2497,2198
202103,46830,전라남도,영암군,60-64세,4699,2507,2192
202104,46830,전라남도,영암군,60-64세,4731,2526,2205
202105,46830,전라남도,영암군,60-64세,4744,2540,2204
202106,46830,전라남도,영암군,60-64세,4770,2562,2208
202007,46830,전라남도,영암군,65-69세,3422,1644,1778
202008,46830,전라남도,영암군,65-69세,3420,1648,1772
202009,46830,전라남도,영암군,65-69세,3423,1661,1762
202010,46830,전라남도,영암군,65-69세,3422,1667,1755
202011,46830,전라남도,영암군,65-69세,3452,1682,1770
202012,46830,전라남도,영암군,65-69세,3459,1694,1765
202101,46830,전라남도,영암군,65-69세,3453,1692,1761
202102,46830,전라남도,영암군,65-69세,3453,1690,1763
202103,46830,전라남도,영암군,65-69세,3478,1714,1764
202104,46830,전라남도,영암군,65-69세,3496,1729,1767
202105,46830,전라남도,영암군,65-69세,3510,1737,1773
202106,46830,전라남도,영암군,65-69세,3546,1752,1794
202007,46830,전라남도,영암군,70-74세,3129,1407,1722
202008,46830,전라남도,영암군,70-74세,3132,1413,1719
202009,46830,전라남도,영암군,70-74세,3136,1415,1721
202010,46830,전라남도,영암군,70-74세,3167,1427,1740
202011,46830,전라남도,영암군,70-74세,3178,1433,1745
202012,46830,전라남도,영암군,70-74세,3188,1435,1753
202101,46830,전라남도,영암군,70-74세,3216,1449,1767
202102,46830,전라남도,영암군,70-74세,3248,1469,1779
202103,46830,전라남도,영암군,70-74세,3231,1473,1758
202104,46830,전라남도,영암군,70-74세,3229,1477,1752
202105,46830,전라남도,영암군,70-74세,3228,1489,1739
202106,46830,전라남도,영암군,70-74세,3216,1482,1734
202007,46830,전라남도,영암군,75-79세,3207,1235,1972
202008,46830,전라남도,영암군,75-79세,3215,1237,1978
202009,46830,전라남도,영암군,75-79세,3202,1240,1962
202010,46830,전라남도,영암군,75-79세,3180,1235,1945
202011,46830,전라남도,영암군,75-79세,3180,1237,1943
202012,46830,전라남도,영암군,75-79세,3141,1217,1924
202101,46830,전라남도,영암군,75-79세,3117,1210,1907
202102,46830,전라남도,영암군,75-79세,3077,1202,1875
202103,46830,전라남도,영암군,75-79세,3053,1198,1855
202104,46830,전라남도,영암군,75-79세,3034,1189,1845
202105,46830,전라남도,영암군,75-79세,3023,1188,1835
202106,46830,전라남도,영암군,75-79세,3028,1194,1834
202007,46830,전라남도,영암군,80-84세,2596,849,1747
202008,46830,전라남도,영암군,80-84세,2588,846,1742
202009,46830,전라남도,영암군,80-84세,2603,852,1751
202010,46830,전라남도,영암군,80-84세,2608,853,1755
202011,46830,전라남도,영암군,80-84세,2595,850,1745
202012,46830,전라남도,영암군,80-84세,2618,862,1756
202101,46830,전라남도,영암군,80-84세,2622,867,1755
202102,46830,전라남도,영암군,80-84세,2626,866,1760
202103,46830,전라남도,영암군,80-84세,2632,864,1768
202104,46830,전라남도,영암군,80-84세,2637,866,1771
202105,46830,전라남도,영암군,80-84세,2659,872,1787
202106,46830,전라남도,영암군,80-84세,2669,867,1802
202007,46830,전라남도,영암군,85-89세,1383,386,997
202008,46830,전라남도,영암군,85-89세,1390,387,1003
202009,46830,전라남도,영암군,85-89세,1403,387,1016
202010,46830,전라남도,영암군,85-89세,1403,386,1017
202011,46830,전라남도,영암군,85-89세,1422,395,1027
202012,46830,전라남도,영암군,85-89세,1422,395,1027
202101,46830,전라남도,영암군,85-89세,1431,398,1033
202102,46830,전라남도,영암군,85-89세,1445,399,1046
202103,46830,전라남도,영암군,85-89세,1444,401,1043
202104,46830,전라남도,영암군,85-89세,1466,407,1059
202105,46830,전라남도,영암군,85-89세,1469,406,1063
202106,46830,전라남도,영암군,85-89세,1464,408,1056
202007,46830,전라남도,영암군,90-94세,404,84,320
202008,46830,전라남도,영암군,90-94세,409,85,324
202009,46830,전라남도,영암군,90-94세,414,81,333
202010,46830,전라남도,영암군,90-94세,421,84,337
202011,46830,전라남도,영암군,90-94세,423,81,342
202012,46830,전라남도,영암군,90-94세,435,81,354
202101,46830,전라남도,영암군,90-94세,444,81,363
202102,46830,전라남도,영암군,90-94세,446,83,363
202103,46830,전라남도,영암군,90-94세,458,85,373
202104,46830,전라남도,영암군,90-94세,457,86,371
202105,46830,전라남도,영암군,90-94세,459,90,369
202106,46830,전라남도,영암군,90-94세,458,90,368
202007,46830,전라남도,영암군,95-99세,107,20,87
202008,46830,전라남도,영암군,95-99세,109,20,89
202009,46830,전라남도,영암군,95-99세,112,21,91
202010,46830,전라남도,영암군,95-99세,109,21,88
202011,46830,전라남도,영암군,95-99세,105,21,84
202012,46830,전라남도,영암군,95-99세,102,19,83
202101,46830,전라남도,영암군,95-99세,101,19,82
202102,46830,전라남도,영암군,95-99세,102,21,81
202103,46830,전라남도,영암군,95-99세,102,20,82
202104,46830,전라남도,영암군,95-99세,103,19,84
202105,46830,전라남도,영암군,95-99세,105,19,86
202106,46830,전라남도,영암군,95-99세,102,19,83
202007,46830,전라남도,영암군,100+,34,7,27
202008,46830,전라남도,영암군,100+,34,7,27
202009,46830,전라남도,영암군,100+,34,7,27
202010,46830,전라남도,영암군,100+,35,8,27
202011,46830,전라남도,영암군,100+,35,8,27
202012,46830,전라남도,영암군,100+,35,8,27
202101,46830,전라남도,영암군,100+,34,8,26
202102,46830,전라남도,영암군,100+,36,8,28
202103,46830,전라남도,영암군,100+,25,4,21
202104,46830,전라남도,영암군,100+,21,3,18
202105,46830,전라남도,영암군,100+,20,2,18
202106,46830,전라남도,영암군,100+,20,2,18
202007,46840,전라남도,무안군,0-4세,2653,1370,1283
202008,46840,전라남도,무안군,0-4세,2806,1447,1359
202009,46840,전라남도,무안군,0-4세,2926,1508,1418
202010,46840,전라남도,무안군,0-4세,2958,1524,1434
202011,46840,전라남도,무안군,0-4세,2979,1533,1446
202012,46840,전라남도,무안군,0-4세,3041,1574,1467
202101,46840,전라남도,무안군,0-4세,3064,1583,1481
202102,46840,전라남도,무안군,0-4세,3095,1599,1496
202103,46840,전라남도,무안군,0-4세,3112,1616,1496
202104,46840,전라남도,무안군,0-4세,3096,1604,1492
202105,46840,전라남도,무안군,0-4세,3087,1602,1485
202106,46840,전라남도,무안군,0-4세,3095,1605,1490
202007,46840,전라남도,무안군,5-9세,4351,2211,2140
202008,46840,전라남도,무안군,5-9세,4523,2309,2214
202009,46840,전라남도,무안군,5-9세,4657,2389,2268
202010,46840,전라남도,무안군,5-9세,4668,2407,2261
202011,46840,전라남도,무안군,5-9세,4683,2413,2270
202012,46840,전라남도,무안군,5-9세,4754,2435,2319
202101,46840,전라남도,무안군,5-9세,4824,2478,2346
202102,46840,전라남도,무안군,5-9세,4886,2507,2379
202103,46840,전라남도,무안군,5-9세,4934,2534,2400
202104,46840,전라남도,무안군,5-9세,4923,2535,2388
202105,46840,전라남도,무안군,5-9세,4930,2533,2397
202106,46840,전라남도,무안군,5-9세,4941,2531,2410
202007,46840,전라남도,무안군,10-14세,4493,2305,2188
202008,46840,전라남도,무안군,10-14세,4632,2374,2258
202009,46840,전라남도,무안군,10-14세,4724,2419,2305
202010,46840,전라남도,무안군,10-14세,4771,2431,2340
202011,46840,전라남도,무안군,10-14세,4812,2443,2369
202012,46840,전라남도,무안군,10-14세,4860,2470,2390
202101,46840,전라남도,무안군,10-14세,4917,2506,2411
202102,46840,전라남도,무안군,10-14세,5011,2551,2460
202103,46840,전라남도,무안군,10-14세,5033,2554,2479
202104,46840,전라남도,무안군,10-14세,5064,2546,2518
202105,46840,전라남도,무안군,10-14세,5096,2575,2521
202106,46840,전라남도,무안군,10-14세,5120,2585,2535
202007,46840,전라남도,무안군,15-19세,4297,2190,2107
202008,46840,전라남도,무안군,15-19세,4336,2212,2124
202009,46840,전라남도,무안군,15-19세,4377,2227,2150
202010,46840,전라남도,무안군,15-19세,4389,2232,2157
202011,46840,전라남도,무안군,15-19세,4380,2234,2146
202012,46840,전라남도,무안군,15-19세,4381,2224,2157
202101,46840,전라남도,무안군,15-19세,4378,2218,2160
202102,46840,전라남도,무안군,15-19세,4378,2223,2155
202103,46840,전라남도,무안군,15-19세,4350,2210,2140
202104,46840,전라남도,무안군,15-19세,4336,2208,2128
202105,46840,전라남도,무안군,15-19세,4318,2198,2120
202106,46840,전라남도,무안군,15-19세,4309,2195,2114
202007,46840,전라남도,무안군,20-24세,4518,2478,2040
202008,46840,전라남도,무안군,20-24세,4550,2508,2042
202009,46840,전라남도,무안군,20-24세,4625,2540,2085
202010,46840,전라남도,무안군,20-24세,4656,2561,2095
202011,46840,전라남도,무안군,20-24세,4666,2565,2101
202012,46840,전라남도,무안군,20-24세,4690,2576,2114
202101,46840,전라남도,무안군,20-24세,4742,2600,2142
202102,46840,전라남도,무안군,20-24세,4747,2605,2142
202103,46840,전라남도,무안군,20-24세,4770,2594,2176
202104,46840,전라남도,무안군,20-24세,4787,2622,2165
202105,46840,전라남도,무안군,20-24세,4791,2620,2171
202106,46840,전라남도,무안군,20-24세,4794,2618,2176
202007,46840,전라남도,무안군,25-29세,3772,1991,1781
202008,46840,전라남도,무안군,25-29세,3857,2023,1834
202009,46840,전라남도,무안군,25-29세,3950,2061,1889
202010,46840,전라남도,무안군,25-29세,4022,2102,1920
202011,46840,전라남도,무안군,25-29세,4066,2139,1927
202012,46840,전라남도,무안군,25-29세,4138,2198,1940
202101,46840,전라남도,무안군,25-29세,4160,2209,1951
202102,46840,전라남도,무안군,25-29세,4215,2227,1988
202103,46840,전라남도,무안군,25-29세,4269,2247,2022
202104,46840,전라남도,무안군,25-29세,4275,2247,2028
202105,46840,전라남도,무안군,25-29세,4345,2282,2063
202106,46840,전라남도,무안군,25-29세,4384,2304,2080
202007,46840,전라남도,무안군,30-34세,3647,1886,1761
202008,46840,전라남도,무안군,30-34세,3771,1938,1833
202009,46840,전라남도,무안군,30-34세,3910,2007,1903
202010,46840,전라남도,무안군,30-34세,3933,2029,1904
202011,46840,전라남도,무안군,30-34세,3980,2049,1931
202012,46840,전라남도,무안군,30-34세,4066,2084,1982
202101,46840,전라남도,무안군,30-34세,4127,2100,2027
202102,46840,전라남도,무안군,30-34세,4177,2116,2061
202103,46840,전라남도,무안군,30-34세,4238,2155,2083
202104,46840,전라남도,무안군,30-34세,4289,2179,2110
202105,46840,전라남도,무안군,30-34세,4290,2186,2104
202106,46840,전라남도,무안군,30-34세,4342,2216,2126
202007,46840,전라남도,무안군,35-39세,5609,2856,2753
202008,46840,전라남도,무안군,35-39세,5796,2957,2839
202009,46840,전라남도,무안군,35-39세,5994,3054,2940
202010,46840,전라남도,무안군,35-39세,6035,3059,2976
202011,46840,전라남도,무안군,35-39세,6053,3061,2992
202012,46840,전라남도,무안군,35-39세,6203,3137,3066
202101,46840,전라남도,무안군,35-39세,6287,3207,3080
202102,46840,전라남도,무안군,35-39세,6353,3245,3108
202103,46840,전라남도,무안군,35-39세,6413,3266,3147
202104,46840,전라남도,무안군,35-39세,6400,3258,3142
202105,46840,전라남도,무안군,35-39세,6374,3244,3130
202106,46840,전라남도,무안군,35-39세,6396,3254,3142
202007,46840,전라남도,무안군,40-44세,6140,3150,2990
202008,46840,전라남도,무안군,40-44세,6333,3251,3082
202009,46840,전라남도,무안군,40-44세,6506,3338,3168
202010,46840,전라남도,무안군,40-44세,6575,3389,3186
202011,46840,전라남도,무안군,40-44세,6613,3424,3189
202012,46840,전라남도,무안군,40-44세,6716,3464,3252
202101,46840,전라남도,무안군,40-44세,6835,3514,3321
202102,46840,전라남도,무안군,40-44세,6936,3569,3367
202103,46840,전라남도,무안군,40-44세,6976,3594,3382
202104,46840,전라남도,무안군,40-44세,7002,3604,3398
202105,46840,전라남도,무안군,40-44세,7078,3646,3432
202106,46840,전라남도,무안군,40-44세,7131,3664,3467
202007,46840,전라남도,무안군,45-49세,6548,3605,2943
202008,46840,전라남도,무안군,45-49세,6669,3659,3010
202009,46840,전라남도,무안군,45-49세,6752,3688,3064
202010,46840,전라남도,무안군,45-49세,6748,3663,3085
202011,46840,전라남도,무안군,45-49세,6738,3661,3077
202012,46840,전라남도,무안군,45-49세,6803,3689,3114
202101,46840,전라남도,무안군,45-49세,6910,3740,3170
202102,46840,전라남도,무안군,45-49세,6964,3747,3217
202103,46840,전라남도,무안군,45-49세,6962,3743,3219
202104,46840,전라남도,무안군,45-49세,6986,3749,3237
202105,46840,전라남도,무안군,45-49세,6947,3734,3213
202106,46840,전라남도,무안군,45-49세,6934,3724,3210
202007,46840,전라남도,무안군,50-54세,6357,3470,2887
202008,46840,전라남도,무안군,50-54세,6439,3528,2911
202009,46840,전라남도,무안군,50-54세,6484,3558,2926
202010,46840,전라남도,무안군,50-54세,6523,3586,2937
202011,46840,전라남도,무안군,50-54세,6509,3592,2917
202012,46840,전라남도,무안군,50-54세,6540,3607,2933
202101,46840,전라남도,무안군,50-54세,6592,3637,2955
202102,46840,전라남도,무안군,50-54세,6598,3654,2944
202103,46840,전라남도,무안군,50-54세,6582,3654,2928
202104,46840,전라남도,무안군,50-54세,6614,3683,2931
202105,46840,전라남도,무안군,50-54세,6679,3708,2971
202106,46840,전라남도,무안군,50-54세,6725,3738,2987
202007,46840,전라남도,무안군,55-59세,6090,3343,2747
202008,46840,전라남도,무안군,55-59세,6135,3360,2775
202009,46840,전라남도,무안군,55-59세,6204,3399,2805
202010,46840,전라남도,무안군,55-59세,6216,3403,2813
202011,46840,전라남도,무안군,55-59세,6275,3431,2844
202012,46840,전라남도,무안군,55-59세,6332,3453,2879
202101,46840,전라남도,무안군,55-59세,6348,3451,2897
202102,46840,전라남도,무안군,55-59세,6363,3445,2918
202103,46840,전라남도,무안군,55-59세,6370,3461,2909
202104,46840,전라남도,무안군,55-59세,6353,3455,2898
202105,46840,전라남도,무안군,55-59세,6337,3450,2887
202106,46840,전라남도,무안군,55-59세,6306,3422,2884
202007,46840,전라남도,무안군,60-64세,5824,2958,2866
202008,46840,전라남도,무안군,60-64세,5883,2986,2897
202009,46840,전라남도,무안군,60-64세,5962,3039,2923
202010,46840,전라남도,무안군,60-64세,6017,3071,2946
202011,46840,전라남도,무안군,60-64세,6047,3087,2960
202012,46840,전라남도,무안군,60-64세,6080,3099,2981
202101,46840,전라남도,무안군,60-64세,6155,3150,3005
202102,46840,전라남도,무안군,60-64세,6218,3194,3024
202103,46840,전라남도,무안군,60-64세,6258,3215,3043
202104,46840,전라남도,무안군,60-64세,6316,3248,3068
202105,46840,전라남도,무안군,60-64세,6357,3275,3082
202106,46840,전라남도,무안군,60-64세,6432,3318,3114
202007,46840,전라남도,무안군,65-69세,4658,2284,2374
202008,46840,전라남도,무안군,65-69세,4679,2289,2390
202009,46840,전라남도,무안군,65-69세,4689,2289,2400
202010,46840,전라남도,무안군,65-69세,4728,2312,2416
202011,46840,전라남도,무안군,65-69세,4717,2306,2411
202012,46840,전라남도,무안군,65-69세,4765,2335,2430
202101,46840,전라남도,무안군,65-69세,4788,2335,2453
202102,46840,전라남도,무안군,65-69세,4794,2326,2468
202103,46840,전라남도,무안군,65-69세,4840,2369,2471
202104,46840,전라남도,무안군,65-69세,4860,2379,2481
202105,46840,전라남도,무안군,65-69세,4873,2381,2492
202106,46840,전라남도,무안군,65-69세,4890,2404,2486
202007,46840,전라남도,무안군,70-74세,4064,1937,2127
202008,46840,전라남도,무안군,70-74세,4076,1953,2123
202009,46840,전라남도,무안군,70-74세,4119,1977,2142
202010,46840,전라남도,무안군,70-74세,4138,1984,2154
202011,46840,전라남도,무안군,70-74세,4154,1998,2156
202012,46840,전라남도,무안군,70-74세,4174,2009,2165
202101,46840,전라남도,무안군,70-74세,4194,2012,2182
202102,46840,전라남도,무안군,70-74세,4209,2019,2190
202103,46840,전라남도,무안군,70-74세,4187,2011,2176
202104,46840,전라남도,무안군,70-74세,4188,2012,2176
202105,46840,전라남도,무안군,70-74세,4201,2025,2176
202106,46840,전라남도,무안군,70-74세,4219,2032,2187
202007,46840,전라남도,무안군,75-79세,3751,1512,2239
202008,46840,전라남도,무안군,75-79세,3762,1522,2240
202009,46840,전라남도,무안군,75-79세,3766,1533,2233
202010,46840,전라남도,무안군,75-79세,3752,1531,2221
202011,46840,전라남도,무안군,75-79세,3752,1530,2222
202012,46840,전라남도,무안군,75-79세,3739,1528,2211
202101,46840,전라남도,무안군,75-79세,3722,1537,2185
202102,46840,전라남도,무안군,75-79세,3684,1530,2154
202103,46840,전라남도,무안군,75-79세,3652,1511,2141
202104,46840,전라남도,무안군,75-79세,3639,1510,2129
202105,46840,전라남도,무안군,75-79세,3649,1522,2127
202106,46840,전라남도,무안군,75-79세,3630,1527,2103
202007,46840,전라남도,무안군,80-84세,2786,886,1900
202008,46840,전라남도,무안군,80-84세,2774,881,1893
202009,46840,전라남도,무안군,80-84세,2776,883,1893
202010,46840,전라남도,무안군,80-84세,2779,883,1896
202011,46840,전라남도,무안군,80-84세,2786,888,1898
202012,46840,전라남도,무안군,80-84세,2800,893,1907
202101,46840,전라남도,무안군,80-84세,2827,898,1929
202102,46840,전라남도,무안군,80-84세,2852,905,1947
202103,46840,전라남도,무안군,80-84세,2831,912,1919
202104,46840,전라남도,무안군,80-84세,2846,927,1919
202105,46840,전라남도,무안군,80-84세,2881,943,1938
202106,46840,전라남도,무안군,80-84세,2899,941,1958
202007,46840,전라남도,무안군,85-89세,1353,354,999
202008,46840,전라남도,무안군,85-89세,1368,362,1006
202009,46840,전라남도,무안군,85-89세,1383,368,1015
202010,46840,전라남도,무안군,85-89세,1403,373,1030
202011,46840,전라남도,무안군,85-89세,1386,373,1013
202012,46840,전라남도,무안군,85-89세,1396,378,1018
202101,46840,전라남도,무안군,85-89세,1406,380,1026
202102,46840,전라남도,무안군,85-89세,1423,385,1038
202103,46840,전라남도,무안군,85-89세,1452,387,1065
202104,46840,전라남도,무안군,85-89세,1458,383,1075
202105,46840,전라남도,무안군,85-89세,1461,382,1079
202106,46840,전라남도,무안군,85-89세,1473,385,1088
202007,46840,전라남도,무안군,90-94세,486,91,395
202008,46840,전라남도,무안군,90-94세,489,91,398
202009,46840,전라남도,무안군,90-94세,495,90,405
202010,46840,전라남도,무안군,90-94세,495,88,407
202011,46840,전라남도,무안군,90-94세,510,90,420
202012,46840,전라남도,무안군,90-94세,514,89,425
202101,46840,전라남도,무안군,90-94세,523,93,430
202102,46840,전라남도,무안군,90-94세,526,92,434
202103,46840,전라남도,무안군,90-94세,516,91,425
202104,46840,전라남도,무안군,90-94세,513,91,422
202105,46840,전라남도,무안군,90-94세,515,91,424
202106,46840,전라남도,무안군,90-94세,509,89,420
202007,46840,전라남도,무안군,95-99세,89,5,84
202008,46840,전라남도,무안군,95-99세,92,5,87
202009,46840,전라남도,무안군,95-99세,98,6,92
202010,46840,전라남도,무안군,95-99세,101,7,94
202011,46840,전라남도,무안군,95-99세,103,7,96
202012,46840,전라남도,무안군,95-99세,106,7,99
202101,46840,전라남도,무안군,95-99세,106,5,101
202102,46840,전라남도,무안군,95-99세,106,7,99
202103,46840,전라남도,무안군,95-99세,101,6,95
202104,46840,전라남도,무안군,95-99세,106,9,97
202105,46840,전라남도,무안군,95-99세,105,9,96
202106,46840,전라남도,무안군,95-99세,106,11,95
202007,46840,전라남도,무안군,100+,36,4,32
202008,46840,전라남도,무안군,100+,36,4,32
202009,46840,전라남도,무안군,100+,36,4,32
202010,46840,전라남도,무안군,100+,37,5,32
202011,46840,전라남도,무안군,100+,36,5,31
202012,46840,전라남도,무안군,100+,34,5,29
202101,46840,전라남도,무안군,100+,35,6,29
202102,46840,전라남도,무안군,100+,35,6,29
202103,46840,전라남도,무안군,100+,24,3,21
202104,46840,전라남도,무안군,100+,24,3,21
202105,46840,전라남도,무안군,100+,25,3,22
202106,46840,전라남도,무안군,100+,25,3,22
202007,46860,전라남도,함평군,0-4세,594,313,281
202008,46860,전라남도,함평군,0-4세,605,326,279
202009,46860,전라남도,함평군,0-4세,599,321,278
202010,46860,전라남도,함평군,0-4세,608,324,284
202011,46860,전라남도,함평군,0-4세,611,323,288
202012,46860,전라남도,함평군,0-4세,616,324,292
202101,46860,전라남도,함평군,0-4세,597,320,277
202102,46860,전라남도,함평군,0-4세,591,316,275
202103,46860,전라남도,함평군,0-4세,582,312,270
202104,46860,전라남도,함평군,0-4세,574,307,267
202105,46860,전라남도,함평군,0-4세,572,302,270
202106,46860,전라남도,함평군,0-4세,563,296,267
202007,46860,전라남도,함평군,5-9세,844,436,408
202008,46860,전라남도,함평군,5-9세,834,428,406
202009,46860,전라남도,함평군,5-9세,829,427,402
202010,46860,전라남도,함평군,5-9세,800,410,390
202011,46860,전라남도,함평군,5-9세,777,398,379
202012,46860,전라남도,함평군,5-9세,771,397,374
202101,46860,전라남도,함평군,5-9세,758,386,372
202102,46860,전라남도,함평군,5-9세,755,387,368
202103,46860,전라남도,함평군,5-9세,738,381,357
202104,46860,전라남도,함평군,5-9세,734,380,354
202105,46860,전라남도,함평군,5-9세,725,377,348
202106,46860,전라남도,함평군,5-9세,715,367,348
202007,46860,전라남도,함평군,10-14세,906,473,433
202008,46860,전라남도,함평군,10-14세,904,471,433
202009,46860,전라남도,함평군,10-14세,899,468,431
202010,46860,전라남도,함평군,10-14세,912,473,439
202011,46860,전라남도,함평군,10-14세,912,474,438
202012,46860,전라남도,함평군,10-14세,914,475,439
202101,46860,전라남도,함평군,10-14세,927,488,439
202102,46860,전라남도,함평군,10-14세,927,491,436
202103,46860,전라남도,함평군,10-14세,961,504,457
202104,46860,전라남도,함평군,10-14세,967,504,463
202105,46860,전라남도,함평군,10-14세,963,503,460
202106,46860,전라남도,함평군,10-14세,967,512,455
202007,46860,전라남도,함평군,15-19세,1182,633,549
202008,46860,전라남도,함평군,15-19세,1165,623,542
202009,46860,전라남도,함평군,15-19세,1170,625,545
202010,46860,전라남도,함평군,15-19세,1162,622,540
202011,46860,전라남도,함평군,15-19세,1155,614,541
202012,46860,전라남도,함평군,15-19세,1134,608,526
202101,46860,전라남도,함평군,15-19세,1119,597,522
202102,46860,전라남도,함평군,15-19세,1090,584,506
202103,46860,전라남도,함평군,15-19세,1110,598,512
202104,46860,전라남도,함평군,15-19세,1111,599,512
202105,46860,전라남도,함평군,15-19세,1097,595,502
202106,46860,전라남도,함평군,15-19세,1077,584,493
202007,46860,전라남도,함평군,20-24세,1416,809,607
202008,46860,전라남도,함평군,20-24세,1412,802,610
202009,46860,전라남도,함평군,20-24세,1397,796,601
202010,46860,전라남도,함평군,20-24세,1400,800,600
202011,46860,전라남도,함평군,20-24세,1391,801,590
202012,46860,전라남도,함평군,20-24세,1373,784,589
202101,46860,전라남도,함평군,20-24세,1364,778,586
202102,46860,전라남도,함평군,20-24세,1351,765,586
202103,46860,전라남도,함평군,20-24세,1337,756,581
202104,46860,전라남도,함평군,20-24세,1338,758,580
202105,46860,전라남도,함평군,20-24세,1335,750,585
202106,46860,전라남도,함평군,20-24세,1325,748,577
202007,46860,전라남도,함평군,25-29세,1128,685,443
202008,46860,전라남도,함평군,25-29세,1122,688,434
202009,46860,전라남도,함평군,25-29세,1115,687,428
202010,46860,전라남도,함평군,25-29세,1118,691,427
202011,46860,전라남도,함평군,25-29세,1136,700,436
202012,46860,전라남도,함평군,25-29세,1143,714,429
202101,46860,전라남도,함평군,25-29세,1132,712,420
202102,46860,전라남도,함평군,25-29세,1113,705,408
202103,46860,전라남도,함평군,25-29세,1103,700,403
202104,46860,전라남도,함평군,25-29세,1084,690,394
202105,46860,전라남도,함평군,25-29세,1084,688,396
202106,46860,전라남도,함평군,25-29세,1070,680,390
202007,46860,전라남도,함평군,30-34세,961,527,434
202008,46860,전라남도,함평군,30-34세,961,527,434
202009,46860,전라남도,함평군,30-34세,951,521,430
202010,46860,전라남도,함평군,30-34세,941,514,427
202011,46860,전라남도,함평군,30-34세,933,511,422
202012,46860,전라남도,함평군,30-34세,938,510,428
202101,46860,전라남도,함평군,30-34세,920,506,414
202102,46860,전라남도,함평군,30-34세,911,496,415
202103,46860,전라남도,함평군,30-34세,895,486,409
202104,46860,전라남도,함평군,30-34세,899,487,412
202105,46860,전라남도,함평군,30-34세,900,487,413
202106,46860,전라남도,함평군,30-34세,882,481,401
202007,46860,전라남도,함평군,35-39세,1221,646,575
202008,46860,전라남도,함평군,35-39세,1221,646,575
202009,46860,전라남도,함평군,35-39세,1222,642,580
202010,46860,전라남도,함평군,35-39세,1224,640,584
202011,46860,전라남도,함평군,35-39세,1200,628,572
202012,46860,전라남도,함평군,35-39세,1186,619,567
202101,46860,전라남도,함평군,35-39세,1177,615,562
202102,46860,전라남도,함평군,35-39세,1168,617,551
202103,46860,전라남도,함평군,35-39세,1124,594,530
202104,46860,전라남도,함평군,35-39세,1104,590,514
202105,46860,전라남도,함평군,35-39세,1089,583,506
202106,46860,전라남도,함평군,35-39세,1068,566,502
202007,46860,전라남도,함평군,40-44세,1473,859,614
202008,46860,전라남도,함평군,40-44세,1468,855,613
202009,46860,전라남도,함평군,40-44세,1463,857,606
202010,46860,전라남도,함평군,40-44세,1454,853,601
202011,46860,전라남도,함평군,40-44세,1448,848,600
202012,46860,전라남도,함평군,40-44세,1421,838,583
202101,46860,전라남도,함평군,40-44세,1427,850,577
202102,46860,전라남도,함평군,40-44세,1431,843,588
202103,46860,전라남도,함평군,40-44세,1413,834,579
202104,46860,전라남도,함평군,40-44세,1397,822,575
202105,46860,전라남도,함평군,40-44세,1403,826,577
202106,46860,전라남도,함평군,40-44세,1409,834,575
202007,46860,전라남도,함평군,45-49세,2089,1258,831
202008,46860,전라남도,함평군,45-49세,2057,1229,828
202009,46860,전라남도,함평군,45-49세,2054,1222,832
202010,46860,전라남도,함평군,45-49세,2053,1230,823
202011,46860,전라남도,함평군,45-49세,2052,1232,820
202012,46860,전라남도,함평군,45-49세,2056,1228,828
202101,46860,전라남도,함평군,45-49세,2058,1217,841
202102,46860,전라남도,함평군,45-49세,2032,1207,825
202103,46860,전라남도,함평군,45-49세,1998,1188,810
202104,46860,전라남도,함평군,45-49세,1997,1198,799
202105,46860,전라남도,함평군,45-49세,1959,1170,789
202106,46860,전라남도,함평군,45-49세,1944,1164,780
202007,46860,전라남도,함평군,50-54세,2595,1577,1018
202008,46860,전라남도,함평군,50-54세,2596,1584,1012
202009,46860,전라남도,함평군,50-54세,2573,1566,1007
202010,46860,전라남도,함평군,50-54세,2577,1558,1019
202011,46860,전라남도,함평군,50-54세,2553,1536,1017
202012,46860,전라남도,함평군,50-54세,2532,1535,997
202101,46860,전라남도,함평군,50-54세,2528,1536,992
202102,46860,전라남도,함평군,50-54세,2522,1525,997
202103,46860,전라남도,함평군,50-54세,2489,1513,976
202104,46860,전라남도,함평군,50-54세,2450,1498,952
202105,46860,전라남도,함평군,50-54세,2463,1505,958
202106,46860,전라남도,함평군,50-54세,2452,1490,962
202007,46860,전라남도,함평군,55-59세,2997,1664,1333
202008,46860,전라남도,함평군,55-59세,2980,1657,1323
202009,46860,전라남도,함평군,55-59세,2984,1675,1309
202010,46860,전라남도,함평군,55-59세,2962,1660,1302
202011,46860,전라남도,함평군,55-59세,2957,1664,1293
202012,46860,전라남도,함평군,55-59세,2973,1676,1297
202101,46860,전라남도,함평군,55-59세,2971,1673,1298
202102,46860,전라남도,함평군,55-59세,2949,1667,1282
202103,46860,전라남도,함평군,55-59세,2933,1664,1269
202104,46860,전라남도,함평군,55-59세,2907,1644,1263
202105,46860,전라남도,함평군,55-59세,2910,1654,1256
202106,46860,전라남도,함평군,55-59세,2891,1647,1244
202007,46860,전라남도,함평군,60-64세,3229,1742,1487
202008,46860,전라남도,함평군,60-64세,3246,1760,1486
202009,46860,전라남도,함평군,60-64세,3245,1755,1490
202010,46860,전라남도,함평군,60-64세,3267,1780,1487
202011,46860,전라남도,함평군,60-64세,3278,1786,1492
202012,46860,전라남도,함평군,60-64세,3273,1778,1495
202101,46860,전라남도,함평군,60-64세,3278,1783,1495
202102,46860,전라남도,함평군,60-64세,3289,1779,1510
202103,46860,전라남도,함평군,60-64세,3294,1781,1513
202104,46860,전라남도,함평군,60-64세,3347,1814,1533
202105,46860,전라남도,함평군,60-64세,3361,1815,1546
202106,46860,전라남도,함평군,60-64세,3385,1840,1545
202007,46860,전라남도,함평군,65-69세,2588,1252,1336
202008,46860,전라남도,함평군,65-69세,2594,1253,1341
202009,46860,전라남도,함평군,65-69세,2612,1266,1346
202010,46860,전라남도,함평군,65-69세,2620,1278,1342
202011,46860,전라남도,함평군,65-69세,2626,1285,1341
202012,46860,전라남도,함평군,65-69세,2646,1296,1350
202101,46860,전라남도,함평군,65-69세,2656,1307,1349
202102,46860,전라남도,함평군,65-69세,2683,1336,1347
202103,46860,전라남도,함평군,65-69세,2693,1350,1343
202104,46860,전라남도,함평군,65-69세,2703,1360,1343
202105,46860,전라남도,함평군,65-69세,2709,1379,1330
202106,46860,전라남도,함평군,65-69세,2718,1382,1336
202007,46860,전라남도,함평군,70-74세,2543,1163,1380
202008,46860,전라남도,함평군,70-74세,2536,1166,1370
202009,46860,전라남도,함평군,70-74세,2543,1174,1369
202010,46860,전라남도,함평군,70-74세,2550,1170,1380
202011,46860,전라남도,함평군,70-74세,2560,1168,1392
202012,46860,전라남도,함평군,70-74세,2566,1183,1383
202101,46860,전라남도,함평군,70-74세,2574,1187,1387
202102,46860,전라남도,함평군,70-74세,2568,1180,1388
202103,46860,전라남도,함평군,70-74세,2535,1172,1363
202104,46860,전라남도,함평군,70-74세,2534,1173,1361
202105,46860,전라남도,함평군,70-74세,2530,1168,1362
202106,46860,전라남도,함평군,70-74세,2529,1168,1361
202007,46860,전라남도,함평군,75-79세,2673,1006,1667
202008,46860,전라남도,함평군,75-79세,2655,1004,1651
202009,46860,전라남도,함평군,75-79세,2639,998,1641
202010,46860,전라남도,함평군,75-79세,2613,982,1631
202011,46860,전라남도,함평군,75-79세,2605,981,1624
202012,46860,전라남도,함평군,75-79세,2589,964,1625
202101,46860,전라남도,함평군,75-79세,2565,965,1600
202102,46860,전라남도,함평군,75-79세,2540,960,1580
202103,46860,전라남도,함평군,75-79세,2527,959,1568
202104,46860,전라남도,함평군,75-79세,2503,951,1552
202105,46860,전라남도,함평군,75-79세,2489,949,1540
202106,46860,전라남도,함평군,75-79세,2479,950,1529
202007,46860,전라남도,함평군,80-84세,2290,728,1562
202008,46860,전라남도,함평군,80-84세,2296,729,1567
202009,46860,전라남도,함평군,80-84세,2295,732,1563
202010,46860,전라남도,함평군,80-84세,2298,741,1557
202011,46860,전라남도,함평군,80-84세,2287,742,1545
202012,46860,전라남도,함평군,80-84세,2286,739,1547
202101,46860,전라남도,함평군,80-84세,2293,732,1561
202102,46860,전라남도,함평군,80-84세,2293,730,1563
202103,46860,전라남도,함평군,80-84세,2285,729,1556
202104,46860,전라남도,함평군,80-84세,2288,738,1550
202105,46860,전라남도,함평군,80-84세,2314,749,1565
202106,46860,전라남도,함평군,80-84세,2326,754,1572
202007,46860,전라남도,함평군,85-89세,1078,273,805
202008,46860,전라남도,함평군,85-89세,1078,270,808
202009,46860,전라남도,함평군,85-89세,1101,271,830
202010,46860,전라남도,함평군,85-89세,1117,274,843
202011,46860,전라남도,함평군,85-89세,1114,275,839
202012,46860,전라남도,함평군,85-89세,1118,279,839
202101,46860,전라남도,함평군,85-89세,1128,288,840
202102,46860,전라남도,함평군,85-89세,1163,301,862
202103,46860,전라남도,함평군,85-89세,1174,300,874
202104,46860,전라남도,함평군,85-89세,1199,307,892
202105,46860,전라남도,함평군,85-89세,1200,310,890
202106,46860,전라남도,함평군,85-89세,1202,310,892
202007,46860,전라남도,함평군,90-94세,379,96,283
202008,46860,전라남도,함평군,90-94세,386,98,288
202009,46860,전라남도,함평군,90-94세,392,99,293
202010,46860,전라남도,함평군,90-94세,394,100,294
202011,46860,전라남도,함평군,90-94세,397,101,296
202012,46860,전라남도,함평군,90-94세,396,103,293
202101,46860,전라남도,함평군,90-94세,400,103,297
202102,46860,전라남도,함평군,90-94세,401,104,297
202103,46860,전라남도,함평군,90-94세,408,105,303
202104,46860,전라남도,함평군,90-94세,408,103,305
202105,46860,전라남도,함평군,90-94세,419,104,315
202106,46860,전라남도,함평군,90-94세,420,103,317
202007,46860,전라남도,함평군,95-99세,95,11,84
202008,46860,전라남도,함평군,95-99세,95,11,84
202009,46860,전라남도,함평군,95-99세,98,11,87
202010,46860,전라남도,함평군,95-99세,96,11,85
202011,46860,전라남도,함평군,95-99세,94,10,84
202012,46860,전라남도,함평군,95-99세,94,10,84
202101,46860,전라남도,함평군,95-99세,93,11,82
202102,46860,전라남도,함평군,95-99세,94,11,83
202103,46860,전라남도,함평군,95-99세,94,11,83
202104,46860,전라남도,함평군,95-99세,96,11,85
202105,46860,전라남도,함평군,95-99세,94,13,81
202106,46860,전라남도,함평군,95-99세,90,13,77
202007,46860,전라남도,함평군,100+,26,3,23
202008,46860,전라남도,함평군,100+,27,3,24
202009,46860,전라남도,함평군,100+,28,3,25
202010,46860,전라남도,함평군,100+,26,2,24
202011,46860,전라남도,함평군,100+,26,2,24
202012,46860,전라남도,함평군,100+,25,2,23
202101,46860,전라남도,함평군,100+,27,2,25
202102,46860,전라남도,함평군,100+,28,2,26
202103,46860,전라남도,함평군,100+,18,2,16
202104,46860,전라남도,함평군,100+,13,0,13
202105,46860,전라남도,함평군,100+,13,0,13
202106,46860,전라남도,함평군,100+,14,0,14
202007,46870,전라남도,영광군,0-4세,2031,1034,997
202008,46870,전라남도,영광군,0-4세,2049,1045,1004
202009,46870,전라남도,영광군,0-4세,2058,1049,1009
202010,46870,전라남도,영광군,0-4세,2040,1046,994
202011,46870,전라남도,영광군,0-4세,2034,1043,991
202012,46870,전라남도,영광군,0-4세,2037,1042,995
202101,46870,전라남도,영광군,0-4세,2031,1036,995
202102,46870,전라남도,영광군,0-4세,2030,1036,994
202103,46870,전라남도,영광군,0-4세,2022,1033,989
202104,46870,전라남도,영광군,0-4세,2004,1018,986
202105,46870,전라남도,영광군,0-4세,2014,1028,986
202106,46870,전라남도,영광군,0-4세,2018,1027,991
202007,46870,전라남도,영광군,5-9세,1784,908,876
202008,46870,전라남도,영광군,5-9세,1771,904,867
202009,46870,전라남도,영광군,5-9세,1756,898,858
202010,46870,전라남도,영광군,5-9세,1753,896,857
202011,46870,전라남도,영광군,5-9세,1736,884,852
202012,46870,전라남도,영광군,5-9세,1728,884,844
202101,46870,전라남도,영광군,5-9세,1729,883,846
202102,46870,전라남도,영광군,5-9세,1721,873,848
202103,46870,전라남도,영광군,5-9세,1701,868,833
202104,46870,전라남도,영광군,5-9세,1685,855,830
202105,46870,전라남도,영광군,5-9세,1689,858,831
202106,46870,전라남도,영광군,5-9세,1690,860,830
202007,46870,전라남도,영광군,10-14세,1980,1016,964
202008,46870,전라남도,영광군,10-14세,1985,1017,968
202009,46870,전라남도,영광군,10-14세,1991,1022,969
202010,46870,전라남도,영광군,10-14세,1981,1015,966
202011,46870,전라남도,영광군,10-14세,1990,1017,973
202012,46870,전라남도,영광군,10-14세,1993,1009,984
202101,46870,전라남도,영광군,10-14세,1997,1022,975
202102,46870,전라남도,영광군,10-14세,1992,1027,965
202103,46870,전라남도,영광군,10-14세,2010,1028,982
202104,46870,전라남도,영광군,10-14세,2006,1032,974
202105,46870,전라남도,영광군,10-14세,2000,1031,969
202106,46870,전라남도,영광군,10-14세,1985,1020,965
202007,46870,전라남도,영광군,15-19세,2291,1210,1081
202008,46870,전라남도,영광군,15-19세,2264,1197,1067
202009,46870,전라남도,영광군,15-19세,2241,1179,1062
202010,46870,전라남도,영광군,15-19세,2214,1155,1059
202011,46870,전라남도,영광군,15-19세,2209,1157,1052
202012,46870,전라남도,영광군,15-19세,2176,1138,1038
202101,46870,전라남도,영광군,15-19세,2166,1141,1025
202102,46870,전라남도,영광군,15-19세,2159,1138,1021
202103,46870,전라남도,영광군,15-19세,2127,1132,995
202104,46870,전라남도,영광군,15-19세,2129,1137,992
202105,46870,전라남도,영광군,15-19세,2121,1129,992
202106,46870,전라남도,영광군,15-19세,2118,1130,988
202007,46870,전라남도,영광군,20-24세,2669,1534,1135
202008,46870,전라남도,영광군,20-24세,2663,1522,1141
202009,46870,전라남도,영광군,20-24세,2637,1508,1129
202010,46870,전라남도,영광군,20-24세,2637,1512,1125
202011,46870,전라남도,영광군,20-24세,2629,1501,1128
202012,46870,전라남도,영광군,20-24세,2612,1501,1111
202101,46870,전라남도,영광군,20-24세,2607,1499,1108
202102,46870,전라남도,영광군,20-24세,2589,1485,1104
202103,46870,전라남도,영광군,20-24세,2574,1485,1089
202104,46870,전라남도,영광군,20-24세,2553,1471,1082
202105,46870,전라남도,영광군,20-24세,2534,1466,1068
202106,46870,전라남도,영광군,20-24세,2517,1454,1063
202007,46870,전라남도,영광군,25-29세,2376,1291,1085
202008,46870,전라남도,영광군,25-29세,2360,1279,1081
202009,46870,전라남도,영광군,25-29세,2370,1292,1078
202010,46870,전라남도,영광군,25-29세,2372,1293,1079
202011,46870,전라남도,영광군,25-29세,2393,1315,1078
202012,46870,전라남도,영광군,25-29세,2400,1312,1088
202101,46870,전라남도,영광군,25-29세,2388,1304,1084
202102,46870,전라남도,영광군,25-29세,2337,1273,1064
202103,46870,전라남도,영광군,25-29세,2346,1290,1056
202104,46870,전라남도,영광군,25-29세,2341,1295,1046
202105,46870,전라남도,영광군,25-29세,2333,1284,1049
202106,46870,전라남도,영광군,25-29세,2321,1271,1050
202007,46870,전라남도,영광군,30-34세,2310,1180,1130
202008,46870,전라남도,영광군,30-34세,2295,1181,1114
202009,46870,전라남도,영광군,30-34세,2279,1175,1104
202010,46870,전라남도,영광군,30-34세,2273,1176,1097
202011,46870,전라남도,영광군,30-34세,2272,1178,1094
202012,46870,전라남도,영광군,30-34세,2278,1176,1102
202101,46870,전라남도,영광군,30-34세,2256,1160,1096
202102,46870,전라남도,영광군,30-34세,2242,1149,1093
202103,46870,전라남도,영광군,30-34세,2242,1145,1097
202104,46870,전라남도,영광군,30-34세,2255,1145,1110
202105,46870,전라남도,영광군,30-34세,2253,1135,1118
202106,46870,전라남도,영광군,30-34세,2240,1127,1113
202007,46870,전라남도,영광군,35-39세,2635,1370,1265
202008,46870,전라남도,영광군,35-39세,2625,1352,1273
202009,46870,전라남도,영광군,35-39세,2625,1348,1277
202010,46870,전라남도,영광군,35-39세,2617,1343,1274
202011,46870,전라남도,영광군,35-39세,2616,1340,1276
202012,46870,전라남도,영광군,35-39세,2593,1332,1261
202101,46870,전라남도,영광군,35-39세,2580,1325,1255
202102,46870,전라남도,영광군,35-39세,2563,1329,1234
202103,46870,전라남도,영광군,35-39세,2533,1325,1208
202104,46870,전라남도,영광군,35-39세,2527,1333,1194
202105,46870,전라남도,영광군,35-39세,2497,1312,1185
202106,46870,전라남도,영광군,35-39세,2487,1314,1173
202007,46870,전라남도,영광군,40-44세,2950,1665,1285
202008,46870,전라남도,영광군,40-44세,2946,1659,1287
202009,46870,전라남도,영광군,40-44세,2928,1644,1284
202010,46870,전라남도,영광군,40-44세,2916,1638,1278
202011,46870,전라남도,영광군,40-44세,2907,1631,1276
202012,46870,전라남도,영광군,40-44세,2892,1621,1271
202101,46870,전라남도,영광군,40-44세,2889,1611,1278
202102,46870,전라남도,영광군,40-44세,2873,1593,1280
202103,46870,전라남도,영광군,40-44세,2855,1583,1272
202104,46870,전라남도,영광군,40-44세,2836,1559,1277
202105,46870,전라남도,영광군,40-44세,2845,1561,1284
202106,46870,전라남도,영광군,40-44세,2854,1561,1293
202007,46870,전라남도,영광군,45-49세,3719,2135,1584
202008,46870,전라남도,영광군,45-49세,3714,2131,1583
202009,46870,전라남도,영광군,45-49세,3707,2117,1590
202010,46870,전라남도,영광군,45-49세,3687,2104,1583
202011,46870,전라남도,영광군,45-49세,3670,2089,1581
202012,46870,전라남도,영광군,45-49세,3661,2081,1580
202101,46870,전라남도,영광군,45-49세,3648,2069,1579
202102,46870,전라남도,영광군,45-49세,3631,2059,1572
202103,46870,전라남도,영광군,45-49세,3592,2045,1547
202104,46870,전라남도,영광군,45-49세,3561,2031,1530
202105,46870,전라남도,영광군,45-49세,3520,2020,1500
202106,46870,전라남도,영광군,45-49세,3494,2011,1483
202007,46870,전라남도,영광군,50-54세,4154,2358,1796
202008,46870,전라남도,영광군,50-54세,4134,2346,1788
202009,46870,전라남도,영광군,50-54세,4111,2338,1773
202010,46870,전라남도,영광군,50-54세,4100,2329,1771
202011,46870,전라남도,영광군,50-54세,4106,2340,1766
202012,46870,전라남도,영광군,50-54세,4078,2323,1755
202101,46870,전라남도,영광군,50-54세,4096,2341,1755
202102,46870,전라남도,영광군,50-54세,4119,2355,1764
202103,46870,전라남도,영광군,50-54세,4060,2330,1730
202104,46870,전라남도,영광군,50-54세,4061,2330,1731
202105,46870,전라남도,영광군,50-54세,4092,2340,1752
202106,46870,전라남도,영광군,50-54세,4074,2322,1752
202007,46870,전라남도,영광군,55-59세,4524,2388,2136
202008,46870,전라남도,영광군,55-59세,4515,2391,2124
202009,46870,전라남도,영광군,55-59세,4502,2400,2102
202010,46870,전라남도,영광군,55-59세,4492,2405,2087
202011,46870,전라남도,영광군,55-59세,4467,2380,2087
202012,46870,전라남도,영광군,55-59세,4465,2388,2077
202101,46870,전라남도,영광군,55-59세,4420,2363,2057
202102,46870,전라남도,영광군,55-59세,4421,2374,2047
202103,46870,전라남도,영광군,55-59세,4388,2362,2026
202104,46870,전라남도,영광군,55-59세,4404,2372,2032
202105,46870,전라남도,영광군,55-59세,4395,2376,2019
202106,46870,전라남도,영광군,55-59세,4373,2357,2016
202007,46870,전라남도,영광군,60-64세,4627,2402,2225
202008,46870,전라남도,영광군,60-64세,4629,2419,2210
202009,46870,전라남도,영광군,60-64세,4648,2422,2226
202010,46870,전라남도,영광군,60-64세,4667,2433,2234
202011,46870,전라남도,영광군,60-64세,4689,2449,2240
202012,46870,전라남도,영광군,60-64세,4698,2454,2244
202101,46870,전라남도,영광군,60-64세,4712,2454,2258
202102,46870,전라남도,영광군,60-64세,4730,2450,2280
202103,46870,전라남도,영광군,60-64세,4721,2461,2260
202104,46870,전라남도,영광군,60-64세,4732,2464,2268
202105,46870,전라남도,영광군,60-64세,4757,2474,2283
202106,46870,전라남도,영광군,60-64세,4773,2482,2291
202007,46870,전라남도,영광군,65-69세,3742,1793,1949
202008,46870,전라남도,영광군,65-69세,3756,1794,1962
202009,46870,전라남도,영광군,65-69세,3753,1793,1960
202010,46870,전라남도,영광군,65-69세,3759,1797,1962
202011,46870,전라남도,영광군,65-69세,3767,1808,1959
202012,46870,전라남도,영광군,65-69세,3769,1807,1962
202101,46870,전라남도,영광군,65-69세,3772,1810,1962
202102,46870,전라남도,영광군,65-69세,3774,1822,1952
202103,46870,전라남도,영광군,65-69세,3779,1837,1942
202104,46870,전라남도,영광군,65-69세,3785,1852,1933
202105,46870,전라남도,영광군,65-69세,3776,1858,1918
202106,46870,전라남도,영광군,65-69세,3774,1852,1922
202007,46870,전라남도,영광군,70-74세,3581,1640,1941
202008,46870,전라남도,영광군,70-74세,3596,1645,1951
202009,46870,전라남도,영광군,70-74세,3630,1667,1963
202010,46870,전라남도,영광군,70-74세,3649,1676,1973
202011,46870,전라남도,영광군,70-74세,3655,1676,1979
202012,46870,전라남도,영광군,70-74세,3670,1681,1989
202101,46870,전라남도,영광군,70-74세,3684,1687,1997
202102,46870,전라남도,영광군,70-74세,3684,1694,1990
202103,46870,전라남도,영광군,70-74세,3684,1687,1997
202104,46870,전라남도,영광군,70-74세,3675,1686,1989
202105,46870,전라남도,영광군,70-74세,3688,1688,2000
202106,46870,전라남도,영광군,70-74세,3680,1691,1989
202007,46870,전라남도,영광군,75-79세,3556,1406,2150
202008,46870,전라남도,영광군,75-79세,3546,1402,2144
202009,46870,전라남도,영광군,75-79세,3526,1397,2129
202010,46870,전라남도,영광군,75-79세,3510,1399,2111
202011,46870,전라남도,영광군,75-79세,3498,1391,2107
202012,46870,전라남도,영광군,75-79세,3501,1394,2107
202101,46870,전라남도,영광군,75-79세,3485,1399,2086
202102,46870,전라남도,영광군,75-79세,3462,1389,2073
202103,46870,전라남도,영광군,75-79세,3408,1368,2040
202104,46870,전라남도,영광군,75-79세,3386,1354,2032
202105,46870,전라남도,영광군,75-79세,3368,1343,2025
202106,46870,전라남도,영광군,75-79세,3359,1342,2017
202007,46870,전라남도,영광군,80-84세,2707,882,1825
202008,46870,전라남도,영광군,80-84세,2693,873,1820
202009,46870,전라남도,영광군,80-84세,2690,872,1818
202010,46870,전라남도,영광군,80-84세,2694,872,1822
202011,46870,전라남도,영광군,80-84세,2692,872,1820
202012,46870,전라남도,영광군,80-84세,2681,874,1807
202101,46870,전라남도,영광군,80-84세,2695,877,1818
202102,46870,전라남도,영광군,80-84세,2707,881,1826
202103,46870,전라남도,영광군,80-84세,2723,883,1840
202104,46870,전라남도,영광군,80-84세,2739,886,1853
202105,46870,전라남도,영광군,80-84세,2762,904,1858
202106,46870,전라남도,영광군,80-84세,2793,916,1877
202007,46870,전라남도,영광군,85-89세,1224,332,892
202008,46870,전라남도,영광군,85-89세,1243,340,903
202009,46870,전라남도,영광군,85-89세,1271,346,925
202010,46870,전라남도,영광군,85-89세,1283,343,940
202011,46870,전라남도,영광군,85-89세,1272,337,935
202012,46870,전라남도,영광군,85-89세,1284,341,943
202101,46870,전라남도,영광군,85-89세,1308,355,953
202102,46870,전라남도,영광군,85-89세,1322,359,963
202103,46870,전라남도,영광군,85-89세,1327,361,966
202104,46870,전라남도,영광군,85-89세,1336,369,967
202105,46870,전라남도,영광군,85-89세,1352,371,981
202106,46870,전라남도,영광군,85-89세,1363,371,992
202007,46870,전라남도,영광군,90-94세,421,86,335
202008,46870,전라남도,영광군,90-94세,423,89,334
202009,46870,전라남도,영광군,90-94세,425,91,334
202010,46870,전라남도,영광군,90-94세,422,92,330
202011,46870,전라남도,영광군,90-94세,425,94,331
202012,46870,전라남도,영광군,90-94세,431,97,334
202101,46870,전라남도,영광군,90-94세,431,98,333
202102,46870,전라남도,영광군,90-94세,435,101,334
202103,46870,전라남도,영광군,90-94세,442,101,341
202104,46870,전라남도,영광군,90-94세,442,102,340
202105,46870,전라남도,영광군,90-94세,445,102,343
202106,46870,전라남도,영광군,90-94세,443,101,342
202007,46870,전라남도,영광군,95-99세,125,12,113
202008,46870,전라남도,영광군,95-99세,124,12,112
202009,46870,전라남도,영광군,95-99세,125,12,113
202010,46870,전라남도,영광군,95-99세,126,12,114
202011,46870,전라남도,영광군,95-99세,123,12,111
202012,46870,전라남도,영광군,95-99세,118,10,108
202101,46870,전라남도,영광군,95-99세,119,9,110
202102,46870,전라남도,영광군,95-99세,118,9,109
202103,46870,전라남도,영광군,95-99세,106,9,97
202104,46870,전라남도,영광군,95-99세,106,8,98
202105,46870,전라남도,영광군,95-99세,106,8,98
202106,46870,전라남도,영광군,95-99세,106,8,98
202007,46870,전라남도,영광군,100+,34,4,30
202008,46870,전라남도,영광군,100+,34,3,31
202009,46870,전라남도,영광군,100+,35,3,32
202010,46870,전라남도,영광군,100+,34,3,31
202011,46870,전라남도,영광군,100+,33,3,30
202012,46870,전라남도,영광군,100+,34,3,31
202101,46870,전라남도,영광군,100+,35,3,32
202102,46870,전라남도,영광군,100+,35,3,32
202103,46870,전라남도,영광군,100+,23,0,23
202104,46870,전라남도,영광군,100+,24,0,24
202105,46870,전라남도,영광군,100+,24,0,24
202106,46870,전라남도,영광군,100+,25,0,25
202007,46880,전라남도,장성군,0-4세,1345,691,654
202008,46880,전라남도,장성군,0-4세,1325,686,639
202009,46880,전라남도,장성군,0-4세,1304,674,630
202010,46880,전라남도,장성군,0-4세,1286,668,618
202011,46880,전라남도,장성군,0-4세,1278,665,613
202012,46880,전라남도,장성군,0-4세,1250,649,601
202101,46880,전라남도,장성군,0-4세,1224,640,584
202102,46880,전라남도,장성군,0-4세,1224,640,584
202103,46880,전라남도,장성군,0-4세,1200,626,574
202104,46880,전라남도,장성군,0-4세,1182,614,568
202105,46880,전라남도,장성군,0-4세,1159,605,554
202106,46880,전라남도,장성군,0-4세,1135,591,544
202007,46880,전라남도,장성군,5-9세,1575,775,800
202008,46880,전라남도,장성군,5-9세,1553,762,791
202009,46880,전라남도,장성군,5-9세,1549,758,791
202010,46880,전라남도,장성군,5-9세,1531,748,783
202011,46880,전라남도,장성군,5-9세,1521,740,781
202012,46880,전라남도,장성군,5-9세,1531,754,777
202101,46880,전라남도,장성군,5-9세,1510,745,765
202102,46880,전라남도,장성군,5-9세,1521,752,769
202103,46880,전라남도,장성군,5-9세,1511,743,768
202104,46880,전라남도,장성군,5-9세,1509,748,761
202105,46880,전라남도,장성군,5-9세,1494,742,752
202106,46880,전라남도,장성군,5-9세,1486,743,743
202007,46880,전라남도,장성군,10-14세,1561,820,741
202008,46880,전라남도,장성군,10-14세,1568,820,748
202009,46880,전라남도,장성군,10-14세,1564,816,748
202010,46880,전라남도,장성군,10-14세,1563,813,750
202011,46880,전라남도,장성군,10-14세,1574,819,755
202012,46880,전라남도,장성군,10-14세,1550,811,739
202101,46880,전라남도,장성군,10-14세,1548,807,741
202102,46880,전라남도,장성군,10-14세,1558,827,731
202103,46880,전라남도,장성군,10-14세,1555,827,728
202104,46880,전라남도,장성군,10-14세,1555,829,726
202105,46880,전라남도,장성군,10-14세,1561,833,728
202106,46880,전라남도,장성군,10-14세,1552,823,729
202007,46880,전라남도,장성군,15-19세,1752,934,818
202008,46880,전라남도,장성군,15-19세,1738,924,814
202009,46880,전라남도,장성군,15-19세,1744,930,814
202010,46880,전라남도,장성군,15-19세,1750,934,816
202011,46880,전라남도,장성군,15-19세,1735,927,808
202012,46880,전라남도,장성군,15-19세,1733,920,813
202101,46880,전라남도,장성군,15-19세,1721,913,808
202102,46880,전라남도,장성군,15-19세,1716,898,818
202103,46880,전라남도,장성군,15-19세,1693,894,799
202104,46880,전라남도,장성군,15-19세,1679,881,798
202105,46880,전라남도,장성군,15-19세,1654,862,792
202106,46880,전라남도,장성군,15-19세,1658,867,791
202007,46880,전라남도,장성군,20-24세,2148,1219,929
202008,46880,전라남도,장성군,20-24세,2116,1203,913
202009,46880,전라남도,장성군,20-24세,2083,1187,896
202010,46880,전라남도,장성군,20-24세,2059,1177,882
202011,46880,전라남도,장성군,20-24세,2026,1158,868
202012,46880,전라남도,장성군,20-24세,2033,1166,867
202101,46880,전라남도,장성군,20-24세,2060,1181,879
202102,46880,전라남도,장성군,20-24세,2051,1188,863
202103,46880,전라남도,장성군,20-24세,2019,1171,848
202104,46880,전라남도,장성군,20-24세,2022,1169,853
202105,46880,전라남도,장성군,20-24세,2006,1172,834
202106,46880,전라남도,장성군,20-24세,1991,1161,830
202007,46880,전라남도,장성군,25-29세,2360,1500,860
202008,46880,전라남도,장성군,25-29세,2302,1446,856
202009,46880,전라남도,장성군,25-29세,2284,1424,860
202010,46880,전라남도,장성군,25-29세,2241,1394,847
202011,46880,전라남도,장성군,25-29세,2227,1377,850
202012,46880,전라남도,장성군,25-29세,2240,1376,864
202101,46880,전라남도,장성군,25-29세,2161,1308,853
202102,46880,전라남도,장성군,25-29세,2148,1294,854
202103,46880,전라남도,장성군,25-29세,2147,1292,855
202104,46880,전라남도,장성군,25-29세,2147,1292,855
202105,46880,전라남도,장성군,25-29세,2129,1287,842
202106,46880,전라남도,장성군,25-29세,2091,1259,832
202007,46880,전라남도,장성군,30-34세,1672,873,799
202008,46880,전라남도,장성군,30-34세,1654,872,782
202009,46880,전라남도,장성군,30-34세,1631,862,769
202010,46880,전라남도,장성군,30-34세,1608,848,760
202011,46880,전라남도,장성군,30-34세,1613,843,770
202012,46880,전라남도,장성군,30-34세,1589,834,755
202101,46880,전라남도,장성군,30-34세,1570,827,743
202102,46880,전라남도,장성군,30-34세,1592,846,746
202103,46880,전라남도,장성군,30-34세,1577,833,744
202104,46880,전라남도,장성군,30-34세,1564,825,739
202105,46880,전라남도,장성군,30-34세,1558,817,741
202106,46880,전라남도,장성군,30-34세,1544,821,723
202007,46880,전라남도,장성군,35-39세,2151,1155,996
202008,46880,전라남도,장성군,35-39세,2148,1157,991
202009,46880,전라남도,장성군,35-39세,2116,1136,980
202010,46880,전라남도,장성군,35-39세,2075,1117,958
202011,46880,전라남도,장성군,35-39세,2071,1106,965
202012,46880,전라남도,장성군,35-39세,2072,1107,965
202101,46880,전라남도,장성군,35-39세,2044,1104,940
202102,46880,전라남도,장성군,35-39세,2058,1111,947
202103,46880,전라남도,장성군,35-39세,2015,1086,929
202104,46880,전라남도,장성군,35-39세,1990,1077,913
202105,46880,전라남도,장성군,35-39세,1977,1075,902
202106,46880,전라남도,장성군,35-39세,1964,1065,899
202007,46880,전라남도,장성군,40-44세,2531,1424,1107
202008,46880,전라남도,장성군,40-44세,2522,1422,1100
202009,46880,전라남도,장성군,40-44세,2522,1423,1099
202010,46880,전라남도,장성군,40-44세,2498,1409,1089
202011,46880,전라남도,장성군,40-44세,2499,1417,1082
202012,46880,전라남도,장성군,40-44세,2461,1394,1067
202101,46880,전라남도,장성군,40-44세,2450,1374,1076
202102,46880,전라남도,장성군,40-44세,2466,1376,1090
202103,46880,전라남도,장성군,40-44세,2453,1376,1077
202104,46880,전라남도,장성군,40-44세,2437,1370,1067
202105,46880,전라남도,장성군,40-44세,2442,1371,1071
202106,46880,전라남도,장성군,40-44세,2431,1353,1078
202007,46880,전라남도,장성군,45-49세,3177,1864,1313
202008,46880,전라남도,장성군,45-49세,3132,1823,1309
202009,46880,전라남도,장성군,45-49세,3122,1814,1308
202010,46880,전라남도,장성군,45-49세,3104,1792,1312
202011,46880,전라남도,장성군,45-49세,3077,1777,1300
202012,46880,전라남도,장성군,45-49세,3075,1772,1303
202101,46880,전라남도,장성군,45-49세,3060,1760,1300
202102,46880,전라남도,장성군,45-49세,3047,1760,1287
202103,46880,전라남도,장성군,45-49세,3016,1733,1283
202104,46880,전라남도,장성군,45-49세,3009,1720,1289
202105,46880,전라남도,장성군,45-49세,2961,1689,1272
202106,46880,전라남도,장성군,45-49세,2945,1680,1265
202007,46880,전라남도,장성군,50-54세,3590,2089,1501
202008,46880,전라남도,장성군,50-54세,3575,2081,1494
202009,46880,전라남도,장성군,50-54세,3591,2086,1505
202010,46880,전라남도,장성군,50-54세,3594,2095,1499
202011,46880,전라남도,장성군,50-54세,3591,2110,1481
202012,46880,전라남도,장성군,50-54세,3557,2087,1470
202101,46880,전라남도,장성군,50-54세,3557,2095,1462
202102,46880,전라남도,장성군,50-54세,3567,2099,1468
202103,46880,전라남도,장성군,50-54세,3519,2080,1439
202104,46880,전라남도,장성군,50-54세,3508,2070,1438
202105,46880,전라남도,장성군,50-54세,3534,2082,1452
202106,46880,전라남도,장성군,50-54세,3557,2097,1460
202007,46880,전라남도,장성군,55-59세,3985,2205,1780
202008,46880,전라남도,장성군,55-59세,3973,2210,1763
202009,46880,전라남도,장성군,55-59세,3950,2198,1752
202010,46880,전라남도,장성군,55-59세,3923,2194,1729
202011,46880,전라남도,장성군,55-59세,3913,2172,1741
202012,46880,전라남도,장성군,55-59세,3924,2181,1743
202101,46880,전라남도,장성군,55-59세,3904,2173,1731
202102,46880,전라남도,장성군,55-59세,3908,2167,1741
202103,46880,전라남도,장성군,55-59세,3909,2174,1735
202104,46880,전라남도,장성군,55-59세,3918,2181,1737
202105,46880,전라남도,장성군,55-59세,3921,2191,1730
202106,46880,전라남도,장성군,55-59세,3875,2166,1709
202007,46880,전라남도,장성군,60-64세,3974,2137,1837
202008,46880,전라남도,장성군,60-64세,4002,2148,1854
202009,46880,전라남도,장성군,60-64세,4006,2156,1850
202010,46880,전라남도,장성군,60-64세,4022,2163,1859
202011,46880,전라남도,장성군,60-64세,4046,2190,1856
202012,46880,전라남도,장성군,60-64세,4049,2205,1844
202101,46880,전라남도,장성군,60-64세,4076,2219,1857
202102,46880,전라남도,장성군,60-64세,4096,2239,1857
202103,46880,전라남도,장성군,60-64세,4092,2237,1855
202104,46880,전라남도,장성군,60-64세,4118,2254,1864
202105,46880,전라남도,장성군,60-64세,4145,2256,1889
202106,46880,전라남도,장성군,60-64세,4183,2276,1907
202007,46880,전라남도,장성군,65-69세,3127,1565,1562
202008,46880,전라남도,장성군,65-69세,3135,1577,1558
202009,46880,전라남도,장성군,65-69세,3170,1597,1573
202010,46880,전라남도,장성군,65-69세,3178,1595,1583
202011,46880,전라남도,장성군,65-69세,3189,1596,1593
202012,46880,전라남도,장성군,65-69세,3211,1607,1604
202101,46880,전라남도,장성군,65-69세,3225,1618,1607
202102,46880,전라남도,장성군,65-69세,3246,1631,1615
202103,46880,전라남도,장성군,65-69세,3263,1657,1606
202104,46880,전라남도,장성군,65-69세,3277,1666,1611
202105,46880,전라남도,장성군,65-69세,3290,1680,1610
202106,46880,전라남도,장성군,65-69세,3291,1684,1607
202007,46880,전라남도,장성군,70-74세,3006,1417,1589
202008,46880,전라남도,장성군,70-74세,3008,1410,1598
202009,46880,전라남도,장성군,70-74세,3012,1408,1604
202010,46880,전라남도,장성군,70-74세,3033,1417,1616
202011,46880,전라남도,장성군,70-74세,3054,1429,1625
202012,46880,전라남도,장성군,70-74세,3071,1434,1637
202101,46880,전라남도,장성군,70-74세,3087,1440,1647
202102,46880,전라남도,장성군,70-74세,3101,1449,1652
202103,46880,전라남도,장성군,70-74세,3077,1440,1637
202104,46880,전라남도,장성군,70-74세,3070,1435,1635
202105,46880,전라남도,장성군,70-74세,3077,1442,1635
202106,46880,전라남도,장성군,70-74세,3089,1444,1645
202007,46880,전라남도,장성군,75-79세,2976,1201,1775
202008,46880,전라남도,장성군,75-79세,2957,1206,1751
202009,46880,전라남도,장성군,75-79세,2930,1198,1732
202010,46880,전라남도,장성군,75-79세,2915,1198,1717
202011,46880,전라남도,장성군,75-79세,2894,1184,1710
202012,46880,전라남도,장성군,75-79세,2866,1178,1688
202101,46880,전라남도,장성군,75-79세,2830,1171,1659
202102,46880,전라남도,장성군,75-79세,2810,1163,1647
202103,46880,전라남도,장성군,75-79세,2788,1153,1635
202104,46880,전라남도,장성군,75-79세,2765,1154,1611
202105,46880,전라남도,장성군,75-79세,2756,1149,1607
202106,46880,전라남도,장성군,75-79세,2737,1135,1602
202007,46880,전라남도,장성군,80-84세,2423,822,1601
202008,46880,전라남도,장성군,80-84세,2426,822,1604
202009,46880,전라남도,장성군,80-84세,2414,822,1592
202010,46880,전라남도,장성군,80-84세,2413,817,1596
202011,46880,전라남도,장성군,80-84세,2410,819,1591
202012,46880,전라남도,장성군,80-84세,2402,816,1586
202101,46880,전라남도,장성군,80-84세,2432,824,1608
202102,46880,전라남도,장성군,80-84세,2435,830,1605
202103,46880,전라남도,장성군,80-84세,2423,821,1602
202104,46880,전라남도,장성군,80-84세,2439,822,1617
202105,46880,전라남도,장성군,80-84세,2458,832,1626
202106,46880,전라남도,장성군,80-84세,2472,842,1630
202007,46880,전라남도,장성군,85-89세,1247,360,887
202008,46880,전라남도,장성군,85-89세,1254,358,896
202009,46880,전라남도,장성군,85-89세,1279,358,921
202010,46880,전라남도,장성군,85-89세,1282,358,924
202011,46880,전라남도,장성군,85-89세,1282,361,921
202012,46880,전라남도,장성군,85-89세,1308,367,941
202101,46880,전라남도,장성군,85-89세,1323,371,952
202102,46880,전라남도,장성군,85-89세,1331,376,955
202103,46880,전라남도,장성군,85-89세,1336,382,954
202104,46880,전라남도,장성군,85-89세,1350,395,955
202105,46880,전라남도,장성군,85-89세,1366,394,972
202106,46880,전라남도,장성군,85-89세,1373,397,976
202007,46880,전라남도,장성군,90-94세,396,98,298
202008,46880,전라남도,장성군,90-94세,398,97,301
202009,46880,전라남도,장성군,90-94세,402,95,307
202010,46880,전라남도,장성군,90-94세,408,98,310
202011,46880,전라남도,장성군,90-94세,411,99,312
202012,46880,전라남도,장성군,90-94세,407,95,312
202101,46880,전라남도,장성군,90-94세,412,101,311
202102,46880,전라남도,장성군,90-94세,422,100,322
202103,46880,전라남도,장성군,90-94세,423,102,321
202104,46880,전라남도,장성군,90-94세,426,101,325
202105,46880,전라남도,장성군,90-94세,429,99,330
202106,46880,전라남도,장성군,90-94세,424,96,328
202007,46880,전라남도,장성군,95-99세,88,18,70
202008,46880,전라남도,장성군,95-99세,93,20,73
202009,46880,전라남도,장성군,95-99세,96,22,74
202010,46880,전라남도,장성군,95-99세,97,22,75
202011,46880,전라남도,장성군,95-99세,92,22,70
202012,46880,전라남도,장성군,95-99세,95,23,72
202101,46880,전라남도,장성군,95-99세,98,23,75
202102,46880,전라남도,장성군,95-99세,97,24,73
202103,46880,전라남도,장성군,95-99세,96,24,72
202104,46880,전라남도,장성군,95-99세,97,23,74
202105,46880,전라남도,장성군,95-99세,95,22,73
202106,46880,전라남도,장성군,95-99세,99,23,76
202007,46880,전라남도,장성군,100+,42,5,37
202008,46880,전라남도,장성군,100+,42,5,37
202009,46880,전라남도,장성군,100+,41,5,36
202010,46880,전라남도,장성군,100+,40,5,35
202011,46880,전라남도,장성군,100+,40,5,35
202012,46880,전라남도,장성군,100+,40,5,35
202101,46880,전라남도,장성군,100+,38,4,34
202102,46880,전라남도,장성군,100+,38,4,34
202103,46880,전라남도,장성군,100+,17,1,16
202104,46880,전라남도,장성군,100+,16,1,15
202105,46880,전라남도,장성군,100+,17,1,16
202106,46880,전라남도,장성군,100+,18,1,17
202007,46890,전라남도,완도군,0-4세,1480,757,723
202008,46890,전라남도,완도군,0-4세,1466,746,720
202009,46890,전라남도,완도군,0-4세,1449,737,712
202010,46890,전라남도,완도군,0-4세,1444,735,709
202011,46890,전라남도,완도군,0-4세,1418,719,699
202012,46890,전라남도,완도군,0-4세,1413,711,702
202101,46890,전라남도,완도군,0-4세,1393,698,695
202102,46890,전라남도,완도군,0-4세,1379,691,688
202103,46890,전라남도,완도군,0-4세,1360,674,686
202104,46890,전라남도,완도군,0-4세,1338,661,677
202105,46890,전라남도,완도군,0-4세,1319,654,665
202106,46890,전라남도,완도군,0-4세,1297,655,642
202007,46890,전라남도,완도군,5-9세,1778,927,851
202008,46890,전라남도,완도군,5-9세,1774,926,848
202009,46890,전라남도,완도군,5-9세,1764,928,836
202010,46890,전라남도,완도군,5-9세,1751,918,833
202011,46890,전라남도,완도군,5-9세,1747,920,827
202012,46890,전라남도,완도군,5-9세,1740,913,827
202101,46890,전라남도,완도군,5-9세,1739,910,829
202102,46890,전라남도,완도군,5-9세,1741,907,834
202103,46890,전라남도,완도군,5-9세,1739,914,825
202104,46890,전라남도,완도군,5-9세,1736,912,824
202105,46890,전라남도,완도군,5-9세,1734,901,833
202106,46890,전라남도,완도군,5-9세,1735,901,834
202007,46890,전라남도,완도군,10-14세,1736,884,852
202008,46890,전라남도,완도군,10-14세,1741,888,853
202009,46890,전라남도,완도군,10-14세,1738,886,852
202010,46890,전라남도,완도군,10-14세,1746,892,854
202011,46890,전라남도,완도군,10-14세,1749,893,856
202012,46890,전라남도,완도군,10-14세,1756,904,852
202101,46890,전라남도,완도군,10-14세,1750,914,836
202102,46890,전라남도,완도군,10-14세,1745,912,833
202103,46890,전라남도,완도군,10-14세,1740,907,833
202104,46890,전라남도,완도군,10-14세,1742,906,836
202105,46890,전라남도,완도군,10-14세,1736,904,832
202106,46890,전라남도,완도군,10-14세,1729,897,832
202007,46890,전라남도,완도군,15-19세,1946,1006,940
202008,46890,전라남도,완도군,15-19세,1938,1001,937
202009,46890,전라남도,완도군,15-19세,1931,1002,929
202010,46890,전라남도,완도군,15-19세,1921,995,926
202011,46890,전라남도,완도군,15-19세,1907,989,918
202012,46890,전라남도,완도군,15-19세,1881,973,908
202101,46890,전라남도,완도군,15-19세,1883,969,914
202102,46890,전라남도,완도군,15-19세,1870,967,903
202103,46890,전라남도,완도군,15-19세,1857,961,896
202104,46890,전라남도,완도군,15-19세,1829,950,879
202105,46890,전라남도,완도군,15-19세,1822,946,876
202106,46890,전라남도,완도군,15-19세,1819,946,873
202007,46890,전라남도,완도군,20-24세,2103,1240,863
202008,46890,전라남도,완도군,20-24세,2104,1235,869
202009,46890,전라남도,완도군,20-24세,2097,1227,870
202010,46890,전라남도,완도군,20-24세,2069,1212,857
202011,46890,전라남도,완도군,20-24세,2061,1212,849
202012,46890,전라남도,완도군,20-24세,2070,1213,857
202101,46890,전라남도,완도군,20-24세,2060,1208,852
202102,46890,전라남도,완도군,20-24세,2063,1204,859
202103,46890,전라남도,완도군,20-24세,2069,1207,862
202104,46890,전라남도,완도군,20-24세,2089,1220,869
202105,46890,전라남도,완도군,20-24세,2080,1222,858
202106,46890,전라남도,완도군,20-24세,2074,1218,856
202007,46890,전라남도,완도군,25-29세,1686,989,697
202008,46890,전라남도,완도군,25-29세,1690,985,705
202009,46890,전라남도,완도군,25-29세,1673,972,701
202010,46890,전라남도,완도군,25-29세,1697,986,711
202011,46890,전라남도,완도군,25-29세,1711,994,717
202012,46890,전라남도,완도군,25-29세,1707,994,713
202101,46890,전라남도,완도군,25-29세,1698,992,706
202102,46890,전라남도,완도군,25-29세,1677,982,695
202103,46890,전라남도,완도군,25-29세,1691,995,696
202104,46890,전라남도,완도군,25-29세,1681,989,692
202105,46890,전라남도,완도군,25-29세,1681,985,696
202106,46890,전라남도,완도군,25-29세,1698,996,702
202007,46890,전라남도,완도군,30-34세,1679,905,774
202008,46890,전라남도,완도군,30-34세,1650,886,764
202009,46890,전라남도,완도군,30-34세,1653,891,762
202010,46890,전라남도,완도군,30-34세,1643,890,753
202011,46890,전라남도,완도군,30-34세,1623,881,742
202012,46890,전라남도,완도군,30-34세,1600,861,739
202101,46890,전라남도,완도군,30-34세,1587,861,726
202102,46890,전라남도,완도군,30-34세,1560,852,708
202103,46890,전라남도,완도군,30-34세,1553,845,708
202104,46890,전라남도,완도군,30-34세,1554,846,708
202105,46890,전라남도,완도군,30-34세,1542,840,702
202106,46890,전라남도,완도군,30-34세,1533,838,695
202007,46890,전라남도,완도군,35-39세,2480,1377,1103
202008,46890,전라남도,완도군,35-39세,2462,1366,1096
202009,46890,전라남도,완도군,35-39세,2433,1342,1091
202010,46890,전라남도,완도군,35-39세,2421,1330,1091
202011,46890,전라남도,완도군,35-39세,2411,1327,1084
202012,46890,전라남도,완도군,35-39세,2408,1326,1082
202101,46890,전라남도,완도군,35-39세,2387,1315,1072
202102,46890,전라남도,완도군,35-39세,2377,1303,1074
202103,46890,전라남도,완도군,35-39세,2357,1297,1060
202104,46890,전라남도,완도군,35-39세,2319,1269,1050
202105,46890,전라남도,완도군,35-39세,2297,1258,1039
202106,46890,전라남도,완도군,35-39세,2275,1237,1038
202007,46890,전라남도,완도군,40-44세,2891,1689,1202
202008,46890,전라남도,완도군,40-44세,2891,1686,1205
202009,46890,전라남도,완도군,40-44세,2897,1694,1203
202010,46890,전라남도,완도군,40-44세,2902,1686,1216
202011,46890,전라남도,완도군,40-44세,2909,1688,1221
202012,46890,전라남도,완도군,40-44세,2886,1670,1216
202101,46890,전라남도,완도군,40-44세,2859,1640,1219
202102,46890,전라남도,완도군,40-44세,2884,1667,1217
202103,46890,전라남도,완도군,40-44세,2870,1652,1218
202104,46890,전라남도,완도군,40-44세,2883,1656,1227
202105,46890,전라남도,완도군,40-44세,2874,1644,1230
202106,46890,전라남도,완도군,40-44세,2886,1655,1231
202007,46890,전라남도,완도군,45-49세,3437,2026,1411
202008,46890,전라남도,완도군,45-49세,3414,2005,1409
202009,46890,전라남도,완도군,45-49세,3393,1993,1400
202010,46890,전라남도,완도군,45-49세,3360,1968,1392
202011,46890,전라남도,완도군,45-49세,3341,1967,1374
202012,46890,전라남도,완도군,45-49세,3330,1956,1374
202101,46890,전라남도,완도군,45-49세,3339,1968,1371
202102,46890,전라남도,완도군,45-49세,3323,1950,1373
202103,46890,전라남도,완도군,45-49세,3293,1928,1365
202104,46890,전라남도,완도군,45-49세,3270,1923,1347
202105,46890,전라남도,완도군,45-49세,3219,1908,1311
202106,46890,전라남도,완도군,45-49세,3209,1913,1296
202007,46890,전라남도,완도군,50-54세,3810,2207,1603
202008,46890,전라남도,완도군,50-54세,3812,2219,1593
202009,46890,전라남도,완도군,50-54세,3806,2215,1591
202010,46890,전라남도,완도군,50-54세,3815,2229,1586
202011,46890,전라남도,완도군,50-54세,3807,2217,1590
202012,46890,전라남도,완도군,50-54세,3801,2220,1581
202101,46890,전라남도,완도군,50-54세,3787,2219,1568
202102,46890,전라남도,완도군,50-54세,3794,2226,1568
202103,46890,전라남도,완도군,50-54세,3756,2212,1544
202104,46890,전라남도,완도군,50-54세,3733,2202,1531
202105,46890,전라남도,완도군,50-54세,3735,2197,1538
202106,46890,전라남도,완도군,50-54세,3747,2198,1549
202007,46890,전라남도,완도군,55-59세,4374,2296,2078
202008,46890,전라남도,완도군,55-59세,4365,2285,2080
202009,46890,전라남도,완도군,55-59세,4323,2273,2050
202010,46890,전라남도,완도군,55-59세,4308,2273,2035
202011,46890,전라남도,완도군,55-59세,4285,2263,2022
202012,46890,전라남도,완도군,55-59세,4280,2265,2015
202101,46890,전라남도,완도군,55-59세,4260,2262,1998
202102,46890,전라남도,완도군,55-59세,4252,2267,1985
202103,46890,전라남도,완도군,55-59세,4283,2293,1990
202104,46890,전라남도,완도군,55-59세,4282,2296,1986
202105,46890,전라남도,완도군,55-59세,4267,2299,1968
202106,46890,전라남도,완도군,55-59세,4225,2281,1944
202007,46890,전라남도,완도군,60-64세,4694,2354,2340
202008,46890,전라남도,완도군,60-64세,4701,2365,2336
202009,46890,전라남도,완도군,60-64세,4742,2380,2362
202010,46890,전라남도,완도군,60-64세,4749,2380,2369
202011,46890,전라남도,완도군,60-64세,4775,2395,2380
202012,46890,전라남도,완도군,60-64세,4800,2408,2392
202101,46890,전라남도,완도군,60-64세,4798,2401,2397
202102,46890,전라남도,완도군,60-64세,4804,2391,2413
202103,46890,전라남도,완도군,60-64세,4791,2383,2408
202104,46890,전라남도,완도군,60-64세,4799,2382,2417
202105,46890,전라남도,완도군,60-64세,4792,2372,2420
202106,46890,전라남도,완도군,60-64세,4797,2372,2425
202007,46890,전라남도,완도군,65-69세,3771,1843,1928
202008,46890,전라남도,완도군,65-69세,3766,1844,1922
202009,46890,전라남도,완도군,65-69세,3785,1860,1925
202010,46890,전라남도,완도군,65-69세,3810,1880,1930
202011,46890,전라남도,완도군,65-69세,3826,1892,1934
202012,46890,전라남도,완도군,65-69세,3821,1895,1926
202101,46890,전라남도,완도군,65-69세,3845,1908,1937
202102,46890,전라남도,완도군,65-69세,3841,1916,1925
202103,46890,전라남도,완도군,65-69세,3861,1928,1933
202104,46890,전라남도,완도군,65-69세,3879,1944,1935
202105,46890,전라남도,완도군,65-69세,3887,1957,1930
202106,46890,전라남도,완도군,65-69세,3903,1970,1933
202007,46890,전라남도,완도군,70-74세,3682,1731,1951
202008,46890,전라남도,완도군,70-74세,3690,1729,1961
202009,46890,전라남도,완도군,70-74세,3682,1717,1965
202010,46890,전라남도,완도군,70-74세,3693,1727,1966
202011,46890,전라남도,완도군,70-74세,3728,1747,1981
202012,46890,전라남도,완도군,70-74세,3753,1755,1998
202101,46890,전라남도,완도군,70-74세,3764,1764,2000
202102,46890,전라남도,완도군,70-74세,3770,1763,2007
202103,46890,전라남도,완도군,70-74세,3804,1778,2026
202104,46890,전라남도,완도군,70-74세,3812,1783,2029
202105,46890,전라남도,완도군,70-74세,3787,1774,2013
202106,46890,전라남도,완도군,70-74세,3787,1780,2007
202007,46890,전라남도,완도군,75-79세,3745,1539,2206
202008,46890,전라남도,완도군,75-79세,3752,1549,2203
202009,46890,전라남도,완도군,75-79세,3746,1551,2195
202010,46890,전라남도,완도군,75-79세,3741,1551,2190
202011,46890,전라남도,완도군,75-79세,3703,1540,2163
202012,46890,전라남도,완도군,75-79세,3675,1529,2146
202101,46890,전라남도,완도군,75-79세,3651,1517,2134
202102,46890,전라남도,완도군,75-79세,3631,1509,2122
202103,46890,전라남도,완도군,75-79세,3580,1488,2092
202104,46890,전라남도,완도군,75-79세,3567,1488,2079
202105,46890,전라남도,완도군,75-79세,3573,1489,2084
202106,46890,전라남도,완도군,75-79세,3557,1486,2071
202007,46890,전라남도,완도군,80-84세,2968,1014,1954
202008,46890,전라남도,완도군,80-84세,2974,1012,1962
202009,46890,전라남도,완도군,80-84세,2992,1019,1973
202010,46890,전라남도,완도군,80-84세,3003,1024,1979
202011,46890,전라남도,완도군,80-84세,3005,1015,1990
202012,46890,전라남도,완도군,80-84세,3018,1029,1989
202101,46890,전라남도,완도군,80-84세,3032,1026,2006
202102,46890,전라남도,완도군,80-84세,3042,1036,2006
202103,46890,전라남도,완도군,80-84세,3034,1033,2001
202104,46890,전라남도,완도군,80-84세,3031,1033,1998
202105,46890,전라남도,완도군,80-84세,3030,1038,1992
202106,46890,전라남도,완도군,80-84세,3040,1040,2000
202007,46890,전라남도,완도군,85-89세,1380,380,1000
202008,46890,전라남도,완도군,85-89세,1388,380,1008
202009,46890,전라남도,완도군,85-89세,1374,374,1000
202010,46890,전라남도,완도군,85-89세,1380,375,1005
202011,46890,전라남도,완도군,85-89세,1384,376,1008
202012,46890,전라남도,완도군,85-89세,1392,375,1017
202101,46890,전라남도,완도군,85-89세,1382,375,1007
202102,46890,전라남도,완도군,85-89세,1403,377,1026
202103,46890,전라남도,완도군,85-89세,1434,386,1048
202104,46890,전라남도,완도군,85-89세,1451,387,1064
202105,46890,전라남도,완도군,85-89세,1464,392,1072
202106,46890,전라남도,완도군,85-89세,1464,392,1072
202007,46890,전라남도,완도군,90-94세,436,84,352
202008,46890,전라남도,완도군,90-94세,441,87,354
202009,46890,전라남도,완도군,90-94세,451,90,361
202010,46890,전라남도,완도군,90-94세,456,91,365
202011,46890,전라남도,완도군,90-94세,449,87,362
202012,46890,전라남도,완도군,90-94세,448,87,361
202101,46890,전라남도,완도군,90-94세,460,94,366
202102,46890,전라남도,완도군,90-94세,460,98,362
202103,46890,전라남도,완도군,90-94세,466,99,367
202104,46890,전라남도,완도군,90-94세,470,98,372
202105,46890,전라남도,완도군,90-94세,485,104,381
202106,46890,전라남도,완도군,90-94세,493,103,390
202007,46890,전라남도,완도군,95-99세,109,12,97
202008,46890,전라남도,완도군,95-99세,110,11,99
202009,46890,전라남도,완도군,95-99세,111,11,100
202010,46890,전라남도,완도군,95-99세,107,11,96
202011,46890,전라남도,완도군,95-99세,110,12,98
202012,46890,전라남도,완도군,95-99세,111,12,99
202101,46890,전라남도,완도군,95-99세,110,12,98
202102,46890,전라남도,완도군,95-99세,115,12,103
202103,46890,전라남도,완도군,95-99세,118,13,105
202104,46890,전라남도,완도군,95-99세,122,13,109
202105,46890,전라남도,완도군,95-99세,118,13,105
202106,46890,전라남도,완도군,95-99세,120,15,105
202007,46890,전라남도,완도군,100+,25,3,22
202008,46890,전라남도,완도군,100+,24,3,21
202009,46890,전라남도,완도군,100+,25,3,22
202010,46890,전라남도,완도군,100+,26,3,23
202011,46890,전라남도,완도군,100+,26,3,23
202012,46890,전라남도,완도군,100+,26,3,23
202101,46890,전라남도,완도군,100+,27,3,24
202102,46890,전라남도,완도군,100+,26,3,23
202103,46890,전라남도,완도군,100+,17,2,15
202104,46890,전라남도,완도군,100+,17,2,15
202105,46890,전라남도,완도군,100+,16,2,14
202106,46890,전라남도,완도군,100+,16,2,14
202007,46900,전라남도,진도군,0-4세,746,337,409
202008,46900,전라남도,진도군,0-4세,737,328,409
202009,46900,전라남도,진도군,0-4세,724,317,407
202010,46900,전라남도,진도군,0-4세,714,313,401
202011,46900,전라남도,진도군,0-4세,722,313,409
202012,46900,전라남도,진도군,0-4세,727,317,410
202101,46900,전라남도,진도군,0-4세,714,314,400
202102,46900,전라남도,진도군,0-4세,712,313,399
202103,46900,전라남도,진도군,0-4세,703,309,394
202104,46900,전라남도,진도군,0-4세,697,309,388
202105,46900,전라남도,진도군,0-4세,695,308,387
202106,46900,전라남도,진도군,0-4세,696,314,382
202007,46900,전라남도,진도군,5-9세,998,498,500
202008,46900,전라남도,진도군,5-9세,998,499,499
202009,46900,전라남도,진도군,5-9세,991,496,495
202010,46900,전라남도,진도군,5-9세,981,490,491
202011,46900,전라남도,진도군,5-9세,964,481,483
202012,46900,전라남도,진도군,5-9세,977,492,485
202101,46900,전라남도,진도군,5-9세,960,487,473
202102,46900,전라남도,진도군,5-9세,953,486,467
202103,46900,전라남도,진도군,5-9세,945,487,458
202104,46900,전라남도,진도군,5-9세,940,486,454
202105,46900,전라남도,진도군,5-9세,927,481,446
202106,46900,전라남도,진도군,5-9세,923,478,445
202007,46900,전라남도,진도군,10-14세,1041,534,507
202008,46900,전라남도,진도군,10-14세,1031,526,505
202009,46900,전라남도,진도군,10-14세,1037,532,505
202010,46900,전라남도,진도군,10-14세,1037,537,500
202011,46900,전라남도,진도군,10-14세,1055,545,510
202012,46900,전라남도,진도군,10-14세,1068,551,517
202101,46900,전라남도,진도군,10-14세,1051,539,512
202102,46900,전라남도,진도군,10-14세,1051,538,513
202103,46900,전라남도,진도군,10-14세,1061,535,526
202104,46900,전라남도,진도군,10-14세,1065,542,523
202105,46900,전라남도,진도군,10-14세,1066,533,533
202106,46900,전라남도,진도군,10-14세,1065,529,536
202007,46900,전라남도,진도군,15-19세,1205,630,575
202008,46900,전라남도,진도군,15-19세,1198,631,567
202009,46900,전라남도,진도군,15-19세,1187,624,563
202010,46900,전라남도,진도군,15-19세,1171,612,559
202011,46900,전라남도,진도군,15-19세,1191,624,567
202012,46900,전라남도,진도군,15-19세,1211,640,571
202101,46900,전라남도,진도군,15-19세,1180,617,563
202102,46900,전라남도,진도군,15-19세,1170,610,560
202103,46900,전라남도,진도군,15-19세,1138,581,557
202104,46900,전라남도,진도군,15-19세,1124,574,550
202105,46900,전라남도,진도군,15-19세,1126,577,549
202106,46900,전라남도,진도군,15-19세,1115,576,539
202007,46900,전라남도,진도군,20-24세,1336,773,563
202008,46900,전라남도,진도군,20-24세,1325,761,564
202009,46900,전라남도,진도군,20-24세,1309,756,553
202010,46900,전라남도,진도군,20-24세,1309,757,552
202011,46900,전라남도,진도군,20-24세,1394,802,592
202012,46900,전라남도,진도군,20-24세,1465,839,626
202101,46900,전라남도,진도군,20-24세,1430,831,599
202102,46900,전라남도,진도군,20-24세,1399,819,580
202103,46900,전라남도,진도군,20-24세,1379,820,559
202104,46900,전라남도,진도군,20-24세,1379,817,562
202105,46900,전라남도,진도군,20-24세,1372,811,561
202106,46900,전라남도,진도군,20-24세,1359,800,559
202007,46900,전라남도,진도군,25-29세,1065,607,458
202008,46900,전라남도,진도군,25-29세,1070,609,461
202009,46900,전라남도,진도군,25-29세,1084,617,467
202010,46900,전라남도,진도군,25-29세,1076,614,462
202011,46900,전라남도,진도군,25-29세,1149,661,488
202012,46900,전라남도,진도군,25-29세,1235,714,521
202101,46900,전라남도,진도군,25-29세,1188,685,503
202102,46900,전라남도,진도군,25-29세,1157,665,492
202103,46900,전라남도,진도군,25-29세,1159,673,486
202104,46900,전라남도,진도군,25-29세,1153,670,483
202105,46900,전라남도,진도군,25-29세,1146,672,474
202106,46900,전라남도,진도군,25-29세,1144,666,478
202007,46900,전라남도,진도군,30-34세,988,518,470
202008,46900,전라남도,진도군,30-34세,982,515,467
202009,46900,전라남도,진도군,30-34세,966,507,459
202010,46900,전라남도,진도군,30-34세,962,504,458
202011,46900,전라남도,진도군,30-34세,987,522,465
202012,46900,전라남도,진도군,30-34세,1012,528,484
202101,46900,전라남도,진도군,30-34세,980,514,466
202102,46900,전라남도,진도군,30-34세,961,501,460
202103,46900,전라남도,진도군,30-34세,947,489,458
202104,46900,전라남도,진도군,30-34세,944,490,454
202105,46900,전라남도,진도군,30-34세,940,487,453
202106,46900,전라남도,진도군,30-34세,933,482,451
202007,46900,전라남도,진도군,35-39세,1287,722,565
202008,46900,전라남도,진도군,35-39세,1273,712,561
202009,46900,전라남도,진도군,35-39세,1263,707,556
202010,46900,전라남도,진도군,35-39세,1261,707,554
202011,46900,전라남도,진도군,35-39세,1281,719,562
202012,46900,전라남도,진도군,35-39세,1301,731,570
202101,46900,전라남도,진도군,35-39세,1275,720,555
202102,46900,전라남도,진도군,35-39세,1271,722,549
202103,46900,전라남도,진도군,35-39세,1244,702,542
202104,46900,전라남도,진도군,35-39세,1243,695,548
202105,46900,전라남도,진도군,35-39세,1227,680,547
202106,46900,전라남도,진도군,35-39세,1226,675,551
202007,46900,전라남도,진도군,40-44세,1545,848,697
202008,46900,전라남도,진도군,40-44세,1543,845,698
202009,46900,전라남도,진도군,40-44세,1532,845,687
202010,46900,전라남도,진도군,40-44세,1521,842,679
202011,46900,전라남도,진도군,40-44세,1571,871,700
202012,46900,전라남도,진도군,40-44세,1608,895,713
202101,46900,전라남도,진도군,40-44세,1555,862,693
202102,46900,전라남도,진도군,40-44세,1547,861,686
202103,46900,전라남도,진도군,40-44세,1535,860,675
202104,46900,전라남도,진도군,40-44세,1527,865,662
202105,46900,전라남도,진도군,40-44세,1538,873,665
202106,46900,전라남도,진도군,40-44세,1533,876,657
202007,46900,전라남도,진도군,45-49세,2030,1213,817
202008,46900,전라남도,진도군,45-49세,2032,1216,816
202009,46900,전라남도,진도군,45-49세,2010,1201,809
202010,46900,전라남도,진도군,45-49세,2020,1201,819
202011,46900,전라남도,진도군,45-49세,2079,1237,842
202012,46900,전라남도,진도군,45-49세,2114,1259,855
202101,46900,전라남도,진도군,45-49세,2082,1239,843
202102,46900,전라남도,진도군,45-49세,2068,1230,838
202103,46900,전라남도,진도군,45-49세,2043,1217,826
202104,46900,전라남도,진도군,45-49세,2023,1204,819
202105,46900,전라남도,진도군,45-49세,2003,1191,812
202106,46900,전라남도,진도군,45-49세,1973,1169,804
202007,46900,전라남도,진도군,50-54세,2362,1353,1009
202008,46900,전라남도,진도군,50-54세,2357,1352,1005
202009,46900,전라남도,진도군,50-54세,2345,1343,1002
202010,46900,전라남도,진도군,50-54세,2328,1336,992
202011,46900,전라남도,진도군,50-54세,2366,1360,1006
202012,46900,전라남도,진도군,50-54세,2407,1379,1028
202101,46900,전라남도,진도군,50-54세,2363,1352,1011
202102,46900,전라남도,진도군,50-54세,2341,1338,1003
202103,46900,전라남도,진도군,50-54세,2327,1338,989
202104,46900,전라남도,진도군,50-54세,2319,1337,982
202105,46900,전라남도,진도군,50-54세,2328,1349,979
202106,46900,전라남도,진도군,50-54세,2335,1351,984
202007,46900,전라남도,진도군,55-59세,2670,1403,1267
202008,46900,전라남도,진도군,55-59세,2648,1394,1254
202009,46900,전라남도,진도군,55-59세,2646,1402,1244
202010,46900,전라남도,진도군,55-59세,2637,1401,1236
202011,46900,전라남도,진도군,55-59세,2685,1435,1250
202012,46900,전라남도,진도군,55-59세,2702,1444,1258
202101,46900,전라남도,진도군,55-59세,2683,1444,1239
202102,46900,전라남도,진도군,55-59세,2677,1445,1232
202103,46900,전라남도,진도군,55-59세,2652,1443,1209
202104,46900,전라남도,진도군,55-59세,2634,1443,1191
202105,46900,전라남도,진도군,55-59세,2639,1443,1196
202106,46900,전라남도,진도군,55-59세,2630,1446,1184
202007,46900,전라남도,진도군,60-64세,2935,1533,1402
202008,46900,전라남도,진도군,60-64세,2951,1539,1412
202009,46900,전라남도,진도군,60-64세,2964,1543,1421
202010,46900,전라남도,진도군,60-64세,2970,1545,1425
202011,46900,전라남도,진도군,60-64세,3019,1561,1458
202012,46900,전라남도,진도군,60-64세,3075,1588,1487
202101,46900,전라남도,진도군,60-64세,3045,1568,1477
202102,46900,전라남도,진도군,60-64세,3048,1577,1471
202103,46900,전라남도,진도군,60-64세,3040,1576,1464
202104,46900,전라남도,진도군,60-64세,3088,1595,1493
202105,46900,전라남도,진도군,60-64세,3098,1596,1502
202106,46900,전라남도,진도군,60-64세,3115,1597,1518
202007,46900,전라남도,진도군,65-69세,2230,1070,1160
202008,46900,전라남도,진도군,65-69세,2240,1076,1164
202009,46900,전라남도,진도군,65-69세,2233,1080,1153
202010,46900,전라남도,진도군,65-69세,2234,1080,1154
202011,46900,전라남도,진도군,65-69세,2261,1102,1159
202012,46900,전라남도,진도군,65-69세,2280,1112,1168
202101,46900,전라남도,진도군,65-69세,2282,1117,1165
202102,46900,전라남도,진도군,65-69세,2293,1126,1167
202103,46900,전라남도,진도군,65-69세,2305,1135,1170
202104,46900,전라남도,진도군,65-69세,2307,1144,1163
202105,46900,전라남도,진도군,65-69세,2310,1146,1164
202106,46900,전라남도,진도군,65-69세,2313,1148,1165
202007,46900,전라남도,진도군,70-74세,2294,1096,1198
202008,46900,전라남도,진도군,70-74세,2304,1099,1205
202009,46900,전라남도,진도군,70-74세,2314,1106,1208
202010,46900,전라남도,진도군,70-74세,2317,1113,1204
202011,46900,전라남도,진도군,70-74세,2332,1120,1212
202012,46900,전라남도,진도군,70-74세,2349,1128,1221
202101,46900,전라남도,진도군,70-74세,2358,1136,1222
202102,46900,전라남도,진도군,70-74세,2344,1120,1224
202103,46900,전라남도,진도군,70-74세,2324,1119,1205
202104,46900,전라남도,진도군,70-74세,2320,1114,1206
202105,46900,전라남도,진도군,70-74세,2334,1127,1207
202106,46900,전라남도,진도군,70-74세,2335,1131,1204
202007,46900,전라남도,진도군,75-79세,2484,925,1559
202008,46900,전라남도,진도군,75-79세,2464,918,1546
202009,46900,전라남도,진도군,75-79세,2449,909,1540
202010,46900,전라남도,진도군,75-79세,2432,900,1532
202011,46900,전라남도,진도군,75-79세,2425,898,1527
202012,46900,전라남도,진도군,75-79세,2398,884,1514
202101,46900,전라남도,진도군,75-79세,2384,886,1498
202102,46900,전라남도,진도군,75-79세,2362,890,1472
202103,46900,전라남도,진도군,75-79세,2342,879,1463
202104,46900,전라남도,진도군,75-79세,2315,872,1443
202105,46900,전라남도,진도군,75-79세,2281,864,1417
202106,46900,전라남도,진도군,75-79세,2253,851,1402
202007,46900,전라남도,진도군,80-84세,1920,620,1300
202008,46900,전라남도,진도군,80-84세,1934,623,1311
202009,46900,전라남도,진도군,80-84세,1940,630,1310
202010,46900,전라남도,진도군,80-84세,1956,638,1318
202011,46900,전라남도,진도군,80-84세,1961,634,1327
202012,46900,전라남도,진도군,80-84세,1982,647,1335
202101,46900,전라남도,진도군,80-84세,1992,645,1347
202102,46900,전라남도,진도군,80-84세,1995,640,1355
202103,46900,전라남도,진도군,80-84세,1985,636,1349
202104,46900,전라남도,진도군,80-84세,1990,643,1347
202105,46900,전라남도,진도군,80-84세,2006,648,1358
202106,46900,전라남도,진도군,80-84세,2047,661,1386
202007,46900,전라남도,진도군,85-89세,918,201,717
202008,46900,전라남도,진도군,85-89세,921,204,717
202009,46900,전라남도,진도군,85-89세,924,207,717
202010,46900,전라남도,진도군,85-89세,924,209,715
202011,46900,전라남도,진도군,85-89세,924,214,710
202012,46900,전라남도,진도군,85-89세,931,216,715
202101,46900,전라남도,진도군,85-89세,932,218,714
202102,46900,전라남도,진도군,85-89세,962,230,732
202103,46900,전라남도,진도군,85-89세,976,232,744
202104,46900,전라남도,진도군,85-89세,988,235,753
202105,46900,전라남도,진도군,85-89세,986,231,755
202106,46900,전라남도,진도군,85-89세,977,232,745
202007,46900,전라남도,진도군,90-94세,293,56,237
202008,46900,전라남도,진도군,90-94세,295,55,240
202009,46900,전라남도,진도군,90-94세,296,57,239
202010,46900,전라남도,진도군,90-94세,298,56,242
202011,46900,전라남도,진도군,90-94세,299,56,243
202012,46900,전라남도,진도군,90-94세,301,55,246
202101,46900,전라남도,진도군,90-94세,307,58,249
202102,46900,전라남도,진도군,90-94세,313,60,253
202103,46900,전라남도,진도군,90-94세,310,58,252
202104,46900,전라남도,진도군,90-94세,306,54,252
202105,46900,전라남도,진도군,90-94세,316,60,256
202106,46900,전라남도,진도군,90-94세,314,58,256
202007,46900,전라남도,진도군,95-99세,61,9,52
202008,46900,전라남도,진도군,95-99세,65,10,55
202009,46900,전라남도,진도군,95-99세,69,10,59
202010,46900,전라남도,진도군,95-99세,67,10,57
202011,46900,전라남도,진도군,95-99세,65,10,55
202012,46900,전라남도,진도군,95-99세,66,10,56
202101,46900,전라남도,진도군,95-99세,67,10,57
202102,46900,전라남도,진도군,95-99세,67,10,57
202103,46900,전라남도,진도군,95-99세,66,11,55
202104,46900,전라남도,진도군,95-99세,70,12,58
202105,46900,전라남도,진도군,95-99세,70,12,58
202106,46900,전라남도,진도군,95-99세,70,12,58
202007,46900,전라남도,진도군,100+,17,0,17
202008,46900,전라남도,진도군,100+,17,0,17
202009,46900,전라남도,진도군,100+,17,0,17
202010,46900,전라남도,진도군,100+,18,0,18
202011,46900,전라남도,진도군,100+,18,0,18
202012,46900,전라남도,진도군,100+,18,0,18
202101,46900,전라남도,진도군,100+,17,0,17
202102,46900,전라남도,진도군,100+,18,0,18
202103,46900,전라남도,진도군,100+,13,0,13
202104,46900,전라남도,진도군,100+,13,0,13
202105,46900,전라남도,진도군,100+,13,0,13
202106,46900,전라남도,진도군,100+,12,0,12
202007,46910,전라남도,신안군,0-4세,728,378,350
202008,46910,전라남도,신안군,0-4세,710,367,343
202009,46910,전라남도,신안군,0-4세,710,366,344
202010,46910,전라남도,신안군,0-4세,695,358,337
202011,46910,전라남도,신안군,0-4세,683,352,331
202012,46910,전라남도,신안군,0-4세,681,351,330
202101,46910,전라남도,신안군,0-4세,659,336,323
202102,46910,전라남도,신안군,0-4세,653,334,319
202103,46910,전라남도,신안군,0-4세,654,337,317
202104,46910,전라남도,신안군,0-4세,661,340,321
202105,46910,전라남도,신안군,0-4세,662,339,323
202106,46910,전라남도,신안군,0-4세,648,332,316
202007,46910,전라남도,신안군,5-9세,932,479,453
202008,46910,전라남도,신안군,5-9세,930,481,449
202009,46910,전라남도,신안군,5-9세,916,476,440
202010,46910,전라남도,신안군,5-9세,896,464,432
202011,46910,전라남도,신안군,5-9세,880,447,433
202012,46910,전라남도,신안군,5-9세,879,444,435
202101,46910,전라남도,신안군,5-9세,870,440,430
202102,46910,전라남도,신안군,5-9세,886,439,447
202103,46910,전라남도,신안군,5-9세,886,442,444
202104,46910,전라남도,신안군,5-9세,871,436,435
202105,46910,전라남도,신안군,5-9세,859,435,424
202106,46910,전라남도,신안군,5-9세,851,432,419
202007,46910,전라남도,신안군,10-14세,897,436,461
202008,46910,전라남도,신안군,10-14세,894,437,457
202009,46910,전라남도,신안군,10-14세,894,434,460
202010,46910,전라남도,신안군,10-14세,903,441,462
202011,46910,전라남도,신안군,10-14세,900,447,453
202012,46910,전라남도,신안군,10-14세,906,458,448
202101,46910,전라남도,신안군,10-14세,913,466,447
202102,46910,전라남도,신안군,10-14세,928,472,456
202103,46910,전라남도,신안군,10-14세,923,468,455
202104,46910,전라남도,신안군,10-14세,932,470,462
202105,46910,전라남도,신안군,10-14세,946,479,467
202106,46910,전라남도,신안군,10-14세,953,479,474
202007,46910,전라남도,신안군,15-19세,1151,622,529
202008,46910,전라남도,신안군,15-19세,1149,616,533
202009,46910,전라남도,신안군,15-19세,1155,619,536
202010,46910,전라남도,신안군,15-19세,1143,614,529
202011,46910,전라남도,신안군,15-19세,1140,605,535
202012,46910,전라남도,신안군,15-19세,1134,599,535
202101,46910,전라남도,신안군,15-19세,1125,593,532
202102,46910,전라남도,신안군,15-19세,1106,583,523
202103,46910,전라남도,신안군,15-19세,1093,573,520
202104,46910,전라남도,신안군,15-19세,1081,565,516
202105,46910,전라남도,신안군,15-19세,1070,555,515
202106,46910,전라남도,신안군,15-19세,1060,552,508
202007,46910,전라남도,신안군,20-24세,1526,894,632
202008,46910,전라남도,신안군,20-24세,1512,892,620
202009,46910,전라남도,신안군,20-24세,1481,879,602
202010,46910,전라남도,신안군,20-24세,1478,885,593
202011,46910,전라남도,신안군,20-24세,1471,879,592
202012,46910,전라남도,신안군,20-24세,1464,877,587
202101,46910,전라남도,신안군,20-24세,1449,859,590
202102,46910,전라남도,신안군,20-24세,1426,850,576
202103,46910,전라남도,신안군,20-24세,1398,834,564
202104,46910,전라남도,신안군,20-24세,1388,832,556
202105,46910,전라남도,신안군,20-24세,1383,828,555
202106,46910,전라남도,신안군,20-24세,1383,829,554
202007,46910,전라남도,신안군,25-29세,1386,835,551
202008,46910,전라남도,신안군,25-29세,1379,833,546
202009,46910,전라남도,신안군,25-29세,1358,829,529
202010,46910,전라남도,신안군,25-29세,1339,813,526
202011,46910,전라남도,신안군,25-29세,1324,806,518
202012,46910,전라남도,신안군,25-29세,1315,802,513
202101,46910,전라남도,신안군,25-29세,1306,797,509
202102,46910,전라남도,신안군,25-29세,1303,797,506
202103,46910,전라남도,신안군,25-29세,1308,792,516
202104,46910,전라남도,신안군,25-29세,1310,795,515
202105,46910,전라남도,신안군,25-29세,1306,795,511
202106,46910,전라남도,신안군,25-29세,1303,791,512
202007,46910,전라남도,신안군,30-34세,1245,766,479
202008,46910,전라남도,신안군,30-34세,1221,755,466
202009,46910,전라남도,신안군,30-34세,1225,747,478
202010,46910,전라남도,신안군,30-34세,1196,739,457
202011,46910,전라남도,신안군,30-34세,1187,738,449
202012,46910,전라남도,신안군,30-34세,1175,734,441
202101,46910,전라남도,신안군,30-34세,1151,720,431
202102,46910,전라남도,신안군,30-34세,1149,716,433
202103,46910,전라남도,신안군,30-34세,1138,715,423
202104,46910,전라남도,신안군,30-34세,1140,707,433
202105,46910,전라남도,신안군,30-34세,1141,705,436
202106,46910,전라남도,신안군,30-34세,1138,695,443
202007,46910,전라남도,신안군,35-39세,1626,1047,579
202008,46910,전라남도,신안군,35-39세,1602,1035,567
202009,46910,전라남도,신안군,35-39세,1565,1011,554
202010,46910,전라남도,신안군,35-39세,1549,995,554
202011,46910,전라남도,신안군,35-39세,1514,979,535
202012,46910,전라남도,신안군,35-39세,1507,976,531
202101,46910,전라남도,신안군,35-39세,1507,974,533
202102,46910,전라남도,신안군,35-39세,1540,989,551
202103,46910,전라남도,신안군,35-39세,1515,985,530
202104,46910,전라남도,신안군,35-39세,1500,975,525
202105,46910,전라남도,신안군,35-39세,1487,960,527
202106,46910,전라남도,신안군,35-39세,1468,949,519
202007,46910,전라남도,신안군,40-44세,1886,1261,625
202008,46910,전라남도,신안군,40-44세,1866,1251,615
202009,46910,전라남도,신안군,40-44세,1869,1259,610
202010,46910,전라남도,신안군,40-44세,1864,1259,605
202011,46910,전라남도,신안군,40-44세,1858,1252,606
202012,46910,전라남도,신안군,40-44세,1831,1237,594
202101,46910,전라남도,신안군,40-44세,1795,1201,594
202102,46910,전라남도,신안군,40-44세,1847,1234,613
202103,46910,전라남도,신안군,40-44세,1827,1211,616
202104,46910,전라남도,신안군,40-44세,1834,1223,611
202105,46910,전라남도,신안군,40-44세,1831,1209,622
202106,46910,전라남도,신안군,40-44세,1841,1213,628
202007,46910,전라남도,신안군,45-49세,2543,1686,857
202008,46910,전라남도,신안군,45-49세,2534,1681,853
202009,46910,전라남도,신안군,45-49세,2519,1671,848
202010,46910,전라남도,신안군,45-49세,2494,1662,832
202011,46910,전라남도,신안군,45-49세,2493,1662,831
202012,46910,전라남도,신안군,45-49세,2493,1662,831
202101,46910,전라남도,신안군,45-49세,2478,1662,816
202102,46910,전라남도,신안군,45-49세,2480,1659,821
202103,46910,전라남도,신안군,45-49세,2461,1661,800
202104,46910,전라남도,신안군,45-49세,2452,1652,800
202105,46910,전라남도,신안군,45-49세,2417,1624,793
202106,46910,전라남도,신안군,45-49세,2388,1604,784
202007,46910,전라남도,신안군,50-54세,3200,2006,1194
202008,46910,전라남도,신안군,50-54세,3200,2015,1185
202009,46910,전라남도,신안군,50-54세,3187,2014,1173
202010,46910,전라남도,신안군,50-54세,3180,2011,1169
202011,46910,전라남도,신안군,50-54세,3147,1988,1159
202012,46910,전라남도,신안군,50-54세,3149,1992,1157
202101,46910,전라남도,신안군,50-54세,3160,2000,1160
202102,46910,전라남도,신안군,50-54세,3170,2011,1159
202103,46910,전라남도,신안군,50-54세,3109,1974,1135
202104,46910,전라남도,신안군,50-54세,3120,1980,1140
202105,46910,전라남도,신안군,50-54세,3124,1988,1136
202106,46910,전라남도,신안군,50-54세,3118,1975,1143
202007,46910,전라남도,신안군,55-59세,3954,2326,1628
202008,46910,전라남도,신안군,55-59세,3940,2318,1622
202009,46910,전라남도,신안군,55-59세,3912,2303,1609
202010,46910,전라남도,신안군,55-59세,3903,2297,1606
202011,46910,전라남도,신안군,55-59세,3898,2297,1601
202012,46910,전라남도,신안군,55-59세,3893,2285,1608
202101,46910,전라남도,신안군,55-59세,3850,2259,1591
202102,46910,전라남도,신안군,55-59세,3858,2268,1590
202103,46910,전라남도,신안군,55-59세,3846,2264,1582
202104,46910,전라남도,신안군,55-59세,3828,2259,1569
202105,46910,전라남도,신안군,55-59세,3832,2272,1560
202106,46910,전라남도,신안군,55-59세,3832,2279,1553
202007,46910,전라남도,신안군,60-64세,4171,2345,1826
202008,46910,전라남도,신안군,60-64세,4184,2351,1833
202009,46910,전라남도,신안군,60-64세,4204,2367,1837
202010,46910,전라남도,신안군,60-64세,4215,2370,1845
202011,46910,전라남도,신안군,60-64세,4225,2377,1848
202012,46910,전라남도,신안군,60-64세,4220,2373,1847
202101,46910,전라남도,신안군,60-64세,4215,2366,1849
202102,46910,전라남도,신안군,60-64세,4240,2382,1858
202103,46910,전라남도,신안군,60-64세,4279,2409,1870
202104,46910,전라남도,신안군,60-64세,4333,2429,1904
202105,46910,전라남도,신안군,60-64세,4345,2445,1900
202106,46910,전라남도,신안군,60-64세,4376,2467,1909
202007,46910,전라남도,신안군,65-69세,3414,1802,1612
202008,46910,전라남도,신안군,65-69세,3425,1817,1608
202009,46910,전라남도,신안군,65-69세,3418,1813,1605
202010,46910,전라남도,신안군,65-69세,3432,1828,1604
202011,46910,전라남도,신안군,65-69세,3416,1820,1596
202012,46910,전라남도,신안군,65-69세,3421,1835,1586
202101,46910,전라남도,신안군,65-69세,3426,1842,1584
202102,46910,전라남도,신안군,65-69세,3427,1842,1585
202103,46910,전라남도,신안군,65-69세,3431,1851,1580
202104,46910,전라남도,신안군,65-69세,3421,1842,1579
202105,46910,전라남도,신안군,65-69세,3439,1840,1599
202106,46910,전라남도,신안군,65-69세,3446,1847,1599
202007,46910,전라남도,신안군,70-74세,3187,1577,1610
202008,46910,전라남도,신안군,70-74세,3187,1576,1611
202009,46910,전라남도,신안군,70-74세,3193,1585,1608
202010,46910,전라남도,신안군,70-74세,3213,1593,1620
202011,46910,전라남도,신안군,70-74세,3227,1598,1629
202012,46910,전라남도,신안군,70-74세,3232,1599,1633
202101,46910,전라남도,신안군,70-74세,3238,1601,1637
202102,46910,전라남도,신안군,70-74세,3256,1611,1645
202103,46910,전라남도,신안군,70-74세,3219,1592,1627
202104,46910,전라남도,신안군,70-74세,3215,1599,1616
202105,46910,전라남도,신안군,70-74세,3207,1607,1600
202106,46910,전라남도,신안군,70-74세,3203,1610,1593
202007,46910,전라남도,신안군,75-79세,3252,1292,1960
202008,46910,전라남도,신안군,75-79세,3237,1294,1943
202009,46910,전라남도,신안군,75-79세,3222,1285,1937
202010,46910,전라남도,신안군,75-79세,3216,1292,1924
202011,46910,전라남도,신안군,75-79세,3201,1295,1906
202012,46910,전라남도,신안군,75-79세,3174,1282,1892
202101,46910,전라남도,신안군,75-79세,3134,1274,1860
202102,46910,전라남도,신안군,75-79세,3100,1254,1846
202103,46910,전라남도,신안군,75-79세,3083,1257,1826
202104,46910,전라남도,신안군,75-79세,3076,1251,1825
202105,46910,전라남도,신안군,75-79세,3057,1249,1808
202106,46910,전라남도,신안군,75-79세,3051,1254,1797
202007,46910,전라남도,신안군,80-84세,2661,854,1807
202008,46910,전라남도,신안군,80-84세,2667,854,1813
202009,46910,전라남도,신안군,80-84세,2678,862,1816
202010,46910,전라남도,신안군,80-84세,2675,858,1817
202011,46910,전라남도,신안군,80-84세,2661,848,1813
202012,46910,전라남도,신안군,80-84세,2661,850,1811
202101,46910,전라남도,신안군,80-84세,2673,859,1814
202102,46910,전라남도,신안군,80-84세,2682,874,1808
202103,46910,전라남도,신안군,80-84세,2679,879,1800
202104,46910,전라남도,신안군,80-84세,2697,899,1798
202105,46910,전라남도,신안군,80-84세,2717,911,1806
202106,46910,전라남도,신안군,80-84세,2724,915,1809
202007,46910,전라남도,신안군,85-89세,1256,302,954
202008,46910,전라남도,신안군,85-89세,1266,306,960
202009,46910,전라남도,신안군,85-89세,1266,306,960
202010,46910,전라남도,신안군,85-89세,1268,309,959
202011,46910,전라남도,신안군,85-89세,1281,316,965
202012,46910,전라남도,신안군,85-89세,1289,316,973
202101,46910,전라남도,신안군,85-89세,1297,318,979
202102,46910,전라남도,신안군,85-89세,1326,324,1002
202103,46910,전라남도,신안군,85-89세,1353,323,1030
202104,46910,전라남도,신안군,85-89세,1363,326,1037
202105,46910,전라남도,신안군,85-89세,1367,330,1037
202106,46910,전라남도,신안군,85-89세,1368,327,1041
202007,46910,전라남도,신안군,90-94세,364,66,298
202008,46910,전라남도,신안군,90-94세,369,67,302
202009,46910,전라남도,신안군,90-94세,384,70,314
202010,46910,전라남도,신안군,90-94세,390,72,318
202011,46910,전라남도,신안군,90-94세,393,71,322
202012,46910,전라남도,신안군,90-94세,400,75,325
202101,46910,전라남도,신안군,90-94세,411,76,335
202102,46910,전라남도,신안군,90-94세,417,78,339
202103,46910,전라남도,신안군,90-94세,413,77,336
202104,46910,전라남도,신안군,90-94세,416,78,338
202105,46910,전라남도,신안군,90-94세,432,79,353
202106,46910,전라남도,신안군,90-94세,434,81,353
202007,46910,전라남도,신안군,95-99세,95,16,79
202008,46910,전라남도,신안군,95-99세,97,16,81
202009,46910,전라남도,신안군,95-99세,99,16,83
202010,46910,전라남도,신안군,95-99세,94,16,78
202011,46910,전라남도,신안군,95-99세,92,16,76
202012,46910,전라남도,신안군,95-99세,96,17,79
202101,46910,전라남도,신안군,95-99세,94,17,77
202102,46910,전라남도,신안군,95-99세,96,18,78
202103,46910,전라남도,신안군,95-99세,93,16,77
202104,46910,전라남도,신안군,95-99세,92,17,75
202105,46910,전라남도,신안군,95-99세,91,17,74
202106,46910,전라남도,신안군,95-99세,90,17,73
202007,46910,전라남도,신안군,100+,16,5,11
202008,46910,전라남도,신안군,100+,17,5,12
202009,46910,전라남도,신안군,100+,16,5,11
202010,46910,전라남도,신안군,100+,18,5,13
202011,46910,전라남도,신안군,100+,18,5,13
202012,46910,전라남도,신안군,100+,18,5,13
202101,46910,전라남도,신안군,100+,17,5,12
202102,46910,전라남도,신안군,100+,17,5,12
202103,46910,전라남도,신안군,100+,11,4,7
202104,46910,전라남도,신안군,100+,11,4,7
202105,46910,전라남도,신안군,100+,11,4,7
202106,46910,전라남도,신안군,100+,12,4,8
202007,47111,경상북도,포항시 남구,0-4세,7226,3744,3482
202008,47111,경상북도,포항시 남구,0-4세,7117,3697,3420
202009,47111,경상북도,포항시 남구,0-4세,7041,3673,3368
202010,47111,경상북도,포항시 남구,0-4세,6944,3621,3323
202011,47111,경상북도,포항시 남구,0-4세,6865,3588,3277
202012,47111,경상북도,포항시 남구,0-4세,6809,3554,3255
202101,47111,경상북도,포항시 남구,0-4세,6747,3535,3212
202102,47111,경상북도,포항시 남구,0-4세,6686,3489,3197
202103,47111,경상북도,포항시 남구,0-4세,6613,3430,3183
202104,47111,경상북도,포항시 남구,0-4세,6545,3390,3155
202105,47111,경상북도,포항시 남구,0-4세,6459,3347,3112
202106,47111,경상북도,포항시 남구,0-4세,6376,3300,3076
202007,47111,경상북도,포항시 남구,5-9세,10769,5582,5187
202008,47111,경상북도,포항시 남구,5-9세,10746,5566,5180
202009,47111,경상북도,포항시 남구,5-9세,10724,5532,5192
202010,47111,경상북도,포항시 남구,5-9세,10730,5538,5192
202011,47111,경상북도,포항시 남구,5-9세,10680,5487,5193
202012,47111,경상북도,포항시 남구,5-9세,10659,5494,5165
202101,47111,경상북도,포항시 남구,5-9세,10576,5439,5137
202102,47111,경상북도,포항시 남구,5-9세,10570,5447,5123
202103,47111,경상북도,포항시 남구,5-9세,10557,5465,5092
202104,47111,경상북도,포항시 남구,5-9세,10561,5465,5096
202105,47111,경상북도,포항시 남구,5-9세,10572,5473,5099
202106,47111,경상북도,포항시 남구,5-9세,10547,5473,5074
202007,47111,경상북도,포항시 남구,10-14세,10415,5388,5027
202008,47111,경상북도,포항시 남구,10-14세,10429,5383,5046
202009,47111,경상북도,포항시 남구,10-14세,10449,5407,5042
202010,47111,경상북도,포항시 남구,10-14세,10476,5417,5059
202011,47111,경상북도,포항시 남구,10-14세,10493,5447,5046
202012,47111,경상북도,포항시 남구,10-14세,10532,5460,5072
202101,47111,경상북도,포항시 남구,10-14세,10565,5471,5094
202102,47111,경상북도,포항시 남구,10-14세,10623,5501,5122
202103,47111,경상북도,포항시 남구,10-14세,10627,5490,5137
202104,47111,경상북도,포항시 남구,10-14세,10652,5506,5146
202105,47111,경상북도,포항시 남구,10-14세,10646,5514,5132
202106,47111,경상북도,포항시 남구,10-14세,10647,5509,5138
202007,47111,경상북도,포항시 남구,15-19세,11014,5917,5097
202008,47111,경상북도,포항시 남구,15-19세,10917,5857,5060
202009,47111,경상북도,포항시 남구,15-19세,10875,5812,5063
202010,47111,경상북도,포항시 남구,15-19세,10843,5785,5058
202011,47111,경상북도,포항시 남구,15-19세,10804,5762,5042
202012,47111,경상북도,포항시 남구,15-19세,10710,5699,5011
202101,47111,경상북도,포항시 남구,15-19세,10633,5665,4968
202102,47111,경상북도,포항시 남구,15-19세,10568,5650,4918
202103,47111,경상북도,포항시 남구,15-19세,10569,5683,4886
202104,47111,경상북도,포항시 남구,15-19세,10511,5640,4871
202105,47111,경상북도,포항시 남구,15-19세,10464,5600,4864
202106,47111,경상북도,포항시 남구,15-19세,10432,5583,4849
202007,47111,경상북도,포항시 남구,20-24세,13408,7685,5723
202008,47111,경상북도,포항시 남구,20-24세,13339,7661,5678
202009,47111,경상북도,포항시 남구,20-24세,13275,7644,5631
202010,47111,경상북도,포항시 남구,20-24세,13187,7599,5588
202011,47111,경상북도,포항시 남구,20-24세,13122,7576,5546
202012,47111,경상북도,포항시 남구,20-24세,13063,7563,5500
202101,47111,경상북도,포항시 남구,20-24세,13062,7571,5491
202102,47111,경상북도,포항시 남구,20-24세,13089,7617,5472
202103,47111,경상북도,포항시 남구,20-24세,13104,7624,5480
202104,47111,경상북도,포항시 남구,20-24세,13110,7635,5475
202105,47111,경상북도,포항시 남구,20-24세,13075,7609,5466
202106,47111,경상북도,포항시 남구,20-24세,13060,7596,5464
202007,47111,경상북도,포항시 남구,25-29세,13103,7875,5228
202008,47111,경상북도,포항시 남구,25-29세,13065,7871,5194
202009,47111,경상북도,포항시 남구,25-29세,13051,7866,5185
202010,47111,경상북도,포항시 남구,25-29세,13040,7833,5207
202011,47111,경상북도,포항시 남구,25-29세,13053,7850,5203
202012,47111,경상북도,포항시 남구,25-29세,13130,7903,5227
202101,47111,경상북도,포항시 남구,25-29세,13240,7973,5267
202102,47111,경상북도,포항시 남구,25-29세,13308,8034,5274
202103,47111,경상북도,포항시 남구,25-29세,13492,8164,5328
202104,47111,경상북도,포항시 남구,25-29세,13558,8209,5349
202105,47111,경상북도,포항시 남구,25-29세,13612,8249,5363
202106,47111,경상북도,포항시 남구,25-29세,13624,8264,5360
202007,47111,경상북도,포항시 남구,30-34세,11789,6570,5219
202008,47111,경상북도,포항시 남구,30-34세,11760,6531,5229
202009,47111,경상북도,포항시 남구,30-34세,11663,6484,5179
202010,47111,경상북도,포항시 남구,30-34세,11656,6507,5149
202011,47111,경상북도,포항시 남구,30-34세,11659,6522,5137
202012,47111,경상북도,포항시 남구,30-34세,11591,6499,5092
202101,47111,경상북도,포항시 남구,30-34세,11493,6450,5043
202102,47111,경상북도,포항시 남구,30-34세,11491,6452,5039
202103,47111,경상북도,포항시 남구,30-34세,11510,6453,5057
202104,47111,경상북도,포항시 남구,30-34세,11574,6512,5062
202105,47111,경상북도,포항시 남구,30-34세,11583,6534,5049
202106,47111,경상북도,포항시 남구,30-34세,11538,6526,5012
202007,47111,경상북도,포항시 남구,35-39세,15842,8294,7548
202008,47111,경상북도,포항시 남구,35-39세,15724,8251,7473
202009,47111,경상북도,포항시 남구,35-39세,15613,8205,7408
202010,47111,경상북도,포항시 남구,35-39세,15531,8147,7384
202011,47111,경상북도,포항시 남구,35-39세,15411,8094,7317
202012,47111,경상북도,포항시 남구,35-39세,15388,8091,7297
202101,47111,경상북도,포항시 남구,35-39세,15252,8021,7231
202102,47111,경상북도,포항시 남구,35-39세,15186,7964,7222
202103,47111,경상북도,포항시 남구,35-39세,15079,7916,7163
202104,47111,경상북도,포항시 남구,35-39세,15027,7916,7111
202105,47111,경상북도,포항시 남구,35-39세,14952,7877,7075
202106,47111,경상북도,포항시 남구,35-39세,14844,7804,7040
202007,47111,경상북도,포항시 남구,40-44세,16368,8504,7864
202008,47111,경상북도,포항시 남구,40-44세,16400,8521,7879
202009,47111,경상북도,포항시 남구,40-44세,16487,8558,7929
202010,47111,경상북도,포항시 남구,40-44세,16538,8581,7957
202011,47111,경상북도,포항시 남구,40-44세,16604,8615,7989
202012,47111,경상북도,포항시 남구,40-44세,16615,8638,7977
202101,47111,경상북도,포항시 남구,40-44세,16663,8671,7992
202102,47111,경상북도,포항시 남구,40-44세,16769,8742,8027
202103,47111,경상북도,포항시 남구,40-44세,16779,8775,8004
202104,47111,경상북도,포항시 남구,40-44세,16835,8792,8043
202105,47111,경상북도,포항시 남구,40-44세,16896,8816,8080
202106,47111,경상북도,포항시 남구,40-44세,16991,8873,8118
202007,47111,경상북도,포항시 남구,45-49세,19473,9986,9487
202008,47111,경상북도,포항시 남구,45-49세,19389,9945,9444
202009,47111,경상북도,포항시 남구,45-49세,19269,9887,9382
202010,47111,경상북도,포항시 남구,45-49세,19152,9821,9331
202011,47111,경상북도,포항시 남구,45-49세,19038,9750,9288
202012,47111,경상북도,포항시 남구,45-49세,19010,9713,9297
202101,47111,경상북도,포항시 남구,45-49세,18948,9707,9241
202102,47111,경상북도,포항시 남구,45-49세,18915,9679,9236
202103,47111,경상북도,포항시 남구,45-49세,18877,9655,9222
202104,47111,경상북도,포항시 남구,45-49세,18864,9653,9211
202105,47111,경상북도,포항시 남구,45-49세,18695,9590,9105
202106,47111,경상북도,포항시 남구,45-49세,18632,9582,9050
202007,47111,경상북도,포항시 남구,50-54세,20933,11012,9921
202008,47111,경상북도,포항시 남구,50-54세,20902,11003,9899
202009,47111,경상북도,포항시 남구,50-54세,20920,11033,9887
202010,47111,경상북도,포항시 남구,50-54세,20867,10997,9870
202011,47111,경상북도,포항시 남구,50-54세,20853,11003,9850
202012,47111,경상북도,포항시 남구,50-54세,20748,10969,9779
202101,47111,경상북도,포항시 남구,50-54세,20804,10993,9811
202102,47111,경상북도,포항시 남구,50-54세,20793,10986,9807
202103,47111,경상북도,포항시 남구,50-54세,20703,10944,9759
202104,47111,경상북도,포항시 남구,50-54세,20713,10956,9757
202105,47111,경상북도,포항시 남구,50-54세,20805,10998,9807
202106,47111,경상북도,포항시 남구,50-54세,20813,10970,9843
202007,47111,경상북도,포항시 남구,55-59세,20931,10697,10234
202008,47111,경상북도,포항시 남구,55-59세,20862,10655,10207
202009,47111,경상북도,포항시 남구,55-59세,20785,10590,10195
202010,47111,경상북도,포항시 남구,55-59세,20755,10578,10177
202011,47111,경상북도,포항시 남구,55-59세,20655,10528,10127
202012,47111,경상북도,포항시 남구,55-59세,20633,10526,10107
202101,47111,경상북도,포항시 남구,55-59세,20521,10467,10054
202102,47111,경상북도,포항시 남구,55-59세,20461,10446,10015
202103,47111,경상북도,포항시 남구,55-59세,20464,10463,10001
202104,47111,경상북도,포항시 남구,55-59세,20402,10439,9963
202105,47111,경상북도,포항시 남구,55-59세,20252,10385,9867
202106,47111,경상북도,포항시 남구,55-59세,20116,10337,9779
202007,47111,경상북도,포항시 남구,60-64세,20638,10082,10556
202008,47111,경상북도,포항시 남구,60-64세,20709,10101,10608
202009,47111,경상북도,포항시 남구,60-64세,20770,10132,10638
202010,47111,경상북도,포항시 남구,60-64세,20847,10171,10676
202011,47111,경상북도,포항시 남구,60-64세,20913,10201,10712
202012,47111,경상북도,포항시 남구,60-64세,20915,10188,10727
202101,47111,경상북도,포항시 남구,60-64세,21005,10247,10758
202102,47111,경상북도,포항시 남구,60-64세,21142,10303,10839
202103,47111,경상북도,포항시 남구,60-64세,21223,10338,10885
202104,47111,경상북도,포항시 남구,60-64세,21292,10373,10919
202105,47111,경상북도,포항시 남구,60-64세,21361,10407,10954
202106,47111,경상북도,포항시 남구,60-64세,21460,10474,10986
202007,47111,경상북도,포항시 남구,65-69세,15160,7662,7498
202008,47111,경상북도,포항시 남구,65-69세,15259,7716,7543
202009,47111,경상북도,포항시 남구,65-69세,15402,7768,7634
202010,47111,경상북도,포항시 남구,65-69세,15504,7821,7683
202011,47111,경상북도,포항시 남구,65-69세,15602,7860,7742
202012,47111,경상북도,포항시 남구,65-69세,15686,7890,7796
202101,47111,경상북도,포항시 남구,65-69세,15775,7927,7848
202102,47111,경상북도,포항시 남구,65-69세,15866,7970,7896
202103,47111,경상북도,포항시 남구,65-69세,16066,8070,7996
202104,47111,경상북도,포항시 남구,65-69세,16206,8120,8086
202105,47111,경상북도,포항시 남구,65-69세,16276,8146,8130
202106,47111,경상북도,포항시 남구,65-69세,16376,8204,8172
202007,47111,경상북도,포항시 남구,70-74세,9769,4854,4915
202008,47111,경상북도,포항시 남구,70-74세,9850,4884,4966
202009,47111,경상북도,포항시 남구,70-74세,9914,4927,4987
202010,47111,경상북도,포항시 남구,70-74세,9986,4972,5014
202011,47111,경상북도,포항시 남구,70-74세,10083,5027,5056
202012,47111,경상북도,포항시 남구,70-74세,10211,5090,5121
202101,47111,경상북도,포항시 남구,70-74세,10366,5176,5190
202102,47111,경상북도,포항시 남구,70-74세,10478,5245,5233
202103,47111,경상북도,포항시 남구,70-74세,10531,5261,5270
202104,47111,경상북도,포항시 남구,70-74세,10545,5251,5294
202105,47111,경상북도,포항시 남구,70-74세,10569,5237,5332
202106,47111,경상북도,포항시 남구,70-74세,10622,5257,5365
202007,47111,경상북도,포항시 남구,75-79세,7198,3206,3992
202008,47111,경상북도,포항시 남구,75-79세,7195,3219,3976
202009,47111,경상북도,포항시 남구,75-79세,7155,3199,3956
202010,47111,경상북도,포항시 남구,75-79세,7115,3175,3940
202011,47111,경상북도,포항시 남구,75-79세,7083,3157,3926
202012,47111,경상북도,포항시 남구,75-79세,7026,3137,3889
202101,47111,경상북도,포항시 남구,75-79세,7003,3130,3873
202102,47111,경상북도,포항시 남구,75-79세,6957,3115,3842
202103,47111,경상북도,포항시 남구,75-79세,6948,3120,3828
202104,47111,경상북도,포항시 남구,75-79세,6944,3130,3814
202105,47111,경상북도,포항시 남구,75-79세,6928,3125,3803
202106,47111,경상북도,포항시 남구,75-79세,6922,3111,3811
202007,47111,경상북도,포항시 남구,80-84세,4448,1560,2888
202008,47111,경상북도,포항시 남구,80-84세,4469,1564,2905
202009,47111,경상북도,포항시 남구,80-84세,4491,1585,2906
202010,47111,경상북도,포항시 남구,80-84세,4535,1606,2929
202011,47111,경상북도,포항시 남구,80-84세,4545,1614,2931
202012,47111,경상북도,포항시 남구,80-84세,4564,1628,2936
202101,47111,경상북도,포항시 남구,80-84세,4562,1644,2918
202102,47111,경상북도,포항시 남구,80-84세,4595,1663,2932
202103,47111,경상북도,포항시 남구,80-84세,4648,1690,2958
202104,47111,경상북도,포항시 남구,80-84세,4664,1708,2956
202105,47111,경상북도,포항시 남구,80-84세,4668,1715,2953
202106,47111,경상북도,포항시 남구,80-84세,4704,1737,2967
202007,47111,경상북도,포항시 남구,85-89세,2143,552,1591
202008,47111,경상북도,포항시 남구,85-89세,2143,553,1590
202009,47111,경상북도,포항시 남구,85-89세,2170,561,1609
202010,47111,경상북도,포항시 남구,85-89세,2176,563,1613
202011,47111,경상북도,포항시 남구,85-89세,2178,564,1614
202012,47111,경상북도,포항시 남구,85-89세,2188,565,1623
202101,47111,경상북도,포항시 남구,85-89세,2222,575,1647
202102,47111,경상북도,포항시 남구,85-89세,2246,585,1661
202103,47111,경상북도,포항시 남구,85-89세,2281,597,1684
202104,47111,경상북도,포항시 남구,85-89세,2311,610,1701
202105,47111,경상북도,포항시 남구,85-89세,2313,611,1702
202106,47111,경상북도,포항시 남구,85-89세,2326,613,1713
202007,47111,경상북도,포항시 남구,90-94세,681,106,575
202008,47111,경상북도,포항시 남구,90-94세,678,107,571
202009,47111,경상북도,포항시 남구,90-94세,682,104,578
202010,47111,경상북도,포항시 남구,90-94세,690,103,587
202011,47111,경상북도,포항시 남구,90-94세,704,106,598
202012,47111,경상북도,포항시 남구,90-94세,713,109,604
202101,47111,경상북도,포항시 남구,90-94세,713,110,603
202102,47111,경상북도,포항시 남구,90-94세,732,115,617
202103,47111,경상북도,포항시 남구,90-94세,731,112,619
202104,47111,경상북도,포항시 남구,90-94세,730,111,619
202105,47111,경상북도,포항시 남구,90-94세,740,109,631
202106,47111,경상북도,포항시 남구,90-94세,743,115,628
202007,47111,경상북도,포항시 남구,95-99세,171,30,141
202008,47111,경상북도,포항시 남구,95-99세,172,30,142
202009,47111,경상북도,포항시 남구,95-99세,176,32,144
202010,47111,경상북도,포항시 남구,95-99세,173,32,141
202011,47111,경상북도,포항시 남구,95-99세,171,33,138
202012,47111,경상북도,포항시 남구,95-99세,174,34,140
202101,47111,경상북도,포항시 남구,95-99세,172,32,140
202102,47111,경상북도,포항시 남구,95-99세,177,32,145
202103,47111,경상북도,포항시 남구,95-99세,177,33,144
202104,47111,경상북도,포항시 남구,95-99세,179,33,146
202105,47111,경상북도,포항시 남구,95-99세,179,30,149
202106,47111,경상북도,포항시 남구,95-99세,171,30,141
202007,47111,경상북도,포항시 남구,100+,54,17,37
202008,47111,경상북도,포항시 남구,100+,55,17,38
202009,47111,경상북도,포항시 남구,100+,55,17,38
202010,47111,경상북도,포항시 남구,100+,55,17,38
202011,47111,경상북도,포항시 남구,100+,57,17,40
202012,47111,경상북도,포항시 남구,100+,57,17,40
202101,47111,경상북도,포항시 남구,100+,59,17,42
202102,47111,경상북도,포항시 남구,100+,60,17,43
202103,47111,경상북도,포항시 남구,100+,40,10,30
202104,47111,경상북도,포항시 남구,100+,41,10,31
202105,47111,경상북도,포항시 남구,100+,39,10,29
202106,47111,경상북도,포항시 남구,100+,40,9,31
202007,47113,경상북도,포항시 북구,0-4세,9613,4960,4653
202008,47113,경상북도,포항시 북구,0-4세,9527,4911,4616
202009,47113,경상북도,포항시 북구,0-4세,9447,4874,4573
202010,47113,경상북도,포항시 북구,0-4세,9369,4839,4530
202011,47113,경상북도,포항시 북구,0-4세,9294,4797,4497
202012,47113,경상북도,포항시 북구,0-4세,9233,4768,4465
202101,47113,경상북도,포항시 북구,0-4세,9086,4693,4393
202102,47113,경상북도,포항시 북구,0-4세,8974,4616,4358
202103,47113,경상북도,포항시 북구,0-4세,8886,4570,4316
202104,47113,경상북도,포항시 북구,0-4세,8818,4540,4278
202105,47113,경상북도,포항시 북구,0-4세,8697,4487,4210
202106,47113,경상북도,포항시 북구,0-4세,8630,4446,4184
202007,47113,경상북도,포항시 북구,5-9세,13110,6827,6283
202008,47113,경상북도,포항시 북구,5-9세,13119,6830,6289
202009,47113,경상북도,포항시 북구,5-9세,13114,6820,6294
202010,47113,경상북도,포항시 북구,5-9세,13065,6806,6259
202011,47113,경상북도,포항시 북구,5-9세,13013,6781,6232
202012,47113,경상북도,포항시 북구,5-9세,12972,6784,6188
202101,47113,경상북도,포항시 북구,5-9세,12944,6771,6173
202102,47113,경상북도,포항시 북구,5-9세,12929,6769,6160
202103,47113,경상북도,포항시 북구,5-9세,12943,6764,6179
202104,47113,경상북도,포항시 북구,5-9세,12905,6729,6176
202105,47113,경상북도,포항시 북구,5-9세,12901,6716,6185
202106,47113,경상북도,포항시 북구,5-9세,12894,6731,6163
202007,47113,경상북도,포항시 북구,10-14세,12271,6359,5912
202008,47113,경상북도,포항시 북구,10-14세,12297,6383,5914
202009,47113,경상북도,포항시 북구,10-14세,12309,6386,5923
202010,47113,경상북도,포항시 북구,10-14세,12362,6400,5962
202011,47113,경상북도,포항시 북구,10-14세,12416,6419,5997
202012,47113,경상북도,포항시 북구,10-14세,12453,6416,6037
202101,47113,경상북도,포항시 북구,10-14세,12535,6471,6064
202102,47113,경상북도,포항시 북구,10-14세,12553,6505,6048
202103,47113,경상북도,포항시 북구,10-14세,12565,6510,6055
202104,47113,경상북도,포항시 북구,10-14세,12565,6536,6029
202105,47113,경상북도,포항시 북구,10-14세,12577,6533,6044
202106,47113,경상북도,포항시 북구,10-14세,12610,6529,6081
202007,47113,경상북도,포항시 북구,15-19세,13504,7128,6376
202008,47113,경상북도,포항시 북구,15-19세,13393,7080,6313
202009,47113,경상북도,포항시 북구,15-19세,13314,7037,6277
202010,47113,경상북도,포항시 북구,15-19세,13208,6985,6223
202011,47113,경상북도,포항시 북구,15-19세,13144,6954,6190
202012,47113,경상북도,포항시 북구,15-19세,13058,6912,6146
202101,47113,경상북도,포항시 북구,15-19세,12970,6857,6113
202102,47113,경상북도,포항시 북구,15-19세,12904,6820,6084
202103,47113,경상북도,포항시 북구,15-19세,12851,6798,6053
202104,47113,경상북도,포항시 북구,15-19세,12785,6754,6031
202105,47113,경상북도,포항시 북구,15-19세,12745,6727,6018
202106,47113,경상북도,포항시 북구,15-19세,12681,6699,5982
202007,47113,경상북도,포항시 북구,20-24세,16032,8880,7152
202008,47113,경상북도,포항시 북구,20-24세,15979,8824,7155
202009,47113,경상북도,포항시 북구,20-24세,15956,8781,7175
202010,47113,경상북도,포항시 북구,20-24세,15904,8750,7154
202011,47113,경상북도,포항시 북구,20-24세,15854,8711,7143
202012,47113,경상북도,포항시 북구,20-24세,15794,8678,7116
202101,47113,경상북도,포항시 북구,20-24세,15708,8645,7063
202102,47113,경상북도,포항시 북구,20-24세,15544,8556,6988
202103,47113,경상북도,포항시 북구,20-24세,15626,8605,7021
202104,47113,경상북도,포항시 북구,20-24세,15602,8599,7003
202105,47113,경상북도,포항시 북구,20-24세,15558,8589,6969
202106,47113,경상북도,포항시 북구,20-24세,15553,8577,6976
202007,47113,경상북도,포항시 북구,25-29세,14327,8103,6224
202008,47113,경상북도,포항시 북구,25-29세,14318,8114,6204
202009,47113,경상북도,포항시 북구,25-29세,14353,8159,6194
202010,47113,경상북도,포항시 북구,25-29세,14408,8196,6212
202011,47113,경상북도,포항시 북구,25-29세,14441,8201,6240
202012,47113,경상북도,포항시 북구,25-29세,14463,8200,6263
202101,47113,경상북도,포항시 북구,25-29세,14410,8167,6243
202102,47113,경상북도,포항시 북구,25-29세,14431,8155,6276
202103,47113,경상북도,포항시 북구,25-29세,14494,8211,6283
202104,47113,경상북도,포항시 북구,25-29세,14584,8274,6310
202105,47113,경상북도,포항시 북구,25-29세,14631,8310,6321
202106,47113,경상북도,포항시 북구,25-29세,14715,8340,6375
202007,47113,경상북도,포항시 북구,30-34세,14053,7483,6570
202008,47113,경상북도,포항시 북구,30-34세,14084,7521,6563
202009,47113,경상북도,포항시 북구,30-34세,14093,7521,6572
202010,47113,경상북도,포항시 북구,30-34세,14037,7483,6554
202011,47113,경상북도,포항시 북구,30-34세,13937,7431,6506
202012,47113,경상북도,포항시 북구,30-34세,13898,7427,6471
202101,47113,경상북도,포항시 북구,30-34세,13930,7436,6494
202102,47113,경상북도,포항시 북구,30-34세,13936,7461,6475
202103,47113,경상북도,포항시 북구,30-34세,14014,7503,6511
202104,47113,경상북도,포항시 북구,30-34세,14046,7525,6521
202105,47113,경상북도,포항시 북구,30-34세,14004,7500,6504
202106,47113,경상북도,포항시 북구,30-34세,14034,7529,6505
202007,47113,경상북도,포항시 북구,35-39세,19131,9700,9431
202008,47113,경상북도,포항시 북구,35-39세,19054,9669,9385
202009,47113,경상북도,포항시 북구,35-39세,18960,9618,9342
202010,47113,경상북도,포항시 북구,35-39세,18895,9607,9288
202011,47113,경상북도,포항시 북구,35-39세,18780,9528,9252
202012,47113,경상북도,포항시 북구,35-39세,18700,9479,9221
202101,47113,경상북도,포항시 북구,35-39세,18575,9438,9137
202102,47113,경상북도,포항시 북구,35-39세,18478,9373,9105
202103,47113,경상북도,포항시 북구,35-39세,18368,9332,9036
202104,47113,경상북도,포항시 북구,35-39세,18202,9250,8952
202105,47113,경상북도,포항시 북구,35-39세,18071,9206,8865
202106,47113,경상북도,포항시 북구,35-39세,17972,9150,8822
202007,47113,경상북도,포항시 북구,40-44세,19164,9464,9700
202008,47113,경상북도,포항시 북구,40-44세,19205,9478,9727
202009,47113,경상북도,포항시 북구,40-44세,19257,9508,9749
202010,47113,경상북도,포항시 북구,40-44세,19289,9518,9771
202011,47113,경상북도,포항시 북구,40-44세,19367,9571,9796
202012,47113,경상북도,포항시 북구,40-44세,19331,9581,9750
202101,47113,경상북도,포항시 북구,40-44세,19332,9584,9748
202102,47113,경상북도,포항시 북구,40-44세,19407,9636,9771
202103,47113,경상북도,포항시 북구,40-44세,19465,9656,9809
202104,47113,경상북도,포항시 북구,40-44세,19534,9686,9848
202105,47113,경상북도,포항시 북구,40-44세,19574,9717,9857
202106,47113,경상북도,포항시 북구,40-44세,19736,9827,9909
202007,47113,경상북도,포항시 북구,45-49세,22629,11021,11608
202008,47113,경상북도,포항시 북구,45-49세,22518,10975,11543
202009,47113,경상북도,포항시 북구,45-49세,22399,10937,11462
202010,47113,경상북도,포항시 북구,45-49세,22239,10874,11365
202011,47113,경상북도,포항시 북구,45-49세,22170,10873,11297
202012,47113,경상북도,포항시 북구,45-49세,22174,10845,11329
202101,47113,경상북도,포항시 북구,45-49세,22091,10799,11292
202102,47113,경상북도,포항시 북구,45-49세,21983,10751,11232
202103,47113,경상북도,포항시 북구,45-49세,21901,10694,11207
202104,47113,경상북도,포항시 북구,45-49세,21869,10662,11207
202105,47113,경상북도,포항시 북구,45-49세,21712,10588,11124
202106,47113,경상북도,포항시 북구,45-49세,21599,10527,11072
202007,47113,경상북도,포항시 북구,50-54세,23877,11710,12167
202008,47113,경상북도,포항시 북구,50-54세,23903,11720,12183
202009,47113,경상북도,포항시 북구,50-54세,23946,11709,12237
202010,47113,경상북도,포항시 북구,50-54세,23995,11737,12258
202011,47113,경상북도,포항시 북구,50-54세,24018,11722,12296
202012,47113,경상북도,포항시 북구,50-54세,23935,11708,12227
202101,47113,경상북도,포항시 북구,50-54세,24013,11746,12267
202102,47113,경상북도,포항시 북구,50-54세,24069,11745,12324
202103,47113,경상북도,포항시 북구,50-54세,23918,11697,12221
202104,47113,경상북도,포항시 북구,50-54세,23867,11679,12188
202105,47113,경상북도,포항시 북구,50-54세,23917,11703,12214
202106,47113,경상북도,포항시 북구,50-54세,23935,11706,12229
202007,47113,경상북도,포항시 북구,55-59세,25119,12200,12919
202008,47113,경상북도,포항시 북구,55-59세,25091,12180,12911
202009,47113,경상북도,포항시 북구,55-59세,24993,12160,12833
202010,47113,경상북도,포항시 북구,55-59세,24885,12111,12774
202011,47113,경상북도,포항시 북구,55-59세,24827,12076,12751
202012,47113,경상북도,포항시 북구,55-59세,24833,12041,12792
202101,47113,경상북도,포항시 북구,55-59세,24621,11937,12684
202102,47113,경상북도,포항시 북구,55-59세,24521,11880,12641
202103,47113,경상북도,포항시 북구,55-59세,24538,11930,12608
202104,47113,경상북도,포항시 북구,55-59세,24549,11930,12619
202105,47113,경상북도,포항시 북구,55-59세,24370,11858,12512
202106,47113,경상북도,포항시 북구,55-59세,24268,11802,12466
202007,47113,경상북도,포항시 북구,60-64세,23716,11450,12266
202008,47113,경상북도,포항시 북구,60-64세,23826,11503,12323
202009,47113,경상북도,포항시 북구,60-64세,23971,11568,12403
202010,47113,경상북도,포항시 북구,60-64세,24106,11625,12481
202011,47113,경상북도,포항시 북구,60-64세,24208,11683,12525
202012,47113,경상북도,포항시 북구,60-64세,24309,11750,12559
202101,47113,경상북도,포항시 북구,60-64세,24504,11833,12671
202102,47113,경상북도,포항시 북구,60-64세,24675,11933,12742
202103,47113,경상북도,포항시 북구,60-64세,24822,11996,12826
202104,47113,경상북도,포항시 북구,60-64세,24904,12019,12885
202105,47113,경상북도,포항시 북구,60-64세,25062,12073,12989
202106,47113,경상북도,포항시 북구,60-64세,25198,12157,13041
202007,47113,경상북도,포항시 북구,65-69세,16928,8346,8582
202008,47113,경상북도,포항시 북구,65-69세,17093,8436,8657
202009,47113,경상북도,포항시 북구,65-69세,17242,8498,8744
202010,47113,경상북도,포항시 북구,65-69세,17389,8570,8819
202011,47113,경상북도,포항시 북구,65-69세,17523,8641,8882
202012,47113,경상북도,포항시 북구,65-69세,17670,8698,8972
202101,47113,경상북도,포항시 북구,65-69세,17802,8772,9030
202102,47113,경상북도,포항시 북구,65-69세,17922,8841,9081
202103,47113,경상북도,포항시 북구,65-69세,18200,8946,9254
202104,47113,경상북도,포항시 북구,65-69세,18330,9024,9306
202105,47113,경상북도,포항시 북구,65-69세,18398,9066,9332
202106,47113,경상북도,포항시 북구,65-69세,18471,9111,9360
202007,47113,경상북도,포항시 북구,70-74세,10998,5381,5617
202008,47113,경상북도,포항시 북구,70-74세,11043,5389,5654
202009,47113,경상북도,포항시 북구,70-74세,11147,5450,5697
202010,47113,경상북도,포항시 북구,70-74세,11284,5510,5774
202011,47113,경상북도,포항시 북구,70-74세,11347,5526,5821
202012,47113,경상북도,포항시 북구,70-74세,11477,5596,5881
202101,47113,경상북도,포항시 북구,70-74세,11615,5672,5943
202102,47113,경상북도,포항시 북구,70-74세,11726,5717,6009
202103,47113,경상북도,포항시 북구,70-74세,11823,5772,6051
202104,47113,경상북도,포항시 북구,70-74세,11863,5789,6074
202105,47113,경상북도,포항시 북구,70-74세,11887,5819,6068
202106,47113,경상북도,포항시 북구,70-74세,11951,5852,6099
202007,47113,경상북도,포항시 북구,75-79세,8466,3542,4924
202008,47113,경상북도,포항시 북구,75-79세,8482,3554,4928
202009,47113,경상북도,포항시 북구,75-79세,8431,3530,4901
202010,47113,경상북도,포항시 북구,75-79세,8368,3506,4862
202011,47113,경상북도,포항시 북구,75-79세,8352,3504,4848
202012,47113,경상북도,포항시 북구,75-79세,8285,3471,4814
202101,47113,경상북도,포항시 북구,75-79세,8251,3466,4785
202102,47113,경상북도,포항시 북구,75-79세,8213,3455,4758
202103,47113,경상북도,포항시 북구,75-79세,8198,3451,4747
202104,47113,경상북도,포항시 북구,75-79세,8191,3459,4732
202105,47113,경상북도,포항시 북구,75-79세,8141,3439,4702
202106,47113,경상북도,포항시 북구,75-79세,8115,3432,4683
202007,47113,경상북도,포항시 북구,80-84세,5628,2005,3623
202008,47113,경상북도,포항시 북구,80-84세,5612,2007,3605
202009,47113,경상북도,포항시 북구,80-84세,5636,2032,3604
202010,47113,경상북도,포항시 북구,80-84세,5673,2033,3640
202011,47113,경상북도,포항시 북구,80-84세,5684,2039,3645
202012,47113,경상북도,포항시 북구,80-84세,5717,2058,3659
202101,47113,경상북도,포항시 북구,80-84세,5737,2074,3663
202102,47113,경상북도,포항시 북구,80-84세,5800,2092,3708
202103,47113,경상북도,포항시 북구,80-84세,5843,2117,3726
202104,47113,경상북도,포항시 북구,80-84세,5849,2124,3725
202105,47113,경상북도,포항시 북구,80-84세,5871,2131,3740
202106,47113,경상북도,포항시 북구,80-84세,5891,2144,3747
202007,47113,경상북도,포항시 북구,85-89세,2852,762,2090
202008,47113,경상북도,포항시 북구,85-89세,2870,768,2102
202009,47113,경상북도,포항시 북구,85-89세,2888,764,2124
202010,47113,경상북도,포항시 북구,85-89세,2873,769,2104
202011,47113,경상북도,포항시 북구,85-89세,2881,780,2101
202012,47113,경상북도,포항시 북구,85-89세,2882,781,2101
202101,47113,경상북도,포항시 북구,85-89세,2900,777,2123
202102,47113,경상북도,포항시 북구,85-89세,2928,795,2133
202103,47113,경상북도,포항시 북구,85-89세,2977,813,2164
202104,47113,경상북도,포항시 북구,85-89세,3036,831,2205
202105,47113,경상북도,포항시 북구,85-89세,3048,843,2205
202106,47113,경상북도,포항시 북구,85-89세,3069,847,2222
202007,47113,경상북도,포항시 북구,90-94세,1012,197,815
202008,47113,경상북도,포항시 북구,90-94세,1020,196,824
202009,47113,경상북도,포항시 북구,90-94세,1032,202,830
202010,47113,경상북도,포항시 북구,90-94세,1032,201,831
202011,47113,경상북도,포항시 북구,90-94세,1044,206,838
202012,47113,경상북도,포항시 북구,90-94세,1044,208,836
202101,47113,경상북도,포항시 북구,90-94세,1065,210,855
202102,47113,경상북도,포항시 북구,90-94세,1080,213,867
202103,47113,경상북도,포항시 북구,90-94세,1091,210,881
202104,47113,경상북도,포항시 북구,90-94세,1093,207,886
202105,47113,경상북도,포항시 북구,90-94세,1099,206,893
202106,47113,경상북도,포항시 북구,90-94세,1096,205,891
202007,47113,경상북도,포항시 북구,95-99세,216,46,170
202008,47113,경상북도,포항시 북구,95-99세,218,44,174
202009,47113,경상북도,포항시 북구,95-99세,222,43,179
202010,47113,경상북도,포항시 북구,95-99세,219,42,177
202011,47113,경상북도,포항시 북구,95-99세,212,42,170
202012,47113,경상북도,포항시 북구,95-99세,211,41,170
202101,47113,경상북도,포항시 북구,95-99세,214,42,172
202102,47113,경상북도,포항시 북구,95-99세,213,42,171
202103,47113,경상북도,포항시 북구,95-99세,210,41,169
202104,47113,경상북도,포항시 북구,95-99세,214,41,173
202105,47113,경상북도,포항시 북구,95-99세,203,36,167
202106,47113,경상북도,포항시 북구,95-99세,203,35,168
202007,47113,경상북도,포항시 북구,100+,51,12,39
202008,47113,경상북도,포항시 북구,100+,51,12,39
202009,47113,경상북도,포항시 북구,100+,54,13,41
202010,47113,경상북도,포항시 북구,100+,56,13,43
202011,47113,경상북도,포항시 북구,100+,54,13,41
202012,47113,경상북도,포항시 북구,100+,55,13,42
202101,47113,경상북도,포항시 북구,100+,52,13,39
202102,47113,경상북도,포항시 북구,100+,53,13,40
202103,47113,경상북도,포항시 북구,100+,34,5,29
202104,47113,경상북도,포항시 북구,100+,33,5,28
202105,47113,경상북도,포항시 북구,100+,30,4,26
202106,47113,경상북도,포항시 북구,100+,29,4,25
202007,47130,경상북도,경주시,0-4세,6989,3556,3433
202008,47130,경상북도,경주시,0-4세,6930,3519,3411
202009,47130,경상북도,경주시,0-4세,6910,3510,3400
202010,47130,경상북도,경주시,0-4세,6834,3481,3353
202011,47130,경상북도,경주시,0-4세,6790,3462,3328
202012,47130,경상북도,경주시,0-4세,6761,3447,3314
202101,47130,경상북도,경주시,0-4세,6698,3405,3293
202102,47130,경상북도,경주시,0-4세,6686,3384,3302
202103,47130,경상북도,경주시,0-4세,6648,3369,3279
202104,47130,경상북도,경주시,0-4세,6625,3346,3279
202105,47130,경상북도,경주시,0-4세,6589,3336,3253
202106,47130,경상북도,경주시,0-4세,6541,3314,3227
202007,47130,경상북도,경주시,5-9세,9541,4904,4637
202008,47130,경상북도,경주시,5-9세,9560,4918,4642
202009,47130,경상북도,경주시,5-9세,9535,4899,4636
202010,47130,경상북도,경주시,5-9세,9523,4885,4638
202011,47130,경상북도,경주시,5-9세,9505,4881,4624
202012,47130,경상북도,경주시,5-9세,9435,4849,4586
202101,47130,경상북도,경주시,5-9세,9399,4836,4563
202102,47130,경상북도,경주시,5-9세,9370,4819,4551
202103,47130,경상북도,경주시,5-9세,9365,4814,4551
202104,47130,경상북도,경주시,5-9세,9351,4821,4530
202105,47130,경상북도,경주시,5-9세,9315,4790,4525
202106,47130,경상북도,경주시,5-9세,9277,4747,4530
202007,47130,경상북도,경주시,10-14세,9885,5087,4798
202008,47130,경상북도,경주시,10-14세,9844,5068,4776
202009,47130,경상북도,경주시,10-14세,9870,5082,4788
202010,47130,경상북도,경주시,10-14세,9881,5081,4800
202011,47130,경상북도,경주시,10-14세,9899,5082,4817
202012,47130,경상북도,경주시,10-14세,9926,5110,4816
202101,47130,경상북도,경주시,10-14세,9973,5137,4836
202102,47130,경상북도,경주시,10-14세,9950,5113,4837
202103,47130,경상북도,경주시,10-14세,9959,5103,4856
202104,47130,경상북도,경주시,10-14세,9948,5091,4857
202105,47130,경상북도,경주시,10-14세,9951,5102,4849
202106,47130,경상북도,경주시,10-14세,9939,5114,4825
202007,47130,경상북도,경주시,15-19세,11343,6027,5316
202008,47130,경상북도,경주시,15-19세,11271,5982,5289
202009,47130,경상북도,경주시,15-19세,11172,5934,5238
202010,47130,경상북도,경주시,15-19세,11054,5866,5188
202011,47130,경상북도,경주시,15-19세,10969,5823,5146
202012,47130,경상북도,경주시,15-19세,10910,5782,5128
202101,47130,경상북도,경주시,15-19세,10886,5766,5120
202102,47130,경상북도,경주시,15-19세,10876,5793,5083
202103,47130,경상북도,경주시,15-19세,10746,5725,5021
202104,47130,경상북도,경주시,15-19세,10641,5662,4979
202105,47130,경상북도,경주시,15-19세,10565,5609,4956
202106,47130,경상북도,경주시,15-19세,10488,5554,4934
202007,47130,경상북도,경주시,20-24세,14293,7949,6344
202008,47130,경상북도,경주시,20-24세,14218,7918,6300
202009,47130,경상북도,경주시,20-24세,14164,7867,6297
202010,47130,경상북도,경주시,20-24세,14194,7885,6309
202011,47130,경상북도,경주시,20-24세,14248,7925,6323
202012,47130,경상북도,경주시,20-24세,14203,7917,6286
202101,47130,경상북도,경주시,20-24세,14149,7877,6272
202102,47130,경상북도,경주시,20-24세,13986,7778,6208
202103,47130,경상북도,경주시,20-24세,13897,7749,6148
202104,47130,경상북도,경주시,20-24세,13809,7697,6112
202105,47130,경상북도,경주시,20-24세,13779,7691,6088
202106,47130,경상북도,경주시,20-24세,13728,7659,6069
202007,47130,경상북도,경주시,25-29세,12748,7351,5397
202008,47130,경상북도,경주시,25-29세,12726,7307,5419
202009,47130,경상북도,경주시,25-29세,12701,7271,5430
202010,47130,경상북도,경주시,25-29세,12694,7260,5434
202011,47130,경상북도,경주시,25-29세,12705,7262,5443
202012,47130,경상북도,경주시,25-29세,12718,7275,5443
202101,47130,경상북도,경주시,25-29세,12636,7232,5404
202102,47130,경상북도,경주시,25-29세,12588,7206,5382
202103,47130,경상북도,경주시,25-29세,12555,7166,5389
202104,47130,경상북도,경주시,25-29세,12563,7180,5383
202105,47130,경상북도,경주시,25-29세,12538,7168,5370
202106,47130,경상북도,경주시,25-29세,12495,7150,5345
202007,47130,경상북도,경주시,30-34세,11371,6206,5165
202008,47130,경상북도,경주시,30-34세,11337,6204,5133
202009,47130,경상북도,경주시,30-34세,11345,6206,5139
202010,47130,경상북도,경주시,30-34세,11304,6202,5102
202011,47130,경상북도,경주시,30-34세,11333,6230,5103
202012,47130,경상북도,경주시,30-34세,11282,6199,5083
202101,47130,경상북도,경주시,30-34세,11267,6187,5080
202102,47130,경상북도,경주시,30-34세,11276,6199,5077
202103,47130,경상북도,경주시,30-34세,11255,6168,5087
202104,47130,경상북도,경주시,30-34세,11272,6168,5104
202105,47130,경상북도,경주시,30-34세,11316,6173,5143
202106,47130,경상북도,경주시,30-34세,11381,6226,5155
202007,47130,경상북도,경주시,35-39세,14517,7571,6946
202008,47130,경상북도,경주시,35-39세,14451,7548,6903
202009,47130,경상북도,경주시,35-39세,14345,7481,6864
202010,47130,경상북도,경주시,35-39세,14238,7414,6824
202011,47130,경상북도,경주시,35-39세,14197,7408,6789
202012,47130,경상북도,경주시,35-39세,14178,7389,6789
202101,47130,경상북도,경주시,35-39세,14055,7326,6729
202102,47130,경상북도,경주시,35-39세,13941,7279,6662
202103,47130,경상북도,경주시,35-39세,13825,7224,6601
202104,47130,경상북도,경주시,35-39세,13789,7206,6583
202105,47130,경상북도,경주시,35-39세,13694,7156,6538
202106,47130,경상북도,경주시,35-39세,13592,7101,6491
202007,47130,경상북도,경주시,40-44세,16085,8448,7637
202008,47130,경상북도,경주시,40-44세,16070,8431,7639
202009,47130,경상북도,경주시,40-44세,16090,8440,7650
202010,47130,경상북도,경주시,40-44세,16070,8453,7617
202011,47130,경상북도,경주시,40-44세,16113,8464,7649
202012,47130,경상북도,경주시,40-44세,16081,8443,7638
202101,47130,경상북도,경주시,40-44세,16067,8437,7630
202102,47130,경상북도,경주시,40-44세,16150,8483,7667
202103,47130,경상북도,경주시,40-44세,16099,8468,7631
202104,47130,경상북도,경주시,40-44세,16085,8470,7615
202105,47130,경상북도,경주시,40-44세,16133,8510,7623
202106,47130,경상북도,경주시,40-44세,16231,8570,7661
202007,47130,경상북도,경주시,45-49세,21072,10975,10097
202008,47130,경상북도,경주시,45-49세,20942,10914,10028
202009,47130,경상북도,경주시,45-49세,20874,10869,10005
202010,47130,경상북도,경주시,45-49세,20765,10790,9975
202011,47130,경상북도,경주시,45-49세,20650,10699,9951
202012,47130,경상북도,경주시,45-49세,20606,10674,9932
202101,47130,경상북도,경주시,45-49세,20529,10623,9906
202102,47130,경상북도,경주시,45-49세,20511,10610,9901
202103,47130,경상북도,경주시,45-49세,20402,10537,9865
202104,47130,경상북도,경주시,45-49세,20366,10512,9854
202105,47130,경상북도,경주시,45-49세,20196,10399,9797
202106,47130,경상북도,경주시,45-49세,20017,10298,9719
202007,47130,경상북도,경주시,50-54세,22975,11900,11075
202008,47130,경상북도,경주시,50-54세,23053,11945,11108
202009,47130,경상북도,경주시,50-54세,23059,11951,11108
202010,47130,경상북도,경주시,50-54세,23074,11969,11105
202011,47130,경상북도,경주시,50-54세,23130,11999,11131
202012,47130,경상북도,경주시,50-54세,23125,12001,11124
202101,47130,경상북도,경주시,50-54세,23233,12036,11197
202102,47130,경상북도,경주시,50-54세,23280,12032,11248
202103,47130,경상북도,경주시,50-54세,23130,11970,11160
202104,47130,경상북도,경주시,50-54세,23122,11939,11183
202105,47130,경상북도,경주시,50-54세,23190,11981,11209
202106,47130,경상북도,경주시,50-54세,23171,11963,11208
202007,47130,경상북도,경주시,55-59세,23906,12254,11652
202008,47130,경상북도,경주시,55-59세,23802,12198,11604
202009,47130,경상북도,경주시,55-59세,23743,12190,11553
202010,47130,경상북도,경주시,55-59세,23705,12185,11520
202011,47130,경상북도,경주시,55-59세,23716,12225,11491
202012,47130,경상북도,경주시,55-59세,23727,12215,11512
202101,47130,경상북도,경주시,55-59세,23619,12174,11445
202102,47130,경상북도,경주시,55-59세,23605,12182,11423
202103,47130,경상북도,경주시,55-59세,23550,12170,11380
202104,47130,경상북도,경주시,55-59세,23530,12186,11344
202105,47130,경상북도,경주시,55-59세,23505,12181,11324
202106,47130,경상북도,경주시,55-59세,23387,12146,11241
202007,47130,경상북도,경주시,60-64세,22680,11423,11257
202008,47130,경상북도,경주시,60-64세,22824,11502,11322
202009,47130,경상북도,경주시,60-64세,22941,11549,11392
202010,47130,경상북도,경주시,60-64세,23091,11620,11471
202011,47130,경상북도,경주시,60-64세,23140,11621,11519
202012,47130,경상북도,경주시,60-64세,23237,11689,11548
202101,47130,경상북도,경주시,60-64세,23316,11728,11588
202102,47130,경상북도,경주시,60-64세,23471,11838,11633
202103,47130,경상북도,경주시,60-64세,23488,11847,11641
202104,47130,경상북도,경주시,60-64세,23614,11891,11723
202105,47130,경상북도,경주시,60-64세,23715,11933,11782
202106,47130,경상북도,경주시,60-64세,23890,12004,11886
202007,47130,경상북도,경주시,65-69세,17314,8229,9085
202008,47130,경상북도,경주시,65-69세,17401,8278,9123
202009,47130,경상북도,경주시,65-69세,17517,8366,9151
202010,47130,경상북도,경주시,65-69세,17620,8430,9190
202011,47130,경상북도,경주시,65-69세,17766,8517,9249
202012,47130,경상북도,경주시,65-69세,17932,8592,9340
202101,47130,경상북도,경주시,65-69세,18096,8668,9428
202102,47130,경상북도,경주시,65-69세,18188,8694,9494
202103,47130,경상북도,경주시,65-69세,18360,8792,9568
202104,47130,경상북도,경주시,65-69세,18469,8879,9590
202105,47130,경상북도,경주시,65-69세,18535,8907,9628
202106,47130,경상북도,경주시,65-69세,18606,8956,9650
202007,47130,경상북도,경주시,70-74세,13005,6139,6866
202008,47130,경상북도,경주시,70-74세,13053,6169,6884
202009,47130,경상북도,경주시,70-74세,13133,6186,6947
202010,47130,경상북도,경주시,70-74세,13227,6220,7007
202011,47130,경상북도,경주시,70-74세,13329,6265,7064
202012,47130,경상북도,경주시,70-74세,13429,6318,7111
202101,47130,경상북도,경주시,70-74세,13565,6385,7180
202102,47130,경상북도,경주시,70-74세,13712,6468,7244
202103,47130,경상북도,경주시,70-74세,13762,6506,7256
202104,47130,경상북도,경주시,70-74세,13823,6528,7295
202105,47130,경상북도,경주시,70-74세,13917,6581,7336
202106,47130,경상북도,경주시,70-74세,13979,6599,7380
202007,47130,경상북도,경주시,75-79세,11378,4625,6753
202008,47130,경상북도,경주시,75-79세,11373,4635,6738
202009,47130,경상북도,경주시,75-79세,11294,4610,6684
202010,47130,경상북도,경주시,75-79세,11250,4600,6650
202011,47130,경상북도,경주시,75-79세,11193,4574,6619
202012,47130,경상북도,경주시,75-79세,11094,4554,6540
202101,47130,경상북도,경주시,75-79세,11035,4549,6486
202102,47130,경상북도,경주시,75-79세,10920,4518,6402
202103,47130,경상북도,경주시,75-79세,10861,4496,6365
202104,47130,경상북도,경주시,75-79세,10811,4476,6335
202105,47130,경상북도,경주시,75-79세,10771,4472,6299
202106,47130,경상북도,경주시,75-79세,10720,4446,6274
202007,47130,경상북도,경주시,80-84세,8346,2804,5542
202008,47130,경상북도,경주시,80-84세,8333,2792,5541
202009,47130,경상북도,경주시,80-84세,8368,2810,5558
202010,47130,경상북도,경주시,80-84세,8407,2814,5593
202011,47130,경상북도,경주시,80-84세,8407,2818,5589
202012,47130,경상북도,경주시,80-84세,8452,2834,5618
202101,47130,경상북도,경주시,80-84세,8474,2838,5636
202102,47130,경상북도,경주시,80-84세,8529,2858,5671
202103,47130,경상북도,경주시,80-84세,8459,2845,5614
202104,47130,경상북도,경주시,80-84세,8437,2859,5578
202105,47130,경상북도,경주시,80-84세,8450,2865,5585
202106,47130,경상북도,경주시,80-84세,8478,2870,5608
202007,47130,경상북도,경주시,85-89세,4455,1223,3232
202008,47130,경상북도,경주시,85-89세,4481,1231,3250
202009,47130,경상북도,경주시,85-89세,4526,1244,3282
202010,47130,경상북도,경주시,85-89세,4527,1237,3290
202011,47130,경상북도,경주시,85-89세,4539,1248,3291
202012,47130,경상북도,경주시,85-89세,4560,1260,3300
202101,47130,경상북도,경주시,85-89세,4626,1285,3341
202102,47130,경상북도,경주시,85-89세,4669,1304,3365
202103,47130,경상북도,경주시,85-89세,4733,1321,3412
202104,47130,경상북도,경주시,85-89세,4786,1329,3457
202105,47130,경상북도,경주시,85-89세,4818,1340,3478
202106,47130,경상북도,경주시,85-89세,4814,1350,3464
202007,47130,경상북도,경주시,90-94세,1355,257,1098
202008,47130,경상북도,경주시,90-94세,1371,262,1109
202009,47130,경상북도,경주시,90-94세,1382,269,1113
202010,47130,경상북도,경주시,90-94세,1399,277,1122
202011,47130,경상북도,경주시,90-94세,1419,276,1143
202012,47130,경상북도,경주시,90-94세,1421,275,1146
202101,47130,경상북도,경주시,90-94세,1430,274,1156
202102,47130,경상북도,경주시,90-94세,1442,279,1163
202103,47130,경상북도,경주시,90-94세,1443,278,1165
202104,47130,경상북도,경주시,90-94세,1458,279,1179
202105,47130,경상북도,경주시,90-94세,1482,289,1193
202106,47130,경상북도,경주시,90-94세,1501,294,1207
202007,47130,경상북도,경주시,95-99세,325,70,255
202008,47130,경상북도,경주시,95-99세,327,70,257
202009,47130,경상북도,경주시,95-99세,335,70,265
202010,47130,경상북도,경주시,95-99세,335,70,265
202011,47130,경상북도,경주시,95-99세,329,67,262
202012,47130,경상북도,경주시,95-99세,333,66,267
202101,47130,경상북도,경주시,95-99세,332,68,264
202102,47130,경상북도,경주시,95-99세,334,69,265
202103,47130,경상북도,경주시,95-99세,310,58,252
202104,47130,경상북도,경주시,95-99세,304,55,249
202105,47130,경상북도,경주시,95-99세,304,54,250
202106,47130,경상북도,경주시,95-99세,299,54,245
202007,47130,경상북도,경주시,100+,91,21,70
202008,47130,경상북도,경주시,100+,93,22,71
202009,47130,경상북도,경주시,100+,92,22,70
202010,47130,경상북도,경주시,100+,90,21,69
202011,47130,경상북도,경주시,100+,91,21,70
202012,47130,경상북도,경주시,100+,92,22,70
202101,47130,경상북도,경주시,100+,90,22,68
202102,47130,경상북도,경주시,100+,95,23,72
202103,47130,경상북도,경주시,100+,64,13,51
202104,47130,경상북도,경주시,100+,66,15,51
202105,47130,경상북도,경주시,100+,67,15,52
202106,47130,경상북도,경주시,100+,68,14,54
202007,47150,경상북도,김천시,0-4세,4848,2506,2342
202008,47150,경상북도,김천시,0-4세,4801,2491,2310
202009,47150,경상북도,김천시,0-4세,4767,2479,2288
202010,47150,경상북도,김천시,0-4세,4749,2475,2274
202011,47150,경상북도,김천시,0-4세,4719,2461,2258
202012,47150,경상북도,김천시,0-4세,4681,2456,2225
202101,47150,경상북도,김천시,0-4세,4607,2428,2179
202102,47150,경상북도,김천시,0-4세,4566,2403,2163
202103,47150,경상북도,김천시,0-4세,4543,2392,2151
202104,47150,경상북도,김천시,0-4세,4494,2356,2138
202105,47150,경상북도,김천시,0-4세,4489,2342,2147
202106,47150,경상북도,김천시,0-4세,4458,2332,2126
202007,47150,경상북도,김천시,5-9세,5820,2998,2822
202008,47150,경상북도,김천시,5-9세,5823,2998,2825
202009,47150,경상북도,김천시,5-9세,5811,2990,2821
202010,47150,경상북도,김천시,5-9세,5772,2973,2799
202011,47150,경상북도,김천시,5-9세,5752,2964,2788
202012,47150,경상북도,김천시,5-9세,5756,2960,2796
202101,47150,경상북도,김천시,5-9세,5772,2963,2809
202102,47150,경상북도,김천시,5-9세,5750,2940,2810
202103,47150,경상북도,김천시,5-9세,5723,2928,2795
202104,47150,경상북도,김천시,5-9세,5705,2914,2791
202105,47150,경상북도,김천시,5-9세,5689,2919,2770
202106,47150,경상북도,김천시,5-9세,5697,2912,2785
202007,47150,경상북도,김천시,10-14세,5577,2958,2619
202008,47150,경상북도,김천시,10-14세,5581,2958,2623
202009,47150,경상북도,김천시,10-14세,5600,2972,2628
202010,47150,경상북도,김천시,10-14세,5634,2990,2644
202011,47150,경상북도,김천시,10-14세,5724,3023,2701
202012,47150,경상북도,김천시,10-14세,5746,3043,2703
202101,47150,경상북도,김천시,10-14세,5804,3089,2715
202102,47150,경상북도,김천시,10-14세,5801,3102,2699
202103,47150,경상북도,김천시,10-14세,5859,3132,2727
202104,47150,경상북도,김천시,10-14세,5882,3145,2737
202105,47150,경상북도,김천시,10-14세,5865,3130,2735
202106,47150,경상북도,김천시,10-14세,5876,3131,2745
202007,47150,경상북도,김천시,15-19세,6590,3596,2994
202008,47150,경상북도,김천시,15-19세,6545,3577,2968
202009,47150,경상북도,김천시,15-19세,6520,3563,2957
202010,47150,경상북도,김천시,15-19세,6501,3546,2955
202011,47150,경상북도,김천시,15-19세,6496,3538,2958
202012,47150,경상북도,김천시,15-19세,6499,3551,2948
202101,47150,경상북도,김천시,15-19세,6400,3494,2906
202102,47150,경상북도,김천시,15-19세,6487,3604,2883
202103,47150,경상북도,김천시,15-19세,6595,3660,2935
202104,47150,경상북도,김천시,15-19세,6559,3619,2940
202105,47150,경상북도,김천시,15-19세,6531,3613,2918
202106,47150,경상북도,김천시,15-19세,6507,3599,2908
202007,47150,경상북도,김천시,20-24세,7702,4286,3416
202008,47150,경상북도,김천시,20-24세,7644,4257,3387
202009,47150,경상북도,김천시,20-24세,7639,4249,3390
202010,47150,경상북도,김천시,20-24세,7644,4245,3399
202011,47150,경상북도,김천시,20-24세,7615,4231,3384
202012,47150,경상북도,김천시,20-24세,7576,4212,3364
202101,47150,경상북도,김천시,20-24세,7566,4191,3375
202102,47150,경상북도,김천시,20-24세,7525,4159,3366
202103,47150,경상북도,김천시,20-24세,7502,4137,3365
202104,47150,경상북도,김천시,20-24세,7499,4136,3363
202105,47150,경상북도,김천시,20-24세,7496,4145,3351
202106,47150,경상북도,김천시,20-24세,7429,4111,3318
202007,47150,경상북도,김천시,25-29세,7086,4039,3047
202008,47150,경상북도,김천시,25-29세,7080,4046,3034
202009,47150,경상북도,김천시,25-29세,7072,4036,3036
202010,47150,경상북도,김천시,25-29세,7043,4010,3033
202011,47150,경상북도,김천시,25-29세,7061,4017,3044
202012,47150,경상북도,김천시,25-29세,7044,4001,3043
202101,47150,경상북도,김천시,25-29세,7042,4011,3031
202102,47150,경상북도,김천시,25-29세,7032,4013,3019
202103,47150,경상북도,김천시,25-29세,7064,4008,3056
202104,47150,경상북도,김천시,25-29세,7052,4019,3033
202105,47150,경상북도,김천시,25-29세,7036,4001,3035
202106,47150,경상북도,김천시,25-29세,7026,3996,3030
202007,47150,경상북도,김천시,30-34세,6725,3632,3093
202008,47150,경상북도,김천시,30-34세,6709,3616,3093
202009,47150,경상북도,김천시,30-34세,6679,3600,3079
202010,47150,경상북도,김천시,30-34세,6674,3590,3084
202011,47150,경상북도,김천시,30-34세,6650,3590,3060
202012,47150,경상북도,김천시,30-34세,6625,3595,3030
202101,47150,경상북도,김천시,30-34세,6612,3578,3034
202102,47150,경상북도,김천시,30-34세,6609,3577,3032
202103,47150,경상북도,김천시,30-34세,6583,3578,3005
202104,47150,경상북도,김천시,30-34세,6579,3553,3026
202105,47150,경상북도,김천시,30-34세,6588,3572,3016
202106,47150,경상북도,김천시,30-34세,6572,3563,3009
202007,47150,경상북도,김천시,35-39세,8728,4528,4200
202008,47150,경상북도,김천시,35-39세,8673,4498,4175
202009,47150,경상북도,김천시,35-39세,8621,4474,4147
202010,47150,경상북도,김천시,35-39세,8582,4454,4128
202011,47150,경상북도,김천시,35-39세,8544,4417,4127
202012,47150,경상북도,김천시,35-39세,8517,4408,4109
202101,47150,경상북도,김천시,35-39세,8495,4387,4108
202102,47150,경상북도,김천시,35-39세,8420,4355,4065
202103,47150,경상북도,김천시,35-39세,8363,4321,4042
202104,47150,경상북도,김천시,35-39세,8292,4281,4011
202105,47150,경상북도,김천시,35-39세,8183,4210,3973
202106,47150,경상북도,김천시,35-39세,8114,4171,3943
202007,47150,경상북도,김천시,40-44세,8959,4760,4199
202008,47150,경상북도,김천시,40-44세,8972,4757,4215
202009,47150,경상북도,김천시,40-44세,8999,4781,4218
202010,47150,경상북도,김천시,40-44세,9003,4767,4236
202011,47150,경상북도,김천시,40-44세,9064,4812,4252
202012,47150,경상북도,김천시,40-44세,9081,4814,4267
202101,47150,경상북도,김천시,40-44세,9046,4804,4242
202102,47150,경상북도,김천시,40-44세,9087,4813,4274
202103,47150,경상북도,김천시,40-44세,9065,4789,4276
202104,47150,경상북도,김천시,40-44세,9092,4814,4278
202105,47150,경상북도,김천시,40-44세,9130,4825,4305
202106,47150,경상북도,김천시,40-44세,9131,4834,4297
202007,47150,경상북도,김천시,45-49세,10535,5535,5000
202008,47150,경상북도,김천시,45-49세,10494,5507,4987
202009,47150,경상북도,김천시,45-49세,10420,5467,4953
202010,47150,경상북도,김천시,45-49세,10371,5442,4929
202011,47150,경상북도,김천시,45-49세,10344,5437,4907
202012,47150,경상북도,김천시,45-49세,10320,5417,4903
202101,47150,경상북도,김천시,45-49세,10285,5393,4892
202102,47150,경상북도,김천시,45-49세,10253,5383,4870
202103,47150,경상북도,김천시,45-49세,10250,5385,4865
202104,47150,경상북도,김천시,45-49세,10237,5364,4873
202105,47150,경상북도,김천시,45-49세,10157,5324,4833
202106,47150,경상북도,김천시,45-49세,10085,5291,4794
202007,47150,경상북도,김천시,50-54세,11683,6096,5587
202008,47150,경상북도,김천시,50-54세,11693,6111,5582
202009,47150,경상북도,김천시,50-54세,11724,6135,5589
202010,47150,경상북도,김천시,50-54세,11728,6132,5596
202011,47150,경상북도,김천시,50-54세,11712,6117,5595
202012,47150,경상북도,김천시,50-54세,11653,6086,5567
202101,47150,경상북도,김천시,50-54세,11694,6113,5581
202102,47150,경상북도,김천시,50-54세,11689,6120,5569
202103,47150,경상북도,김천시,50-54세,11657,6098,5559
202104,47150,경상북도,김천시,50-54세,11600,6084,5516
202105,47150,경상북도,김천시,50-54세,11650,6101,5549
202106,47150,경상북도,김천시,50-54세,11658,6118,5540
202007,47150,경상북도,김천시,55-59세,12265,6383,5882
202008,47150,경상북도,김천시,55-59세,12262,6387,5875
202009,47150,경상북도,김천시,55-59세,12239,6384,5855
202010,47150,경상북도,김천시,55-59세,12215,6385,5830
202011,47150,경상북도,김천시,55-59세,12214,6367,5847
202012,47150,경상북도,김천시,55-59세,12254,6397,5857
202101,47150,경상북도,김천시,55-59세,12184,6338,5846
202102,47150,경상북도,김천시,55-59세,12141,6317,5824
202103,47150,경상북도,김천시,55-59세,12062,6276,5786
202104,47150,경상북도,김천시,55-59세,12047,6278,5769
202105,47150,경상북도,김천시,55-59세,11999,6262,5737
202106,47150,경상북도,김천시,55-59세,11899,6208,5691
202007,47150,경상북도,김천시,60-64세,12049,6047,6002
202008,47150,경상북도,김천시,60-64세,12067,6061,6006
202009,47150,경상북도,김천시,60-64세,12109,6088,6021
202010,47150,경상북도,김천시,60-64세,12153,6110,6043
202011,47150,경상북도,김천시,60-64세,12242,6181,6061
202012,47150,경상북도,김천시,60-64세,12276,6161,6115
202101,47150,경상북도,김천시,60-64세,12363,6230,6133
202102,47150,경상북도,김천시,60-64세,12467,6289,6178
202103,47150,경상북도,김천시,60-64세,12579,6351,6228
202104,47150,경상북도,김천시,60-64세,12685,6411,6274
202105,47150,경상북도,김천시,60-64세,12736,6442,6294
202106,47150,경상북도,김천시,60-64세,12792,6468,6324
202007,47150,경상북도,김천시,65-69세,9392,4468,4924
202008,47150,경상북도,김천시,65-69세,9475,4501,4974
202009,47150,경상북도,김천시,65-69세,9535,4534,5001
202010,47150,경상북도,김천시,65-69세,9589,4554,5035
202011,47150,경상북도,김천시,65-69세,9635,4569,5066
202012,47150,경상북도,김천시,65-69세,9736,4648,5088
202101,47150,경상북도,김천시,65-69세,9814,4697,5117
202102,47150,경상북도,김천시,65-69세,9869,4720,5149
202103,47150,경상북도,김천시,65-69세,9990,4786,5204
202104,47150,경상북도,김천시,65-69세,10019,4786,5233
202105,47150,경상북도,김천시,65-69세,10101,4829,5272
202106,47150,경상북도,김천시,65-69세,10124,4851,5273
202007,47150,경상북도,김천시,70-74세,7161,3350,3811
202008,47150,경상북도,김천시,70-74세,7172,3357,3815
202009,47150,경상북도,김천시,70-74세,7230,3388,3842
202010,47150,경상북도,김천시,70-74세,7252,3401,3851
202011,47150,경상북도,김천시,70-74세,7311,3424,3887
202012,47150,경상북도,김천시,70-74세,7350,3444,3906
202101,47150,경상북도,김천시,70-74세,7383,3450,3933
202102,47150,경상북도,김천시,70-74세,7406,3468,3938
202103,47150,경상북도,김천시,70-74세,7398,3460,3938
202104,47150,경상북도,김천시,70-74세,7437,3489,3948
202105,47150,경상북도,김천시,70-74세,7485,3511,3974
202106,47150,경상북도,김천시,70-74세,7483,3512,3971
202007,47150,경상북도,김천시,75-79세,6345,2486,3859
202008,47150,경상북도,김천시,75-79세,6305,2474,3831
202009,47150,경상북도,김천시,75-79세,6240,2453,3787
202010,47150,경상북도,김천시,75-79세,6200,2436,3764
202011,47150,경상북도,김천시,75-79세,6142,2422,3720
202012,47150,경상북도,김천시,75-79세,6085,2402,3683
202101,47150,경상북도,김천시,75-79세,6026,2386,3640
202102,47150,경상북도,김천시,75-79세,5961,2360,3601
202103,47150,경상북도,김천시,75-79세,5954,2367,3587
202104,47150,경상북도,김천시,75-79세,5895,2356,3539
202105,47150,경상북도,김천시,75-79세,5864,2348,3516
202106,47150,경상북도,김천시,75-79세,5822,2337,3485
202007,47150,경상북도,김천시,80-84세,5194,1797,3397
202008,47150,경상북도,김천시,80-84세,5243,1818,3425
202009,47150,경상북도,김천시,80-84세,5247,1818,3429
202010,47150,경상북도,김천시,80-84세,5260,1821,3439
202011,47150,경상북도,김천시,80-84세,5236,1809,3427
202012,47150,경상북도,김천시,80-84세,5213,1792,3421
202101,47150,경상북도,김천시,80-84세,5225,1786,3439
202102,47150,경상북도,김천시,80-84세,5241,1795,3446
202103,47150,경상북도,김천시,80-84세,5258,1804,3454
202104,47150,경상북도,김천시,80-84세,5265,1807,3458
202105,47150,경상북도,김천시,80-84세,5284,1809,3475
202106,47150,경상북도,김천시,80-84세,5299,1822,3477
202007,47150,경상북도,김천시,85-89세,2784,839,1945
202008,47150,경상북도,김천시,85-89세,2768,832,1936
202009,47150,경상북도,김천시,85-89세,2789,835,1954
202010,47150,경상북도,김천시,85-89세,2802,840,1962
202011,47150,경상북도,김천시,85-89세,2848,851,1997
202012,47150,경상북도,김천시,85-89세,2901,871,2030
202101,47150,경상북도,김천시,85-89세,2934,893,2041
202102,47150,경상북도,김천시,85-89세,2963,914,2049
202103,47150,경상북도,김천시,85-89세,2988,917,2071
202104,47150,경상북도,김천시,85-89세,3022,928,2094
202105,47150,경상북도,김천시,85-89세,3035,930,2105
202106,47150,경상북도,김천시,85-89세,3031,918,2113
202007,47150,경상북도,김천시,90-94세,943,202,741
202008,47150,경상북도,김천시,90-94세,956,208,748
202009,47150,경상북도,김천시,90-94세,971,213,758
202010,47150,경상북도,김천시,90-94세,988,217,771
202011,47150,경상북도,김천시,90-94세,994,222,772
202012,47150,경상북도,김천시,90-94세,994,220,774
202101,47150,경상북도,김천시,90-94세,1020,227,793
202102,47150,경상북도,김천시,90-94세,1050,232,818
202103,47150,경상북도,김천시,90-94세,1060,235,825
202104,47150,경상북도,김천시,90-94세,1077,238,839
202105,47150,경상북도,김천시,90-94세,1076,241,835
202106,47150,경상북도,김천시,90-94세,1061,238,823
202007,47150,경상북도,김천시,95-99세,187,32,155
202008,47150,경상북도,김천시,95-99세,194,34,160
202009,47150,경상북도,김천시,95-99세,200,34,166
202010,47150,경상북도,김천시,95-99세,196,35,161
202011,47150,경상북도,김천시,95-99세,188,35,153
202012,47150,경상북도,김천시,95-99세,188,36,152
202101,47150,경상북도,김천시,95-99세,185,35,150
202102,47150,경상북도,김천시,95-99세,189,34,155
202103,47150,경상북도,김천시,95-99세,197,33,164
202104,47150,경상북도,김천시,95-99세,197,34,163
202105,47150,경상북도,김천시,95-99세,204,34,170
202106,47150,경상북도,김천시,95-99세,197,30,167
202007,47150,경상북도,김천시,100+,54,10,44
202008,47150,경상북도,김천시,100+,54,10,44
202009,47150,경상북도,김천시,100+,56,11,45
202010,47150,경상북도,김천시,100+,57,11,46
202011,47150,경상북도,김천시,100+,56,11,45
202012,47150,경상북도,김천시,100+,53,11,42
202101,47150,경상북도,김천시,100+,54,11,43
202102,47150,경상북도,김천시,100+,54,11,43
202103,47150,경상북도,김천시,100+,30,2,28
202104,47150,경상북도,김천시,100+,30,2,28
202105,47150,경상북도,김천시,100+,31,2,29
202106,47150,경상북도,김천시,100+,32,2,30
202007,47170,경상북도,안동시,0-4세,4706,2451,2255
202008,47170,경상북도,안동시,0-4세,4677,2430,2247
202009,47170,경상북도,안동시,0-4세,4627,2414,2213
202010,47170,경상북도,안동시,0-4세,4568,2384,2184
202011,47170,경상북도,안동시,0-4세,4521,2350,2171
202012,47170,경상북도,안동시,0-4세,4496,2329,2167
202101,47170,경상북도,안동시,0-4세,4431,2288,2143
202102,47170,경상북도,안동시,0-4세,4388,2272,2116
202103,47170,경상북도,안동시,0-4세,4350,2253,2097
202104,47170,경상북도,안동시,0-4세,4308,2224,2084
202105,47170,경상북도,안동시,0-4세,4272,2212,2060
202106,47170,경상북도,안동시,0-4세,4237,2200,2037
202007,47170,경상북도,안동시,5-9세,6192,3282,2910
202008,47170,경상북도,안동시,5-9세,6184,3278,2906
202009,47170,경상북도,안동시,5-9세,6180,3270,2910
202010,47170,경상북도,안동시,5-9세,6168,3261,2907
202011,47170,경상북도,안동시,5-9세,6174,3265,2909
202012,47170,경상북도,안동시,5-9세,6147,3253,2894
202101,47170,경상북도,안동시,5-9세,6120,3242,2878
202102,47170,경상북도,안동시,5-9세,6121,3225,2896
202103,47170,경상북도,안동시,5-9세,6118,3219,2899
202104,47170,경상북도,안동시,5-9세,6113,3231,2882
202105,47170,경상북도,안동시,5-9세,6099,3218,2881
202106,47170,경상북도,안동시,5-9세,6072,3197,2875
202007,47170,경상북도,안동시,10-14세,6432,3352,3080
202008,47170,경상북도,안동시,10-14세,6473,3377,3096
202009,47170,경상북도,안동시,10-14세,6484,3385,3099
202010,47170,경상북도,안동시,10-14세,6489,3390,3099
202011,47170,경상북도,안동시,10-14세,6460,3378,3082
202012,47170,경상북도,안동시,10-14세,6482,3386,3096
202101,47170,경상북도,안동시,10-14세,6479,3392,3087
202102,47170,경상북도,안동시,10-14세,6472,3396,3076
202103,47170,경상북도,안동시,10-14세,6481,3405,3076
202104,47170,경상북도,안동시,10-14세,6473,3383,3090
202105,47170,경상북도,안동시,10-14세,6480,3373,3107
202106,47170,경상북도,안동시,10-14세,6470,3369,3101
202007,47170,경상북도,안동시,15-19세,7371,3873,3498
202008,47170,경상북도,안동시,15-19세,7324,3849,3475
202009,47170,경상북도,안동시,15-19세,7353,3873,3480
202010,47170,경상북도,안동시,15-19세,7332,3854,3478
202011,47170,경상북도,안동시,15-19세,7319,3847,3472
202012,47170,경상북도,안동시,15-19세,7254,3801,3453
202101,47170,경상북도,안동시,15-19세,7216,3771,3445
202102,47170,경상북도,안동시,15-19세,7171,3735,3436
202103,47170,경상북도,안동시,15-19세,7094,3684,3410
202104,47170,경상북도,안동시,15-19세,7091,3693,3398
202105,47170,경상북도,안동시,15-19세,7043,3681,3362
202106,47170,경상북도,안동시,15-19세,7052,3682,3370
202007,47170,경상북도,안동시,20-24세,8687,4705,3982
202008,47170,경상북도,안동시,20-24세,8642,4664,3978
202009,47170,경상북도,안동시,20-24세,8623,4662,3961
202010,47170,경상북도,안동시,20-24세,8620,4670,3950
202011,47170,경상북도,안동시,20-24세,8634,4671,3963
202012,47170,경상북도,안동시,20-24세,8659,4684,3975
202101,47170,경상북도,안동시,20-24세,8598,4674,3924
202102,47170,경상북도,안동시,20-24세,8528,4621,3907
202103,47170,경상북도,안동시,20-24세,8505,4604,3901
202104,47170,경상북도,안동시,20-24세,8505,4603,3902
202105,47170,경상북도,안동시,20-24세,8493,4596,3897
202106,47170,경상북도,안동시,20-24세,8485,4591,3894
202007,47170,경상북도,안동시,25-29세,7893,4389,3504
202008,47170,경상북도,안동시,25-29세,7970,4434,3536
202009,47170,경상북도,안동시,25-29세,7997,4440,3557
202010,47170,경상북도,안동시,25-29세,8031,4449,3582
202011,47170,경상북도,안동시,25-29세,8070,4480,3590
202012,47170,경상북도,안동시,25-29세,8131,4510,3621
202101,47170,경상북도,안동시,25-29세,8112,4478,3634
202102,47170,경상북도,안동시,25-29세,8027,4421,3606
202103,47170,경상북도,안동시,25-29세,8021,4440,3581
202104,47170,경상북도,안동시,25-29세,8039,4447,3592
202105,47170,경상북도,안동시,25-29세,8053,4481,3572
202106,47170,경상북도,안동시,25-29세,8076,4480,3596
202007,47170,경상북도,안동시,30-34세,6904,3669,3235
202008,47170,경상북도,안동시,30-34세,6914,3665,3249
202009,47170,경상북도,안동시,30-34세,6942,3674,3268
202010,47170,경상북도,안동시,30-34세,6923,3679,3244
202011,47170,경상북도,안동시,30-34세,6886,3654,3232
202012,47170,경상북도,안동시,30-34세,6912,3666,3246
202101,47170,경상북도,안동시,30-34세,6894,3662,3232
202102,47170,경상북도,안동시,30-34세,6926,3682,3244
202103,47170,경상북도,안동시,30-34세,6912,3672,3240
202104,47170,경상북도,안동시,30-34세,6922,3688,3234
202105,47170,경상북도,안동시,30-34세,6952,3714,3238
202106,47170,경상북도,안동시,30-34세,6921,3698,3223
202007,47170,경상북도,안동시,35-39세,8753,4435,4318
202008,47170,경상북도,안동시,35-39세,8745,4442,4303
202009,47170,경상북도,안동시,35-39세,8674,4417,4257
202010,47170,경상북도,안동시,35-39세,8598,4381,4217
202011,47170,경상북도,안동시,35-39세,8583,4376,4207
202012,47170,경상북도,안동시,35-39세,8569,4355,4214
202101,47170,경상북도,안동시,35-39세,8506,4317,4189
202102,47170,경상북도,안동시,35-39세,8492,4308,4184
202103,47170,경상북도,안동시,35-39세,8450,4288,4162
202104,47170,경상북도,안동시,35-39세,8423,4288,4135
202105,47170,경상북도,안동시,35-39세,8324,4241,4083
202106,47170,경상북도,안동시,35-39세,8304,4234,4070
202007,47170,경상북도,안동시,40-44세,10252,5257,4995
202008,47170,경상북도,안동시,40-44세,10246,5259,4987
202009,47170,경상북도,안동시,40-44세,10259,5262,4997
202010,47170,경상북도,안동시,40-44세,10227,5226,5001
202011,47170,경상북도,안동시,40-44세,10212,5224,4988
202012,47170,경상북도,안동시,40-44세,10168,5214,4954
202101,47170,경상북도,안동시,40-44세,10081,5182,4899
202102,47170,경상북도,안동시,40-44세,10061,5163,4898
202103,47170,경상북도,안동시,40-44세,9971,5113,4858
202104,47170,경상북도,안동시,40-44세,9928,5082,4846
202105,47170,경상북도,안동시,40-44세,9892,5069,4823
202106,47170,경상북도,안동시,40-44세,9946,5104,4842
202007,47170,경상북도,안동시,45-49세,12278,6476,5802
202008,47170,경상북도,안동시,45-49세,12244,6457,5787
202009,47170,경상북도,안동시,45-49세,12212,6446,5766
202010,47170,경상북도,안동시,45-49세,12185,6436,5749
202011,47170,경상북도,안동시,45-49세,12147,6401,5746
202012,47170,경상북도,안동시,45-49세,12164,6403,5761
202101,47170,경상북도,안동시,45-49세,12143,6386,5757
202102,47170,경상북도,안동시,45-49세,12084,6342,5742
202103,47170,경상북도,안동시,45-49세,12039,6331,5708
202104,47170,경상북도,안동시,45-49세,12028,6328,5700
202105,47170,경상북도,안동시,45-49세,11964,6267,5697
202106,47170,경상북도,안동시,45-49세,11899,6221,5678
202007,47170,경상북도,안동시,50-54세,12969,6738,6231
202008,47170,경상북도,안동시,50-54세,13024,6761,6263
202009,47170,경상북도,안동시,50-54세,13105,6791,6314
202010,47170,경상북도,안동시,50-54세,13101,6802,6299
202011,47170,경상북도,안동시,50-54세,13123,6833,6290
202012,47170,경상북도,안동시,50-54세,13077,6821,6256
202101,47170,경상북도,안동시,50-54세,13132,6861,6271
202102,47170,경상북도,안동시,50-54세,13110,6849,6261
202103,47170,경상북도,안동시,50-54세,13040,6782,6258
202104,47170,경상북도,안동시,50-54세,12993,6779,6214
202105,47170,경상북도,안동시,50-54세,12998,6798,6200
202106,47170,경상북도,안동시,50-54세,12993,6788,6205
202007,47170,경상북도,안동시,55-59세,13674,6861,6813
202008,47170,경상북도,안동시,55-59세,13634,6830,6804
202009,47170,경상북도,안동시,55-59세,13499,6784,6715
202010,47170,경상북도,안동시,55-59세,13459,6768,6691
202011,47170,경상북도,안동시,55-59세,13402,6733,6669
202012,47170,경상북도,안동시,55-59세,13423,6754,6669
202101,47170,경상북도,안동시,55-59세,13280,6690,6590
202102,47170,경상북도,안동시,55-59세,13237,6695,6542
202103,47170,경상북도,안동시,55-59세,13148,6654,6494
202104,47170,경상북도,안동시,55-59세,13090,6609,6481
202105,47170,경상북도,안동시,55-59세,12945,6544,6401
202106,47170,경상북도,안동시,55-59세,12787,6476,6311
202007,47170,경상북도,안동시,60-64세,13822,6913,6909
202008,47170,경상북도,안동시,60-64세,13879,6956,6923
202009,47170,경상북도,안동시,60-64세,13957,6999,6958
202010,47170,경상북도,안동시,60-64세,14043,7042,7001
202011,47170,경상북도,안동시,60-64세,14148,7073,7075
202012,47170,경상북도,안동시,60-64세,14232,7106,7126
202101,47170,경상북도,안동시,60-64세,14335,7153,7182
202102,47170,경상북도,안동시,60-64세,14431,7183,7248
202103,47170,경상북도,안동시,60-64세,14482,7214,7268
202104,47170,경상북도,안동시,60-64세,14549,7238,7311
202105,47170,경상북도,안동시,60-64세,14632,7291,7341
202106,47170,경상북도,안동시,60-64세,14755,7359,7396
202007,47170,경상북도,안동시,65-69세,11109,5156,5953
202008,47170,경상북도,안동시,65-69세,11165,5186,5979
202009,47170,경상북도,안동시,65-69세,11243,5212,6031
202010,47170,경상북도,안동시,65-69세,11304,5244,6060
202011,47170,경상북도,안동시,65-69세,11366,5281,6085
202012,47170,경상북도,안동시,65-69세,11409,5288,6121
202101,47170,경상북도,안동시,65-69세,11492,5339,6153
202102,47170,경상북도,안동시,65-69세,11537,5366,6171
202103,47170,경상북도,안동시,65-69세,11655,5445,6210
202104,47170,경상북도,안동시,65-69세,11730,5501,6229
202105,47170,경상북도,안동시,65-69세,11763,5517,6246
202106,47170,경상북도,안동시,65-69세,11789,5526,6263
202007,47170,경상북도,안동시,70-74세,8471,4074,4397
202008,47170,경상북도,안동시,70-74세,8497,4088,4409
202009,47170,경상북도,안동시,70-74세,8541,4102,4439
202010,47170,경상북도,안동시,70-74세,8584,4121,4463
202011,47170,경상북도,안동시,70-74세,8604,4127,4477
202012,47170,경상북도,안동시,70-74세,8686,4184,4502
202101,47170,경상북도,안동시,70-74세,8754,4212,4542
202102,47170,경상북도,안동시,70-74세,8795,4224,4571
202103,47170,경상북도,안동시,70-74세,8818,4221,4597
202104,47170,경상북도,안동시,70-74세,8858,4233,4625
202105,47170,경상북도,안동시,70-74세,8892,4257,4635
202106,47170,경상북도,안동시,70-74세,8935,4278,4657
202007,47170,경상북도,안동시,75-79세,8244,3385,4859
202008,47170,경상북도,안동시,75-79세,8218,3374,4844
202009,47170,경상북도,안동시,75-79세,8151,3349,4802
202010,47170,경상북도,안동시,75-79세,8091,3318,4773
202011,47170,경상북도,안동시,75-79세,8038,3293,4745
202012,47170,경상북도,안동시,75-79세,7940,3246,4694
202101,47170,경상북도,안동시,75-79세,7845,3215,4630
202102,47170,경상북도,안동시,75-79세,7756,3179,4577
202103,47170,경상북도,안동시,75-79세,7722,3187,4535
202104,47170,경상북도,안동시,75-79세,7665,3161,4504
202105,47170,경상북도,안동시,75-79세,7601,3136,4465
202106,47170,경상북도,안동시,75-79세,7586,3135,4451
202007,47170,경상북도,안동시,80-84세,6189,2274,3915
202008,47170,경상북도,안동시,80-84세,6174,2266,3908
202009,47170,경상북도,안동시,80-84세,6185,2272,3913
202010,47170,경상북도,안동시,80-84세,6197,2285,3912
202011,47170,경상북도,안동시,80-84세,6191,2282,3909
202012,47170,경상북도,안동시,80-84세,6230,2299,3931
202101,47170,경상북도,안동시,80-84세,6280,2313,3967
202102,47170,경상북도,안동시,80-84세,6311,2317,3994
202103,47170,경상북도,안동시,80-84세,6347,2325,4022
202104,47170,경상북도,안동시,80-84세,6339,2339,4000
202105,47170,경상북도,안동시,80-84세,6370,2346,4024
202106,47170,경상북도,안동시,80-84세,6372,2351,4021
202007,47170,경상북도,안동시,85-89세,3342,993,2349
202008,47170,경상북도,안동시,85-89세,3370,1012,2358
202009,47170,경상북도,안동시,85-89세,3381,1025,2356
202010,47170,경상북도,안동시,85-89세,3403,1032,2371
202011,47170,경상북도,안동시,85-89세,3414,1040,2374
202012,47170,경상북도,안동시,85-89세,3414,1042,2372
202101,47170,경상북도,안동시,85-89세,3445,1057,2388
202102,47170,경상북도,안동시,85-89세,3501,1085,2416
202103,47170,경상북도,안동시,85-89세,3536,1098,2438
202104,47170,경상북도,안동시,85-89세,3590,1116,2474
202105,47170,경상북도,안동시,85-89세,3579,1102,2477
202106,47170,경상북도,안동시,85-89세,3589,1104,2485
202007,47170,경상북도,안동시,90-94세,1166,269,897
202008,47170,경상북도,안동시,90-94세,1172,261,911
202009,47170,경상북도,안동시,90-94세,1188,260,928
202010,47170,경상북도,안동시,90-94세,1182,259,923
202011,47170,경상북도,안동시,90-94세,1180,255,925
202012,47170,경상북도,안동시,90-94세,1185,251,934
202101,47170,경상북도,안동시,90-94세,1194,259,935
202102,47170,경상북도,안동시,90-94세,1197,261,936
202103,47170,경상북도,안동시,90-94세,1207,261,946
202104,47170,경상북도,안동시,90-94세,1225,263,962
202105,47170,경상북도,안동시,90-94세,1210,255,955
202106,47170,경상북도,안동시,90-94세,1214,251,963
202007,47170,경상북도,안동시,95-99세,248,46,202
202008,47170,경상북도,안동시,95-99세,253,48,205
202009,47170,경상북도,안동시,95-99세,265,52,213
202010,47170,경상북도,안동시,95-99세,265,53,212
202011,47170,경상북도,안동시,95-99세,269,55,214
202012,47170,경상북도,안동시,95-99세,267,55,212
202101,47170,경상북도,안동시,95-99세,273,57,216
202102,47170,경상북도,안동시,95-99세,280,58,222
202103,47170,경상북도,안동시,95-99세,282,63,219
202104,47170,경상북도,안동시,95-99세,277,61,216
202105,47170,경상북도,안동시,95-99세,271,59,212
202106,47170,경상북도,안동시,95-99세,274,62,212
202007,47170,경상북도,안동시,100+,63,16,47
202008,47170,경상북도,안동시,100+,62,16,46
202009,47170,경상북도,안동시,100+,63,15,48
202010,47170,경상북도,안동시,100+,64,15,49
202011,47170,경상북도,안동시,100+,62,14,48
202012,47170,경상북도,안동시,100+,62,14,48
202101,47170,경상북도,안동시,100+,65,15,50
202102,47170,경상북도,안동시,100+,68,16,52
202103,47170,경상북도,안동시,100+,62,12,50
202104,47170,경상북도,안동시,100+,64,12,52
202105,47170,경상북도,안동시,100+,49,10,39
202106,47170,경상북도,안동시,100+,49,10,39
202007,47190,경상북도,구미시,0-4세,18122,9262,8860
202008,47190,경상북도,구미시,0-4세,17977,9210,8767
202009,47190,경상북도,구미시,0-4세,17807,9127,8680
202010,47190,경상북도,구미시,0-4세,17608,9034,8574
202011,47190,경상북도,구미시,0-4세,17474,8967,8507
202012,47190,경상북도,구미시,0-4세,17332,8871,8461
202101,47190,경상북도,구미시,0-4세,17053,8724,8329
202102,47190,경상북도,구미시,0-4세,16889,8638,8251
202103,47190,경상북도,구미시,0-4세,16695,8560,8135
202104,47190,경상북도,구미시,0-4세,16529,8464,8065
202105,47190,경상북도,구미시,0-4세,16373,8370,8003
202106,47190,경상북도,구미시,0-4세,16242,8302,7940
202007,47190,경상북도,구미시,5-9세,24220,12600,11620
202008,47190,경상북도,구미시,5-9세,24135,12550,11585
202009,47190,경상북도,구미시,5-9세,24126,12542,11584
202010,47190,경상북도,구미시,5-9세,24106,12531,11575
202011,47190,경상북도,구미시,5-9세,24041,12442,11599
202012,47190,경상북도,구미시,5-9세,24034,12441,11593
202101,47190,경상북도,구미시,5-9세,23964,12415,11549
202102,47190,경상북도,구미시,5-9세,23885,12375,11510
202103,47190,경상북도,구미시,5-9세,23856,12333,11523
202104,47190,경상북도,구미시,5-9세,23808,12308,11500
202105,47190,경상북도,구미시,5-9세,23767,12257,11510
202106,47190,경상북도,구미시,5-9세,23720,12236,11484
202007,47190,경상북도,구미시,10-14세,22183,11541,10642
202008,47190,경상북도,구미시,10-14세,22159,11517,10642
202009,47190,경상북도,구미시,10-14세,22248,11561,10687
202010,47190,경상북도,구미시,10-14세,22283,11581,10702
202011,47190,경상북도,구미시,10-14세,22362,11652,10710
202012,47190,경상북도,구미시,10-14세,22353,11633,10720
202101,47190,경상북도,구미시,10-14세,22380,11627,10753
202102,47190,경상북도,구미시,10-14세,22406,11648,10758
202103,47190,경상북도,구미시,10-14세,22416,11669,10747
202104,47190,경상북도,구미시,10-14세,22491,11731,10760
202105,47190,경상북도,구미시,10-14세,22574,11813,10761
202106,47190,경상북도,구미시,10-14세,22631,11862,10769
202007,47190,경상북도,구미시,15-19세,23333,12250,11083
202008,47190,경상북도,구미시,15-19세,23234,12177,11057
202009,47190,경상북도,구미시,15-19세,23050,12071,10979
202010,47190,경상북도,구미시,15-19세,22921,11986,10935
202011,47190,경상북도,구미시,15-19세,22707,11862,10845
202012,47190,경상북도,구미시,15-19세,22564,11774,10790
202101,47190,경상북도,구미시,15-19세,22483,11734,10749
202102,47190,경상북도,구미시,15-19세,22283,11594,10689
202103,47190,경상북도,구미시,15-19세,22019,11478,10541
202104,47190,경상북도,구미시,15-19세,21903,11406,10497
202105,47190,경상북도,구미시,15-19세,21779,11330,10449
202106,47190,경상북도,구미시,15-19세,21710,11279,10431
202007,47190,경상북도,구미시,20-24세,27793,15647,12146
202008,47190,경상북도,구미시,20-24세,27638,15611,12027
202009,47190,경상북도,구미시,20-24세,27588,15592,11996
202010,47190,경상북도,구미시,20-24세,27556,15559,11997
202011,47190,경상북도,구미시,20-24세,27519,15519,12000
202012,47190,경상북도,구미시,20-24세,27486,15528,11958
202101,47190,경상북도,구미시,20-24세,27370,15451,11919
202102,47190,경상북도,구미시,20-24세,27152,15347,11805
202103,47190,경상북도,구미시,20-24세,26987,15252,11735
202104,47190,경상북도,구미시,20-24세,26852,15174,11678
202105,47190,경상북도,구미시,20-24세,26830,15160,11670
202106,47190,경상북도,구미시,20-24세,26742,15091,11651
202007,47190,경상북도,구미시,25-29세,29135,15760,13375
202008,47190,경상북도,구미시,25-29세,29043,15690,13353
202009,47190,경상북도,구미시,25-29세,29072,15725,13347
202010,47190,경상북도,구미시,25-29세,29105,15787,13318
202011,47190,경상북도,구미시,25-29세,29062,15777,13285
202012,47190,경상북도,구미시,25-29세,29165,15865,13300
202101,47190,경상북도,구미시,25-29세,29138,15907,13231
202102,47190,경상북도,구미시,25-29세,29061,15900,13161
202103,47190,경상북도,구미시,25-29세,29063,15933,13130
202104,47190,경상북도,구미시,25-29세,29004,15912,13092
202105,47190,경상북도,구미시,25-29세,28997,15955,13042
202106,47190,경상북도,구미시,25-29세,29035,16012,13023
202007,47190,경상북도,구미시,30-34세,30004,16296,13708
202008,47190,경상북도,구미시,30-34세,29898,16249,13649
202009,47190,경상북도,구미시,30-34세,29870,16225,13645
202010,47190,경상북도,구미시,30-34세,29815,16186,13629
202011,47190,경상북도,구미시,30-34세,29627,16098,13529
202012,47190,경상북도,구미시,30-34세,29597,16148,13449
202101,47190,경상북도,구미시,30-34세,29344,16026,13318
202102,47190,경상북도,구미시,30-34세,29138,15899,13239
202103,47190,경상북도,구미시,30-34세,29138,15886,13252
202104,47190,경상북도,구미시,30-34세,29109,15870,13239
202105,47190,경상북도,구미시,30-34세,29066,15800,13266
202106,47190,경상북도,구미시,30-34세,28967,15760,13207
202007,47190,경상북도,구미시,35-39세,36702,19203,17499
202008,47190,경상북도,구미시,35-39세,36513,19107,17406
202009,47190,경상북도,구미시,35-39세,36337,19041,17296
202010,47190,경상북도,구미시,35-39세,36183,18965,17218
202011,47190,경상북도,구미시,35-39세,36139,18919,17220
202012,47190,경상북도,구미시,35-39세,36121,18887,17234
202101,47190,경상북도,구미시,35-39세,36034,18847,17187
202102,47190,경상북도,구미시,35-39세,35886,18803,17083
202103,47190,경상북도,구미시,35-39세,35732,18736,16996
202104,47190,경상북도,구미시,35-39세,35636,18699,16937
202105,47190,경상북도,구미시,35-39세,35439,18621,16818
202106,47190,경상북도,구미시,35-39세,35279,18513,16766
202007,47190,경상북도,구미시,40-44세,35979,18390,17589
202008,47190,경상북도,구미시,40-44세,35979,18423,17556
202009,47190,경상북도,구미시,40-44세,36105,18481,17624
202010,47190,경상북도,구미시,40-44세,36268,18597,17671
202011,47190,경상북도,구미시,40-44세,36275,18641,17634
202012,47190,경상북도,구미시,40-44세,36214,18641,17573
202101,47190,경상북도,구미시,40-44세,36123,18600,17523
202102,47190,경상북도,구미시,40-44세,36183,18627,17556
202103,47190,경상북도,구미시,40-44세,36121,18606,17515
202104,47190,경상북도,구미시,40-44세,36073,18568,17505
202105,47190,경상북도,구미시,40-44세,36203,18636,17567
202106,47190,경상북도,구미시,40-44세,36349,18774,17575
202007,47190,경상북도,구미시,45-49세,37412,18697,18715
202008,47190,경상북도,구미시,45-49세,37305,18605,18700
202009,47190,경상북도,구미시,45-49세,37284,18625,18659
202010,47190,경상북도,구미시,45-49세,37127,18521,18606
202011,47190,경상북도,구미시,45-49세,36969,18401,18568
202012,47190,경상북도,구미시,45-49세,36929,18335,18594
202101,47190,경상북도,구미시,45-49세,36930,18322,18608
202102,47190,경상북도,구미시,45-49세,36866,18298,18568
202103,47190,경상북도,구미시,45-49세,36745,18201,18544
202104,47190,경상북도,구미시,45-49세,36714,18180,18534
202105,47190,경상북도,구미시,45-49세,36468,18032,18436
202106,47190,경상북도,구미시,45-49세,36315,17930,18385
202007,47190,경상북도,구미시,50-54세,37066,18466,18600
202008,47190,경상북도,구미시,50-54세,37114,18502,18612
202009,47190,경상북도,구미시,50-54세,37189,18515,18674
202010,47190,경상북도,구미시,50-54세,37290,18542,18748
202011,47190,경상북도,구미시,50-54세,37327,18562,18765
202012,47190,경상북도,구미시,50-54세,37298,18578,18720
202101,47190,경상북도,구미시,50-54세,37461,18665,18796
202102,47190,경상북도,구미시,50-54세,37489,18685,18804
202103,47190,경상북도,구미시,50-54세,37420,18624,18796
202104,47190,경상북도,구미시,50-54세,37456,18642,18814
202105,47190,경상북도,구미시,50-54세,37585,18715,18870
202106,47190,경상북도,구미시,50-54세,37672,18776,18896
202007,47190,경상북도,구미시,55-59세,32382,17015,15367
202008,47190,경상북도,구미시,55-59세,32376,17001,15375
202009,47190,경상북도,구미시,55-59세,32393,16972,15421
202010,47190,경상북도,구미시,55-59세,32476,17045,15431
202011,47190,경상북도,구미시,55-59세,32499,17044,15455
202012,47190,경상북도,구미시,55-59세,32505,17035,15470
202101,47190,경상북도,구미시,55-59세,32365,16954,15411
202102,47190,경상북도,구미시,55-59세,32372,16962,15410
202103,47190,경상북도,구미시,55-59세,32422,17013,15409
202104,47190,경상북도,구미시,55-59세,32426,16999,15427
202105,47190,경상북도,구미시,55-59세,32318,16952,15366
202106,47190,경상북도,구미시,55-59세,32086,16824,15262
202007,47190,경상북도,구미시,60-64세,23741,12378,11363
202008,47190,경상북도,구미시,60-64세,23969,12508,11461
202009,47190,경상북도,구미시,60-64세,24122,12618,11504
202010,47190,경상북도,구미시,60-64세,24337,12709,11628
202011,47190,경상북도,구미시,60-64세,24524,12802,11722
202012,47190,경상북도,구미시,60-64세,24732,12905,11827
202101,47190,경상북도,구미시,60-64세,24994,13044,11950
202102,47190,경상북도,구미시,60-64세,25246,13174,12072
202103,47190,경상북도,구미시,60-64세,25474,13288,12186
202104,47190,경상북도,구미시,60-64세,25671,13390,12281
202105,47190,경상북도,구미시,60-64세,25907,13509,12398
202106,47190,경상북도,구미시,60-64세,26168,13636,12532
202007,47190,경상북도,구미시,65-69세,14025,6903,7122
202008,47190,경상북도,구미시,65-69세,14162,6979,7183
202009,47190,경상북도,구미시,65-69세,14337,7071,7266
202010,47190,경상북도,구미시,65-69세,14508,7179,7329
202011,47190,경상북도,구미시,65-69세,14586,7235,7351
202012,47190,경상북도,구미시,65-69세,14737,7328,7409
202101,47190,경상북도,구미시,65-69세,14925,7437,7488
202102,47190,경상북도,구미시,65-69세,15090,7523,7567
202103,47190,경상북도,구미시,65-69세,15374,7676,7698
202104,47190,경상북도,구미시,65-69세,15495,7752,7743
202105,47190,경상북도,구미시,65-69세,15589,7781,7808
202106,47190,경상북도,구미시,65-69세,15702,7864,7838
202007,47190,경상북도,구미시,70-74세,8798,4218,4580
202008,47190,경상북도,구미시,70-74세,8856,4240,4616
202009,47190,경상북도,구미시,70-74세,8921,4266,4655
202010,47190,경상북도,구미시,70-74세,8996,4304,4692
202011,47190,경상북도,구미시,70-74세,9052,4324,4728
202012,47190,경상북도,구미시,70-74세,9161,4365,4796
202101,47190,경상북도,구미시,70-74세,9265,4413,4852
202102,47190,경상북도,구미시,70-74세,9297,4441,4856
202103,47190,경상북도,구미시,70-74세,9298,4436,4862
202104,47190,경상북도,구미시,70-74세,9349,4448,4901
202105,47190,경상북도,구미시,70-74세,9421,4499,4922
202106,47190,경상북도,구미시,70-74세,9453,4502,4951
202007,47190,경상북도,구미시,75-79세,7120,2764,4356
202008,47190,경상북도,구미시,75-79세,7083,2750,4333
202009,47190,경상북도,구미시,75-79세,7056,2737,4319
202010,47190,경상북도,구미시,75-79세,6985,2700,4285
202011,47190,경상북도,구미시,75-79세,6937,2683,4254
202012,47190,경상북도,구미시,75-79세,6874,2668,4206
202101,47190,경상북도,구미시,75-79세,6825,2666,4159
202102,47190,경상북도,구미시,75-79세,6776,2653,4123
202103,47190,경상북도,구미시,75-79세,6757,2658,4099
202104,47190,경상북도,구미시,75-79세,6730,2657,4073
202105,47190,경상북도,구미시,75-79세,6698,2655,4043
202106,47190,경상북도,구미시,75-79세,6674,2659,4015
202007,47190,경상북도,구미시,80-84세,5143,1695,3448
202008,47190,경상북도,구미시,80-84세,5132,1696,3436
202009,47190,경상북도,구미시,80-84세,5113,1703,3410
202010,47190,경상북도,구미시,80-84세,5131,1716,3415
202011,47190,경상북도,구미시,80-84세,5148,1721,3427
202012,47190,경상북도,구미시,80-84세,5165,1723,3442
202101,47190,경상북도,구미시,80-84세,5176,1717,3459
202102,47190,경상북도,구미시,80-84세,5245,1732,3513
202103,47190,경상북도,구미시,80-84세,5275,1750,3525
202104,47190,경상북도,구미시,80-84세,5257,1755,3502
202105,47190,경상북도,구미시,80-84세,5244,1761,3483
202106,47190,경상북도,구미시,80-84세,5260,1760,3500
202007,47190,경상북도,구미시,85-89세,2772,752,2020
202008,47190,경상북도,구미시,85-89세,2804,767,2037
202009,47190,경상북도,구미시,85-89세,2817,766,2051
202010,47190,경상북도,구미시,85-89세,2828,767,2061
202011,47190,경상북도,구미시,85-89세,2825,768,2057
202012,47190,경상북도,구미시,85-89세,2854,780,2074
202101,47190,경상북도,구미시,85-89세,2900,797,2103
202102,47190,경상북도,구미시,85-89세,2927,805,2122
202103,47190,경상북도,구미시,85-89세,2946,813,2133
202104,47190,경상북도,구미시,85-89세,2993,827,2166
202105,47190,경상북도,구미시,85-89세,3023,830,2193
202106,47190,경상북도,구미시,85-89세,3034,830,2204
202007,47190,경상북도,구미시,90-94세,909,176,733
202008,47190,경상북도,구미시,90-94세,915,174,741
202009,47190,경상북도,구미시,90-94세,930,176,754
202010,47190,경상북도,구미시,90-94세,941,181,760
202011,47190,경상북도,구미시,90-94세,947,176,771
202012,47190,경상북도,구미시,90-94세,950,178,772
202101,47190,경상북도,구미시,90-94세,958,182,776
202102,47190,경상북도,구미시,90-94세,951,184,767
202103,47190,경상북도,구미시,90-94세,959,183,776
202104,47190,경상북도,구미시,90-94세,977,186,791
202105,47190,경상북도,구미시,90-94세,985,191,794
202106,47190,경상북도,구미시,90-94세,986,191,795
202007,47190,경상북도,구미시,95-99세,210,32,178
202008,47190,경상북도,구미시,95-99세,207,33,174
202009,47190,경상북도,구미시,95-99세,207,35,172
202010,47190,경상북도,구미시,95-99세,206,34,172
202011,47190,경상북도,구미시,95-99세,205,34,171
202012,47190,경상북도,구미시,95-99세,205,30,175
202101,47190,경상북도,구미시,95-99세,209,32,177
202102,47190,경상북도,구미시,95-99세,215,34,181
202103,47190,경상북도,구미시,95-99세,216,33,183
202104,47190,경상북도,구미시,95-99세,217,36,181
202105,47190,경상북도,구미시,95-99세,220,37,183
202106,47190,경상북도,구미시,95-99세,219,37,182
202007,47190,경상북도,구미시,100+,49,7,42
202008,47190,경상북도,구미시,100+,52,7,45
202009,47190,경상북도,구미시,100+,54,7,47
202010,47190,경상북도,구미시,100+,52,7,45
202011,47190,경상북도,구미시,100+,54,7,47
202012,47190,경상북도,구미시,100+,52,7,45
202101,47190,경상북도,구미시,100+,52,7,45
202102,47190,경상북도,구미시,100+,52,6,46
202103,47190,경상북도,구미시,100+,40,3,37
202104,47190,경상북도,구미시,100+,40,3,37
202105,47190,경상북도,구미시,100+,39,3,36
202106,47190,경상북도,구미시,100+,40,3,37
202007,47210,경상북도,영주시,0-4세,2482,1261,1221
202008,47210,경상북도,영주시,0-4세,2450,1247,1203
202009,47210,경상북도,영주시,0-4세,2421,1234,1187
202010,47210,경상북도,영주시,0-4세,2399,1229,1170
202011,47210,경상북도,영주시,0-4세,2388,1218,1170
202012,47210,경상북도,영주시,0-4세,2372,1211,1161
202101,47210,경상북도,영주시,0-4세,2355,1205,1150
202102,47210,경상북도,영주시,0-4세,2346,1206,1140
202103,47210,경상북도,영주시,0-4세,2319,1198,1121
202104,47210,경상북도,영주시,0-4세,2285,1176,1109
202105,47210,경상북도,영주시,0-4세,2252,1155,1097
202106,47210,경상북도,영주시,0-4세,2236,1148,1088
202007,47210,경상북도,영주시,5-9세,3836,1992,1844
202008,47210,경상북도,영주시,5-9세,3808,1974,1834
202009,47210,경상북도,영주시,5-9세,3787,1964,1823
202010,47210,경상북도,영주시,5-9세,3751,1944,1807
202011,47210,경상북도,영주시,5-9세,3741,1947,1794
202012,47210,경상북도,영주시,5-9세,3728,1942,1786
202101,47210,경상북도,영주시,5-9세,3692,1922,1770
202102,47210,경상북도,영주시,5-9세,3683,1904,1779
202103,47210,경상북도,영주시,5-9세,3668,1896,1772
202104,47210,경상북도,영주시,5-9세,3659,1905,1754
202105,47210,경상북도,영주시,5-9세,3668,1917,1751
202106,47210,경상북도,영주시,5-9세,3655,1913,1742
202007,47210,경상북도,영주시,10-14세,4167,2143,2024
202008,47210,경상북도,영주시,10-14세,4179,2148,2031
202009,47210,경상북도,영주시,10-14세,4183,2149,2034
202010,47210,경상북도,영주시,10-14세,4193,2145,2048
202011,47210,경상북도,영주시,10-14세,4175,2129,2046
202012,47210,경상북도,영주시,10-14세,4174,2121,2053
202101,47210,경상북도,영주시,10-14세,4173,2114,2059
202102,47210,경상북도,영주시,10-14세,4170,2126,2044
202103,47210,경상북도,영주시,10-14세,4167,2116,2051
202104,47210,경상북도,영주시,10-14세,4167,2104,2063
202105,47210,경상북도,영주시,10-14세,4152,2087,2065
202106,47210,경상북도,영주시,10-14세,4163,2093,2070
202007,47210,경상북도,영주시,15-19세,4871,2584,2287
202008,47210,경상북도,영주시,15-19세,4826,2565,2261
202009,47210,경상북도,영주시,15-19세,4779,2535,2244
202010,47210,경상북도,영주시,15-19세,4752,2530,2222
202011,47210,경상북도,영주시,15-19세,4736,2515,2221
202012,47210,경상북도,영주시,15-19세,4709,2503,2206
202101,47210,경상북도,영주시,15-19세,4682,2501,2181
202102,47210,경상북도,영주시,15-19세,4625,2479,2146
202103,47210,경상북도,영주시,15-19세,4585,2463,2122
202104,47210,경상북도,영주시,15-19세,4612,2513,2099
202105,47210,경상북도,영주시,15-19세,4569,2482,2087
202106,47210,경상북도,영주시,15-19세,4551,2462,2089
202007,47210,경상북도,영주시,20-24세,5536,3211,2325
202008,47210,경상북도,영주시,20-24세,5495,3194,2301
202009,47210,경상북도,영주시,20-24세,5462,3176,2286
202010,47210,경상북도,영주시,20-24세,5437,3168,2269
202011,47210,경상북도,영주시,20-24세,5422,3175,2247
202012,47210,경상북도,영주시,20-24세,5393,3158,2235
202101,47210,경상북도,영주시,20-24세,5339,3121,2218
202102,47210,경상북도,영주시,20-24세,5309,3095,2214
202103,47210,경상북도,영주시,20-24세,5305,3097,2208
202104,47210,경상북도,영주시,20-24세,5306,3092,2214
202105,47210,경상북도,영주시,20-24세,5330,3101,2229
202106,47210,경상북도,영주시,20-24세,5306,3085,2221
202007,47210,경상북도,영주시,25-29세,4261,2540,1721
202008,47210,경상북도,영주시,25-29세,4232,2516,1716
202009,47210,경상북도,영주시,25-29세,4209,2498,1711
202010,47210,경상북도,영주시,25-29세,4209,2489,1720
202011,47210,경상북도,영주시,25-29세,4234,2499,1735
202012,47210,경상북도,영주시,25-29세,4236,2514,1722
202101,47210,경상북도,영주시,25-29세,4283,2538,1745
202102,47210,경상북도,영주시,25-29세,4266,2528,1738
202103,47210,경상북도,영주시,25-29세,4279,2529,1750
202104,47210,경상북도,영주시,25-29세,4285,2529,1756
202105,47210,경상북도,영주시,25-29세,4292,2536,1756
202106,47210,경상북도,영주시,25-29세,4305,2538,1767
202007,47210,경상북도,영주시,30-34세,3692,2064,1628
202008,47210,경상북도,영주시,30-34세,3697,2057,1640
202009,47210,경상북도,영주시,30-34세,3694,2056,1638
202010,47210,경상북도,영주시,30-34세,3687,2055,1632
202011,47210,경상북도,영주시,30-34세,3673,2060,1613
202012,47210,경상북도,영주시,30-34세,3658,2045,1613
202101,47210,경상북도,영주시,30-34세,3659,2061,1598
202102,47210,경상북도,영주시,30-34세,3653,2061,1592
202103,47210,경상북도,영주시,30-34세,3658,2051,1607
202104,47210,경상북도,영주시,30-34세,3666,2054,1612
202105,47210,경상북도,영주시,30-34세,3649,2047,1602
202106,47210,경상북도,영주시,30-34세,3637,2041,1596
202007,47210,경상북도,영주시,35-39세,5058,2624,2434
202008,47210,경상북도,영주시,35-39세,4974,2582,2392
202009,47210,경상북도,영주시,35-39세,4946,2569,2377
202010,47210,경상북도,영주시,35-39세,4908,2536,2372
202011,47210,경상북도,영주시,35-39세,4855,2492,2363
202012,47210,경상북도,영주시,35-39세,4830,2466,2364
202101,47210,경상북도,영주시,35-39세,4785,2429,2356
202102,47210,경상북도,영주시,35-39세,4751,2431,2320
202103,47210,경상북도,영주시,35-39세,4720,2424,2296
202104,47210,경상북도,영주시,35-39세,4718,2432,2286
202105,47210,경상북도,영주시,35-39세,4673,2411,2262
202106,47210,경상북도,영주시,35-39세,4658,2403,2255
202007,47210,경상북도,영주시,40-44세,6230,3152,3078
202008,47210,경상북도,영주시,40-44세,6218,3148,3070
202009,47210,경상북도,영주시,40-44세,6180,3137,3043
202010,47210,경상북도,영주시,40-44세,6181,3152,3029
202011,47210,경상북도,영주시,40-44세,6189,3162,3027
202012,47210,경상북도,영주시,40-44세,6139,3138,3001
202101,47210,경상북도,영주시,40-44세,6106,3138,2968
202102,47210,경상북도,영주시,40-44세,6104,3133,2971
202103,47210,경상북도,영주시,40-44세,6057,3116,2941
202104,47210,경상북도,영주시,40-44세,6026,3102,2924
202105,47210,경상북도,영주시,40-44세,5993,3086,2907
202106,47210,경상북도,영주시,40-44세,5988,3088,2900
202007,47210,경상북도,영주시,45-49세,7847,4130,3717
202008,47210,경상북도,영주시,45-49세,7856,4136,3720
202009,47210,경상북도,영주시,45-49세,7850,4131,3719
202010,47210,경상북도,영주시,45-49세,7801,4097,3704
202011,47210,경상북도,영주시,45-49세,7781,4084,3697
202012,47210,경상북도,영주시,45-49세,7762,4070,3692
202101,47210,경상북도,영주시,45-49세,7770,4062,3708
202102,47210,경상북도,영주시,45-49세,7726,4024,3702
202103,47210,경상북도,영주시,45-49세,7672,3990,3682
202104,47210,경상북도,영주시,45-49세,7666,3975,3691
202105,47210,경상북도,영주시,45-49세,7597,3934,3663
202106,47210,경상북도,영주시,45-49세,7573,3917,3656
202007,47210,경상북도,영주시,50-54세,8825,4550,4275
202008,47210,경상북도,영주시,50-54세,8814,4552,4262
202009,47210,경상북도,영주시,50-54세,8824,4565,4259
202010,47210,경상북도,영주시,50-54세,8820,4560,4260
202011,47210,경상북도,영주시,50-54세,8779,4540,4239
202012,47210,경상북도,영주시,50-54세,8752,4528,4224
202101,47210,경상북도,영주시,50-54세,8754,4538,4216
202102,47210,경상북도,영주시,50-54세,8741,4542,4199
202103,47210,경상북도,영주시,50-54세,8691,4519,4172
202104,47210,경상북도,영주시,50-54세,8651,4500,4151
202105,47210,경상북도,영주시,50-54세,8678,4523,4155
202106,47210,경상북도,영주시,50-54세,8675,4529,4146
202007,47210,경상북도,영주시,55-59세,9391,4728,4663
202008,47210,경상북도,영주시,55-59세,9347,4703,4644
202009,47210,경상북도,영주시,55-59세,9334,4692,4642
202010,47210,경상북도,영주시,55-59세,9257,4666,4591
202011,47210,경상북도,영주시,55-59세,9215,4634,4581
202012,47210,경상북도,영주시,55-59세,9189,4611,4578
202101,47210,경상북도,영주시,55-59세,9133,4577,4556
202102,47210,경상북도,영주시,55-59세,9099,4564,4535
202103,47210,경상북도,영주시,55-59세,9040,4556,4484
202104,47210,경상북도,영주시,55-59세,8950,4521,4429
202105,47210,경상북도,영주시,55-59세,8874,4492,4382
202106,47210,경상북도,영주시,55-59세,8806,4464,4342
202007,47210,경상북도,영주시,60-64세,9805,4801,5004
202008,47210,경상북도,영주시,60-64세,9839,4819,5020
202009,47210,경상북도,영주시,60-64세,9852,4812,5040
202010,47210,경상북도,영주시,60-64세,9922,4848,5074
202011,47210,경상북도,영주시,60-64세,9993,4893,5100
202012,47210,경상북도,영주시,60-64세,10031,4913,5118
202101,47210,경상북도,영주시,60-64세,10066,4939,5127
202102,47210,경상북도,영주시,60-64세,10137,4991,5146
202103,47210,경상북도,영주시,60-64세,10173,5002,5171
202104,47210,경상북도,영주시,60-64세,10233,5020,5213
202105,47210,경상북도,영주시,60-64세,10276,5058,5218
202106,47210,경상북도,영주시,60-64세,10334,5091,5243
202007,47210,경상북도,영주시,65-69세,8128,3783,4345
202008,47210,경상북도,영주시,65-69세,8190,3814,4376
202009,47210,경상북도,영주시,65-69세,8246,3852,4394
202010,47210,경상북도,영주시,65-69세,8303,3874,4429
202011,47210,경상북도,영주시,65-69세,8309,3874,4435
202012,47210,경상북도,영주시,65-69세,8346,3891,4455
202101,47210,경상북도,영주시,65-69세,8391,3902,4489
202102,47210,경상북도,영주시,65-69세,8422,3907,4515
202103,47210,경상북도,영주시,65-69세,8527,3968,4559
202104,47210,경상북도,영주시,65-69세,8570,3991,4579
202105,47210,경상북도,영주시,65-69세,8599,3998,4601
202106,47210,경상북도,영주시,65-69세,8657,4034,4623
202007,47210,경상북도,영주시,70-74세,6125,2937,3188
202008,47210,경상북도,영주시,70-74세,6128,2938,3190
202009,47210,경상북도,영주시,70-74세,6145,2938,3207
202010,47210,경상북도,영주시,70-74세,6184,2958,3226
202011,47210,경상북도,영주시,70-74세,6233,2983,3250
202012,47210,경상북도,영주시,70-74세,6280,3007,3273
202101,47210,경상북도,영주시,70-74세,6334,3032,3302
202102,47210,경상북도,영주시,70-74세,6375,3057,3318
202103,47210,경상북도,영주시,70-74세,6420,3086,3334
202104,47210,경상북도,영주시,70-74세,6441,3095,3346
202105,47210,경상북도,영주시,70-74세,6444,3098,3346
202106,47210,경상북도,영주시,70-74세,6438,3092,3346
202007,47210,경상북도,영주시,75-79세,5859,2419,3440
202008,47210,경상북도,영주시,75-79세,5817,2399,3418
202009,47210,경상북도,영주시,75-79세,5748,2379,3369
202010,47210,경상북도,영주시,75-79세,5716,2372,3344
202011,47210,경상북도,영주시,75-79세,5660,2353,3307
202012,47210,경상북도,영주시,75-79세,5588,2331,3257
202101,47210,경상북도,영주시,75-79세,5543,2326,3217
202102,47210,경상북도,영주시,75-79세,5474,2292,3182
202103,47210,경상북도,영주시,75-79세,5408,2262,3146
202104,47210,경상북도,영주시,75-79세,5356,2246,3110
202105,47210,경상북도,영주시,75-79세,5295,2231,3064
202106,47210,경상북도,영주시,75-79세,5286,2225,3061
202007,47210,경상북도,영주시,80-84세,4439,1700,2739
202008,47210,경상북도,영주시,80-84세,4456,1708,2748
202009,47210,경상북도,영주시,80-84세,4475,1708,2767
202010,47210,경상북도,영주시,80-84세,4488,1709,2779
202011,47210,경상북도,영주시,80-84세,4490,1706,2784
202012,47210,경상북도,영주시,80-84세,4500,1704,2796
202101,47210,경상북도,영주시,80-84세,4533,1713,2820
202102,47210,경상북도,영주시,80-84세,4547,1733,2814
202103,47210,경상북도,영주시,80-84세,4538,1723,2815
202104,47210,경상북도,영주시,80-84세,4551,1724,2827
202105,47210,경상북도,영주시,80-84세,4564,1731,2833
202106,47210,경상북도,영주시,80-84세,4563,1739,2824
202007,47210,경상북도,영주시,85-89세,2288,659,1629
202008,47210,경상북도,영주시,85-89세,2293,659,1634
202009,47210,경상북도,영주시,85-89세,2311,663,1648
202010,47210,경상북도,영주시,85-89세,2321,669,1652
202011,47210,경상북도,영주시,85-89세,2337,681,1656
202012,47210,경상북도,영주시,85-89세,2356,688,1668
202101,47210,경상북도,영주시,85-89세,2345,684,1661
202102,47210,경상북도,영주시,85-89세,2377,697,1680
202103,47210,경상북도,영주시,85-89세,2416,720,1696
202104,47210,경상북도,영주시,85-89세,2452,742,1710
202105,47210,경상북도,영주시,85-89세,2476,755,1721
202106,47210,경상북도,영주시,85-89세,2483,750,1733
202007,47210,경상북도,영주시,90-94세,763,173,590
202008,47210,경상북도,영주시,90-94세,771,175,596
202009,47210,경상북도,영주시,90-94세,785,179,606
202010,47210,경상북도,영주시,90-94세,784,179,605
202011,47210,경상북도,영주시,90-94세,795,181,614
202012,47210,경상북도,영주시,90-94세,809,186,623
202101,47210,경상북도,영주시,90-94세,830,195,635
202102,47210,경상북도,영주시,90-94세,839,196,643
202103,47210,경상북도,영주시,90-94세,836,189,647
202104,47210,경상북도,영주시,90-94세,844,191,653
202105,47210,경상북도,영주시,90-94세,865,197,668
202106,47210,경상북도,영주시,90-94세,866,199,667
202007,47210,경상북도,영주시,95-99세,200,31,169
202008,47210,경상북도,영주시,95-99세,203,32,171
202009,47210,경상북도,영주시,95-99세,211,34,177
202010,47210,경상북도,영주시,95-99세,212,34,178
202011,47210,경상북도,영주시,95-99세,207,32,175
202012,47210,경상북도,영주시,95-99세,207,32,175
202101,47210,경상북도,영주시,95-99세,209,33,176
202102,47210,경상북도,영주시,95-99세,212,34,178
202103,47210,경상북도,영주시,95-99세,208,31,177
202104,47210,경상북도,영주시,95-99세,213,31,182
202105,47210,경상북도,영주시,95-99세,210,30,180
202106,47210,경상북도,영주시,95-99세,208,30,178
202007,47210,경상북도,영주시,100+,59,13,46
202008,47210,경상북도,영주시,100+,59,13,46
202009,47210,경상북도,영주시,100+,61,13,48
202010,47210,경상북도,영주시,100+,61,13,48
202011,47210,경상북도,영주시,100+,60,12,48
202012,47210,경상북도,영주시,100+,60,11,49
202101,47210,경상북도,영주시,100+,61,11,50
202102,47210,경상북도,영주시,100+,61,11,50
202103,47210,경상북도,영주시,100+,51,9,42
202104,47210,경상북도,영주시,100+,52,9,43
202105,47210,경상북도,영주시,100+,50,9,41
202106,47210,경상북도,영주시,100+,52,9,43
202007,47230,경상북도,영천시,0-4세,2783,1403,1380
202008,47230,경상북도,영천시,0-4세,2791,1410,1381
202009,47230,경상북도,영천시,0-4세,2784,1411,1373
202010,47230,경상북도,영천시,0-4세,2783,1408,1375
202011,47230,경상북도,영천시,0-4세,2774,1410,1364
202012,47230,경상북도,영천시,0-4세,2748,1399,1349
202101,47230,경상북도,영천시,0-4세,2710,1381,1329
202102,47230,경상북도,영천시,0-4세,2725,1392,1333
202103,47230,경상북도,영천시,0-4세,2734,1395,1339
202104,47230,경상북도,영천시,0-4세,2739,1395,1344
202105,47230,경상북도,영천시,0-4세,2724,1387,1337
202106,47230,경상북도,영천시,0-4세,2722,1378,1344
202007,47230,경상북도,영천시,5-9세,3022,1527,1495
202008,47230,경상북도,영천시,5-9세,3020,1522,1498
202009,47230,경상북도,영천시,5-9세,3025,1521,1504
202010,47230,경상북도,영천시,5-9세,2993,1505,1488
202011,47230,경상북도,영천시,5-9세,2965,1493,1472
202012,47230,경상북도,영천시,5-9세,2951,1489,1462
202101,47230,경상북도,영천시,5-9세,2935,1487,1448
202102,47230,경상북도,영천시,5-9세,2912,1475,1437
202103,47230,경상북도,영천시,5-9세,2935,1481,1454
202104,47230,경상북도,영천시,5-9세,2950,1495,1455
202105,47230,경상북도,영천시,5-9세,2949,1490,1459
202106,47230,경상북도,영천시,5-9세,2943,1495,1448
202007,47230,경상북도,영천시,10-14세,3081,1637,1444
202008,47230,경상북도,영천시,10-14세,3086,1642,1444
202009,47230,경상북도,영천시,10-14세,3108,1663,1445
202010,47230,경상북도,영천시,10-14세,3124,1678,1446
202011,47230,경상북도,영천시,10-14세,3157,1694,1463
202012,47230,경상북도,영천시,10-14세,3159,1701,1458
202101,47230,경상북도,영천시,10-14세,3167,1707,1460
202102,47230,경상북도,영천시,10-14세,3181,1711,1470
202103,47230,경상북도,영천시,10-14세,3191,1713,1478
202104,47230,경상북도,영천시,10-14세,3192,1713,1479
202105,47230,경상북도,영천시,10-14세,3199,1728,1471
202106,47230,경상북도,영천시,10-14세,3182,1715,1467
202007,47230,경상북도,영천시,15-19세,3610,1953,1657
202008,47230,경상북도,영천시,15-19세,3569,1923,1646
202009,47230,경상북도,영천시,15-19세,3570,1926,1644
202010,47230,경상북도,영천시,15-19세,3560,1916,1644
202011,47230,경상북도,영천시,15-19세,3528,1896,1632
202012,47230,경상북도,영천시,15-19세,3533,1892,1641
202101,47230,경상북도,영천시,15-19세,3516,1881,1635
202102,47230,경상북도,영천시,15-19세,3532,1909,1623
202103,47230,경상북도,영천시,15-19세,3569,1937,1632
202104,47230,경상북도,영천시,15-19세,3552,1935,1617
202105,47230,경상북도,영천시,15-19세,3523,1909,1614
202106,47230,경상북도,영천시,15-19세,3495,1885,1610
202007,47230,경상북도,영천시,20-24세,5457,3269,2188
202008,47230,경상북도,영천시,20-24세,5387,3224,2163
202009,47230,경상북도,영천시,20-24세,5369,3204,2165
202010,47230,경상북도,영천시,20-24세,5363,3198,2165
202011,47230,경상북도,영천시,20-24세,5358,3201,2157
202012,47230,경상북도,영천시,20-24세,5328,3184,2144
202101,47230,경상북도,영천시,20-24세,5240,3127,2113
202102,47230,경상북도,영천시,20-24세,5339,3234,2105
202103,47230,경상북도,영천시,20-24세,5313,3238,2075
202104,47230,경상북도,영천시,20-24세,5295,3225,2070
202105,47230,경상북도,영천시,20-24세,5264,3186,2078
202106,47230,경상북도,영천시,20-24세,5238,3157,2081
202007,47230,경상북도,영천시,25-29세,4744,2761,1983
202008,47230,경상북도,영천시,25-29세,4768,2778,1990
202009,47230,경상북도,영천시,25-29세,4788,2798,1990
202010,47230,경상북도,영천시,25-29세,4794,2790,2004
202011,47230,경상북도,영천시,25-29세,4767,2776,1991
202012,47230,경상북도,영천시,25-29세,4823,2811,2012
202101,47230,경상북도,영천시,25-29세,4798,2808,1990
202102,47230,경상북도,영천시,25-29세,4802,2819,1983
202103,47230,경상북도,영천시,25-29세,4849,2858,1991
202104,47230,경상북도,영천시,25-29세,4862,2870,1992
202105,47230,경상북도,영천시,25-29세,4858,2863,1995
202106,47230,경상북도,영천시,25-29세,4831,2853,1978
202007,47230,경상북도,영천시,30-34세,4359,2397,1962
202008,47230,경상북도,영천시,30-34세,4356,2391,1965
202009,47230,경상북도,영천시,30-34세,4379,2407,1972
202010,47230,경상북도,영천시,30-34세,4387,2395,1992
202011,47230,경상북도,영천시,30-34세,4389,2402,1987
202012,47230,경상북도,영천시,30-34세,4382,2399,1983
202101,47230,경상북도,영천시,30-34세,4346,2367,1979
202102,47230,경상북도,영천시,30-34세,4331,2372,1959
202103,47230,경상북도,영천시,30-34세,4363,2381,1982
202104,47230,경상북도,영천시,30-34세,4365,2390,1975
202105,47230,경상북도,영천시,30-34세,4333,2371,1962
202106,47230,경상북도,영천시,30-34세,4343,2364,1979
202007,47230,경상북도,영천시,35-39세,5094,2770,2324
202008,47230,경상북도,영천시,35-39세,5070,2774,2296
202009,47230,경상북도,영천시,35-39세,5055,2755,2300
202010,47230,경상북도,영천시,35-39세,5077,2776,2301
202011,47230,경상북도,영천시,35-39세,5061,2758,2303
202012,47230,경상북도,영천시,35-39세,5058,2768,2290
202101,47230,경상북도,영천시,35-39세,5041,2739,2302
202102,47230,경상북도,영천시,35-39세,5020,2724,2296
202103,47230,경상북도,영천시,35-39세,5017,2711,2306
202104,47230,경상북도,영천시,35-39세,5009,2701,2308
202105,47230,경상북도,영천시,35-39세,4949,2673,2276
202106,47230,경상북도,영천시,35-39세,4923,2668,2255
202007,47230,경상북도,영천시,40-44세,5468,3043,2425
202008,47230,경상북도,영천시,40-44세,5452,3020,2432
202009,47230,경상북도,영천시,40-44세,5456,3017,2439
202010,47230,경상북도,영천시,40-44세,5425,2994,2431
202011,47230,경상북도,영천시,40-44세,5422,2987,2435
202012,47230,경상북도,영천시,40-44세,5401,2976,2425
202101,47230,경상북도,영천시,40-44세,5359,2965,2394
202102,47230,경상북도,영천시,40-44세,5356,2956,2400
202103,47230,경상북도,영천시,40-44세,5378,2958,2420
202104,47230,경상북도,영천시,40-44세,5372,2953,2419
202105,47230,경상북도,영천시,40-44세,5393,2962,2431
202106,47230,경상북도,영천시,40-44세,5377,2951,2426
202007,47230,경상북도,영천시,45-49세,7388,4014,3374
202008,47230,경상북도,영천시,45-49세,7391,4034,3357
202009,47230,경상북도,영천시,45-49세,7332,4013,3319
202010,47230,경상북도,영천시,45-49세,7302,4007,3295
202011,47230,경상북도,영천시,45-49세,7273,3999,3274
202012,47230,경상북도,영천시,45-49세,7257,3974,3283
202101,47230,경상북도,영천시,45-49세,7248,3985,3263
202102,47230,경상북도,영천시,45-49세,7219,3962,3257
202103,47230,경상북도,영천시,45-49세,7219,3957,3262
202104,47230,경상북도,영천시,45-49세,7210,3960,3250
202105,47230,경상북도,영천시,45-49세,7095,3901,3194
202106,47230,경상북도,영천시,45-49세,7068,3885,3183
202007,47230,경상북도,영천시,50-54세,8711,4755,3956
202008,47230,경상북도,영천시,50-54세,8727,4759,3968
202009,47230,경상북도,영천시,50-54세,8782,4783,3999
202010,47230,경상북도,영천시,50-54세,8790,4773,4017
202011,47230,경상북도,영천시,50-54세,8769,4760,4009
202012,47230,경상북도,영천시,50-54세,8763,4756,4007
202101,47230,경상북도,영천시,50-54세,8770,4745,4025
202102,47230,경상북도,영천시,50-54세,8760,4730,4030
202103,47230,경상북도,영천시,50-54세,8714,4708,4006
202104,47230,경상북도,영천시,50-54세,8727,4707,4020
202105,47230,경상북도,영천시,50-54세,8749,4715,4034
202106,47230,경상북도,영천시,50-54세,8729,4702,4027
202007,47230,경상북도,영천시,55-59세,9581,4999,4582
202008,47230,경상북도,영천시,55-59세,9555,4996,4559
202009,47230,경상북도,영천시,55-59세,9540,5007,4533
202010,47230,경상북도,영천시,55-59세,9521,5011,4510
202011,47230,경상북도,영천시,55-59세,9531,5019,4512
202012,47230,경상북도,영천시,55-59세,9547,5039,4508
202101,47230,경상북도,영천시,55-59세,9443,4990,4453
202102,47230,경상북도,영천시,55-59세,9447,4990,4457
202103,47230,경상북도,영천시,55-59세,9520,5026,4494
202104,47230,경상북도,영천시,55-59세,9512,5018,4494
202105,47230,경상북도,영천시,55-59세,9403,4988,4415
202106,47230,경상북도,영천시,55-59세,9340,4959,4381
202007,47230,경상북도,영천시,60-64세,9872,5043,4829
202008,47230,경상북도,영천시,60-64세,9916,5071,4845
202009,47230,경상북도,영천시,60-64세,9945,5077,4868
202010,47230,경상북도,영천시,60-64세,10043,5130,4913
202011,47230,경상북도,영천시,60-64세,10140,5188,4952
202012,47230,경상북도,영천시,60-64세,10194,5206,4988
202101,47230,경상북도,영천시,60-64세,10241,5240,5001
202102,47230,경상북도,영천시,60-64세,10303,5269,5034
202103,47230,경상북도,영천시,60-64세,10409,5341,5068
202104,47230,경상북도,영천시,60-64세,10466,5384,5082
202105,47230,경상북도,영천시,60-64세,10543,5428,5115
202106,47230,경상북도,영천시,60-64세,10619,5478,5141
202007,47230,경상북도,영천시,65-69세,8273,4023,4250
202008,47230,경상북도,영천시,65-69세,8308,4033,4275
202009,47230,경상북도,영천시,65-69세,8363,4064,4299
202010,47230,경상북도,영천시,65-69세,8401,4081,4320
202011,47230,경상북도,영천시,65-69세,8453,4101,4352
202012,47230,경상북도,영천시,65-69세,8530,4146,4384
202101,47230,경상북도,영천시,65-69세,8557,4179,4378
202102,47230,경상북도,영천시,65-69세,8586,4202,4384
202103,47230,경상북도,영천시,65-69세,8630,4244,4386
202104,47230,경상북도,영천시,65-69세,8695,4278,4417
202105,47230,경상북도,영천시,65-69세,8642,4270,4372
202106,47230,경상북도,영천시,65-69세,8679,4281,4398
202007,47230,경상북도,영천시,70-74세,6402,3109,3293
202008,47230,경상북도,영천시,70-74세,6443,3139,3304
202009,47230,경상북도,영천시,70-74세,6533,3176,3357
202010,47230,경상북도,영천시,70-74세,6603,3193,3410
202011,47230,경상북도,영천시,70-74세,6653,3228,3425
202012,47230,경상북도,영천시,70-74세,6719,3248,3471
202101,47230,경상북도,영천시,70-74세,6796,3281,3515
202102,47230,경상북도,영천시,70-74세,6882,3332,3550
202103,47230,경상북도,영천시,70-74세,6955,3365,3590
202104,47230,경상북도,영천시,70-74세,6991,3381,3610
202105,47230,경상북도,영천시,70-74세,7010,3404,3606
202106,47230,경상북도,영천시,70-74세,7026,3413,3613
202007,47230,경상북도,영천시,75-79세,6021,2400,3621
202008,47230,경상북도,영천시,75-79세,6002,2406,3596
202009,47230,경상북도,영천시,75-79세,5955,2399,3556
202010,47230,경상북도,영천시,75-79세,5929,2393,3536
202011,47230,경상북도,영천시,75-79세,5895,2380,3515
202012,47230,경상북도,영천시,75-79세,5819,2349,3470
202101,47230,경상북도,영천시,75-79세,5788,2334,3454
202102,47230,경상북도,영천시,75-79세,5743,2313,3430
202103,47230,경상북도,영천시,75-79세,5707,2311,3396
202104,47230,경상북도,영천시,75-79세,5654,2294,3360
202105,47230,경상북도,영천시,75-79세,5605,2261,3344
202106,47230,경상북도,영천시,75-79세,5575,2251,3324
202007,47230,경상북도,영천시,80-84세,4517,1587,2930
202008,47230,경상북도,영천시,80-84세,4533,1579,2954
202009,47230,경상북도,영천시,80-84세,4512,1560,2952
202010,47230,경상북도,영천시,80-84세,4524,1566,2958
202011,47230,경상북도,영천시,80-84세,4533,1570,2963
202012,47230,경상북도,영천시,80-84세,4543,1576,2967
202101,47230,경상북도,영천시,80-84세,4532,1571,2961
202102,47230,경상북도,영천시,80-84세,4536,1579,2957
202103,47230,경상북도,영천시,80-84세,4532,1576,2956
202104,47230,경상북도,영천시,80-84세,4530,1584,2946
202105,47230,경상북도,영천시,80-84세,4521,1584,2937
202106,47230,경상북도,영천시,80-84세,4566,1600,2966
202007,47230,경상북도,영천시,85-89세,2325,656,1669
202008,47230,경상북도,영천시,85-89세,2327,663,1664
202009,47230,경상북도,영천시,85-89세,2362,677,1685
202010,47230,경상북도,영천시,85-89세,2384,682,1702
202011,47230,경상북도,영천시,85-89세,2393,681,1712
202012,47230,경상북도,영천시,85-89세,2423,693,1730
202101,47230,경상북도,영천시,85-89세,2451,701,1750
202102,47230,경상북도,영천시,85-89세,2479,711,1768
202103,47230,경상북도,영천시,85-89세,2511,721,1790
202104,47230,경상북도,영천시,85-89세,2565,738,1827
202105,47230,경상북도,영천시,85-89세,2585,731,1854
202106,47230,경상북도,영천시,85-89세,2594,736,1858
202007,47230,경상북도,영천시,90-94세,660,173,487
202008,47230,경상북도,영천시,90-94세,670,174,496
202009,47230,경상북도,영천시,90-94세,680,173,507
202010,47230,경상북도,영천시,90-94세,683,170,513
202011,47230,경상북도,영천시,90-94세,687,170,517
202012,47230,경상북도,영천시,90-94세,684,171,513
202101,47230,경상북도,영천시,90-94세,703,174,529
202102,47230,경상북도,영천시,90-94세,714,172,542
202103,47230,경상북도,영천시,90-94세,708,171,537
202104,47230,경상북도,영천시,90-94세,710,168,542
202105,47230,경상북도,영천시,90-94세,714,169,545
202106,47230,경상북도,영천시,90-94세,715,169,546
202007,47230,경상북도,영천시,95-99세,105,18,87
202008,47230,경상북도,영천시,95-99세,110,20,90
202009,47230,경상북도,영천시,95-99세,114,23,91
202010,47230,경상북도,영천시,95-99세,112,22,90
202011,47230,경상북도,영천시,95-99세,114,23,91
202012,47230,경상북도,영천시,95-99세,110,21,89
202101,47230,경상북도,영천시,95-99세,114,23,91
202102,47230,경상북도,영천시,95-99세,112,24,88
202103,47230,경상북도,영천시,95-99세,105,23,82
202104,47230,경상북도,영천시,95-99세,108,22,86
202105,47230,경상북도,영천시,95-99세,112,22,90
202106,47230,경상북도,영천시,95-99세,111,22,89
202007,47230,경상북도,영천시,100+,42,13,29
202008,47230,경상북도,영천시,100+,42,13,29
202009,47230,경상북도,영천시,100+,41,13,28
202010,47230,경상북도,영천시,100+,42,13,29
202011,47230,경상북도,영천시,100+,42,13,29
202012,47230,경상북도,영천시,100+,43,14,29
202101,47230,경상북도,영천시,100+,44,14,30
202102,47230,경상북도,영천시,100+,45,14,31
202103,47230,경상북도,영천시,100+,24,4,20
202104,47230,경상북도,영천시,100+,25,5,20
202105,47230,경상북도,영천시,100+,23,5,18
202106,47230,경상북도,영천시,100+,23,5,18
202007,47250,경상북도,상주시,0-4세,2280,1161,1119
202008,47250,경상북도,상주시,0-4세,2261,1146,1115
202009,47250,경상북도,상주시,0-4세,2229,1129,1100
202010,47250,경상북도,상주시,0-4세,2219,1122,1097
202011,47250,경상북도,상주시,0-4세,2212,1118,1094
202012,47250,경상북도,상주시,0-4세,2191,1110,1081
202101,47250,경상북도,상주시,0-4세,2178,1105,1073
202102,47250,경상북도,상주시,0-4세,2156,1097,1059
202103,47250,경상북도,상주시,0-4세,2145,1091,1054
202104,47250,경상북도,상주시,0-4세,2118,1080,1038
202105,47250,경상북도,상주시,0-4세,2092,1066,1026
202106,47250,경상북도,상주시,0-4세,2069,1045,1024
202007,47250,경상북도,상주시,5-9세,3025,1593,1432
202008,47250,경상북도,상주시,5-9세,3025,1598,1427
202009,47250,경상북도,상주시,5-9세,3037,1604,1433
202010,47250,경상북도,상주시,5-9세,3029,1601,1428
202011,47250,경상북도,상주시,5-9세,3013,1588,1425
202012,47250,경상북도,상주시,5-9세,3009,1578,1431
202101,47250,경상북도,상주시,5-9세,3023,1583,1440
202102,47250,경상북도,상주시,5-9세,3007,1580,1427
202103,47250,경상북도,상주시,5-9세,2988,1572,1416
202104,47250,경상북도,상주시,5-9세,2972,1554,1418
202105,47250,경상북도,상주시,5-9세,2970,1558,1412
202106,47250,경상북도,상주시,5-9세,2968,1565,1403
202007,47250,경상북도,상주시,10-14세,3485,1797,1688
202008,47250,경상북도,상주시,10-14세,3483,1797,1686
202009,47250,경상북도,상주시,10-14세,3467,1788,1679
202010,47250,경상북도,상주시,10-14세,3475,1798,1677
202011,47250,경상북도,상주시,10-14세,3482,1818,1664
202012,47250,경상북도,상주시,10-14세,3466,1807,1659
202101,47250,경상북도,상주시,10-14세,3467,1826,1641
202102,47250,경상북도,상주시,10-14세,3473,1826,1647
202103,47250,경상북도,상주시,10-14세,3460,1819,1641
202104,47250,경상북도,상주시,10-14세,3461,1822,1639
202105,47250,경상북도,상주시,10-14세,3457,1816,1641
202106,47250,경상북도,상주시,10-14세,3479,1827,1652
202007,47250,경상북도,상주시,15-19세,4318,2319,1999
202008,47250,경상북도,상주시,15-19세,4264,2281,1983
202009,47250,경상북도,상주시,15-19세,4225,2257,1968
202010,47250,경상북도,상주시,15-19세,4180,2225,1955
202011,47250,경상북도,상주시,15-19세,4174,2207,1967
202012,47250,경상북도,상주시,15-19세,4075,2126,1949
202101,47250,경상북도,상주시,15-19세,4032,2095,1937
202102,47250,경상북도,상주시,15-19세,3976,2077,1899
202103,47250,경상북도,상주시,15-19세,4055,2108,1947
202104,47250,경상북도,상주시,15-19세,4042,2113,1929
202105,47250,경상북도,상주시,15-19세,4005,2095,1910
202106,47250,경상북도,상주시,15-19세,3996,2111,1885
202007,47250,경상북도,상주시,20-24세,4732,2722,2010
202008,47250,경상북도,상주시,20-24세,4700,2713,1987
202009,47250,경상북도,상주시,20-24세,4664,2696,1968
202010,47250,경상북도,상주시,20-24세,4675,2704,1971
202011,47250,경상북도,상주시,20-24세,4660,2696,1964
202012,47250,경상북도,상주시,20-24세,4636,2697,1939
202101,47250,경상북도,상주시,20-24세,4605,2674,1931
202102,47250,경상북도,상주시,20-24세,4522,2624,1898
202103,47250,경상북도,상주시,20-24세,4490,2606,1884
202104,47250,경상북도,상주시,20-24세,4474,2600,1874
202105,47250,경상북도,상주시,20-24세,4508,2607,1901
202106,47250,경상북도,상주시,20-24세,4504,2597,1907
202007,47250,경상북도,상주시,25-29세,3567,2087,1480
202008,47250,경상북도,상주시,25-29세,3565,2078,1487
202009,47250,경상북도,상주시,25-29세,3549,2067,1482
202010,47250,경상북도,상주시,25-29세,3547,2063,1484
202011,47250,경상북도,상주시,25-29세,3546,2067,1479
202012,47250,경상북도,상주시,25-29세,3527,2053,1474
202101,47250,경상북도,상주시,25-29세,3470,2018,1452
202102,47250,경상북도,상주시,25-29세,3438,2002,1436
202103,47250,경상북도,상주시,25-29세,3405,1976,1429
202104,47250,경상북도,상주시,25-29세,3389,1971,1418
202105,47250,경상북도,상주시,25-29세,3364,1959,1405
202106,47250,경상북도,상주시,25-29세,3366,1963,1403
202007,47250,경상북도,상주시,30-34세,3345,1838,1507
202008,47250,경상북도,상주시,30-34세,3313,1820,1493
202009,47250,경상북도,상주시,30-34세,3296,1816,1480
202010,47250,경상북도,상주시,30-34세,3262,1784,1478
202011,47250,경상북도,상주시,30-34세,3249,1772,1477
202012,47250,경상북도,상주시,30-34세,3210,1747,1463
202101,47250,경상북도,상주시,30-34세,3245,1758,1487
202102,47250,경상북도,상주시,30-34세,3206,1736,1470
202103,47250,경상북도,상주시,30-34세,3196,1721,1475
202104,47250,경상북도,상주시,30-34세,3181,1714,1467
202105,47250,경상북도,상주시,30-34세,3158,1697,1461
202106,47250,경상북도,상주시,30-34세,3134,1672,1462
202007,47250,경상북도,상주시,35-39세,4301,2302,1999
202008,47250,경상북도,상주시,35-39세,4290,2295,1995
202009,47250,경상북도,상주시,35-39세,4283,2294,1989
202010,47250,경상북도,상주시,35-39세,4274,2292,1982
202011,47250,경상북도,상주시,35-39세,4236,2268,1968
202012,47250,경상북도,상주시,35-39세,4235,2268,1967
202101,47250,경상북도,상주시,35-39세,4185,2239,1946
202102,47250,경상북도,상주시,35-39세,4148,2222,1926
202103,47250,경상북도,상주시,35-39세,4127,2217,1910
202104,47250,경상북도,상주시,35-39세,4104,2200,1904
202105,47250,경상북도,상주시,35-39세,4060,2182,1878
202106,47250,경상북도,상주시,35-39세,4049,2180,1869
202007,47250,경상북도,상주시,40-44세,4955,2615,2340
202008,47250,경상북도,상주시,40-44세,4931,2599,2332
202009,47250,경상북도,상주시,40-44세,4909,2595,2314
202010,47250,경상북도,상주시,40-44세,4898,2583,2315
202011,47250,경상북도,상주시,40-44세,4889,2583,2306
202012,47250,경상북도,상주시,40-44세,4876,2572,2304
202101,47250,경상북도,상주시,40-44세,4867,2573,2294
202102,47250,경상북도,상주시,40-44세,4878,2581,2297
202103,47250,경상북도,상주시,40-44세,4868,2574,2294
202104,47250,경상북도,상주시,40-44세,4863,2572,2291
202105,47250,경상북도,상주시,40-44세,4824,2554,2270
202106,47250,경상북도,상주시,40-44세,4839,2569,2270
202007,47250,경상북도,상주시,45-49세,6776,3633,3143
202008,47250,경상북도,상주시,45-49세,6755,3622,3133
202009,47250,경상북도,상주시,45-49세,6733,3607,3126
202010,47250,경상북도,상주시,45-49세,6694,3581,3113
202011,47250,경상북도,상주시,45-49세,6679,3558,3121
202012,47250,경상북도,상주시,45-49세,6614,3519,3095
202101,47250,경상북도,상주시,45-49세,6610,3512,3098
202102,47250,경상북도,상주시,45-49세,6549,3482,3067
202103,47250,경상북도,상주시,45-49세,6482,3435,3047
202104,47250,경상북도,상주시,45-49세,6465,3430,3035
202105,47250,경상북도,상주시,45-49세,6377,3390,2987
202106,47250,경상북도,상주시,45-49세,6344,3375,2969
202007,47250,경상북도,상주시,50-54세,7737,4164,3573
202008,47250,경상북도,상주시,50-54세,7731,4160,3571
202009,47250,경상북도,상주시,50-54세,7730,4174,3556
202010,47250,경상북도,상주시,50-54세,7741,4180,3561
202011,47250,경상북도,상주시,50-54세,7724,4176,3548
202012,47250,경상북도,상주시,50-54세,7690,4163,3527
202101,47250,경상북도,상주시,50-54세,7698,4178,3520
202102,47250,경상북도,상주시,50-54세,7745,4200,3545
202103,47250,경상북도,상주시,50-54세,7678,4167,3511
202104,47250,경상북도,상주시,50-54세,7696,4163,3533
202105,47250,경상북도,상주시,50-54세,7672,4152,3520
202106,47250,경상북도,상주시,50-54세,7677,4141,3536
202007,47250,경상북도,상주시,55-59세,9301,4758,4543
202008,47250,경상북도,상주시,55-59세,9243,4748,4495
202009,47250,경상북도,상주시,55-59세,9162,4709,4453
202010,47250,경상북도,상주시,55-59세,9098,4683,4415
202011,47250,경상북도,상주시,55-59세,9035,4666,4369
202012,47250,경상북도,상주시,55-59세,9038,4665,4373
202101,47250,경상북도,상주시,55-59세,8970,4633,4337
202102,47250,경상북도,상주시,55-59세,8905,4604,4301
202103,47250,경상북도,상주시,55-59세,8931,4633,4298
202104,47250,경상북도,상주시,55-59세,8880,4621,4259
202105,47250,경상북도,상주시,55-59세,8766,4574,4192
202106,47250,경상북도,상주시,55-59세,8653,4525,4128
202007,47250,경상북도,상주시,60-64세,9967,4985,4982
202008,47250,경상북도,상주시,60-64세,10029,5013,5016
202009,47250,경상북도,상주시,60-64세,10059,5025,5034
202010,47250,경상북도,상주시,60-64세,10127,5068,5059
202011,47250,경상북도,상주시,60-64세,10165,5074,5091
202012,47250,경상북도,상주시,60-64세,10189,5120,5069
202101,47250,경상북도,상주시,60-64세,10237,5132,5105
202102,47250,경상북도,상주시,60-64세,10297,5176,5121
202103,47250,경상북도,상주시,60-64세,10268,5167,5101
202104,47250,경상북도,상주시,60-64세,10313,5185,5128
202105,47250,경상북도,상주시,60-64세,10332,5210,5122
202106,47250,경상북도,상주시,60-64세,10420,5264,5156
202007,47250,경상북도,상주시,65-69세,7923,3764,4159
202008,47250,경상북도,상주시,65-69세,7960,3791,4169
202009,47250,경상북도,상주시,65-69세,8031,3824,4207
202010,47250,경상북도,상주시,65-69세,8063,3837,4226
202011,47250,경상북도,상주시,65-69세,8080,3854,4226
202012,47250,경상북도,상주시,65-69세,8129,3868,4261
202101,47250,경상북도,상주시,65-69세,8180,3895,4285
202102,47250,경상북도,상주시,65-69세,8236,3925,4311
202103,47250,경상북도,상주시,65-69세,8364,3992,4372
202104,47250,경상북도,상주시,65-69세,8434,4029,4405
202105,47250,경상북도,상주시,65-69세,8438,4032,4406
202106,47250,경상북도,상주시,65-69세,8480,4054,4426
202007,47250,경상북도,상주시,70-74세,6561,3097,3464
202008,47250,경상북도,상주시,70-74세,6581,3109,3472
202009,47250,경상북도,상주시,70-74세,6577,3118,3459
202010,47250,경상북도,상주시,70-74세,6612,3131,3481
202011,47250,경상북도,상주시,70-74세,6663,3153,3510
202012,47250,경상북도,상주시,70-74세,6697,3164,3533
202101,47250,경상북도,상주시,70-74세,6764,3199,3565
202102,47250,경상북도,상주시,70-74세,6773,3200,3573
202103,47250,경상북도,상주시,70-74세,6779,3202,3577
202104,47250,경상북도,상주시,70-74세,6790,3203,3587
202105,47250,경상북도,상주시,70-74세,6782,3202,3580
202106,47250,경상북도,상주시,70-74세,6801,3198,3603
202007,47250,경상북도,상주시,75-79세,6201,2375,3826
202008,47250,경상북도,상주시,75-79세,6151,2356,3795
202009,47250,경상북도,상주시,75-79세,6096,2329,3767
202010,47250,경상북도,상주시,75-79세,6061,2320,3741
202011,47250,경상북도,상주시,75-79세,6010,2295,3715
202012,47250,경상북도,상주시,75-79세,5942,2288,3654
202101,47250,경상북도,상주시,75-79세,5863,2265,3598
202102,47250,경상북도,상주시,75-79세,5791,2249,3542
202103,47250,경상북도,상주시,75-79세,5736,2226,3510
202104,47250,경상북도,상주시,75-79세,5693,2221,3472
202105,47250,경상북도,상주시,75-79세,5616,2195,3421
202106,47250,경상북도,상주시,75-79세,5577,2185,3392
202007,47250,경상북도,상주시,80-84세,5415,1819,3596
202008,47250,경상북도,상주시,80-84세,5411,1813,3598
202009,47250,경상북도,상주시,80-84세,5392,1798,3594
202010,47250,경상북도,상주시,80-84세,5414,1800,3614
202011,47250,경상북도,상주시,80-84세,5385,1799,3586
202012,47250,경상북도,상주시,80-84세,5393,1795,3598
202101,47250,경상북도,상주시,80-84세,5395,1791,3604
202102,47250,경상북도,상주시,80-84세,5393,1788,3605
202103,47250,경상북도,상주시,80-84세,5398,1803,3595
202104,47250,경상북도,상주시,80-84세,5393,1812,3581
202105,47250,경상북도,상주시,80-84세,5390,1811,3579
202106,47250,경상북도,상주시,80-84세,5392,1809,3583
202007,47250,경상북도,상주시,85-89세,2855,796,2059
202008,47250,경상북도,상주시,85-89세,2878,810,2068
202009,47250,경상북도,상주시,85-89세,2927,829,2098
202010,47250,경상북도,상주시,85-89세,2930,826,2104
202011,47250,경상북도,상주시,85-89세,2943,825,2118
202012,47250,경상북도,상주시,85-89세,2973,837,2136
202101,47250,경상북도,상주시,85-89세,3021,853,2168
202102,47250,경상북도,상주시,85-89세,3084,879,2205
202103,47250,경상북도,상주시,85-89세,3122,896,2226
202104,47250,경상북도,상주시,85-89세,3144,893,2251
202105,47250,경상북도,상주시,85-89세,3152,903,2249
202106,47250,경상북도,상주시,85-89세,3157,902,2255
202007,47250,경상북도,상주시,90-94세,995,196,799
202008,47250,경상북도,상주시,90-94세,998,197,801
202009,47250,경상북도,상주시,90-94세,1012,202,810
202010,47250,경상북도,상주시,90-94세,1023,199,824
202011,47250,경상북도,상주시,90-94세,1028,200,828
202012,47250,경상북도,상주시,90-94세,1027,196,831
202101,47250,경상북도,상주시,90-94세,1033,198,835
202102,47250,경상북도,상주시,90-94세,1048,197,851
202103,47250,경상북도,상주시,90-94세,1065,201,864
202104,47250,경상북도,상주시,90-94세,1073,204,869
202105,47250,경상북도,상주시,90-94세,1071,203,868
202106,47250,경상북도,상주시,90-94세,1066,205,861
202007,47250,경상북도,상주시,95-99세,241,46,195
202008,47250,경상북도,상주시,95-99세,248,45,203
202009,47250,경상북도,상주시,95-99세,250,46,204
202010,47250,경상북도,상주시,95-99세,250,48,202
202011,47250,경상북도,상주시,95-99세,249,50,199
202012,47250,경상북도,상주시,95-99세,249,48,201
202101,47250,경상북도,상주시,95-99세,252,49,203
202102,47250,경상북도,상주시,95-99세,253,48,205
202103,47250,경상북도,상주시,95-99세,256,44,212
202104,47250,경상북도,상주시,95-99세,267,47,220
202105,47250,경상북도,상주시,95-99세,266,45,221
202106,47250,경상북도,상주시,95-99세,263,45,218
202007,47250,경상북도,상주시,100+,58,10,48
202008,47250,경상북도,상주시,100+,58,10,48
202009,47250,경상북도,상주시,100+,61,11,50
202010,47250,경상북도,상주시,100+,61,11,50
202011,47250,경상북도,상주시,100+,61,12,49
202012,47250,경상북도,상주시,100+,62,13,49
202101,47250,경상북도,상주시,100+,64,13,51
202102,47250,경상북도,상주시,100+,64,13,51
202103,47250,경상북도,상주시,100+,42,5,37
202104,47250,경상북도,상주시,100+,41,4,37
202105,47250,경상북도,상주시,100+,37,3,34
202106,47250,경상북도,상주시,100+,39,3,36
202007,47280,경상북도,문경시,0-4세,1725,888,837
202008,47280,경상북도,문경시,0-4세,1723,882,841
202009,47280,경상북도,문경시,0-4세,1724,887,837
202010,47280,경상북도,문경시,0-4세,1733,891,842
202011,47280,경상북도,문경시,0-4세,1721,877,844
202012,47280,경상북도,문경시,0-4세,1713,878,835
202101,47280,경상북도,문경시,0-4세,1689,870,819
202102,47280,경상북도,문경시,0-4세,1678,872,806
202103,47280,경상북도,문경시,0-4세,1693,882,811
202104,47280,경상북도,문경시,0-4세,1694,875,819
202105,47280,경상북도,문경시,0-4세,1690,869,821
202106,47280,경상북도,문경시,0-4세,1673,861,812
202007,47280,경상북도,문경시,5-9세,2374,1251,1123
202008,47280,경상북도,문경시,5-9세,2361,1247,1114
202009,47280,경상북도,문경시,5-9세,2367,1244,1123
202010,47280,경상북도,문경시,5-9세,2357,1237,1120
202011,47280,경상북도,문경시,5-9세,2348,1237,1111
202012,47280,경상북도,문경시,5-9세,2359,1237,1122
202101,47280,경상북도,문경시,5-9세,2324,1204,1120
202102,47280,경상북도,문경시,5-9세,2296,1186,1110
202103,47280,경상북도,문경시,5-9세,2300,1189,1111
202104,47280,경상북도,문경시,5-9세,2289,1190,1099
202105,47280,경상북도,문경시,5-9세,2264,1176,1088
202106,47280,경상북도,문경시,5-9세,2245,1163,1082
202007,47280,경상북도,문경시,10-14세,2541,1406,1135
202008,47280,경상북도,문경시,10-14세,2534,1391,1143
202009,47280,경상북도,문경시,10-14세,2541,1394,1147
202010,47280,경상북도,문경시,10-14세,2520,1374,1146
202011,47280,경상북도,문경시,10-14세,2510,1365,1145
202012,47280,경상북도,문경시,10-14세,2491,1360,1131
202101,47280,경상북도,문경시,10-14세,2469,1347,1122
202102,47280,경상북도,문경시,10-14세,2481,1348,1133
202103,47280,경상북도,문경시,10-14세,2550,1397,1153
202104,47280,경상북도,문경시,10-14세,2551,1395,1156
202105,47280,경상북도,문경시,10-14세,2560,1398,1162
202106,47280,경상북도,문경시,10-14세,2551,1388,1163
202007,47280,경상북도,문경시,15-19세,3200,1694,1506
202008,47280,경상북도,문경시,15-19세,3156,1678,1478
202009,47280,경상북도,문경시,15-19세,3127,1662,1465
202010,47280,경상북도,문경시,15-19세,3104,1657,1447
202011,47280,경상북도,문경시,15-19세,3082,1654,1428
202012,47280,경상북도,문경시,15-19세,3089,1661,1428
202101,47280,경상북도,문경시,15-19세,3024,1627,1397
202102,47280,경상북도,문경시,15-19세,3006,1621,1385
202103,47280,경상북도,문경시,15-19세,3119,1686,1433
202104,47280,경상북도,문경시,15-19세,3085,1665,1420
202105,47280,경상북도,문경시,15-19세,3027,1648,1379
202106,47280,경상북도,문경시,15-19세,3007,1631,1376
202007,47280,경상북도,문경시,20-24세,3578,2010,1568
202008,47280,경상북도,문경시,20-24세,3550,1983,1567
202009,47280,경상북도,문경시,20-24세,3542,1977,1565
202010,47280,경상북도,문경시,20-24세,3558,1985,1573
202011,47280,경상북도,문경시,20-24세,3561,1988,1573
202012,47280,경상북도,문경시,20-24세,3581,1998,1583
202101,47280,경상북도,문경시,20-24세,3529,1980,1549
202102,47280,경상북도,문경시,20-24세,3518,1980,1538
202103,47280,경상북도,문경시,20-24세,3626,2031,1595
202104,47280,경상북도,문경시,20-24세,3601,2030,1571
202105,47280,경상북도,문경시,20-24세,3574,2011,1563
202106,47280,경상북도,문경시,20-24세,3570,2015,1555
202007,47280,경상북도,문경시,25-29세,2541,1436,1105
202008,47280,경상북도,문경시,25-29세,2555,1450,1105
202009,47280,경상북도,문경시,25-29세,2550,1447,1103
202010,47280,경상북도,문경시,25-29세,2572,1467,1105
202011,47280,경상북도,문경시,25-29세,2574,1471,1103
202012,47280,경상북도,문경시,25-29세,2626,1519,1107
202101,47280,경상북도,문경시,25-29세,2598,1501,1097
202102,47280,경상북도,문경시,25-29세,2603,1490,1113
202103,47280,경상북도,문경시,25-29세,2712,1555,1157
202104,47280,경상북도,문경시,25-29세,2725,1561,1164
202105,47280,경상북도,문경시,25-29세,2721,1560,1161
202106,47280,경상북도,문경시,25-29세,2694,1536,1158
202007,47280,경상북도,문경시,30-34세,2508,1379,1129
202008,47280,경상북도,문경시,30-34세,2471,1348,1123
202009,47280,경상북도,문경시,30-34세,2455,1337,1118
202010,47280,경상북도,문경시,30-34세,2467,1344,1123
202011,47280,경상북도,문경시,30-34세,2440,1331,1109
202012,47280,경상북도,문경시,30-34세,2444,1325,1119
202101,47280,경상북도,문경시,30-34세,2368,1282,1086
202102,47280,경상북도,문경시,30-34세,2380,1284,1096
202103,47280,경상북도,문경시,30-34세,2407,1302,1105
202104,47280,경상북도,문경시,30-34세,2406,1302,1104
202105,47280,경상북도,문경시,30-34세,2388,1295,1093
202106,47280,경상북도,문경시,30-34세,2369,1286,1083
202007,47280,경상북도,문경시,35-39세,3390,1757,1633
202008,47280,경상북도,문경시,35-39세,3354,1745,1609
202009,47280,경상북도,문경시,35-39세,3329,1721,1608
202010,47280,경상북도,문경시,35-39세,3296,1710,1586
202011,47280,경상북도,문경시,35-39세,3282,1697,1585
202012,47280,경상북도,문경시,35-39세,3282,1691,1591
202101,47280,경상북도,문경시,35-39세,3266,1691,1575
202102,47280,경상북도,문경시,35-39세,3250,1682,1568
202103,47280,경상북도,문경시,35-39세,3277,1694,1583
202104,47280,경상북도,문경시,35-39세,3241,1669,1572
202105,47280,경상북도,문경시,35-39세,3206,1659,1547
202106,47280,경상북도,문경시,35-39세,3198,1663,1535
202007,47280,경상북도,문경시,40-44세,3891,2070,1821
202008,47280,경상북도,문경시,40-44세,3882,2064,1818
202009,47280,경상북도,문경시,40-44세,3885,2063,1822
202010,47280,경상북도,문경시,40-44세,3876,2062,1814
202011,47280,경상북도,문경시,40-44세,3859,2058,1801
202012,47280,경상북도,문경시,40-44세,3847,2067,1780
202101,47280,경상북도,문경시,40-44세,3777,2020,1757
202102,47280,경상북도,문경시,40-44세,3809,2043,1766
202103,47280,경상북도,문경시,40-44세,3818,2041,1777
202104,47280,경상북도,문경시,40-44세,3821,2039,1782
202105,47280,경상북도,문경시,40-44세,3811,2024,1787
202106,47280,경상북도,문경시,40-44세,3803,2023,1780
202007,47280,경상북도,문경시,45-49세,4955,2671,2284
202008,47280,경상북도,문경시,45-49세,4931,2663,2268
202009,47280,경상북도,문경시,45-49세,4921,2656,2265
202010,47280,경상북도,문경시,45-49세,4933,2660,2273
202011,47280,경상북도,문경시,45-49세,4915,2647,2268
202012,47280,경상북도,문경시,45-49세,4940,2658,2282
202101,47280,경상북도,문경시,45-49세,4886,2633,2253
202102,47280,경상북도,문경시,45-49세,4880,2625,2255
202103,47280,경상북도,문경시,45-49세,4954,2662,2292
202104,47280,경상북도,문경시,45-49세,4906,2639,2267
202105,47280,경상북도,문경시,45-49세,4838,2612,2226
202106,47280,경상북도,문경시,45-49세,4818,2597,2221
202007,47280,경상북도,문경시,50-54세,5584,2919,2665
202008,47280,경상북도,문경시,50-54세,5556,2911,2645
202009,47280,경상북도,문경시,50-54세,5567,2918,2649
202010,47280,경상북도,문경시,50-54세,5569,2927,2642
202011,47280,경상북도,문경시,50-54세,5548,2927,2621
202012,47280,경상북도,문경시,50-54세,5546,2939,2607
202101,47280,경상북도,문경시,50-54세,5553,2946,2607
202102,47280,경상북도,문경시,50-54세,5562,2947,2615
202103,47280,경상북도,문경시,50-54세,5611,2984,2627
202104,47280,경상북도,문경시,50-54세,5598,2976,2622
202105,47280,경상북도,문경시,50-54세,5618,2994,2624
202106,47280,경상북도,문경시,50-54세,5602,2983,2619
202007,47280,경상북도,문경시,55-59세,6530,3325,3205
202008,47280,경상북도,문경시,55-59세,6501,3306,3195
202009,47280,경상북도,문경시,55-59세,6483,3305,3178
202010,47280,경상북도,문경시,55-59세,6467,3288,3179
202011,47280,경상북도,문경시,55-59세,6458,3272,3186
202012,47280,경상북도,문경시,55-59세,6491,3273,3218
202101,47280,경상북도,문경시,55-59세,6387,3226,3161
202102,47280,경상북도,문경시,55-59세,6372,3224,3148
202103,47280,경상북도,문경시,55-59세,6421,3250,3171
202104,47280,경상북도,문경시,55-59세,6388,3243,3145
202105,47280,경상북도,문경시,55-59세,6325,3214,3111
202106,47280,경상북도,문경시,55-59세,6271,3189,3082
202007,47280,경상북도,문경시,60-64세,7309,3599,3710
202008,47280,경상북도,문경시,60-64세,7339,3616,3723
202009,47280,경상북도,문경시,60-64세,7332,3598,3734
202010,47280,경상북도,문경시,60-64세,7368,3623,3745
202011,47280,경상북도,문경시,60-64세,7395,3641,3754
202012,47280,경상북도,문경시,60-64세,7397,3647,3750
202101,47280,경상북도,문경시,60-64세,7407,3660,3747
202102,47280,경상북도,문경시,60-64세,7467,3674,3793
202103,47280,경상북도,문경시,60-64세,7508,3693,3815
202104,47280,경상북도,문경시,60-64세,7518,3711,3807
202105,47280,경상북도,문경시,60-64세,7517,3710,3807
202106,47280,경상북도,문경시,60-64세,7567,3744,3823
202007,47280,경상북도,문경시,65-69세,5775,2694,3081
202008,47280,경상북도,문경시,65-69세,5821,2721,3100
202009,47280,경상북도,문경시,65-69세,5882,2759,3123
202010,47280,경상북도,문경시,65-69세,5915,2785,3130
202011,47280,경상북도,문경시,65-69세,5923,2796,3127
202012,47280,경상북도,문경시,65-69세,5981,2820,3161
202101,47280,경상북도,문경시,65-69세,6002,2840,3162
202102,47280,경상북도,문경시,65-69세,6054,2875,3179
202103,47280,경상북도,문경시,65-69세,6202,2954,3248
202104,47280,경상북도,문경시,65-69세,6238,2975,3263
202105,47280,경상북도,문경시,65-69세,6282,3006,3276
202106,47280,경상북도,문경시,65-69세,6313,3033,3280
202007,47280,경상북도,문경시,70-74세,4737,2190,2547
202008,47280,경상북도,문경시,70-74세,4758,2199,2559
202009,47280,경상북도,문경시,70-74세,4782,2215,2567
202010,47280,경상북도,문경시,70-74세,4820,2222,2598
202011,47280,경상북도,문경시,70-74세,4861,2239,2622
202012,47280,경상북도,문경시,70-74세,4888,2252,2636
202101,47280,경상북도,문경시,70-74세,4918,2263,2655
202102,47280,경상북도,문경시,70-74세,4941,2274,2667
202103,47280,경상북도,문경시,70-74세,4955,2282,2673
202104,47280,경상북도,문경시,70-74세,4969,2288,2681
202105,47280,경상북도,문경시,70-74세,5000,2297,2703
202106,47280,경상북도,문경시,70-74세,4984,2292,2692
202007,47280,경상북도,문경시,75-79세,4591,1840,2751
202008,47280,경상북도,문경시,75-79세,4556,1825,2731
202009,47280,경상북도,문경시,75-79세,4530,1816,2714
202010,47280,경상북도,문경시,75-79세,4492,1801,2691
202011,47280,경상북도,문경시,75-79세,4428,1771,2657
202012,47280,경상북도,문경시,75-79세,4380,1752,2628
202101,47280,경상북도,문경시,75-79세,4324,1730,2594
202102,47280,경상북도,문경시,75-79세,4265,1707,2558
202103,47280,경상북도,문경시,75-79세,4240,1691,2549
202104,47280,경상북도,문경시,75-79세,4200,1684,2516
202105,47280,경상북도,문경시,75-79세,4164,1676,2488
202106,47280,경상북도,문경시,75-79세,4152,1671,2481
202007,47280,경상북도,문경시,80-84세,3590,1217,2373
202008,47280,경상북도,문경시,80-84세,3600,1224,2376
202009,47280,경상북도,문경시,80-84세,3603,1229,2374
202010,47280,경상북도,문경시,80-84세,3625,1241,2384
202011,47280,경상북도,문경시,80-84세,3647,1249,2398
202012,47280,경상북도,문경시,80-84세,3663,1262,2401
202101,47280,경상북도,문경시,80-84세,3659,1272,2387
202102,47280,경상북도,문경시,80-84세,3685,1284,2401
202103,47280,경상북도,문경시,80-84세,3694,1302,2392
202104,47280,경상북도,문경시,80-84세,3687,1297,2390
202105,47280,경상북도,문경시,80-84세,3709,1309,2400
202106,47280,경상북도,문경시,80-84세,3730,1315,2415
202007,47280,경상북도,문경시,85-89세,1764,471,1293
202008,47280,경상북도,문경시,85-89세,1762,467,1295
202009,47280,경상북도,문경시,85-89세,1770,467,1303
202010,47280,경상북도,문경시,85-89세,1779,471,1308
202011,47280,경상북도,문경시,85-89세,1793,477,1316
202012,47280,경상북도,문경시,85-89세,1817,485,1332
202101,47280,경상북도,문경시,85-89세,1860,499,1361
202102,47280,경상북도,문경시,85-89세,1899,510,1389
202103,47280,경상북도,문경시,85-89세,1945,516,1429
202104,47280,경상북도,문경시,85-89세,1994,534,1460
202105,47280,경상북도,문경시,85-89세,1994,530,1464
202106,47280,경상북도,문경시,85-89세,1997,534,1463
202007,47280,경상북도,문경시,90-94세,616,127,489
202008,47280,경상북도,문경시,90-94세,629,128,501
202009,47280,경상북도,문경시,90-94세,636,131,505
202010,47280,경상북도,문경시,90-94세,649,136,513
202011,47280,경상북도,문경시,90-94세,648,135,513
202012,47280,경상북도,문경시,90-94세,655,136,519
202101,47280,경상북도,문경시,90-94세,658,139,519
202102,47280,경상북도,문경시,90-94세,658,141,517
202103,47280,경상북도,문경시,90-94세,665,142,523
202104,47280,경상북도,문경시,90-94세,661,141,520
202105,47280,경상북도,문경시,90-94세,673,145,528
202106,47280,경상북도,문경시,90-94세,664,142,522
202007,47280,경상북도,문경시,95-99세,162,25,137
202008,47280,경상북도,문경시,95-99세,164,27,137
202009,47280,경상북도,문경시,95-99세,169,28,141
202010,47280,경상북도,문경시,95-99세,162,28,134
202011,47280,경상북도,문경시,95-99세,162,27,135
202012,47280,경상북도,문경시,95-99세,159,26,133
202101,47280,경상북도,문경시,95-99세,163,25,138
202102,47280,경상북도,문경시,95-99세,166,27,139
202103,47280,경상북도,문경시,95-99세,166,26,140
202104,47280,경상북도,문경시,95-99세,168,27,141
202105,47280,경상북도,문경시,95-99세,169,26,143
202106,47280,경상북도,문경시,95-99세,163,23,140
202007,47280,경상북도,문경시,100+,56,15,41
202008,47280,경상북도,문경시,100+,55,15,40
202009,47280,경상북도,문경시,100+,55,15,40
202010,47280,경상북도,문경시,100+,56,15,41
202011,47280,경상북도,문경시,100+,58,15,43
202012,47280,경상북도,문경시,100+,57,14,43
202101,47280,경상북도,문경시,100+,58,15,43
202102,47280,경상북도,문경시,100+,60,15,45
202103,47280,경상북도,문경시,100+,61,15,46
202104,47280,경상북도,문경시,100+,60,15,45
202105,47280,경상북도,문경시,100+,61,16,45
202106,47280,경상북도,문경시,100+,38,9,29
202007,47290,경상북도,경산시,0-4세,9155,4704,4451
202008,47290,경상북도,경산시,0-4세,9070,4633,4437
202009,47290,경상북도,경산시,0-4세,8965,4587,4378
202010,47290,경상북도,경산시,0-4세,8864,4528,4336
202011,47290,경상북도,경산시,0-4세,8781,4491,4290
202012,47290,경상북도,경산시,0-4세,8755,4472,4283
202101,47290,경상북도,경산시,0-4세,8676,4436,4240
202102,47290,경상북도,경산시,0-4세,8581,4377,4204
202103,47290,경상북도,경산시,0-4세,8489,4336,4153
202104,47290,경상북도,경산시,0-4세,8434,4319,4115
202105,47290,경상북도,경산시,0-4세,8410,4292,4118
202106,47290,경상북도,경산시,0-4세,8322,4244,4078
202007,47290,경상북도,경산시,5-9세,11830,6029,5801
202008,47290,경상북도,경산시,5-9세,11811,6020,5791
202009,47290,경상북도,경산시,5-9세,11786,6008,5778
202010,47290,경상북도,경산시,5-9세,11765,6016,5749
202011,47290,경상북도,경산시,5-9세,11765,6011,5754
202012,47290,경상북도,경산시,5-9세,11721,5969,5752
202101,47290,경상북도,경산시,5-9세,11634,5918,5716
202102,47290,경상북도,경산시,5-9세,11618,5935,5683
202103,47290,경상북도,경산시,5-9세,11623,5922,5701
202104,47290,경상북도,경산시,5-9세,11635,5910,5725
202105,47290,경상북도,경산시,5-9세,11625,5907,5718
202106,47290,경상북도,경산시,5-9세,11659,5931,5728
202007,47290,경상북도,경산시,10-14세,10733,5509,5224
202008,47290,경상북도,경산시,10-14세,10763,5536,5227
202009,47290,경상북도,경산시,10-14세,10784,5531,5253
202010,47290,경상북도,경산시,10-14세,10872,5574,5298
202011,47290,경상북도,경산시,10-14세,10908,5589,5319
202012,47290,경상북도,경산시,10-14세,10964,5638,5326
202101,47290,경상북도,경산시,10-14세,11001,5653,5348
202102,47290,경상북도,경산시,10-14세,11031,5662,5369
202103,47290,경상북도,경산시,10-14세,11058,5684,5374
202104,47290,경상북도,경산시,10-14세,11117,5720,5397
202105,47290,경상북도,경산시,10-14세,11184,5747,5437
202106,47290,경상북도,경산시,10-14세,11256,5796,5460
202007,47290,경상북도,경산시,15-19세,12126,6374,5752
202008,47290,경상북도,경산시,15-19세,12043,6313,5730
202009,47290,경상북도,경산시,15-19세,11958,6266,5692
202010,47290,경상북도,경산시,15-19세,11844,6206,5638
202011,47290,경상북도,경산시,15-19세,11757,6168,5589
202012,47290,경상북도,경산시,15-19세,11736,6140,5596
202101,47290,경상북도,경산시,15-19세,11725,6142,5583
202102,47290,경상북도,경산시,15-19세,11712,6122,5590
202103,47290,경상북도,경산시,15-19세,11615,6062,5553
202104,47290,경상북도,경산시,15-19세,11588,6029,5559
202105,47290,경상북도,경산시,15-19세,11625,6041,5584
202106,47290,경상북도,경산시,15-19세,11652,6052,5600
202007,47290,경상북도,경산시,20-24세,18219,9664,8555
202008,47290,경상북도,경산시,20-24세,18127,9645,8482
202009,47290,경상북도,경산시,20-24세,18084,9613,8471
202010,47290,경상북도,경산시,20-24세,18136,9631,8505
202011,47290,경상북도,경산시,20-24세,18146,9641,8505
202012,47290,경상북도,경산시,20-24세,18212,9706,8506
202101,47290,경상북도,경산시,20-24세,18181,9654,8527
202102,47290,경상북도,경산시,20-24세,18204,9651,8553
202103,47290,경상북도,경산시,20-24세,18198,9664,8534
202104,47290,경상북도,경산시,20-24세,18232,9693,8539
202105,47290,경상북도,경산시,20-24세,18229,9677,8552
202106,47290,경상북도,경산시,20-24세,18242,9665,8577
202007,47290,경상북도,경산시,25-29세,17607,10018,7589
202008,47290,경상북도,경산시,25-29세,17616,10004,7612
202009,47290,경상북도,경산시,25-29세,17685,10042,7643
202010,47290,경상북도,경산시,25-29세,17708,10047,7661
202011,47290,경상북도,경산시,25-29세,17843,10117,7726
202012,47290,경상북도,경산시,25-29세,18017,10208,7809
202101,47290,경상북도,경산시,25-29세,18018,10208,7810
202102,47290,경상북도,경산시,25-29세,17984,10173,7811
202103,47290,경상북도,경산시,25-29세,17967,10175,7792
202104,47290,경상북도,경산시,25-29세,17974,10184,7790
202105,47290,경상북도,경산시,25-29세,18128,10228,7900
202106,47290,경상북도,경산시,25-29세,18176,10252,7924
202007,47290,경상북도,경산시,30-34세,15103,8337,6766
202008,47290,경상북도,경산시,30-34세,15083,8326,6757
202009,47290,경상북도,경산시,30-34세,15015,8295,6720
202010,47290,경상북도,경산시,30-34세,15048,8316,6732
202011,47290,경상북도,경산시,30-34세,15036,8293,6743
202012,47290,경상북도,경산시,30-34세,15094,8313,6781
202101,47290,경상북도,경산시,30-34세,15127,8341,6786
202102,47290,경상북도,경산시,30-34세,15127,8346,6781
202103,47290,경상북도,경산시,30-34세,15125,8332,6793
202104,47290,경상북도,경산시,30-34세,15222,8397,6825
202105,47290,경상북도,경산시,30-34세,15373,8471,6902
202106,47290,경상북도,경산시,30-34세,15465,8527,6938
202007,47290,경상북도,경산시,35-39세,18414,9621,8793
202008,47290,경상북도,경산시,35-39세,18310,9559,8751
202009,47290,경상북도,경산시,35-39세,18196,9505,8691
202010,47290,경상북도,경산시,35-39세,18107,9464,8643
202011,47290,경상북도,경산시,35-39세,18112,9473,8639
202012,47290,경상북도,경산시,35-39세,18098,9486,8612
202101,47290,경상북도,경산시,35-39세,18019,9454,8565
202102,47290,경상북도,경산시,35-39세,17857,9375,8482
202103,47290,경상북도,경산시,35-39세,17755,9327,8428
202104,47290,경상북도,경산시,35-39세,17679,9300,8379
202105,47290,경상북도,경산시,35-39세,17645,9307,8338
202106,47290,경상북도,경산시,35-39세,17615,9293,8322
202007,47290,경상북도,경산시,40-44세,19167,9928,9239
202008,47290,경상북도,경산시,40-44세,19164,9914,9250
202009,47290,경상북도,경산시,40-44세,19192,9910,9282
202010,47290,경상북도,경산시,40-44세,19221,9935,9286
202011,47290,경상북도,경산시,40-44세,19237,9950,9287
202012,47290,경상북도,경산시,40-44세,19232,9962,9270
202101,47290,경상북도,경산시,40-44세,19233,9962,9271
202102,47290,경상북도,경산시,40-44세,19272,9964,9308
202103,47290,경상북도,경산시,40-44세,19195,9937,9258
202104,47290,경상북도,경산시,40-44세,19292,10001,9291
202105,47290,경상북도,경산시,40-44세,19445,10080,9365
202106,47290,경상북도,경산시,40-44세,19577,10137,9440
202007,47290,경상북도,경산시,45-49세,22425,11360,11065
202008,47290,경상북도,경산시,45-49세,22375,11344,11031
202009,47290,경상북도,경산시,45-49세,22366,11354,11012
202010,47290,경상북도,경산시,45-49세,22328,11322,11006
202011,47290,경상북도,경산시,45-49세,22299,11318,10981
202012,47290,경상북도,경산시,45-49세,22336,11353,10983
202101,47290,경상북도,경산시,45-49세,22284,11309,10975
202102,47290,경상북도,경산시,45-49세,22259,11315,10944
202103,47290,경상북도,경산시,45-49세,22164,11250,10914
202104,47290,경상북도,경산시,45-49세,22222,11257,10965
202105,47290,경상북도,경산시,45-49세,22094,11205,10889
202106,47290,경상북도,경산시,45-49세,22019,11189,10830
202007,47290,경상북도,경산시,50-54세,22746,11501,11245
202008,47290,경상북도,경산시,50-54세,22745,11492,11253
202009,47290,경상북도,경산시,50-54세,22758,11497,11261
202010,47290,경상북도,경산시,50-54세,22822,11533,11289
202011,47290,경상북도,경산시,50-54세,22892,11538,11354
202012,47290,경상북도,경산시,50-54세,22931,11536,11395
202101,47290,경상북도,경산시,50-54세,23147,11642,11505
202102,47290,경상북도,경산시,50-54세,23172,11647,11525
202103,47290,경상북도,경산시,50-54세,23094,11626,11468
202104,47290,경상북도,경산시,50-54세,23166,11642,11524
202105,47290,경상북도,경산시,50-54세,23429,11747,11682
202106,47290,경상북도,경산시,50-54세,23607,11807,11800
202007,47290,경상북도,경산시,55-59세,21892,10936,10956
202008,47290,경상북도,경산시,55-59세,21860,10940,10920
202009,47290,경상북도,경산시,55-59세,21859,10952,10907
202010,47290,경상북도,경산시,55-59세,21842,10925,10917
202011,47290,경상북도,경산시,55-59세,21867,10934,10933
202012,47290,경상북도,경산시,55-59세,21922,10954,10968
202101,47290,경상북도,경산시,55-59세,21891,10924,10967
202102,47290,경상북도,경산시,55-59세,21852,10944,10908
202103,47290,경상북도,경산시,55-59세,21833,10922,10911
202104,47290,경상북도,경산시,55-59세,21857,10979,10878
202105,47290,경상북도,경산시,55-59세,21875,10975,10900
202106,47290,경상북도,경산시,55-59세,21833,10977,10856
202007,47290,경상북도,경산시,60-64세,19548,9699,9849
202008,47290,경상북도,경산시,60-64세,19620,9747,9873
202009,47290,경상북도,경산시,60-64세,19725,9816,9909
202010,47290,경상북도,경산시,60-64세,19849,9887,9962
202011,47290,경상북도,경산시,60-64세,20006,9973,10033
202012,47290,경상북도,경산시,60-64세,20131,10027,10104
202101,47290,경상북도,경산시,60-64세,20314,10162,10152
202102,47290,경상북도,경산시,60-64세,20480,10243,10237
202103,47290,경상북도,경산시,60-64세,20597,10293,10304
202104,47290,경상북도,경산시,60-64세,20714,10340,10374
202105,47290,경상북도,경산시,60-64세,20947,10472,10475
202106,47290,경상북도,경산시,60-64세,21188,10570,10618
202007,47290,경상북도,경산시,65-69세,14270,6794,7476
202008,47290,경상북도,경산시,65-69세,14334,6822,7512
202009,47290,경상북도,경산시,65-69세,14418,6858,7560
202010,47290,경상북도,경산시,65-69세,14565,6916,7649
202011,47290,경상북도,경산시,65-69세,14633,6949,7684
202012,47290,경상북도,경산시,65-69세,14770,7018,7752
202101,47290,경상북도,경산시,65-69세,14884,7064,7820
202102,47290,경상북도,경산시,65-69세,14971,7082,7889
202103,47290,경상북도,경산시,65-69세,15084,7160,7924
202104,47290,경상북도,경산시,65-69세,15244,7249,7995
202105,47290,경상북도,경산시,65-69세,15358,7304,8054
202106,47290,경상북도,경산시,65-69세,15466,7364,8102
202007,47290,경상북도,경산시,70-74세,10527,4833,5694
202008,47290,경상북도,경산시,70-74세,10596,4856,5740
202009,47290,경상북도,경산시,70-74세,10701,4915,5786
202010,47290,경상북도,경산시,70-74세,10785,4965,5820
202011,47290,경상북도,경산시,70-74세,10882,5018,5864
202012,47290,경상북도,경산시,70-74세,10956,5052,5904
202101,47290,경상북도,경산시,70-74세,11119,5137,5982
202102,47290,경상북도,경산시,70-74세,11227,5193,6034
202103,47290,경상북도,경산시,70-74세,11288,5217,6071
202104,47290,경상북도,경산시,70-74세,11377,5250,6127
202105,47290,경상북도,경산시,70-74세,11469,5279,6190
202106,47290,경상북도,경산시,70-74세,11548,5315,6233
202007,47290,경상북도,경산시,75-79세,8625,3571,5054
202008,47290,경상북도,경산시,75-79세,8581,3566,5015
202009,47290,경상북도,경산시,75-79세,8551,3559,4992
202010,47290,경상북도,경산시,75-79세,8501,3551,4950
202011,47290,경상북도,경산시,75-79세,8484,3554,4930
202012,47290,경상북도,경산시,75-79세,8439,3547,4892
202101,47290,경상북도,경산시,75-79세,8401,3534,4867
202102,47290,경상북도,경산시,75-79세,8355,3542,4813
202103,47290,경상북도,경산시,75-79세,8349,3549,4800
202104,47290,경상북도,경산시,75-79세,8291,3530,4761
202105,47290,경상북도,경산시,75-79세,8269,3530,4739
202106,47290,경상북도,경산시,75-79세,8274,3544,4730
202007,47290,경상북도,경산시,80-84세,6081,2189,3892
202008,47290,경상북도,경산시,80-84세,6082,2178,3904
202009,47290,경상북도,경산시,80-84세,6109,2200,3909
202010,47290,경상북도,경산시,80-84세,6128,2196,3932
202011,47290,경상북도,경산시,80-84세,6139,2197,3942
202012,47290,경상북도,경산시,80-84세,6173,2208,3965
202101,47290,경상북도,경산시,80-84세,6180,2212,3968
202102,47290,경상북도,경산시,80-84세,6189,2210,3979
202103,47290,경상북도,경산시,80-84세,6184,2217,3967
202104,47290,경상북도,경산시,80-84세,6195,2228,3967
202105,47290,경상북도,경산시,80-84세,6251,2256,3995
202106,47290,경상북도,경산시,80-84세,6302,2280,4022
202007,47290,경상북도,경산시,85-89세,2974,914,2060
202008,47290,경상북도,경산시,85-89세,3012,935,2077
202009,47290,경상북도,경산시,85-89세,3034,936,2098
202010,47290,경상북도,경산시,85-89세,3039,939,2100
202011,47290,경상북도,경산시,85-89세,3051,946,2105
202012,47290,경상북도,경산시,85-89세,3081,960,2121
202101,47290,경상북도,경산시,85-89세,3142,976,2166
202102,47290,경상북도,경산시,85-89세,3184,990,2194
202103,47290,경상북도,경산시,85-89세,3230,1001,2229
202104,47290,경상북도,경산시,85-89세,3287,1017,2270
202105,47290,경상북도,경산시,85-89세,3328,1027,2301
202106,47290,경상북도,경산시,85-89세,3340,1033,2307
202007,47290,경상북도,경산시,90-94세,872,199,673
202008,47290,경상북도,경산시,90-94세,882,204,678
202009,47290,경상북도,경산시,90-94세,899,204,695
202010,47290,경상북도,경산시,90-94세,912,212,700
202011,47290,경상북도,경산시,90-94세,925,215,710
202012,47290,경상북도,경산시,90-94세,934,223,711
202101,47290,경상북도,경산시,90-94세,941,223,718
202102,47290,경상북도,경산시,90-94세,971,225,746
202103,47290,경상북도,경산시,90-94세,976,222,754
202104,47290,경상북도,경산시,90-94세,995,228,767
202105,47290,경상북도,경산시,90-94세,1004,232,772
202106,47290,경상북도,경산시,90-94세,1000,231,769
202007,47290,경상북도,경산시,95-99세,154,26,128
202008,47290,경상북도,경산시,95-99세,158,26,132
202009,47290,경상북도,경산시,95-99세,158,25,133
202010,47290,경상북도,경산시,95-99세,163,25,138
202011,47290,경상북도,경산시,95-99세,159,24,135
202012,47290,경상북도,경산시,95-99세,161,22,139
202101,47290,경상북도,경산시,95-99세,167,24,143
202102,47290,경상북도,경산시,95-99세,166,23,143
202103,47290,경상북도,경산시,95-99세,167,22,145
202104,47290,경상북도,경산시,95-99세,169,24,145
202105,47290,경상북도,경산시,95-99세,168,24,144
202106,47290,경상북도,경산시,95-99세,174,25,149
202007,47290,경상북도,경산시,100+,69,12,57
202008,47290,경상북도,경산시,100+,68,12,56
202009,47290,경상북도,경산시,100+,68,12,56
202010,47290,경상북도,경산시,100+,67,12,55
202011,47290,경상북도,경산시,100+,66,11,55
202012,47290,경상북도,경산시,100+,65,11,54
202101,47290,경상북도,경산시,100+,66,11,55
202102,47290,경상북도,경산시,100+,67,12,55
202103,47290,경상북도,경산시,100+,32,6,26
202104,47290,경상북도,경산시,100+,32,6,26
202105,47290,경상북도,경산시,100+,32,6,26
202106,47290,경상북도,경산시,100+,32,6,26
202007,47720,경상북도,군위군,0-4세,316,172,144
202008,47720,경상북도,군위군,0-4세,315,172,143
202009,47720,경상북도,군위군,0-4세,308,165,143
202010,47720,경상북도,군위군,0-4세,308,168,140
202011,47720,경상북도,군위군,0-4세,304,166,138
202012,47720,경상북도,군위군,0-4세,303,167,136
202101,47720,경상북도,군위군,0-4세,294,155,139
202102,47720,경상북도,군위군,0-4세,294,156,138
202103,47720,경상북도,군위군,0-4세,292,158,134
202104,47720,경상북도,군위군,0-4세,284,153,131
202105,47720,경상북도,군위군,0-4세,278,150,128
202106,47720,경상북도,군위군,0-4세,285,153,132
202007,47720,경상북도,군위군,5-9세,398,211,187
202008,47720,경상북도,군위군,5-9세,397,209,188
202009,47720,경상북도,군위군,5-9세,391,206,185
202010,47720,경상북도,군위군,5-9세,388,204,184
202011,47720,경상북도,군위군,5-9세,382,205,177
202012,47720,경상북도,군위군,5-9세,378,203,175
202101,47720,경상북도,군위군,5-9세,381,207,174
202102,47720,경상북도,군위군,5-9세,374,204,170
202103,47720,경상북도,군위군,5-9세,364,196,168
202104,47720,경상북도,군위군,5-9세,366,196,170
202105,47720,경상북도,군위군,5-9세,361,192,169
202106,47720,경상북도,군위군,5-9세,357,188,169
202007,47720,경상북도,군위군,10-14세,468,265,203
202008,47720,경상북도,군위군,10-14세,472,267,205
202009,47720,경상북도,군위군,10-14세,473,266,207
202010,47720,경상북도,군위군,10-14세,466,260,206
202011,47720,경상북도,군위군,10-14세,467,260,207
202012,47720,경상북도,군위군,10-14세,459,256,203
202101,47720,경상북도,군위군,10-14세,454,252,202
202102,47720,경상북도,군위군,10-14세,446,245,201
202103,47720,경상북도,군위군,10-14세,450,248,202
202104,47720,경상북도,군위군,10-14세,441,243,198
202105,47720,경상북도,군위군,10-14세,442,242,200
202106,47720,경상북도,군위군,10-14세,441,243,198
202007,47720,경상북도,군위군,15-19세,523,277,246
202008,47720,경상북도,군위군,15-19세,521,277,244
202009,47720,경상북도,군위군,15-19세,520,278,242
202010,47720,경상북도,군위군,15-19세,521,277,244
202011,47720,경상북도,군위군,15-19세,511,275,236
202012,47720,경상북도,군위군,15-19세,502,267,235
202101,47720,경상북도,군위군,15-19세,501,269,232
202102,47720,경상북도,군위군,15-19세,501,270,231
202103,47720,경상북도,군위군,15-19세,496,270,226
202104,47720,경상북도,군위군,15-19세,495,272,223
202105,47720,경상북도,군위군,15-19세,485,265,220
202106,47720,경상북도,군위군,15-19세,480,264,216
202007,47720,경상북도,군위군,20-24세,825,474,351
202008,47720,경상북도,군위군,20-24세,811,462,349
202009,47720,경상북도,군위군,20-24세,800,458,342
202010,47720,경상북도,군위군,20-24세,799,460,339
202011,47720,경상북도,군위군,20-24세,796,461,335
202012,47720,경상북도,군위군,20-24세,794,463,331
202101,47720,경상북도,군위군,20-24세,774,455,319
202102,47720,경상북도,군위군,20-24세,748,444,304
202103,47720,경상북도,군위군,20-24세,737,441,296
202104,47720,경상북도,군위군,20-24세,733,433,300
202105,47720,경상북도,군위군,20-24세,732,430,302
202106,47720,경상북도,군위군,20-24세,728,422,306
202007,47720,경상북도,군위군,25-29세,721,458,263
202008,47720,경상북도,군위군,25-29세,724,458,266
202009,47720,경상북도,군위군,25-29세,721,460,261
202010,47720,경상북도,군위군,25-29세,725,463,262
202011,47720,경상북도,군위군,25-29세,719,457,262
202012,47720,경상북도,군위군,25-29세,728,464,264
202101,47720,경상북도,군위군,25-29세,728,459,269
202102,47720,경상북도,군위군,25-29세,727,461,266
202103,47720,경상북도,군위군,25-29세,725,458,267
202104,47720,경상북도,군위군,25-29세,716,451,265
202105,47720,경상북도,군위군,25-29세,707,448,259
202106,47720,경상북도,군위군,25-29세,707,446,261
202007,47720,경상북도,군위군,30-34세,666,399,267
202008,47720,경상북도,군위군,30-34세,668,399,269
202009,47720,경상북도,군위군,30-34세,654,384,270
202010,47720,경상북도,군위군,30-34세,653,395,258
202011,47720,경상북도,군위군,30-34세,644,394,250
202012,47720,경상북도,군위군,30-34세,630,385,245
202101,47720,경상북도,군위군,30-34세,622,382,240
202102,47720,경상북도,군위군,30-34세,615,376,239
202103,47720,경상북도,군위군,30-34세,598,366,232
202104,47720,경상북도,군위군,30-34세,587,360,227
202105,47720,경상북도,군위군,30-34세,584,363,221
202106,47720,경상북도,군위군,30-34세,583,366,217
202007,47720,경상북도,군위군,35-39세,723,388,335
202008,47720,경상북도,군위군,35-39세,715,386,329
202009,47720,경상북도,군위군,35-39세,705,380,325
202010,47720,경상북도,군위군,35-39세,694,375,319
202011,47720,경상북도,군위군,35-39세,687,368,319
202012,47720,경상북도,군위군,35-39세,679,364,315
202101,47720,경상북도,군위군,35-39세,682,368,314
202102,47720,경상북도,군위군,35-39세,673,359,314
202103,47720,경상북도,군위군,35-39세,670,357,313
202104,47720,경상북도,군위군,35-39세,675,357,318
202105,47720,경상북도,군위군,35-39세,665,354,311
202106,47720,경상북도,군위군,35-39세,662,357,305
202007,47720,경상북도,군위군,40-44세,926,543,383
202008,47720,경상북도,군위군,40-44세,922,542,380
202009,47720,경상북도,군위군,40-44세,921,544,377
202010,47720,경상북도,군위군,40-44세,917,542,375
202011,47720,경상북도,군위군,40-44세,910,538,372
202012,47720,경상북도,군위군,40-44세,900,533,367
202101,47720,경상북도,군위군,40-44세,893,527,366
202102,47720,경상북도,군위군,40-44세,893,530,363
202103,47720,경상북도,군위군,40-44세,891,524,367
202104,47720,경상북도,군위군,40-44세,878,519,359
202105,47720,경상북도,군위군,40-44세,861,502,359
202106,47720,경상북도,군위군,40-44세,859,498,361
202007,47720,경상북도,군위군,45-49세,1290,762,528
202008,47720,경상북도,군위군,45-49세,1284,758,526
202009,47720,경상북도,군위군,45-49세,1272,750,522
202010,47720,경상북도,군위군,45-49세,1262,745,517
202011,47720,경상북도,군위군,45-49세,1263,741,522
202012,47720,경상북도,군위군,45-49세,1259,740,519
202101,47720,경상북도,군위군,45-49세,1245,732,513
202102,47720,경상북도,군위군,45-49세,1222,722,500
202103,47720,경상북도,군위군,45-49세,1213,710,503
202104,47720,경상북도,군위군,45-49세,1215,710,505
202105,47720,경상북도,군위군,45-49세,1215,717,498
202106,47720,경상북도,군위군,45-49세,1197,702,495
202007,47720,경상북도,군위군,50-54세,1832,1054,778
202008,47720,경상북도,군위군,50-54세,1835,1060,775
202009,47720,경상북도,군위군,50-54세,1823,1051,772
202010,47720,경상북도,군위군,50-54세,1802,1039,763
202011,47720,경상북도,군위군,50-54세,1791,1042,749
202012,47720,경상북도,군위군,50-54세,1777,1026,751
202101,47720,경상북도,군위군,50-54세,1775,1021,754
202102,47720,경상북도,군위군,50-54세,1771,1024,747
202103,47720,경상북도,군위군,50-54세,1758,1019,739
202104,47720,경상북도,군위군,50-54세,1747,1007,740
202105,47720,경상북도,군위군,50-54세,1726,999,727
202106,47720,경상북도,군위군,50-54세,1731,1006,725
202007,47720,경상북도,군위군,55-59세,2523,1398,1125
202008,47720,경상북도,군위군,55-59세,2516,1394,1122
202009,47720,경상북도,군위군,55-59세,2510,1386,1124
202010,47720,경상북도,군위군,55-59세,2538,1406,1132
202011,47720,경상북도,군위군,55-59세,2534,1413,1121
202012,47720,경상북도,군위군,55-59세,2535,1406,1129
202101,47720,경상북도,군위군,55-59세,2505,1388,1117
202102,47720,경상북도,군위군,55-59세,2487,1370,1117
202103,47720,경상북도,군위군,55-59세,2476,1373,1103
202104,47720,경상북도,군위군,55-59세,2462,1368,1094
202105,47720,경상북도,군위군,55-59세,2417,1341,1076
202106,47720,경상북도,군위군,55-59세,2387,1335,1052
202007,47720,경상북도,군위군,60-64세,2863,1538,1325
202008,47720,경상북도,군위군,60-64세,2854,1529,1325
202009,47720,경상북도,군위군,60-64세,2865,1540,1325
202010,47720,경상북도,군위군,60-64세,2864,1535,1329
202011,47720,경상북도,군위군,60-64세,2860,1533,1327
202012,47720,경상북도,군위군,60-64세,2851,1543,1308
202101,47720,경상북도,군위군,60-64세,2872,1542,1330
202102,47720,경상북도,군위군,60-64세,2895,1557,1338
202103,47720,경상북도,군위군,60-64세,2917,1579,1338
202104,47720,경상북도,군위군,60-64세,2925,1580,1345
202105,47720,경상북도,군위군,60-64세,2929,1591,1338
202106,47720,경상북도,군위군,60-64세,2949,1590,1359
202007,47720,경상북도,군위군,65-69세,2377,1206,1171
202008,47720,경상북도,군위군,65-69세,2400,1220,1180
202009,47720,경상북도,군위군,65-69세,2413,1235,1178
202010,47720,경상북도,군위군,65-69세,2450,1257,1193
202011,47720,경상북도,군위군,65-69세,2460,1256,1204
202012,47720,경상북도,군위군,65-69세,2485,1268,1217
202101,47720,경상북도,군위군,65-69세,2501,1279,1222
202102,47720,경상북도,군위군,65-69세,2515,1290,1225
202103,47720,경상북도,군위군,65-69세,2526,1292,1234
202104,47720,경상북도,군위군,65-69세,2565,1322,1243
202105,47720,경상북도,군위군,65-69세,2554,1317,1237
202106,47720,경상북도,군위군,65-69세,2559,1325,1234
202007,47720,경상북도,군위군,70-74세,2009,1003,1006
202008,47720,경상북도,군위군,70-74세,2019,1013,1006
202009,47720,경상북도,군위군,70-74세,2019,1009,1010
202010,47720,경상북도,군위군,70-74세,2021,1008,1013
202011,47720,경상북도,군위군,70-74세,2044,1021,1023
202012,47720,경상북도,군위군,70-74세,2064,1032,1032
202101,47720,경상북도,군위군,70-74세,2084,1038,1046
202102,47720,경상북도,군위군,70-74세,2085,1035,1050
202103,47720,경상북도,군위군,70-74세,2106,1049,1057
202104,47720,경상북도,군위군,70-74세,2103,1045,1058
202105,47720,경상북도,군위군,70-74세,2127,1058,1069
202106,47720,경상북도,군위군,70-74세,2134,1066,1068
202007,47720,경상북도,군위군,75-79세,2055,858,1197
202008,47720,경상북도,군위군,75-79세,2045,852,1193
202009,47720,경상북도,군위군,75-79세,2027,849,1178
202010,47720,경상북도,군위군,75-79세,2009,839,1170
202011,47720,경상북도,군위군,75-79세,1987,832,1155
202012,47720,경상북도,군위군,75-79세,1954,822,1132
202101,47720,경상북도,군위군,75-79세,1931,815,1116
202102,47720,경상북도,군위군,75-79세,1900,814,1086
202103,47720,경상북도,군위군,75-79세,1887,807,1080
202104,47720,경상북도,군위군,75-79세,1876,805,1071
202105,47720,경상북도,군위군,75-79세,1859,795,1064
202106,47720,경상북도,군위군,75-79세,1856,794,1062
202007,47720,경상북도,군위군,80-84세,1686,603,1083
202008,47720,경상북도,군위군,80-84세,1663,596,1067
202009,47720,경상북도,군위군,80-84세,1661,592,1069
202010,47720,경상북도,군위군,80-84세,1666,597,1069
202011,47720,경상북도,군위군,80-84세,1670,598,1072
202012,47720,경상북도,군위군,80-84세,1680,600,1080
202101,47720,경상북도,군위군,80-84세,1682,607,1075
202102,47720,경상북도,군위군,80-84세,1683,607,1076
202103,47720,경상북도,군위군,80-84세,1678,605,1073
202104,47720,경상북도,군위군,80-84세,1675,603,1072
202105,47720,경상북도,군위군,80-84세,1680,606,1074
202106,47720,경상북도,군위군,80-84세,1679,607,1072
202007,47720,경상북도,군위군,85-89세,902,286,616
202008,47720,경상북도,군위군,85-89세,914,286,628
202009,47720,경상북도,군위군,85-89세,926,291,635
202010,47720,경상북도,군위군,85-89세,928,287,641
202011,47720,경상북도,군위군,85-89세,930,288,642
202012,47720,경상북도,군위군,85-89세,932,286,646
202101,47720,경상북도,군위군,85-89세,943,287,656
202102,47720,경상북도,군위군,85-89세,954,284,670
202103,47720,경상북도,군위군,85-89세,963,289,674
202104,47720,경상북도,군위군,85-89세,972,296,676
202105,47720,경상북도,군위군,85-89세,973,296,677
202106,47720,경상북도,군위군,85-89세,980,295,685
202007,47720,경상북도,군위군,90-94세,273,58,215
202008,47720,경상북도,군위군,90-94세,270,56,214
202009,47720,경상북도,군위군,90-94세,272,55,217
202010,47720,경상북도,군위군,90-94세,275,57,218
202011,47720,경상북도,군위군,90-94세,278,56,222
202012,47720,경상북도,군위군,90-94세,286,58,228
202101,47720,경상북도,군위군,90-94세,287,60,227
202102,47720,경상북도,군위군,90-94세,283,62,221
202103,47720,경상북도,군위군,90-94세,287,61,226
202104,47720,경상북도,군위군,90-94세,288,61,227
202105,47720,경상북도,군위군,90-94세,285,62,223
202106,47720,경상북도,군위군,90-94세,286,64,222
202007,47720,경상북도,군위군,95-99세,46,7,39
202008,47720,경상북도,군위군,95-99세,49,8,41
202009,47720,경상북도,군위군,95-99세,48,8,40
202010,47720,경상북도,군위군,95-99세,49,8,41
202011,47720,경상북도,군위군,95-99세,46,8,38
202012,47720,경상북도,군위군,95-99세,45,8,37
202101,47720,경상북도,군위군,95-99세,46,9,37
202102,47720,경상북도,군위군,95-99세,48,9,39
202103,47720,경상북도,군위군,95-99세,47,7,40
202104,47720,경상북도,군위군,95-99세,48,7,41
202105,47720,경상북도,군위군,95-99세,48,8,40
202106,47720,경상북도,군위군,95-99세,50,8,42
202007,47720,경상북도,군위군,100+,15,1,14
202008,47720,경상북도,군위군,100+,15,1,14
202009,47720,경상북도,군위군,100+,16,1,15
202010,47720,경상북도,군위군,100+,16,1,15
202011,47720,경상북도,군위군,100+,16,1,15
202012,47720,경상북도,군위군,100+,15,1,14
202101,47720,경상북도,군위군,100+,16,1,15
202102,47720,경상북도,군위군,100+,16,1,15
202103,47720,경상북도,군위군,100+,13,1,12
202104,47720,경상북도,군위군,100+,12,1,11
202105,47720,경상북도,군위군,100+,14,1,13
202106,47720,경상북도,군위군,100+,14,1,13
202007,47730,경상북도,의성군,0-4세,1069,575,494
202008,47730,경상북도,의성군,0-4세,1063,574,489
202009,47730,경상북도,의성군,0-4세,1044,565,479
202010,47730,경상북도,의성군,0-4세,1036,558,478
202011,47730,경상북도,의성군,0-4세,1026,552,474
202012,47730,경상북도,의성군,0-4세,1009,539,470
202101,47730,경상북도,의성군,0-4세,999,532,467
202102,47730,경상북도,의성군,0-4세,978,531,447
202103,47730,경상북도,의성군,0-4세,959,517,442
202104,47730,경상북도,의성군,0-4세,955,509,446
202105,47730,경상북도,의성군,0-4세,951,510,441
202106,47730,경상북도,의성군,0-4세,948,512,436
202007,47730,경상북도,의성군,5-9세,922,472,450
202008,47730,경상북도,의성군,5-9세,921,470,451
202009,47730,경상북도,의성군,5-9세,933,472,461
202010,47730,경상북도,의성군,5-9세,918,462,456
202011,47730,경상북도,의성군,5-9세,910,458,452
202012,47730,경상북도,의성군,5-9세,902,463,439
202101,47730,경상북도,의성군,5-9세,895,462,433
202102,47730,경상북도,의성군,5-9세,898,458,440
202103,47730,경상북도,의성군,5-9세,907,466,441
202104,47730,경상북도,의성군,5-9세,915,475,440
202105,47730,경상북도,의성군,5-9세,913,474,439
202106,47730,경상북도,의성군,5-9세,909,471,438
202007,47730,경상북도,의성군,10-14세,1065,564,501
202008,47730,경상북도,의성군,10-14세,1064,560,504
202009,47730,경상북도,의성군,10-14세,1050,552,498
202010,47730,경상북도,의성군,10-14세,1056,554,502
202011,47730,경상북도,의성군,10-14세,1059,554,505
202012,47730,경상북도,의성군,10-14세,1048,547,501
202101,47730,경상북도,의성군,10-14세,1058,546,512
202102,47730,경상북도,의성군,10-14세,1057,549,508
202103,47730,경상북도,의성군,10-14세,1054,543,511
202104,47730,경상북도,의성군,10-14세,1044,536,508
202105,47730,경상북도,의성군,10-14세,1041,534,507
202106,47730,경상북도,의성군,10-14세,1042,536,506
202007,47730,경상북도,의성군,15-19세,1294,676,618
202008,47730,경상북도,의성군,15-19세,1279,665,614
202009,47730,경상북도,의성군,15-19세,1276,665,611
202010,47730,경상북도,의성군,15-19세,1271,668,603
202011,47730,경상북도,의성군,15-19세,1258,662,596
202012,47730,경상북도,의성군,15-19세,1248,656,592
202101,47730,경상북도,의성군,15-19세,1234,646,588
202102,47730,경상북도,의성군,15-19세,1208,630,578
202103,47730,경상북도,의성군,15-19세,1190,619,571
202104,47730,경상북도,의성군,15-19세,1183,616,567
202105,47730,경상북도,의성군,15-19세,1184,618,566
202106,47730,경상북도,의성군,15-19세,1179,614,565
202007,47730,경상북도,의성군,20-24세,1612,906,706
202008,47730,경상북도,의성군,20-24세,1599,896,703
202009,47730,경상북도,의성군,20-24세,1578,891,687
202010,47730,경상북도,의성군,20-24세,1578,885,693
202011,47730,경상북도,의성군,20-24세,1578,888,690
202012,47730,경상북도,의성군,20-24세,1571,890,681
202101,47730,경상북도,의성군,20-24세,1539,873,666
202102,47730,경상북도,의성군,20-24세,1539,879,660
202103,47730,경상북도,의성군,20-24세,1518,867,651
202104,47730,경상북도,의성군,20-24세,1511,858,653
202105,47730,경상북도,의성군,20-24세,1501,857,644
202106,47730,경상북도,의성군,20-24세,1483,849,634
202007,47730,경상북도,의성군,25-29세,1599,943,656
202008,47730,경상북도,의성군,25-29세,1577,932,645
202009,47730,경상북도,의성군,25-29세,1571,938,633
202010,47730,경상북도,의성군,25-29세,1577,932,645
202011,47730,경상북도,의성군,25-29세,1568,918,650
202012,47730,경상북도,의성군,25-29세,1583,924,659
202101,47730,경상북도,의성군,25-29세,1564,918,646
202102,47730,경상북도,의성군,25-29세,1555,901,654
202103,47730,경상북도,의성군,25-29세,1561,902,659
202104,47730,경상북도,의성군,25-29세,1552,906,646
202105,47730,경상북도,의성군,25-29세,1544,907,637
202106,47730,경상북도,의성군,25-29세,1533,906,627
202007,47730,경상북도,의성군,30-34세,1534,868,666
202008,47730,경상북도,의성군,30-34세,1513,853,660
202009,47730,경상북도,의성군,30-34세,1513,850,663
202010,47730,경상북도,의성군,30-34세,1501,848,653
202011,47730,경상북도,의성군,30-34세,1490,838,652
202012,47730,경상북도,의성군,30-34세,1497,847,650
202101,47730,경상북도,의성군,30-34세,1477,839,638
202102,47730,경상북도,의성군,30-34세,1475,844,631
202103,47730,경상북도,의성군,30-34세,1466,844,622
202104,47730,경상북도,의성군,30-34세,1458,837,621
202105,47730,경상북도,의성군,30-34세,1460,839,621
202106,47730,경상북도,의성군,30-34세,1458,838,620
202007,47730,경상북도,의성군,35-39세,1815,991,824
202008,47730,경상북도,의성군,35-39세,1786,975,811
202009,47730,경상북도,의성군,35-39세,1792,982,810
202010,47730,경상북도,의성군,35-39세,1790,982,808
202011,47730,경상북도,의성군,35-39세,1778,979,799
202012,47730,경상북도,의성군,35-39세,1746,957,789
202101,47730,경상북도,의성군,35-39세,1731,946,785
202102,47730,경상북도,의성군,35-39세,1695,926,769
202103,47730,경상북도,의성군,35-39세,1690,924,766
202104,47730,경상북도,의성군,35-39세,1671,910,761
202105,47730,경상북도,의성군,35-39세,1662,906,756
202106,47730,경상북도,의성군,35-39세,1646,895,751
202007,47730,경상북도,의성군,40-44세,2006,1208,798
202008,47730,경상북도,의성군,40-44세,2012,1202,810
202009,47730,경상북도,의성군,40-44세,2004,1198,806
202010,47730,경상북도,의성군,40-44세,1993,1187,806
202011,47730,경상북도,의성군,40-44세,1987,1178,809
202012,47730,경상북도,의성군,40-44세,1967,1155,812
202101,47730,경상북도,의성군,40-44세,1964,1146,818
202102,47730,경상북도,의성군,40-44세,1960,1142,818
202103,47730,경상북도,의성군,40-44세,1949,1140,809
202104,47730,경상북도,의성군,40-44세,1940,1129,811
202105,47730,경상북도,의성군,40-44세,1920,1118,802
202106,47730,경상북도,의성군,40-44세,1931,1115,816
202007,47730,경상북도,의성군,45-49세,2743,1584,1159
202008,47730,경상북도,의성군,45-49세,2755,1600,1155
202009,47730,경상북도,의성군,45-49세,2743,1595,1148
202010,47730,경상북도,의성군,45-49세,2742,1595,1147
202011,47730,경상북도,의성군,45-49세,2729,1586,1143
202012,47730,경상북도,의성군,45-49세,2733,1598,1135
202101,47730,경상북도,의성군,45-49세,2719,1588,1131
202102,47730,경상북도,의성군,45-49세,2717,1587,1130
202103,47730,경상북도,의성군,45-49세,2677,1569,1108
202104,47730,경상북도,의성군,45-49세,2676,1572,1104
202105,47730,경상북도,의성군,45-49세,2633,1548,1085
202106,47730,경상북도,의성군,45-49세,2604,1536,1068
202007,47730,경상북도,의성군,50-54세,3784,2169,1615
202008,47730,경상북도,의성군,50-54세,3753,2150,1603
202009,47730,경상북도,의성군,50-54세,3736,2151,1585
202010,47730,경상북도,의성군,50-54세,3726,2145,1581
202011,47730,경상북도,의성군,50-54세,3733,2151,1582
202012,47730,경상북도,의성군,50-54세,3680,2108,1572
202101,47730,경상북도,의성군,50-54세,3677,2108,1569
202102,47730,경상북도,의성군,50-54세,3648,2089,1559
202103,47730,경상북도,의성군,50-54세,3616,2062,1554
202104,47730,경상북도,의성군,50-54세,3604,2045,1559
202105,47730,경상북도,의성군,50-54세,3601,2033,1568
202106,47730,경상북도,의성군,50-54세,3603,2040,1563
202007,47730,경상북도,의성군,55-59세,5109,2637,2472
202008,47730,경상북도,의성군,55-59세,5111,2642,2469
202009,47730,경상북도,의성군,55-59세,5085,2624,2461
202010,47730,경상북도,의성군,55-59세,5060,2616,2444
202011,47730,경상북도,의성군,55-59세,5029,2599,2430
202012,47730,경상북도,의성군,55-59세,5034,2606,2428
202101,47730,경상북도,의성군,55-59세,4980,2583,2397
202102,47730,경상북도,의성군,55-59세,4959,2576,2383
202103,47730,경상북도,의성군,55-59세,4933,2573,2360
202104,47730,경상북도,의성군,55-59세,4916,2574,2342
202105,47730,경상북도,의성군,55-59세,4813,2534,2279
202106,47730,경상북도,의성군,55-59세,4761,2500,2261
202007,47730,경상북도,의성군,60-64세,6162,3141,3021
202008,47730,경상북도,의성군,60-64세,6142,3142,3000
202009,47730,경상북도,의성군,60-64세,6170,3163,3007
202010,47730,경상북도,의성군,60-64세,6195,3190,3005
202011,47730,경상북도,의성군,60-64세,6226,3208,3018
202012,47730,경상북도,의성군,60-64세,6228,3208,3020
202101,47730,경상북도,의성군,60-64세,6232,3214,3018
202102,47730,경상북도,의성군,60-64세,6258,3231,3027
202103,47730,경상북도,의성군,60-64세,6271,3232,3039
202104,47730,경상북도,의성군,60-64세,6276,3229,3047
202105,47730,경상북도,의성군,60-64세,6259,3230,3029
202106,47730,경상북도,의성군,60-64세,6303,3256,3047
202007,47730,경상북도,의성군,65-69세,5386,2622,2764
202008,47730,경상북도,의성군,65-69세,5435,2639,2796
202009,47730,경상북도,의성군,65-69세,5469,2666,2803
202010,47730,경상북도,의성군,65-69세,5515,2679,2836
202011,47730,경상북도,의성군,65-69세,5527,2695,2832
202012,47730,경상북도,의성군,65-69세,5561,2711,2850
202101,47730,경상북도,의성군,65-69세,5616,2739,2877
202102,47730,경상북도,의성군,65-69세,5640,2754,2886
202103,47730,경상북도,의성군,65-69세,5699,2792,2907
202104,47730,경상북도,의성군,65-69세,5751,2815,2936
202105,47730,경상북도,의성군,65-69세,5746,2820,2926
202106,47730,경상북도,의성군,65-69세,5780,2837,2943
202007,47730,경상북도,의성군,70-74세,4360,2045,2315
202008,47730,경상북도,의성군,70-74세,4360,2047,2313
202009,47730,경상북도,의성군,70-74세,4384,2038,2346
202010,47730,경상북도,의성군,70-74세,4406,2044,2362
202011,47730,경상북도,의성군,70-74세,4453,2071,2382
202012,47730,경상북도,의성군,70-74세,4485,2076,2409
202101,47730,경상북도,의성군,70-74세,4526,2103,2423
202102,47730,경상북도,의성군,70-74세,4545,2113,2432
202103,47730,경상북도,의성군,70-74세,4577,2132,2445
202104,47730,경상북도,의성군,70-74세,4608,2157,2451
202105,47730,경상북도,의성군,70-74세,4634,2180,2454
202106,47730,경상북도,의성군,70-74세,4633,2167,2466
202007,47730,경상북도,의성군,75-79세,4726,1883,2843
202008,47730,경상북도,의성군,75-79세,4686,1868,2818
202009,47730,경상북도,의성군,75-79세,4626,1848,2778
202010,47730,경상북도,의성군,75-79세,4592,1840,2752
202011,47730,경상북도,의성군,75-79세,4541,1822,2719
202012,47730,경상북도,의성군,75-79세,4453,1801,2652
202101,47730,경상북도,의성군,75-79세,4379,1767,2612
202102,47730,경상북도,의성군,75-79세,4317,1749,2568
202103,47730,경상북도,의성군,75-79세,4271,1734,2537
202104,47730,경상북도,의성군,75-79세,4233,1719,2514
202105,47730,경상북도,의성군,75-79세,4212,1709,2503
202106,47730,경상북도,의성군,75-79세,4197,1708,2489
202007,47730,경상북도,의성군,80-84세,3915,1387,2528
202008,47730,경상북도,의성군,80-84세,3913,1380,2533
202009,47730,경상북도,의성군,80-84세,3908,1364,2544
202010,47730,경상북도,의성군,80-84세,3895,1354,2541
202011,47730,경상북도,의성군,80-84세,3898,1352,2546
202012,47730,경상북도,의성군,80-84세,3912,1360,2552
202101,47730,경상북도,의성군,80-84세,3915,1373,2542
202102,47730,경상북도,의성군,80-84세,3913,1366,2547
202103,47730,경상북도,의성군,80-84세,3900,1368,2532
202104,47730,경상북도,의성군,80-84세,3890,1367,2523
202105,47730,경상북도,의성군,80-84세,3876,1361,2515
202106,47730,경상북도,의성군,80-84세,3887,1361,2526
202007,47730,경상북도,의성군,85-89세,2121,603,1518
202008,47730,경상북도,의성군,85-89세,2140,607,1533
202009,47730,경상북도,의성군,85-89세,2166,626,1540
202010,47730,경상북도,의성군,85-89세,2180,634,1546
202011,47730,경상북도,의성군,85-89세,2189,630,1559
202012,47730,경상북도,의성군,85-89세,2223,635,1588
202101,47730,경상북도,의성군,85-89세,2245,642,1603
202102,47730,경상북도,의성군,85-89세,2275,659,1616
202103,47730,경상북도,의성군,85-89세,2309,674,1635
202104,47730,경상북도,의성군,85-89세,2341,685,1656
202105,47730,경상북도,의성군,85-89세,2353,681,1672
202106,47730,경상북도,의성군,85-89세,2349,688,1661
202007,47730,경상북도,의성군,90-94세,649,152,497
202008,47730,경상북도,의성군,90-94세,652,155,497
202009,47730,경상북도,의성군,90-94세,665,157,508
202010,47730,경상북도,의성군,90-94세,666,155,511
202011,47730,경상북도,의성군,90-94세,673,160,513
202012,47730,경상북도,의성군,90-94세,667,160,507
202101,47730,경상북도,의성군,90-94세,667,160,507
202102,47730,경상북도,의성군,90-94세,674,161,513
202103,47730,경상북도,의성군,90-94세,685,161,524
202104,47730,경상북도,의성군,90-94세,683,162,521
202105,47730,경상북도,의성군,90-94세,691,163,528
202106,47730,경상북도,의성군,90-94세,688,162,526
202007,47730,경상북도,의성군,95-99세,136,21,115
202008,47730,경상북도,의성군,95-99세,133,19,114
202009,47730,경상북도,의성군,95-99세,136,19,117
202010,47730,경상북도,의성군,95-99세,134,19,115
202011,47730,경상북도,의성군,95-99세,127,16,111
202012,47730,경상북도,의성군,95-99세,129,15,114
202101,47730,경상북도,의성군,95-99세,135,17,118
202102,47730,경상북도,의성군,95-99세,141,18,123
202103,47730,경상북도,의성군,95-99세,140,19,121
202104,47730,경상북도,의성군,95-99세,143,22,121
202105,47730,경상북도,의성군,95-99세,138,23,115
202106,47730,경상북도,의성군,95-99세,137,22,115
202007,47730,경상북도,의성군,100+,44,8,36
202008,47730,경상북도,의성군,100+,46,8,38
202009,47730,경상북도,의성군,100+,46,8,38
202010,47730,경상북도,의성군,100+,48,8,40
202011,47730,경상북도,의성군,100+,48,9,39
202012,47730,경상북도,의성군,100+,48,9,39
202101,47730,경상북도,의성군,100+,49,9,40
202102,47730,경상북도,의성군,100+,49,9,40
202103,47730,경상북도,의성군,100+,32,4,28
202104,47730,경상북도,의성군,100+,30,4,26
202105,47730,경상북도,의성군,100+,29,3,26
202106,47730,경상북도,의성군,100+,28,3,25
202007,47750,경상북도,청송군,0-4세,433,236,197
202008,47750,경상북도,청송군,0-4세,421,226,195
202009,47750,경상북도,청송군,0-4세,421,225,196
202010,47750,경상북도,청송군,0-4세,421,223,198
202011,47750,경상북도,청송군,0-4세,425,227,198
202012,47750,경상북도,청송군,0-4세,424,225,199
202101,47750,경상북도,청송군,0-4세,428,227,201
202102,47750,경상북도,청송군,0-4세,423,223,200
202103,47750,경상북도,청송군,0-4세,424,226,198
202104,47750,경상북도,청송군,0-4세,422,223,199
202105,47750,경상북도,청송군,0-4세,421,220,201
202106,47750,경상북도,청송군,0-4세,423,219,204
202007,47750,경상북도,청송군,5-9세,570,286,284
202008,47750,경상북도,청송군,5-9세,573,288,285
202009,47750,경상북도,청송군,5-9세,561,281,280
202010,47750,경상북도,청송군,5-9세,561,281,280
202011,47750,경상북도,청송군,5-9세,551,275,276
202012,47750,경상북도,청송군,5-9세,555,278,277
202101,47750,경상북도,청송군,5-9세,545,272,273
202102,47750,경상북도,청송군,5-9세,542,277,265
202103,47750,경상북도,청송군,5-9세,537,276,261
202104,47750,경상북도,청송군,5-9세,537,274,263
202105,47750,경상북도,청송군,5-9세,531,271,260
202106,47750,경상북도,청송군,5-9세,524,265,259
202007,47750,경상북도,청송군,10-14세,552,296,256
202008,47750,경상북도,청송군,10-14세,551,302,249
202009,47750,경상북도,청송군,10-14세,561,306,255
202010,47750,경상북도,청송군,10-14세,554,302,252
202011,47750,경상북도,청송군,10-14세,540,291,249
202012,47750,경상북도,청송군,10-14세,534,283,251
202101,47750,경상북도,청송군,10-14세,542,294,248
202102,47750,경상북도,청송군,10-14세,531,288,243
202103,47750,경상북도,청송군,10-14세,525,277,248
202104,47750,경상북도,청송군,10-14세,528,282,246
202105,47750,경상북도,청송군,10-14세,535,289,246
202106,47750,경상북도,청송군,10-14세,539,294,245
202007,47750,경상북도,청송군,15-19세,700,371,329
202008,47750,경상북도,청송군,15-19세,692,359,333
202009,47750,경상북도,청송군,15-19세,677,353,324
202010,47750,경상북도,청송군,15-19세,679,357,322
202011,47750,경상북도,청송군,15-19세,677,357,320
202012,47750,경상북도,청송군,15-19세,673,352,321
202101,47750,경상북도,청송군,15-19세,670,349,321
202102,47750,경상북도,청송군,15-19세,666,351,315
202103,47750,경상북도,청송군,15-19세,671,355,316
202104,47750,경상북도,청송군,15-19세,649,338,311
202105,47750,경상북도,청송군,15-19세,642,335,307
202106,47750,경상북도,청송군,15-19세,635,332,303
202007,47750,경상북도,청송군,20-24세,877,494,383
202008,47750,경상북도,청송군,20-24세,863,488,375
202009,47750,경상북도,청송군,20-24세,856,482,374
202010,47750,경상북도,청송군,20-24세,861,483,378
202011,47750,경상북도,청송군,20-24세,863,478,385
202012,47750,경상북도,청송군,20-24세,850,475,375
202101,47750,경상북도,청송군,20-24세,838,472,366
202102,47750,경상북도,청송군,20-24세,823,463,360
202103,47750,경상북도,청송군,20-24세,794,449,345
202104,47750,경상북도,청송군,20-24세,810,461,349
202105,47750,경상북도,청송군,20-24세,802,455,347
202106,47750,경상북도,청송군,20-24세,803,456,347
202007,47750,경상북도,청송군,25-29세,878,568,310
202008,47750,경상북도,청송군,25-29세,880,571,309
202009,47750,경상북도,청송군,25-29세,862,553,309
202010,47750,경상북도,청송군,25-29세,861,558,303
202011,47750,경상북도,청송군,25-29세,850,556,294
202012,47750,경상북도,청송군,25-29세,844,550,294
202101,47750,경상북도,청송군,25-29세,839,549,290
202102,47750,경상북도,청송군,25-29세,837,550,287
202103,47750,경상북도,청송군,25-29세,846,551,295
202104,47750,경상북도,청송군,25-29세,845,550,295
202105,47750,경상북도,청송군,25-29세,838,540,298
202106,47750,경상북도,청송군,25-29세,837,541,296
202007,47750,경상북도,청송군,30-34세,801,504,297
202008,47750,경상북도,청송군,30-34세,789,496,293
202009,47750,경상북도,청송군,30-34세,788,496,292
202010,47750,경상북도,청송군,30-34세,788,489,299
202011,47750,경상북도,청송군,30-34세,798,492,306
202012,47750,경상북도,청송군,30-34세,792,487,305
202101,47750,경상북도,청송군,30-34세,789,484,305
202102,47750,경상북도,청송군,30-34세,785,484,301
202103,47750,경상북도,청송군,30-34세,790,484,306
202104,47750,경상북도,청송군,30-34세,781,471,310
202105,47750,경상북도,청송군,30-34세,768,465,303
202106,47750,경상북도,청송군,30-34세,754,452,302
202007,47750,경상북도,청송군,35-39세,946,527,419
202008,47750,경상북도,청송군,35-39세,938,521,417
202009,47750,경상북도,청송군,35-39세,934,519,415
202010,47750,경상북도,청송군,35-39세,928,519,409
202011,47750,경상북도,청송군,35-39세,915,513,402
202012,47750,경상북도,청송군,35-39세,901,505,396
202101,47750,경상북도,청송군,35-39세,897,501,396
202102,47750,경상북도,청송군,35-39세,895,499,396
202103,47750,경상북도,청송군,35-39세,883,490,393
202104,47750,경상북도,청송군,35-39세,880,493,387
202105,47750,경상북도,청송군,35-39세,866,485,381
202106,47750,경상북도,청송군,35-39세,860,482,378
202007,47750,경상북도,청송군,40-44세,1013,577,436
202008,47750,경상북도,청송군,40-44세,1014,578,436
202009,47750,경상북도,청송군,40-44세,1012,580,432
202010,47750,경상북도,청송군,40-44세,1008,583,425
202011,47750,경상북도,청송군,40-44세,1006,582,424
202012,47750,경상북도,청송군,40-44세,1016,585,431
202101,47750,경상북도,청송군,40-44세,1001,573,428
202102,47750,경상북도,청송군,40-44세,994,573,421
202103,47750,경상북도,청송군,40-44세,995,573,422
202104,47750,경상북도,청송군,40-44세,990,570,420
202105,47750,경상북도,청송군,40-44세,987,558,429
202106,47750,경상북도,청송군,40-44세,992,564,428
202007,47750,경상북도,청송군,45-49세,1416,827,589
202008,47750,경상북도,청송군,45-49세,1408,824,584
202009,47750,경상북도,청송군,45-49세,1392,814,578
202010,47750,경상북도,청송군,45-49세,1392,808,584
202011,47750,경상북도,청송군,45-49세,1393,811,582
202012,47750,경상북도,청송군,45-49세,1383,797,586
202101,47750,경상북도,청송군,45-49세,1369,785,584
202102,47750,경상북도,청송군,45-49세,1364,789,575
202103,47750,경상북도,청송군,45-49세,1346,776,570
202104,47750,경상북도,청송군,45-49세,1350,773,577
202105,47750,경상북도,청송군,45-49세,1334,764,570
202106,47750,경상북도,청송군,45-49세,1322,757,565
202007,47750,경상북도,청송군,50-54세,2077,1120,957
202008,47750,경상북도,청송군,50-54세,2075,1129,946
202009,47750,경상북도,청송군,50-54세,2085,1137,948
202010,47750,경상북도,청송군,50-54세,2082,1139,943
202011,47750,경상북도,청송군,50-54세,2073,1132,941
202012,47750,경상북도,청송군,50-54세,2073,1134,939
202101,47750,경상북도,청송군,50-54세,2082,1144,938
202102,47750,경상북도,청송군,50-54세,2061,1130,931
202103,47750,경상북도,청송군,50-54세,2047,1123,924
202104,47750,경상북도,청송군,50-54세,2042,1118,924
202105,47750,경상북도,청송군,50-54세,2032,1116,916
202106,47750,경상북도,청송군,50-54세,2022,1109,913
202007,47750,경상북도,청송군,55-59세,2695,1397,1298
202008,47750,경상북도,청송군,55-59세,2691,1386,1305
202009,47750,경상북도,청송군,55-59세,2672,1369,1303
202010,47750,경상북도,청송군,55-59세,2651,1362,1289
202011,47750,경상북도,청송군,55-59세,2636,1357,1279
202012,47750,경상북도,청송군,55-59세,2635,1359,1276
202101,47750,경상북도,청송군,55-59세,2633,1360,1273
202102,47750,경상북도,청송군,55-59세,2626,1356,1270
202103,47750,경상북도,청송군,55-59세,2615,1366,1249
202104,47750,경상북도,청송군,55-59세,2626,1376,1250
202105,47750,경상북도,청송군,55-59세,2594,1358,1236
202106,47750,경상북도,청송군,55-59세,2566,1341,1225
202007,47750,경상북도,청송군,60-64세,2936,1459,1477
202008,47750,경상북도,청송군,60-64세,2943,1467,1476
202009,47750,경상북도,청송군,60-64세,2942,1473,1469
202010,47750,경상북도,청송군,60-64세,2976,1495,1481
202011,47750,경상북도,청송군,60-64세,2987,1505,1482
202012,47750,경상북도,청송군,60-64세,2982,1500,1482
202101,47750,경상북도,청송군,60-64세,2974,1490,1484
202102,47750,경상북도,청송군,60-64세,2998,1509,1489
202103,47750,경상북도,청송군,60-64세,2999,1506,1493
202104,47750,경상북도,청송군,60-64세,2981,1502,1479
202105,47750,경상북도,청송군,60-64세,3011,1523,1488
202106,47750,경상북도,청송군,60-64세,3032,1539,1493
202007,47750,경상북도,청송군,65-69세,2458,1228,1230
202008,47750,경상북도,청송군,65-69세,2472,1233,1239
202009,47750,경상북도,청송군,65-69세,2499,1240,1259
202010,47750,경상북도,청송군,65-69세,2510,1244,1266
202011,47750,경상북도,청송군,65-69세,2515,1241,1274
202012,47750,경상북도,청송군,65-69세,2545,1252,1293
202101,47750,경상북도,청송군,65-69세,2568,1272,1296
202102,47750,경상북도,청송군,65-69세,2586,1278,1308
202103,47750,경상북도,청송군,65-69세,2608,1298,1310
202104,47750,경상북도,청송군,65-69세,2614,1299,1315
202105,47750,경상북도,청송군,65-69세,2611,1296,1315
202106,47750,경상북도,청송군,65-69세,2616,1295,1321
202007,47750,경상북도,청송군,70-74세,1983,945,1038
202008,47750,경상북도,청송군,70-74세,1988,944,1044
202009,47750,경상북도,청송군,70-74세,2000,958,1042
202010,47750,경상북도,청송군,70-74세,2020,964,1056
202011,47750,경상북도,청송군,70-74세,2041,976,1065
202012,47750,경상북도,청송군,70-74세,2046,982,1064
202101,47750,경상북도,청송군,70-74세,2062,986,1076
202102,47750,경상북도,청송군,70-74세,2070,991,1079
202103,47750,경상북도,청송군,70-74세,2057,990,1067
202104,47750,경상북도,청송군,70-74세,2076,998,1078
202105,47750,경상북도,청송군,70-74세,2089,1005,1084
202106,47750,경상북도,청송군,70-74세,2102,1017,1085
202007,47750,경상북도,청송군,75-79세,2076,821,1255
202008,47750,경상북도,청송군,75-79세,2078,826,1252
202009,47750,경상북도,청송군,75-79세,2056,809,1247
202010,47750,경상북도,청송군,75-79세,2044,804,1240
202011,47750,경상북도,청송군,75-79세,2021,795,1226
202012,47750,경상북도,청송군,75-79세,1996,785,1211
202101,47750,경상북도,청송군,75-79세,1974,783,1191
202102,47750,경상북도,청송군,75-79세,1950,773,1177
202103,47750,경상북도,청송군,75-79세,1922,763,1159
202104,47750,경상북도,청송군,75-79세,1905,756,1149
202105,47750,경상북도,청송군,75-79세,1882,749,1133
202106,47750,경상북도,청송군,75-79세,1869,740,1129
202007,47750,경상북도,청송군,80-84세,1624,596,1028
202008,47750,경상북도,청송군,80-84세,1623,595,1028
202009,47750,경상북도,청송군,80-84세,1626,599,1027
202010,47750,경상북도,청송군,80-84세,1626,601,1025
202011,47750,경상북도,청송군,80-84세,1631,600,1031
202012,47750,경상북도,청송군,80-84세,1633,593,1040
202101,47750,경상북도,청송군,80-84세,1636,585,1051
202102,47750,경상북도,청송군,80-84세,1644,591,1053
202103,47750,경상북도,청송군,80-84세,1641,592,1049
202104,47750,경상북도,청송군,80-84세,1639,594,1045
202105,47750,경상북도,청송군,80-84세,1643,594,1049
202106,47750,경상북도,청송군,80-84세,1658,601,1057
202007,47750,경상북도,청송군,85-89세,803,260,543
202008,47750,경상북도,청송군,85-89세,802,258,544
202009,47750,경상북도,청송군,85-89세,815,262,553
202010,47750,경상북도,청송군,85-89세,824,262,562
202011,47750,경상북도,청송군,85-89세,831,267,564
202012,47750,경상북도,청송군,85-89세,833,277,556
202101,47750,경상북도,청송군,85-89세,857,287,570
202102,47750,경상북도,청송군,85-89세,863,289,574
202103,47750,경상북도,청송군,85-89세,879,288,591
202104,47750,경상북도,청송군,85-89세,893,294,599
202105,47750,경상북도,청송군,85-89세,901,295,606
202106,47750,경상북도,청송군,85-89세,894,293,601
202007,47750,경상북도,청송군,90-94세,261,58,203
202008,47750,경상북도,청송군,90-94세,258,58,200
202009,47750,경상북도,청송군,90-94세,258,58,200
202010,47750,경상북도,청송군,90-94세,259,57,202
202011,47750,경상북도,청송군,90-94세,257,52,205
202012,47750,경상북도,청송군,90-94세,262,52,210
202101,47750,경상북도,청송군,90-94세,257,54,203
202102,47750,경상북도,청송군,90-94세,265,55,210
202103,47750,경상북도,청송군,90-94세,267,56,211
202104,47750,경상북도,청송군,90-94세,275,56,219
202105,47750,경상북도,청송군,90-94세,275,57,218
202106,47750,경상북도,청송군,90-94세,273,57,216
202007,47750,경상북도,청송군,95-99세,41,5,36
202008,47750,경상북도,청송군,95-99세,42,4,38
202009,47750,경상북도,청송군,95-99세,42,4,38
202010,47750,경상북도,청송군,95-99세,43,4,39
202011,47750,경상북도,청송군,95-99세,45,5,40
202012,47750,경상북도,청송군,95-99세,46,5,41
202101,47750,경상북도,청송군,95-99세,48,4,44
202102,47750,경상북도,청송군,95-99세,46,3,43
202103,47750,경상북도,청송군,95-99세,45,2,43
202104,47750,경상북도,청송군,95-99세,45,2,43
202105,47750,경상북도,청송군,95-99세,47,2,45
202106,47750,경상북도,청송군,95-99세,47,2,45
202007,47750,경상북도,청송군,100+,21,5,16
202008,47750,경상북도,청송군,100+,21,5,16
202009,47750,경상북도,청송군,100+,21,5,16
202010,47750,경상북도,청송군,100+,22,6,16
202011,47750,경상북도,청송군,100+,22,6,16
202012,47750,경상북도,청송군,100+,21,6,15
202101,47750,경상북도,청송군,100+,21,6,15
202102,47750,경상북도,청송군,100+,22,6,16
202103,47750,경상북도,청송군,100+,16,3,13
202104,47750,경상북도,청송군,100+,16,3,13
202105,47750,경상북도,청송군,100+,16,3,13
202106,47750,경상북도,청송군,100+,16,3,13
202007,47760,경상북도,영양군,0-4세,350,180,170
202008,47760,경상북도,영양군,0-4세,341,178,163
202009,47760,경상북도,영양군,0-4세,335,173,162
202010,47760,경상북도,영양군,0-4세,342,177,165
202011,47760,경상북도,영양군,0-4세,334,175,159
202012,47760,경상북도,영양군,0-4세,334,173,161
202101,47760,경상북도,영양군,0-4세,336,174,162
202102,47760,경상북도,영양군,0-4세,333,172,161
202103,47760,경상북도,영양군,0-4세,323,166,157
202104,47760,경상북도,영양군,0-4세,319,166,153
202105,47760,경상북도,영양군,0-4세,314,163,151
202106,47760,경상북도,영양군,0-4세,314,163,151
202007,47760,경상북도,영양군,5-9세,410,219,191
202008,47760,경상북도,영양군,5-9세,403,214,189
202009,47760,경상북도,영양군,5-9세,408,219,189
202010,47760,경상북도,영양군,5-9세,400,218,182
202011,47760,경상북도,영양군,5-9세,400,216,184
202012,47760,경상북도,영양군,5-9세,392,212,180
202101,47760,경상북도,영양군,5-9세,392,212,180
202102,47760,경상북도,영양군,5-9세,406,218,188
202103,47760,경상북도,영양군,5-9세,403,214,189
202104,47760,경상북도,영양군,5-9세,396,209,187
202105,47760,경상북도,영양군,5-9세,400,211,189
202106,47760,경상북도,영양군,5-9세,395,211,184
202007,47760,경상북도,영양군,10-14세,448,230,218
202008,47760,경상북도,영양군,10-14세,450,232,218
202009,47760,경상북도,영양군,10-14세,451,234,217
202010,47760,경상북도,영양군,10-14세,455,234,221
202011,47760,경상북도,영양군,10-14세,451,232,219
202012,47760,경상북도,영양군,10-14세,446,230,216
202101,47760,경상북도,영양군,10-14세,441,228,213
202102,47760,경상북도,영양군,10-14세,443,228,215
202103,47760,경상북도,영양군,10-14세,448,232,216
202104,47760,경상북도,영양군,10-14세,448,233,215
202105,47760,경상북도,영양군,10-14세,443,230,213
202106,47760,경상북도,영양군,10-14세,442,229,213
202007,47760,경상북도,영양군,15-19세,512,269,243
202008,47760,경상북도,영양군,15-19세,498,255,243
202009,47760,경상북도,영양군,15-19세,494,253,241
202010,47760,경상북도,영양군,15-19세,496,255,241
202011,47760,경상북도,영양군,15-19세,492,254,238
202012,47760,경상북도,영양군,15-19세,492,249,243
202101,47760,경상북도,영양군,15-19세,483,244,239
202102,47760,경상북도,영양군,15-19세,473,240,233
202103,47760,경상북도,영양군,15-19세,470,240,230
202104,47760,경상북도,영양군,15-19세,472,241,231
202105,47760,경상북도,영양군,15-19세,471,240,231
202106,47760,경상북도,영양군,15-19세,471,240,231
202007,47760,경상북도,영양군,20-24세,602,345,257
202008,47760,경상북도,영양군,20-24세,604,351,253
202009,47760,경상북도,영양군,20-24세,598,352,246
202010,47760,경상북도,영양군,20-24세,586,342,244
202011,47760,경상북도,영양군,20-24세,581,339,242
202012,47760,경상북도,영양군,20-24세,593,353,240
202101,47760,경상북도,영양군,20-24세,596,352,244
202102,47760,경상북도,영양군,20-24세,590,350,240
202103,47760,경상북도,영양군,20-24세,580,343,237
202104,47760,경상북도,영양군,20-24세,575,337,238
202105,47760,경상북도,영양군,20-24세,575,334,241
202106,47760,경상북도,영양군,20-24세,572,337,235
202007,47760,경상북도,영양군,25-29세,546,314,232
202008,47760,경상북도,영양군,25-29세,543,313,230
202009,47760,경상북도,영양군,25-29세,538,306,232
202010,47760,경상북도,영양군,25-29세,541,312,229
202011,47760,경상북도,영양군,25-29세,551,321,230
202012,47760,경상북도,영양군,25-29세,552,322,230
202101,47760,경상북도,영양군,25-29세,562,326,236
202102,47760,경상북도,영양군,25-29세,547,317,230
202103,47760,경상북도,영양군,25-29세,551,322,229
202104,47760,경상북도,영양군,25-29세,546,317,229
202105,47760,경상북도,영양군,25-29세,543,321,222
202106,47760,경상북도,영양군,25-29세,543,318,225
202007,47760,경상북도,영양군,30-34세,492,266,226
202008,47760,경상북도,영양군,30-34세,487,262,225
202009,47760,경상북도,영양군,30-34세,493,265,228
202010,47760,경상북도,영양군,30-34세,489,262,227
202011,47760,경상북도,영양군,30-34세,497,270,227
202012,47760,경상북도,영양군,30-34세,499,272,227
202101,47760,경상북도,영양군,30-34세,481,264,217
202102,47760,경상북도,영양군,30-34세,477,260,217
202103,47760,경상북도,영양군,30-34세,471,257,214
202104,47760,경상북도,영양군,30-34세,470,259,211
202105,47760,경상북도,영양군,30-34세,465,259,206
202106,47760,경상북도,영양군,30-34세,465,257,208
202007,47760,경상북도,영양군,35-39세,563,305,258
202008,47760,경상북도,영양군,35-39세,563,303,260
202009,47760,경상북도,영양군,35-39세,552,295,257
202010,47760,경상북도,영양군,35-39세,548,291,257
202011,47760,경상북도,영양군,35-39세,542,290,252
202012,47760,경상북도,영양군,35-39세,533,285,248
202101,47760,경상북도,영양군,35-39세,540,287,253
202102,47760,경상북도,영양군,35-39세,542,291,251
202103,47760,경상북도,영양군,35-39세,547,295,252
202104,47760,경상북도,영양군,35-39세,541,292,249
202105,47760,경상북도,영양군,35-39세,540,291,249
202106,47760,경상북도,영양군,35-39세,534,291,243
202007,47760,경상북도,영양군,40-44세,725,419,306
202008,47760,경상북도,영양군,40-44세,716,414,302
202009,47760,경상북도,영양군,40-44세,723,417,306
202010,47760,경상북도,영양군,40-44세,724,420,304
202011,47760,경상북도,영양군,40-44세,722,419,303
202012,47760,경상북도,영양군,40-44세,731,426,305
202101,47760,경상북도,영양군,40-44세,723,421,302
202102,47760,경상북도,영양군,40-44세,714,413,301
202103,47760,경상북도,영양군,40-44세,693,400,293
202104,47760,경상북도,영양군,40-44세,693,401,292
202105,47760,경상북도,영양군,40-44세,695,405,290
202106,47760,경상북도,영양군,40-44세,692,407,285
202007,47760,경상북도,영양군,45-49세,1044,628,416
202008,47760,경상북도,영양군,45-49세,1028,620,408
202009,47760,경상북도,영양군,45-49세,1023,614,409
202010,47760,경상북도,영양군,45-49세,1010,603,407
202011,47760,경상북도,영양군,45-49세,1000,597,403
202012,47760,경상북도,영양군,45-49세,998,594,404
202101,47760,경상북도,영양군,45-49세,985,585,400
202102,47760,경상북도,영양군,45-49세,985,587,398
202103,47760,경상북도,영양군,45-49세,974,582,392
202104,47760,경상북도,영양군,45-49세,965,569,396
202105,47760,경상북도,영양군,45-49세,958,569,389
202106,47760,경상북도,영양군,45-49세,934,553,381
202007,47760,경상북도,영양군,50-54세,1330,769,561
202008,47760,경상북도,영양군,50-54세,1328,770,558
202009,47760,경상북도,영양군,50-54세,1321,769,552
202010,47760,경상북도,영양군,50-54세,1333,775,558
202011,47760,경상북도,영양군,50-54세,1337,777,560
202012,47760,경상북도,영양군,50-54세,1312,770,542
202101,47760,경상북도,영양군,50-54세,1309,769,540
202102,47760,경상북도,영양군,50-54세,1306,766,540
202103,47760,경상북도,영양군,50-54세,1292,756,536
202104,47760,경상북도,영양군,50-54세,1281,754,527
202105,47760,경상북도,영양군,50-54세,1285,759,526
202106,47760,경상북도,영양군,50-54세,1280,760,520
202007,47760,경상북도,영양군,55-59세,1668,857,811
202008,47760,경상북도,영양군,55-59세,1662,852,810
202009,47760,경상북도,영양군,55-59세,1665,856,809
202010,47760,경상북도,영양군,55-59세,1661,857,804
202011,47760,경상북도,영양군,55-59세,1664,862,802
202012,47760,경상북도,영양군,55-59세,1675,866,809
202101,47760,경상북도,영양군,55-59세,1652,856,796
202102,47760,경상북도,영양군,55-59세,1649,852,797
202103,47760,경상북도,영양군,55-59세,1632,850,782
202104,47760,경상북도,영양군,55-59세,1627,846,781
202105,47760,경상북도,영양군,55-59세,1608,838,770
202106,47760,경상북도,영양군,55-59세,1587,840,747
202007,47760,경상북도,영양군,60-64세,1811,911,900
202008,47760,경상북도,영양군,60-64세,1815,912,903
202009,47760,경상북도,영양군,60-64세,1817,906,911
202010,47760,경상북도,영양군,60-64세,1832,904,928
202011,47760,경상북도,영양군,60-64세,1842,909,933
202012,47760,경상북도,영양군,60-64세,1857,925,932
202101,47760,경상북도,영양군,60-64세,1858,931,927
202102,47760,경상북도,영양군,60-64세,1862,931,931
202103,47760,경상북도,영양군,60-64세,1885,948,937
202104,47760,경상북도,영양군,60-64세,1900,962,938
202105,47760,경상북도,영양군,60-64세,1899,955,944
202106,47760,경상북도,영양군,60-64세,1910,961,949
202007,47760,경상북도,영양군,65-69세,1551,763,788
202008,47760,경상북도,영양군,65-69세,1558,771,787
202009,47760,경상북도,영양군,65-69세,1575,784,791
202010,47760,경상북도,영양군,65-69세,1574,790,784
202011,47760,경상북도,영양군,65-69세,1591,797,794
202012,47760,경상북도,영양군,65-69세,1599,796,803
202101,47760,경상북도,영양군,65-69세,1603,801,802
202102,47760,경상북도,영양군,65-69세,1616,821,795
202103,47760,경상북도,영양군,65-69세,1621,820,801
202104,47760,경상북도,영양군,65-69세,1640,826,814
202105,47760,경상북도,영양군,65-69세,1657,836,821
202106,47760,경상북도,영양군,65-69세,1661,844,817
202007,47760,경상북도,영양군,70-74세,1254,597,657
202008,47760,경상북도,영양군,70-74세,1251,591,660
202009,47760,경상북도,영양군,70-74세,1251,593,658
202010,47760,경상북도,영양군,70-74세,1266,602,664
202011,47760,경상북도,영양군,70-74세,1270,600,670
202012,47760,경상북도,영양군,70-74세,1284,607,677
202101,47760,경상북도,영양군,70-74세,1286,605,681
202102,47760,경상북도,영양군,70-74세,1290,605,685
202103,47760,경상북도,영양군,70-74세,1285,608,677
202104,47760,경상북도,영양군,70-74세,1286,608,678
202105,47760,경상북도,영양군,70-74세,1286,608,678
202106,47760,경상북도,영양군,70-74세,1276,612,664
202007,47760,경상북도,영양군,75-79세,1458,579,879
202008,47760,경상북도,영양군,75-79세,1461,581,880
202009,47760,경상북도,영양군,75-79세,1447,575,872
202010,47760,경상북도,영양군,75-79세,1435,572,863
202011,47760,경상북도,영양군,75-79세,1422,569,853
202012,47760,경상북도,영양군,75-79세,1400,556,844
202101,47760,경상북도,영양군,75-79세,1391,556,835
202102,47760,경상북도,영양군,75-79세,1377,543,834
202103,47760,경상북도,영양군,75-79세,1369,544,825
202104,47760,경상북도,영양군,75-79세,1347,533,814
202105,47760,경상북도,영양군,75-79세,1333,535,798
202106,47760,경상북도,영양군,75-79세,1318,525,793
202007,47760,경상북도,영양군,80-84세,1137,413,724
202008,47760,경상북도,영양군,80-84세,1132,414,718
202009,47760,경상북도,영양군,80-84세,1132,412,720
202010,47760,경상북도,영양군,80-84세,1124,403,721
202011,47760,경상북도,영양군,80-84세,1131,403,728
202012,47760,경상북도,영양군,80-84세,1148,413,735
202101,47760,경상북도,영양군,80-84세,1144,412,732
202102,47760,경상북도,영양군,80-84세,1150,420,730
202103,47760,경상북도,영양군,80-84세,1139,408,731
202104,47760,경상북도,영양군,80-84세,1143,409,734
202105,47760,경상북도,영양군,80-84세,1149,408,741
202106,47760,경상북도,영양군,80-84세,1159,413,746
202007,47760,경상북도,영양군,85-89세,573,142,431
202008,47760,경상북도,영양군,85-89세,573,144,429
202009,47760,경상북도,영양군,85-89세,574,150,424
202010,47760,경상북도,영양군,85-89세,579,152,427
202011,47760,경상북도,영양군,85-89세,572,150,422
202012,47760,경상북도,영양군,85-89세,567,146,421
202101,47760,경상북도,영양군,85-89세,572,146,426
202102,47760,경상북도,영양군,85-89세,576,148,428
202103,47760,경상북도,영양군,85-89세,581,153,428
202104,47760,경상북도,영양군,85-89세,584,154,430
202105,47760,경상북도,영양군,85-89세,592,158,434
202106,47760,경상북도,영양군,85-89세,582,156,426
202007,47760,경상북도,영양군,90-94세,194,45,149
202008,47760,경상북도,영양군,90-94세,196,47,149
202009,47760,경상북도,영양군,90-94세,201,47,154
202010,47760,경상북도,영양군,90-94세,203,48,155
202011,47760,경상북도,영양군,90-94세,206,47,159
202012,47760,경상북도,영양군,90-94세,205,49,156
202101,47760,경상북도,영양군,90-94세,205,48,157
202102,47760,경상북도,영양군,90-94세,206,49,157
202103,47760,경상북도,영양군,90-94세,215,50,165
202104,47760,경상북도,영양군,90-94세,216,52,164
202105,47760,경상북도,영양군,90-94세,213,51,162
202106,47760,경상북도,영양군,90-94세,213,49,164
202007,47760,경상북도,영양군,95-99세,44,14,30
202008,47760,경상북도,영양군,95-99세,45,14,31
202009,47760,경상북도,영양군,95-99세,45,13,32
202010,47760,경상북도,영양군,95-99세,46,13,33
202011,47760,경상북도,영양군,95-99세,45,13,32
202012,47760,경상북도,영양군,95-99세,47,12,35
202101,47760,경상북도,영양군,95-99세,50,12,38
202102,47760,경상북도,영양군,95-99세,54,12,42
202103,47760,경상북도,영양군,95-99세,51,12,39
202104,47760,경상북도,영양군,95-99세,49,12,37
202105,47760,경상북도,영양군,95-99세,50,13,37
202106,47760,경상북도,영양군,95-99세,47,11,36
202007,47760,경상북도,영양군,100+,26,6,20
202008,47760,경상북도,영양군,100+,26,6,20
202009,47760,경상북도,영양군,100+,26,6,20
202010,47760,경상북도,영양군,100+,26,6,20
202011,47760,경상북도,영양군,100+,27,6,21
202012,47760,경상북도,영양군,100+,28,7,21
202101,47760,경상북도,영양군,100+,29,8,21
202102,47760,경상북도,영양군,100+,27,8,19
202103,47760,경상북도,영양군,100+,19,4,15
202104,47760,경상북도,영양군,100+,18,3,15
202105,47760,경상북도,영양군,100+,18,3,15
202106,47760,경상북도,영양군,100+,16,2,14
202007,47770,경상북도,영덕군,0-4세,816,381,435
202008,47770,경상북도,영덕군,0-4세,814,381,433
202009,47770,경상북도,영덕군,0-4세,813,379,434
202010,47770,경상북도,영덕군,0-4세,793,372,421
202011,47770,경상북도,영덕군,0-4세,769,358,411
202012,47770,경상북도,영덕군,0-4세,758,351,407
202101,47770,경상북도,영덕군,0-4세,732,338,394
202102,47770,경상북도,영덕군,0-4세,720,335,385
202103,47770,경상북도,영덕군,0-4세,711,331,380
202104,47770,경상북도,영덕군,0-4세,690,318,372
202105,47770,경상북도,영덕군,0-4세,688,318,370
202106,47770,경상북도,영덕군,0-4세,677,313,364
202007,47770,경상북도,영덕군,5-9세,941,487,454
202008,47770,경상북도,영덕군,5-9세,924,478,446
202009,47770,경상북도,영덕군,5-9세,922,480,442
202010,47770,경상북도,영덕군,5-9세,902,472,430
202011,47770,경상북도,영덕군,5-9세,910,475,435
202012,47770,경상북도,영덕군,5-9세,917,480,437
202101,47770,경상북도,영덕군,5-9세,912,480,432
202102,47770,경상북도,영덕군,5-9세,901,477,424
202103,47770,경상북도,영덕군,5-9세,882,472,410
202104,47770,경상북도,영덕군,5-9세,877,465,412
202105,47770,경상북도,영덕군,5-9세,878,462,416
202106,47770,경상북도,영덕군,5-9세,882,466,416
202007,47770,경상북도,영덕군,10-14세,985,503,482
202008,47770,경상북도,영덕군,10-14세,991,504,487
202009,47770,경상북도,영덕군,10-14세,996,504,492
202010,47770,경상북도,영덕군,10-14세,1001,504,497
202011,47770,경상북도,영덕군,10-14세,993,495,498
202012,47770,경상북도,영덕군,10-14세,989,494,495
202101,47770,경상북도,영덕군,10-14세,985,489,496
202102,47770,경상북도,영덕군,10-14세,989,491,498
202103,47770,경상북도,영덕군,10-14세,986,485,501
202104,47770,경상북도,영덕군,10-14세,984,489,495
202105,47770,경상북도,영덕군,10-14세,981,486,495
202106,47770,경상북도,영덕군,10-14세,975,486,489
202007,47770,경상북도,영덕군,15-19세,1134,592,542
202008,47770,경상북도,영덕군,15-19세,1126,589,537
202009,47770,경상북도,영덕군,15-19세,1136,599,537
202010,47770,경상북도,영덕군,15-19세,1129,595,534
202011,47770,경상북도,영덕군,15-19세,1134,596,538
202012,47770,경상북도,영덕군,15-19세,1128,595,533
202101,47770,경상북도,영덕군,15-19세,1127,591,536
202102,47770,경상북도,영덕군,15-19세,1109,580,529
202103,47770,경상북도,영덕군,15-19세,1082,565,517
202104,47770,경상북도,영덕군,15-19세,1072,558,514
202105,47770,경상북도,영덕군,15-19세,1072,557,515
202106,47770,경상북도,영덕군,15-19세,1081,561,520
202007,47770,경상북도,영덕군,20-24세,1345,767,578
202008,47770,경상북도,영덕군,20-24세,1346,766,580
202009,47770,경상북도,영덕군,20-24세,1330,763,567
202010,47770,경상북도,영덕군,20-24세,1329,759,570
202011,47770,경상북도,영덕군,20-24세,1303,746,557
202012,47770,경상북도,영덕군,20-24세,1283,734,549
202101,47770,경상북도,영덕군,20-24세,1266,728,538
202102,47770,경상북도,영덕군,20-24세,1260,719,541
202103,47770,경상북도,영덕군,20-24세,1236,704,532
202104,47770,경상북도,영덕군,20-24세,1225,693,532
202105,47770,경상북도,영덕군,20-24세,1215,690,525
202106,47770,경상북도,영덕군,20-24세,1199,677,522
202007,47770,경상북도,영덕군,25-29세,1160,684,476
202008,47770,경상북도,영덕군,25-29세,1149,673,476
202009,47770,경상북도,영덕군,25-29세,1146,672,474
202010,47770,경상북도,영덕군,25-29세,1137,668,469
202011,47770,경상북도,영덕군,25-29세,1143,668,475
202012,47770,경상북도,영덕군,25-29세,1142,673,469
202101,47770,경상북도,영덕군,25-29세,1135,667,468
202102,47770,경상북도,영덕군,25-29세,1132,673,459
202103,47770,경상북도,영덕군,25-29세,1126,672,454
202104,47770,경상북도,영덕군,25-29세,1117,661,456
202105,47770,경상북도,영덕군,25-29세,1129,675,454
202106,47770,경상북도,영덕군,25-29세,1127,681,446
202007,47770,경상북도,영덕군,30-34세,1052,544,508
202008,47770,경상북도,영덕군,30-34세,1046,542,504
202009,47770,경상북도,영덕군,30-34세,1034,537,497
202010,47770,경상북도,영덕군,30-34세,1017,528,489
202011,47770,경상북도,영덕군,30-34세,1010,525,485
202012,47770,경상북도,영덕군,30-34세,1007,529,478
202101,47770,경상북도,영덕군,30-34세,1008,530,478
202102,47770,경상북도,영덕군,30-34세,996,530,466
202103,47770,경상북도,영덕군,30-34세,992,533,459
202104,47770,경상북도,영덕군,30-34세,987,531,456
202105,47770,경상북도,영덕군,30-34세,964,522,442
202106,47770,경상북도,영덕군,30-34세,947,511,436
202007,47770,경상북도,영덕군,35-39세,1475,757,718
202008,47770,경상북도,영덕군,35-39세,1464,746,718
202009,47770,경상북도,영덕군,35-39세,1448,734,714
202010,47770,경상북도,영덕군,35-39세,1431,726,705
202011,47770,경상북도,영덕군,35-39세,1414,712,702
202012,47770,경상북도,영덕군,35-39세,1399,709,690
202101,47770,경상북도,영덕군,35-39세,1391,702,689
202102,47770,경상북도,영덕군,35-39세,1368,689,679
202103,47770,경상북도,영덕군,35-39세,1353,686,667
202104,47770,경상북도,영덕군,35-39세,1350,690,660
202105,47770,경상북도,영덕군,35-39세,1351,690,661
202106,47770,경상북도,영덕군,35-39세,1342,689,653
202007,47770,경상북도,영덕군,40-44세,1679,917,762
202008,47770,경상북도,영덕군,40-44세,1669,912,757
202009,47770,경상북도,영덕군,40-44세,1688,916,772
202010,47770,경상북도,영덕군,40-44세,1679,911,768
202011,47770,경상북도,영덕군,40-44세,1687,911,776
202012,47770,경상북도,영덕군,40-44세,1664,893,771
202101,47770,경상북도,영덕군,40-44세,1643,884,759
202102,47770,경상북도,영덕군,40-44세,1656,890,766
202103,47770,경상북도,영덕군,40-44세,1647,878,769
202104,47770,경상북도,영덕군,40-44세,1640,876,764
202105,47770,경상북도,영덕군,40-44세,1644,874,770
202106,47770,경상북도,영덕군,40-44세,1651,875,776
202007,47770,경상북도,영덕군,45-49세,2333,1338,995
202008,47770,경상북도,영덕군,45-49세,2300,1313,987
202009,47770,경상북도,영덕군,45-49세,2287,1300,987
202010,47770,경상북도,영덕군,45-49세,2252,1278,974
202011,47770,경상북도,영덕군,45-49세,2224,1268,956
202012,47770,경상북도,영덕군,45-49세,2209,1258,951
202101,47770,경상북도,영덕군,45-49세,2207,1256,951
202102,47770,경상북도,영덕군,45-49세,2184,1240,944
202103,47770,경상북도,영덕군,45-49세,2166,1227,939
202104,47770,경상북도,영덕군,45-49세,2154,1212,942
202105,47770,경상북도,영덕군,45-49세,2131,1197,934
202106,47770,경상북도,영덕군,45-49세,2105,1182,923
202007,47770,경상북도,영덕군,50-54세,2832,1551,1281
202008,47770,경상북도,영덕군,50-54세,2832,1558,1274
202009,47770,경상북도,영덕군,50-54세,2842,1566,1276
202010,47770,경상북도,영덕군,50-54세,2851,1575,1276
202011,47770,경상북도,영덕군,50-54세,2825,1573,1252
202012,47770,경상북도,영덕군,50-54세,2809,1569,1240
202101,47770,경상북도,영덕군,50-54세,2805,1566,1239
202102,47770,경상북도,영덕군,50-54세,2807,1568,1239
202103,47770,경상북도,영덕군,50-54세,2788,1563,1225
202104,47770,경상북도,영덕군,50-54세,2783,1556,1227
202105,47770,경상북도,영덕군,50-54세,2788,1567,1221
202106,47770,경상북도,영덕군,50-54세,2771,1563,1208
202007,47770,경상북도,영덕군,55-59세,3428,1742,1686
202008,47770,경상북도,영덕군,55-59세,3411,1732,1679
202009,47770,경상북도,영덕군,55-59세,3387,1732,1655
202010,47770,경상북도,영덕군,55-59세,3381,1729,1652
202011,47770,경상북도,영덕군,55-59세,3369,1712,1657
202012,47770,경상북도,영덕군,55-59세,3356,1705,1651
202101,47770,경상북도,영덕군,55-59세,3340,1705,1635
202102,47770,경상북도,영덕군,55-59세,3326,1705,1621
202103,47770,경상북도,영덕군,55-59세,3315,1706,1609
202104,47770,경상북도,영덕군,55-59세,3300,1706,1594
202105,47770,경상북도,영덕군,55-59세,3265,1697,1568
202106,47770,경상북도,영덕군,55-59세,3204,1669,1535
202007,47770,경상북도,영덕군,60-64세,3845,1870,1975
202008,47770,경상북도,영덕군,60-64세,3868,1887,1981
202009,47770,경상북도,영덕군,60-64세,3871,1884,1987
202010,47770,경상북도,영덕군,60-64세,3880,1889,1991
202011,47770,경상북도,영덕군,60-64세,3904,1909,1995
202012,47770,경상북도,영덕군,60-64세,3902,1902,2000
202101,47770,경상북도,영덕군,60-64세,3908,1899,2009
202102,47770,경상북도,영덕군,60-64세,3923,1905,2018
202103,47770,경상북도,영덕군,60-64세,3923,1902,2021
202104,47770,경상북도,영덕군,60-64세,3944,1923,2021
202105,47770,경상북도,영덕군,60-64세,3968,1934,2034
202106,47770,경상북도,영덕군,60-64세,3996,1947,2049
202007,47770,경상북도,영덕군,65-69세,3429,1601,1828
202008,47770,경상북도,영덕군,65-69세,3436,1604,1832
202009,47770,경상북도,영덕군,65-69세,3463,1619,1844
202010,47770,경상북도,영덕군,65-69세,3457,1621,1836
202011,47770,경상북도,영덕군,65-69세,3473,1618,1855
202012,47770,경상북도,영덕군,65-69세,3508,1635,1873
202101,47770,경상북도,영덕군,65-69세,3523,1654,1869
202102,47770,경상북도,영덕군,65-69세,3536,1669,1867
202103,47770,경상북도,영덕군,65-69세,3574,1695,1879
202104,47770,경상북도,영덕군,65-69세,3580,1691,1889
202105,47770,경상북도,영덕군,65-69세,3577,1687,1890
202106,47770,경상북도,영덕군,65-69세,3575,1689,1886
202007,47770,경상북도,영덕군,70-74세,2777,1231,1546
202008,47770,경상북도,영덕군,70-74세,2788,1234,1554
202009,47770,경상북도,영덕군,70-74세,2810,1246,1564
202010,47770,경상북도,영덕군,70-74세,2836,1262,1574
202011,47770,경상북도,영덕군,70-74세,2857,1284,1573
202012,47770,경상북도,영덕군,70-74세,2868,1291,1577
202101,47770,경상북도,영덕군,70-74세,2897,1304,1593
202102,47770,경상북도,영덕군,70-74세,2922,1319,1603
202103,47770,경상북도,영덕군,70-74세,2933,1316,1617
202104,47770,경상북도,영덕군,70-74세,2944,1323,1621
202105,47770,경상북도,영덕군,70-74세,2959,1331,1628
202106,47770,경상북도,영덕군,70-74세,2964,1334,1630
202007,47770,경상북도,영덕군,75-79세,3211,1152,2059
202008,47770,경상북도,영덕군,75-79세,3177,1141,2036
202009,47770,경상북도,영덕군,75-79세,3155,1131,2024
202010,47770,경상북도,영덕군,75-79세,3117,1113,2004
202011,47770,경상북도,영덕군,75-79세,3093,1105,1988
202012,47770,경상북도,영덕군,75-79세,3041,1089,1952
202101,47770,경상북도,영덕군,75-79세,3007,1079,1928
202102,47770,경상북도,영덕군,75-79세,2973,1072,1901
202103,47770,경상북도,영덕군,75-79세,2924,1052,1872
202104,47770,경상북도,영덕군,75-79세,2875,1034,1841
202105,47770,경상북도,영덕군,75-79세,2836,1016,1820
202106,47770,경상북도,영덕군,75-79세,2811,1012,1799
202007,47770,경상북도,영덕군,80-84세,2479,837,1642
202008,47770,경상북도,영덕군,80-84세,2487,839,1648
202009,47770,경상북도,영덕군,80-84세,2478,839,1639
202010,47770,경상북도,영덕군,80-84세,2498,846,1652
202011,47770,경상북도,영덕군,80-84세,2494,839,1655
202012,47770,경상북도,영덕군,80-84세,2519,847,1672
202101,47770,경상북도,영덕군,80-84세,2523,839,1684
202102,47770,경상북도,영덕군,80-84세,2534,842,1692
202103,47770,경상북도,영덕군,80-84세,2537,843,1694
202104,47770,경상북도,영덕군,80-84세,2553,842,1711
202105,47770,경상북도,영덕군,80-84세,2565,853,1712
202106,47770,경상북도,영덕군,80-84세,2566,858,1708
202007,47770,경상북도,영덕군,85-89세,1227,333,894
202008,47770,경상북도,영덕군,85-89세,1236,334,902
202009,47770,경상북도,영덕군,85-89세,1238,332,906
202010,47770,경상북도,영덕군,85-89세,1236,334,902
202011,47770,경상북도,영덕군,85-89세,1250,334,916
202012,47770,경상북도,영덕군,85-89세,1261,341,920
202101,47770,경상북도,영덕군,85-89세,1279,349,930
202102,47770,경상북도,영덕군,85-89세,1288,347,941
202103,47770,경상북도,영덕군,85-89세,1313,357,956
202104,47770,경상북도,영덕군,85-89세,1334,366,968
202105,47770,경상북도,영덕군,85-89세,1335,365,970
202106,47770,경상북도,영덕군,85-89세,1341,361,980
202007,47770,경상북도,영덕군,90-94세,395,76,319
202008,47770,경상북도,영덕군,90-94세,403,76,327
202009,47770,경상북도,영덕군,90-94세,417,75,342
202010,47770,경상북도,영덕군,90-94세,412,71,341
202011,47770,경상북도,영덕군,90-94세,410,71,339
202012,47770,경상북도,영덕군,90-94세,416,74,342
202101,47770,경상북도,영덕군,90-94세,420,77,343
202102,47770,경상북도,영덕군,90-94세,427,79,348
202103,47770,경상북도,영덕군,90-94세,426,78,348
202104,47770,경상북도,영덕군,90-94세,422,77,345
202105,47770,경상북도,영덕군,90-94세,437,80,357
202106,47770,경상북도,영덕군,90-94세,437,77,360
202007,47770,경상북도,영덕군,95-99세,96,17,79
202008,47770,경상북도,영덕군,95-99세,97,18,79
202009,47770,경상북도,영덕군,95-99세,103,20,83
202010,47770,경상북도,영덕군,95-99세,106,19,87
202011,47770,경상북도,영덕군,95-99세,108,20,88
202012,47770,경상북도,영덕군,95-99세,107,21,86
202101,47770,경상북도,영덕군,95-99세,107,19,88
202102,47770,경상북도,영덕군,95-99세,107,18,89
202103,47770,경상북도,영덕군,95-99세,107,18,89
202104,47770,경상북도,영덕군,95-99세,109,17,92
202105,47770,경상북도,영덕군,95-99세,108,17,91
202106,47770,경상북도,영덕군,95-99세,107,18,89
202007,47770,경상북도,영덕군,100+,27,7,20
202008,47770,경상북도,영덕군,100+,27,7,20
202009,47770,경상북도,영덕군,100+,28,7,21
202010,47770,경상북도,영덕군,100+,29,7,22
202011,47770,경상북도,영덕군,100+,29,7,22
202012,47770,경상북도,영덕군,100+,30,7,23
202101,47770,경상북도,영덕군,100+,30,7,23
202102,47770,경상북도,영덕군,100+,30,7,23
202103,47770,경상북도,영덕군,100+,22,3,19
202104,47770,경상북도,영덕군,100+,22,3,19
202105,47770,경상북도,영덕군,100+,21,3,18
202106,47770,경상북도,영덕군,100+,21,3,18
202007,47820,경상북도,청도군,0-4세,664,344,320
202008,47820,경상북도,청도군,0-4세,661,343,318
202009,47820,경상북도,청도군,0-4세,670,346,324
202010,47820,경상북도,청도군,0-4세,669,349,320
202011,47820,경상북도,청도군,0-4세,658,348,310
202012,47820,경상북도,청도군,0-4세,653,343,310
202101,47820,경상북도,청도군,0-4세,642,336,306
202102,47820,경상북도,청도군,0-4세,629,326,303
202103,47820,경상북도,청도군,0-4세,624,327,297
202104,47820,경상북도,청도군,0-4세,631,335,296
202105,47820,경상북도,청도군,0-4세,611,322,289
202106,47820,경상북도,청도군,0-4세,606,317,289
202007,47820,경상북도,청도군,5-9세,894,451,443
202008,47820,경상북도,청도군,5-9세,889,452,437
202009,47820,경상북도,청도군,5-9세,892,453,439
202010,47820,경상북도,청도군,5-9세,885,442,443
202011,47820,경상북도,청도군,5-9세,880,441,439
202012,47820,경상북도,청도군,5-9세,873,436,437
202101,47820,경상북도,청도군,5-9세,864,433,431
202102,47820,경상북도,청도군,5-9세,860,438,422
202103,47820,경상북도,청도군,5-9세,852,433,419
202104,47820,경상북도,청도군,5-9세,831,425,406
202105,47820,경상북도,청도군,5-9세,844,430,414
202106,47820,경상북도,청도군,5-9세,841,430,411
202007,47820,경상북도,청도군,10-14세,1057,533,524
202008,47820,경상북도,청도군,10-14세,1060,536,524
202009,47820,경상북도,청도군,10-14세,1048,531,517
202010,47820,경상북도,청도군,10-14세,1051,539,512
202011,47820,경상북도,청도군,10-14세,1053,535,518
202012,47820,경상북도,청도군,10-14세,1066,542,524
202101,47820,경상북도,청도군,10-14세,1084,550,534
202102,47820,경상북도,청도군,10-14세,1082,541,541
202103,47820,경상북도,청도군,10-14세,1084,543,541
202104,47820,경상북도,청도군,10-14세,1084,545,539
202105,47820,경상북도,청도군,10-14세,1073,541,532
202106,47820,경상북도,청도군,10-14세,1069,539,530
202007,47820,경상북도,청도군,15-19세,1254,649,605
202008,47820,경상북도,청도군,15-19세,1243,643,600
202009,47820,경상북도,청도군,15-19세,1228,634,594
202010,47820,경상북도,청도군,15-19세,1233,636,597
202011,47820,경상북도,청도군,15-19세,1226,633,593
202012,47820,경상북도,청도군,15-19세,1188,613,575
202101,47820,경상북도,청도군,15-19세,1202,619,583
202102,47820,경상북도,청도군,15-19세,1201,622,579
202103,47820,경상북도,청도군,15-19세,1184,608,576
202104,47820,경상북도,청도군,15-19세,1174,604,570
202105,47820,경상북도,청도군,15-19세,1183,614,569
202106,47820,경상북도,청도군,15-19세,1158,606,552
202007,47820,경상북도,청도군,20-24세,1512,900,612
202008,47820,경상북도,청도군,20-24세,1495,893,602
202009,47820,경상북도,청도군,20-24세,1482,882,600
202010,47820,경상북도,청도군,20-24세,1480,878,602
202011,47820,경상북도,청도군,20-24세,1472,873,599
202012,47820,경상북도,청도군,20-24세,1492,885,607
202101,47820,경상북도,청도군,20-24세,1485,873,612
202102,47820,경상북도,청도군,20-24세,1468,855,613
202103,47820,경상북도,청도군,20-24세,1444,836,608
202104,47820,경상북도,청도군,20-24세,1447,835,612
202105,47820,경상북도,청도군,20-24세,1435,819,616
202106,47820,경상북도,청도군,20-24세,1440,824,616
202007,47820,경상북도,청도군,25-29세,1390,833,557
202008,47820,경상북도,청도군,25-29세,1393,832,561
202009,47820,경상북도,청도군,25-29세,1392,833,559
202010,47820,경상북도,청도군,25-29세,1388,839,549
202011,47820,경상북도,청도군,25-29세,1375,827,548
202012,47820,경상북도,청도군,25-29세,1373,824,549
202101,47820,경상북도,청도군,25-29세,1344,810,534
202102,47820,경상북도,청도군,25-29세,1335,802,533
202103,47820,경상북도,청도군,25-29세,1313,793,520
202104,47820,경상북도,청도군,25-29세,1298,785,513
202105,47820,경상북도,청도군,25-29세,1304,787,517
202106,47820,경상북도,청도군,25-29세,1278,766,512
202007,47820,경상북도,청도군,30-34세,1217,674,543
202008,47820,경상북도,청도군,30-34세,1213,677,536
202009,47820,경상북도,청도군,30-34세,1225,684,541
202010,47820,경상북도,청도군,30-34세,1216,677,539
202011,47820,경상북도,청도군,30-34세,1201,669,532
202012,47820,경상북도,청도군,30-34세,1195,670,525
202101,47820,경상북도,청도군,30-34세,1181,664,517
202102,47820,경상북도,청도군,30-34세,1180,662,518
202103,47820,경상북도,청도군,30-34세,1184,662,522
202104,47820,경상북도,청도군,30-34세,1189,668,521
202105,47820,경상북도,청도군,30-34세,1159,651,508
202106,47820,경상북도,청도군,30-34세,1157,654,503
202007,47820,경상북도,청도군,35-39세,1688,870,818
202008,47820,경상북도,청도군,35-39세,1674,855,819
202009,47820,경상북도,청도군,35-39세,1662,849,813
202010,47820,경상북도,청도군,35-39세,1627,828,799
202011,47820,경상북도,청도군,35-39세,1610,816,794
202012,47820,경상북도,청도군,35-39세,1582,805,777
202101,47820,경상북도,청도군,35-39세,1569,800,769
202102,47820,경상북도,청도군,35-39세,1540,792,748
202103,47820,경상북도,청도군,35-39세,1520,783,737
202104,47820,경상북도,청도군,35-39세,1503,785,718
202105,47820,경상북도,청도군,35-39세,1481,771,710
202106,47820,경상북도,청도군,35-39세,1472,759,713
202007,47820,경상북도,청도군,40-44세,1883,1038,845
202008,47820,경상북도,청도군,40-44세,1870,1034,836
202009,47820,경상북도,청도군,40-44세,1868,1028,840
202010,47820,경상북도,청도군,40-44세,1874,1029,845
202011,47820,경상북도,청도군,40-44세,1870,1028,842
202012,47820,경상북도,청도군,40-44세,1873,1028,845
202101,47820,경상북도,청도군,40-44세,1880,1023,857
202102,47820,경상북도,청도군,40-44세,1887,1020,867
202103,47820,경상북도,청도군,40-44세,1882,1010,872
202104,47820,경상북도,청도군,40-44세,1882,998,884
202105,47820,경상북도,청도군,40-44세,1877,995,882
202106,47820,경상북도,청도군,40-44세,1871,990,881
202007,47820,경상북도,청도군,45-49세,2607,1475,1132
202008,47820,경상북도,청도군,45-49세,2605,1476,1129
202009,47820,경상북도,청도군,45-49세,2582,1468,1114
202010,47820,경상북도,청도군,45-49세,2588,1472,1116
202011,47820,경상북도,청도군,45-49세,2575,1465,1110
202012,47820,경상북도,청도군,45-49세,2566,1462,1104
202101,47820,경상북도,청도군,45-49세,2565,1465,1100
202102,47820,경상북도,청도군,45-49세,2548,1459,1089
202103,47820,경상북도,청도군,45-49세,2516,1439,1077
202104,47820,경상북도,청도군,45-49세,2479,1422,1057
202105,47820,경상북도,청도군,45-49세,2437,1392,1045
202106,47820,경상북도,청도군,45-49세,2409,1379,1030
202007,47820,경상북도,청도군,50-54세,3192,1695,1497
202008,47820,경상북도,청도군,50-54세,3192,1696,1496
202009,47820,경상북도,청도군,50-54세,3187,1687,1500
202010,47820,경상북도,청도군,50-54세,3175,1687,1488
202011,47820,경상북도,청도군,50-54세,3161,1692,1469
202012,47820,경상북도,청도군,50-54세,3147,1687,1460
202101,47820,경상북도,청도군,50-54세,3163,1699,1464
202102,47820,경상북도,청도군,50-54세,3179,1692,1487
202103,47820,경상북도,청도군,50-54세,3137,1673,1464
202104,47820,경상북도,청도군,50-54세,3153,1681,1472
202105,47820,경상북도,청도군,50-54세,3154,1693,1461
202106,47820,경상북도,청도군,50-54세,3147,1686,1461
202007,47820,경상북도,청도군,55-59세,4314,2241,2073
202008,47820,경상북도,청도군,55-59세,4266,2232,2034
202009,47820,경상북도,청도군,55-59세,4225,2214,2011
202010,47820,경상북도,청도군,55-59세,4189,2203,1986
202011,47820,경상북도,청도군,55-59세,4165,2186,1979
202012,47820,경상북도,청도군,55-59세,4155,2194,1961
202101,47820,경상북도,청도군,55-59세,4095,2166,1929
202102,47820,경상북도,청도군,55-59세,4055,2166,1889
202103,47820,경상북도,청도군,55-59세,4048,2159,1889
202104,47820,경상북도,청도군,55-59세,4013,2139,1874
202105,47820,경상북도,청도군,55-59세,3960,2117,1843
202106,47820,경상북도,청도군,55-59세,3943,2109,1834
202007,47820,경상북도,청도군,60-64세,4966,2538,2428
202008,47820,경상북도,청도군,60-64세,5012,2564,2448
202009,47820,경상북도,청도군,60-64세,4998,2563,2435
202010,47820,경상북도,청도군,60-64세,5019,2567,2452
202011,47820,경상북도,청도군,60-64세,5060,2598,2462
202012,47820,경상북도,청도군,60-64세,5073,2591,2482
202101,47820,경상북도,청도군,60-64세,5097,2602,2495
202102,47820,경상북도,청도군,60-64세,5142,2628,2514
202103,47820,경상북도,청도군,60-64세,5141,2636,2505
202104,47820,경상북도,청도군,60-64세,5180,2660,2520
202105,47820,경상북도,청도군,60-64세,5213,2677,2536
202106,47820,경상북도,청도군,60-64세,5233,2677,2556
202007,47820,경상북도,청도군,65-69세,4465,2190,2275
202008,47820,경상북도,청도군,65-69세,4485,2196,2289
202009,47820,경상북도,청도군,65-69세,4529,2207,2322
202010,47820,경상북도,청도군,65-69세,4544,2212,2332
202011,47820,경상북도,청도군,65-69세,4556,2207,2349
202012,47820,경상북도,청도군,65-69세,4540,2209,2331
202101,47820,경상북도,청도군,65-69세,4554,2220,2334
202102,47820,경상북도,청도군,65-69세,4560,2222,2338
202103,47820,경상북도,청도군,65-69세,4590,2244,2346
202104,47820,경상북도,청도군,65-69세,4584,2254,2330
202105,47820,경상북도,청도군,65-69세,4577,2266,2311
202106,47820,경상북도,청도군,65-69세,4575,2277,2298
202007,47820,경상북도,청도군,70-74세,3495,1730,1765
202008,47820,경상북도,청도군,70-74세,3502,1730,1772
202009,47820,경상북도,청도군,70-74세,3524,1747,1777
202010,47820,경상북도,청도군,70-74세,3564,1770,1794
202011,47820,경상북도,청도군,70-74세,3588,1781,1807
202012,47820,경상북도,청도군,70-74세,3641,1801,1840
202101,47820,경상북도,청도군,70-74세,3697,1840,1857
202102,47820,경상북도,청도군,70-74세,3745,1860,1885
202103,47820,경상북도,청도군,70-74세,3790,1873,1917
202104,47820,경상북도,청도군,70-74세,3812,1874,1938
202105,47820,경상북도,청도군,70-74세,3838,1887,1951
202106,47820,경상북도,청도군,70-74세,3845,1887,1958
202007,47820,경상북도,청도군,75-79세,3082,1248,1834
202008,47820,경상북도,청도군,75-79세,3087,1252,1835
202009,47820,경상북도,청도군,75-79세,3068,1254,1814
202010,47820,경상북도,청도군,75-79세,3028,1243,1785
202011,47820,경상북도,청도군,75-79세,2995,1226,1769
202012,47820,경상북도,청도군,75-79세,2947,1208,1739
202101,47820,경상북도,청도군,75-79세,2920,1198,1722
202102,47820,경상북도,청도군,75-79세,2900,1194,1706
202103,47820,경상북도,청도군,75-79세,2871,1178,1693
202104,47820,경상북도,청도군,75-79세,2866,1183,1683
202105,47820,경상북도,청도군,75-79세,2839,1170,1669
202106,47820,경상북도,청도군,75-79세,2824,1164,1660
202007,47820,경상북도,청도군,80-84세,2678,916,1762
202008,47820,경상북도,청도군,80-84세,2671,915,1756
202009,47820,경상북도,청도군,80-84세,2674,914,1760
202010,47820,경상북도,청도군,80-84세,2681,911,1770
202011,47820,경상북도,청도군,80-84세,2683,917,1766
202012,47820,경상북도,청도군,80-84세,2672,923,1749
202101,47820,경상북도,청도군,80-84세,2654,921,1733
202102,47820,경상북도,청도군,80-84세,2648,923,1725
202103,47820,경상북도,청도군,80-84세,2648,926,1722
202104,47820,경상북도,청도군,80-84세,2650,924,1726
202105,47820,경상북도,청도군,80-84세,2650,921,1729
202106,47820,경상북도,청도군,80-84세,2667,932,1735
202007,47820,경상북도,청도군,85-89세,1555,412,1143
202008,47820,경상북도,청도군,85-89세,1551,414,1137
202009,47820,경상북도,청도군,85-89세,1557,417,1140
202010,47820,경상북도,청도군,85-89세,1573,423,1150
202011,47820,경상북도,청도군,85-89세,1574,424,1150
202012,47820,경상북도,청도군,85-89세,1608,433,1175
202101,47820,경상북도,청도군,85-89세,1624,441,1183
202102,47820,경상북도,청도군,85-89세,1633,443,1190
202103,47820,경상북도,청도군,85-89세,1658,457,1201
202104,47820,경상북도,청도군,85-89세,1673,460,1213
202105,47820,경상북도,청도군,85-89세,1682,461,1221
202106,47820,경상북도,청도군,85-89세,1676,456,1220
202007,47820,경상북도,청도군,90-94세,479,107,372
202008,47820,경상북도,청도군,90-94세,489,107,382
202009,47820,경상북도,청도군,90-94세,498,109,389
202010,47820,경상북도,청도군,90-94세,499,107,392
202011,47820,경상북도,청도군,90-94세,506,109,397
202012,47820,경상북도,청도군,90-94세,496,102,394
202101,47820,경상북도,청도군,90-94세,502,102,400
202102,47820,경상북도,청도군,90-94세,511,104,407
202103,47820,경상북도,청도군,90-94세,517,104,413
202104,47820,경상북도,청도군,90-94세,518,109,409
202105,47820,경상북도,청도군,90-94세,518,108,410
202106,47820,경상북도,청도군,90-94세,523,109,414
202007,47820,경상북도,청도군,95-99세,101,14,87
202008,47820,경상북도,청도군,95-99세,103,15,88
202009,47820,경상북도,청도군,95-99세,104,15,89
202010,47820,경상북도,청도군,95-99세,107,15,92
202011,47820,경상북도,청도군,95-99세,104,15,89
202012,47820,경상북도,청도군,95-99세,102,18,84
202101,47820,경상북도,청도군,95-99세,103,19,84
202102,47820,경상북도,청도군,95-99세,102,19,83
202103,47820,경상북도,청도군,95-99세,106,20,86
202104,47820,경상북도,청도군,95-99세,107,20,87
202105,47820,경상북도,청도군,95-99세,106,19,87
202106,47820,경상북도,청도군,95-99세,104,18,86
202007,47820,경상북도,청도군,100+,19,1,18
202008,47820,경상북도,청도군,100+,19,1,18
202009,47820,경상북도,청도군,100+,19,1,18
202010,47820,경상북도,청도군,100+,19,1,18
202011,47820,경상북도,청도군,100+,20,1,19
202012,47820,경상북도,청도군,100+,21,1,20
202101,47820,경상북도,청도군,100+,20,1,19
202102,47820,경상북도,청도군,100+,21,1,20
202103,47820,경상북도,청도군,100+,10,1,9
202104,47820,경상북도,청도군,100+,11,1,10
202105,47820,경상북도,청도군,100+,11,1,10
202106,47820,경상북도,청도군,100+,9,1,8
202007,47830,경상북도,고령군,0-4세,645,319,326
202008,47830,경상북도,고령군,0-4세,634,316,318
202009,47830,경상북도,고령군,0-4세,627,312,315
202010,47830,경상북도,고령군,0-4세,610,300,310
202011,47830,경상북도,고령군,0-4세,604,298,306
202012,47830,경상북도,고령군,0-4세,600,299,301
202101,47830,경상북도,고령군,0-4세,589,296,293
202102,47830,경상북도,고령군,0-4세,590,299,291
202103,47830,경상북도,고령군,0-4세,581,297,284
202104,47830,경상북도,고령군,0-4세,576,293,283
202105,47830,경상북도,고령군,0-4세,566,286,280
202106,47830,경상북도,고령군,0-4세,560,284,276
202007,47830,경상북도,고령군,5-9세,811,417,394
202008,47830,경상북도,고령군,5-9세,815,419,396
202009,47830,경상북도,고령군,5-9세,810,420,390
202010,47830,경상북도,고령군,5-9세,816,427,389
202011,47830,경상북도,고령군,5-9세,820,433,387
202012,47830,경상북도,고령군,5-9세,818,429,389
202101,47830,경상북도,고령군,5-9세,815,433,382
202102,47830,경상북도,고령군,5-9세,813,428,385
202103,47830,경상북도,고령군,5-9세,807,422,385
202104,47830,경상북도,고령군,5-9세,807,422,385
202105,47830,경상북도,고령군,5-9세,817,428,389
202106,47830,경상북도,고령군,5-9세,808,425,383
202007,47830,경상북도,고령군,10-14세,986,523,463
202008,47830,경상북도,고령군,10-14세,981,518,463
202009,47830,경상북도,고령군,10-14세,968,506,462
202010,47830,경상북도,고령군,10-14세,968,509,459
202011,47830,경상북도,고령군,10-14세,967,507,460
202012,47830,경상북도,고령군,10-14세,962,502,460
202101,47830,경상북도,고령군,10-14세,956,494,462
202102,47830,경상북도,고령군,10-14세,945,488,457
202103,47830,경상북도,고령군,10-14세,947,496,451
202104,47830,경상북도,고령군,10-14세,944,491,453
202105,47830,경상북도,고령군,10-14세,921,480,441
202106,47830,경상북도,고령군,10-14세,922,479,443
202007,47830,경상북도,고령군,15-19세,1126,607,519
202008,47830,경상북도,고령군,15-19세,1116,603,513
202009,47830,경상북도,고령군,15-19세,1108,597,511
202010,47830,경상북도,고령군,15-19세,1103,600,503
202011,47830,경상북도,고령군,15-19세,1091,594,497
202012,47830,경상북도,고령군,15-19세,1079,589,490
202101,47830,경상북도,고령군,15-19세,1073,586,487
202102,47830,경상북도,고령군,15-19세,1070,583,487
202103,47830,경상북도,고령군,15-19세,1058,576,482
202104,47830,경상북도,고령군,15-19세,1038,564,474
202105,47830,경상북도,고령군,15-19세,1052,572,480
202106,47830,경상북도,고령군,15-19세,1041,568,473
202007,47830,경상북도,고령군,20-24세,1411,807,604
202008,47830,경상북도,고령군,20-24세,1393,800,593
202009,47830,경상북도,고령군,20-24세,1377,787,590
202010,47830,경상북도,고령군,20-24세,1379,786,593
202011,47830,경상북도,고령군,20-24세,1384,787,597
202012,47830,경상북도,고령군,20-24세,1393,798,595
202101,47830,경상북도,고령군,20-24세,1380,788,592
202102,47830,경상북도,고령군,20-24세,1363,779,584
202103,47830,경상북도,고령군,20-24세,1345,772,573
202104,47830,경상북도,고령군,20-24세,1337,770,567
202105,47830,경상북도,고령군,20-24세,1332,769,563
202106,47830,경상북도,고령군,20-24세,1311,763,548
202007,47830,경상북도,고령군,25-29세,1151,675,476
202008,47830,경상북도,고령군,25-29세,1128,662,466
202009,47830,경상북도,고령군,25-29세,1126,661,465
202010,47830,경상북도,고령군,25-29세,1133,665,468
202011,47830,경상북도,고령군,25-29세,1138,676,462
202012,47830,경상북도,고령군,25-29세,1148,680,468
202101,47830,경상북도,고령군,25-29세,1129,669,460
202102,47830,경상북도,고령군,25-29세,1140,672,468
202103,47830,경상북도,고령군,25-29세,1124,670,454
202104,47830,경상북도,고령군,25-29세,1114,662,452
202105,47830,경상북도,고령군,25-29세,1102,647,455
202106,47830,경상북도,고령군,25-29세,1084,633,451
202007,47830,경상북도,고령군,30-34세,1029,577,452
202008,47830,경상북도,고령군,30-34세,1028,581,447
202009,47830,경상북도,고령군,30-34세,1015,567,448
202010,47830,경상북도,고령군,30-34세,1005,565,440
202011,47830,경상북도,고령군,30-34세,987,557,430
202012,47830,경상북도,고령군,30-34세,984,558,426
202101,47830,경상북도,고령군,30-34세,979,548,431
202102,47830,경상북도,고령군,30-34세,959,539,420
202103,47830,경상북도,고령군,30-34세,970,540,430
202104,47830,경상북도,고령군,30-34세,970,541,429
202105,47830,경상북도,고령군,30-34세,977,544,433
202106,47830,경상북도,고령군,30-34세,970,537,433
202007,47830,경상북도,고령군,35-39세,1338,725,613
202008,47830,경상북도,고령군,35-39세,1316,708,608
202009,47830,경상북도,고령군,35-39세,1294,698,596
202010,47830,경상북도,고령군,35-39세,1292,699,593
202011,47830,경상북도,고령군,35-39세,1283,692,591
202012,47830,경상북도,고령군,35-39세,1281,686,595
202101,47830,경상북도,고령군,35-39세,1261,672,589
202102,47830,경상북도,고령군,35-39세,1251,671,580
202103,47830,경상북도,고령군,35-39세,1233,666,567
202104,47830,경상북도,고령군,35-39세,1222,658,564
202105,47830,경상북도,고령군,35-39세,1211,656,555
202106,47830,경상북도,고령군,35-39세,1202,648,554
202007,47830,경상북도,고령군,40-44세,1580,867,713
202008,47830,경상북도,고령군,40-44세,1577,870,707
202009,47830,경상북도,고령군,40-44세,1584,874,710
202010,47830,경상북도,고령군,40-44세,1579,874,705
202011,47830,경상북도,고령군,40-44세,1569,872,697
202012,47830,경상북도,고령군,40-44세,1548,865,683
202101,47830,경상북도,고령군,40-44세,1552,867,685
202102,47830,경상북도,고령군,40-44세,1551,863,688
202103,47830,경상북도,고령군,40-44세,1535,850,685
202104,47830,경상북도,고령군,40-44세,1541,855,686
202105,47830,경상북도,고령군,40-44세,1515,849,666
202106,47830,경상북도,고령군,40-44세,1513,844,669
202007,47830,경상북도,고령군,45-49세,2369,1352,1017
202008,47830,경상북도,고령군,45-49세,2347,1335,1012
202009,47830,경상북도,고령군,45-49세,2326,1324,1002
202010,47830,경상북도,고령군,45-49세,2325,1322,1003
202011,47830,경상북도,고령군,45-49세,2314,1316,998
202012,47830,경상북도,고령군,45-49세,2274,1283,991
202101,47830,경상북도,고령군,45-49세,2249,1272,977
202102,47830,경상북도,고령군,45-49세,2229,1260,969
202103,47830,경상북도,고령군,45-49세,2221,1258,963
202104,47830,경상북도,고령군,45-49세,2205,1247,958
202105,47830,경상북도,고령군,45-49세,2172,1227,945
202106,47830,경상북도,고령군,45-49세,2140,1215,925
202007,47830,경상북도,고령군,50-54세,2721,1581,1140
202008,47830,경상북도,고령군,50-54세,2697,1562,1135
202009,47830,경상북도,고령군,50-54세,2698,1553,1145
202010,47830,경상북도,고령군,50-54세,2678,1546,1132
202011,47830,경상북도,고령군,50-54세,2670,1537,1133
202012,47830,경상북도,고령군,50-54세,2670,1545,1125
202101,47830,경상북도,고령군,50-54세,2681,1549,1132
202102,47830,경상북도,고령군,50-54세,2660,1543,1117
202103,47830,경상북도,고령군,50-54세,2659,1533,1126
202104,47830,경상북도,고령군,50-54세,2676,1548,1128
202105,47830,경상북도,고령군,50-54세,2683,1560,1123
202106,47830,경상북도,고령군,50-54세,2687,1555,1132
202007,47830,경상북도,고령군,55-59세,3256,1774,1482
202008,47830,경상북도,고령군,55-59세,3242,1776,1466
202009,47830,경상북도,고령군,55-59세,3231,1774,1457
202010,47830,경상북도,고령군,55-59세,3233,1779,1454
202011,47830,경상북도,고령군,55-59세,3231,1773,1458
202012,47830,경상북도,고령군,55-59세,3229,1775,1454
202101,47830,경상북도,고령군,55-59세,3237,1772,1465
202102,47830,경상북도,고령군,55-59세,3216,1772,1444
202103,47830,경상북도,고령군,55-59세,3184,1764,1420
202104,47830,경상북도,고령군,55-59세,3152,1753,1399
202105,47830,경상북도,고령군,55-59세,3112,1734,1378
202106,47830,경상북도,고령군,55-59세,3088,1721,1367
202007,47830,경상북도,고령군,60-64세,3377,1788,1589
202008,47830,경상북도,고령군,60-64세,3390,1798,1592
202009,47830,경상북도,고령군,60-64세,3403,1809,1594
202010,47830,경상북도,고령군,60-64세,3414,1811,1603
202011,47830,경상북도,고령군,60-64세,3440,1830,1610
202012,47830,경상북도,고령군,60-64세,3434,1834,1600
202101,47830,경상북도,고령군,60-64세,3444,1849,1595
202102,47830,경상북도,고령군,60-64세,3466,1856,1610
202103,47830,경상북도,고령군,60-64세,3511,1879,1632
202104,47830,경상북도,고령군,60-64세,3536,1884,1652
202105,47830,경상북도,고령군,60-64세,3558,1901,1657
202106,47830,경상북도,고령군,60-64세,3574,1911,1663
202007,47830,경상북도,고령군,65-69세,2748,1401,1347
202008,47830,경상북도,고령군,65-69세,2753,1405,1348
202009,47830,경상북도,고령군,65-69세,2765,1415,1350
202010,47830,경상북도,고령군,65-69세,2790,1433,1357
202011,47830,경상북도,고령군,65-69세,2796,1440,1356
202012,47830,경상북도,고령군,65-69세,2833,1451,1382
202101,47830,경상북도,고령군,65-69세,2846,1461,1385
202102,47830,경상북도,고령군,65-69세,2869,1476,1393
202103,47830,경상북도,고령군,65-69세,2868,1478,1390
202104,47830,경상북도,고령군,65-69세,2876,1483,1393
202105,47830,경상북도,고령군,65-69세,2885,1489,1396
202106,47830,경상북도,고령군,65-69세,2899,1500,1399
202007,47830,경상북도,고령군,70-74세,2139,1022,1117
202008,47830,경상북도,고령군,70-74세,2146,1027,1119
202009,47830,경상북도,고령군,70-74세,2154,1027,1127
202010,47830,경상북도,고령군,70-74세,2173,1042,1131
202011,47830,경상북도,고령군,70-74세,2183,1049,1134
202012,47830,경상북도,고령군,70-74세,2210,1065,1145
202101,47830,경상북도,고령군,70-74세,2228,1072,1156
202102,47830,경상북도,고령군,70-74세,2230,1068,1162
202103,47830,경상북도,고령군,70-74세,2251,1077,1174
202104,47830,경상북도,고령군,70-74세,2265,1092,1173
202105,47830,경상북도,고령군,70-74세,2259,1086,1173
202106,47830,경상북도,고령군,70-74세,2278,1090,1188
202007,47830,경상북도,고령군,75-79세,1980,797,1183
202008,47830,경상북도,고령군,75-79세,1965,786,1179
202009,47830,경상북도,고령군,75-79세,1942,777,1165
202010,47830,경상북도,고령군,75-79세,1930,769,1161
202011,47830,경상북도,고령군,75-79세,1924,762,1162
202012,47830,경상북도,고령군,75-79세,1899,756,1143
202101,47830,경상북도,고령군,75-79세,1880,754,1126
202102,47830,경상북도,고령군,75-79세,1877,751,1126
202103,47830,경상북도,고령군,75-79세,1866,750,1116
202104,47830,경상북도,고령군,75-79세,1849,745,1104
202105,47830,경상북도,고령군,75-79세,1835,748,1087
202106,47830,경상북도,고령군,75-79세,1813,741,1072
202007,47830,경상북도,고령군,80-84세,1716,598,1118
202008,47830,경상북도,고령군,80-84세,1719,601,1118
202009,47830,경상북도,고령군,80-84세,1723,601,1122
202010,47830,경상북도,고령군,80-84세,1712,599,1113
202011,47830,경상북도,고령군,80-84세,1712,594,1118
202012,47830,경상북도,고령군,80-84세,1712,589,1123
202101,47830,경상북도,고령군,80-84세,1707,582,1125
202102,47830,경상북도,고령군,80-84세,1696,582,1114
202103,47830,경상북도,고령군,80-84세,1697,588,1109
202104,47830,경상북도,고령군,80-84세,1693,585,1108
202105,47830,경상북도,고령군,80-84세,1686,579,1107
202106,47830,경상북도,고령군,80-84세,1696,579,1117
202007,47830,경상북도,고령군,85-89세,909,267,642
202008,47830,경상북도,고령군,85-89세,909,267,642
202009,47830,경상북도,고령군,85-89세,921,270,651
202010,47830,경상북도,고령군,85-89세,939,273,666
202011,47830,경상북도,고령군,85-89세,948,282,666
202012,47830,경상북도,고령군,85-89세,962,290,672
202101,47830,경상북도,고령군,85-89세,975,299,676
202102,47830,경상북도,고령군,85-89세,983,300,683
202103,47830,경상북도,고령군,85-89세,980,298,682
202104,47830,경상북도,고령군,85-89세,995,305,690
202105,47830,경상북도,고령군,85-89세,1001,305,696
202106,47830,경상북도,고령군,85-89세,1002,308,694
202007,47830,경상북도,고령군,90-94세,245,54,191
202008,47830,경상북도,고령군,90-94세,252,56,196
202009,47830,경상북도,고령군,90-94세,252,59,193
202010,47830,경상북도,고령군,90-94세,247,56,191
202011,47830,경상북도,고령군,90-94세,247,56,191
202012,47830,경상북도,고령군,90-94세,254,59,195
202101,47830,경상북도,고령군,90-94세,258,60,198
202102,47830,경상북도,고령군,90-94세,266,62,204
202103,47830,경상북도,고령군,90-94세,264,63,201
202104,47830,경상북도,고령군,90-94세,270,64,206
202105,47830,경상북도,고령군,90-94세,272,62,210
202106,47830,경상북도,고령군,90-94세,269,60,209
202007,47830,경상북도,고령군,95-99세,58,16,42
202008,47830,경상북도,고령군,95-99세,60,16,44
202009,47830,경상북도,고령군,95-99세,61,15,46
202010,47830,경상북도,고령군,95-99세,62,16,46
202011,47830,경상북도,고령군,95-99세,59,16,43
202012,47830,경상북도,고령군,95-99세,60,16,44
202101,47830,경상북도,고령군,95-99세,60,16,44
202102,47830,경상북도,고령군,95-99세,60,16,44
202103,47830,경상북도,고령군,95-99세,58,13,45
202104,47830,경상북도,고령군,95-99세,59,13,46
202105,47830,경상북도,고령군,95-99세,60,14,46
202106,47830,경상북도,고령군,95-99세,62,15,47
202007,47830,경상북도,고령군,100+,7,4,3
202008,47830,경상북도,고령군,100+,9,4,5
202009,47830,경상북도,고령군,100+,9,4,5
202010,47830,경상북도,고령군,100+,10,5,5
202011,47830,경상북도,고령군,100+,11,5,6
202012,47830,경상북도,고령군,100+,11,5,6
202101,47830,경상북도,고령군,100+,11,5,6
202102,47830,경상북도,고령군,100+,11,5,6
202103,47830,경상북도,고령군,100+,8,3,5
202104,47830,경상북도,고령군,100+,8,3,5
202105,47830,경상북도,고령군,100+,8,3,5
202106,47830,경상북도,고령군,100+,8,3,5
202007,47840,경상북도,성주군,0-4세,990,512,478
202008,47840,경상북도,성주군,0-4세,989,508,481
202009,47840,경상북도,성주군,0-4세,972,499,473
202010,47840,경상북도,성주군,0-4세,969,504,465
202011,47840,경상북도,성주군,0-4세,975,505,470
202012,47840,경상북도,성주군,0-4세,977,507,470
202101,47840,경상북도,성주군,0-4세,978,505,473
202102,47840,경상북도,성주군,0-4세,976,505,471
202103,47840,경상북도,성주군,0-4세,967,497,470
202104,47840,경상북도,성주군,0-4세,976,501,475
202105,47840,경상북도,성주군,0-4세,977,495,482
202106,47840,경상북도,성주군,0-4세,971,493,478
202007,47840,경상북도,성주군,5-9세,958,475,483
202008,47840,경상북도,성주군,5-9세,957,475,482
202009,47840,경상북도,성주군,5-9세,953,472,481
202010,47840,경상북도,성주군,5-9세,951,469,482
202011,47840,경상북도,성주군,5-9세,944,466,478
202012,47840,경상북도,성주군,5-9세,933,458,475
202101,47840,경상북도,성주군,5-9세,928,458,470
202102,47840,경상북도,성주군,5-9세,928,461,467
202103,47840,경상북도,성주군,5-9세,915,456,459
202104,47840,경상북도,성주군,5-9세,909,451,458
202105,47840,경상북도,성주군,5-9세,904,446,458
202106,47840,경상북도,성주군,5-9세,886,435,451
202007,47840,경상북도,성주군,10-14세,1061,599,462
202008,47840,경상북도,성주군,10-14세,1057,596,461
202009,47840,경상북도,성주군,10-14세,1057,593,464
202010,47840,경상북도,성주군,10-14세,1045,584,461
202011,47840,경상북도,성주군,10-14세,1053,581,472
202012,47840,경상북도,성주군,10-14세,1053,579,474
202101,47840,경상북도,성주군,10-14세,1046,577,469
202102,47840,경상북도,성주군,10-14세,1051,574,477
202103,47840,경상북도,성주군,10-14세,1051,576,475
202104,47840,경상북도,성주군,10-14세,1051,572,479
202105,47840,경상북도,성주군,10-14세,1048,572,476
202106,47840,경상북도,성주군,10-14세,1054,575,479
202007,47840,경상북도,성주군,15-19세,1285,729,556
202008,47840,경상북도,성주군,15-19세,1259,713,546
202009,47840,경상북도,성주군,15-19세,1239,701,538
202010,47840,경상북도,성주군,15-19세,1238,700,538
202011,47840,경상북도,성주군,15-19세,1219,690,529
202012,47840,경상북도,성주군,15-19세,1204,684,520
202101,47840,경상북도,성주군,15-19세,1205,682,523
202102,47840,경상북도,성주군,15-19세,1198,676,522
202103,47840,경상북도,성주군,15-19세,1175,663,512
202104,47840,경상북도,성주군,15-19세,1158,649,509
202105,47840,경상북도,성주군,15-19세,1141,641,500
202106,47840,경상북도,성주군,15-19세,1140,635,505
202007,47840,경상북도,성주군,20-24세,1769,1014,755
202008,47840,경상북도,성주군,20-24세,1753,1014,739
202009,47840,경상북도,성주군,20-24세,1741,1006,735
202010,47840,경상북도,성주군,20-24세,1725,999,726
202011,47840,경상북도,성주군,20-24세,1737,1005,732
202012,47840,경상북도,성주군,20-24세,1767,1024,743
202101,47840,경상북도,성주군,20-24세,1732,1004,728
202102,47840,경상북도,성주군,20-24세,1696,986,710
202103,47840,경상북도,성주군,20-24세,1663,973,690
202104,47840,경상북도,성주군,20-24세,1645,962,683
202105,47840,경상북도,성주군,20-24세,1636,956,680
202106,47840,경상북도,성주군,20-24세,1632,960,672
202007,47840,경상북도,성주군,25-29세,1805,1077,728
202008,47840,경상북도,성주군,25-29세,1781,1065,716
202009,47840,경상북도,성주군,25-29세,1770,1061,709
202010,47840,경상북도,성주군,25-29세,1752,1054,698
202011,47840,경상북도,성주군,25-29세,1746,1051,695
202012,47840,경상북도,성주군,25-29세,1767,1076,691
202101,47840,경상북도,성주군,25-29세,1753,1069,684
202102,47840,경상북도,성주군,25-29세,1721,1058,663
202103,47840,경상북도,성주군,25-29세,1708,1055,653
202104,47840,경상북도,성주군,25-29세,1724,1068,656
202105,47840,경상북도,성주군,25-29세,1728,1071,657
202106,47840,경상북도,성주군,25-29세,1702,1051,651
202007,47840,경상북도,성주군,30-34세,1572,899,673
202008,47840,경상북도,성주군,30-34세,1552,888,664
202009,47840,경상북도,성주군,30-34세,1541,883,658
202010,47840,경상북도,성주군,30-34세,1526,873,653
202011,47840,경상북도,성주군,30-34세,1524,862,662
202012,47840,경상북도,성주군,30-34세,1536,876,660
202101,47840,경상북도,성주군,30-34세,1537,870,667
202102,47840,경상북도,성주군,30-34세,1538,864,674
202103,47840,경상북도,성주군,30-34세,1521,849,672
202104,47840,경상북도,성주군,30-34세,1525,843,682
202105,47840,경상북도,성주군,30-34세,1505,827,678
202106,47840,경상북도,성주군,30-34세,1493,820,673
202007,47840,경상북도,성주군,35-39세,1774,939,835
202008,47840,경상북도,성주군,35-39세,1754,928,826
202009,47840,경상북도,성주군,35-39세,1736,915,821
202010,47840,경상북도,성주군,35-39세,1733,914,819
202011,47840,경상북도,성주군,35-39세,1740,926,814
202012,47840,경상북도,성주군,35-39세,1754,935,819
202101,47840,경상북도,성주군,35-39세,1742,929,813
202102,47840,경상북도,성주군,35-39세,1717,910,807
202103,47840,경상북도,성주군,35-39세,1695,911,784
202104,47840,경상북도,성주군,35-39세,1695,906,789
202105,47840,경상북도,성주군,35-39세,1688,901,787
202106,47840,경상북도,성주군,35-39세,1707,912,795
202007,47840,경상북도,성주군,40-44세,2062,1262,800
202008,47840,경상북도,성주군,40-44세,2065,1267,798
202009,47840,경상북도,성주군,40-44세,2048,1261,787
202010,47840,경상북도,성주군,40-44세,2053,1259,794
202011,47840,경상북도,성주군,40-44세,2051,1248,803
202012,47840,경상북도,성주군,40-44세,2056,1243,813
202101,47840,경상북도,성주군,40-44세,2053,1236,817
202102,47840,경상북도,성주군,40-44세,2044,1235,809
202103,47840,경상북도,성주군,40-44세,2030,1223,807
202104,47840,경상북도,성주군,40-44세,2020,1218,802
202105,47840,경상북도,성주군,40-44세,2010,1217,793
202106,47840,경상북도,성주군,40-44세,2007,1208,799
202007,47840,경상북도,성주군,45-49세,2754,1628,1126
202008,47840,경상북도,성주군,45-49세,2730,1610,1120
202009,47840,경상북도,성주군,45-49세,2722,1610,1112
202010,47840,경상북도,성주군,45-49세,2709,1595,1114
202011,47840,경상북도,성주군,45-49세,2691,1584,1107
202012,47840,경상북도,성주군,45-49세,2703,1596,1107
202101,47840,경상북도,성주군,45-49세,2680,1579,1101
202102,47840,경상북도,성주군,45-49세,2677,1587,1090
202103,47840,경상북도,성주군,45-49세,2649,1566,1083
202104,47840,경상북도,성주군,45-49세,2631,1559,1072
202105,47840,경상북도,성주군,45-49세,2591,1530,1061
202106,47840,경상북도,성주군,45-49세,2585,1529,1056
202007,47840,경상북도,성주군,50-54세,3729,2077,1652
202008,47840,경상북도,성주군,50-54세,3721,2082,1639
202009,47840,경상북도,성주군,50-54세,3715,2071,1644
202010,47840,경상북도,성주군,50-54세,3694,2066,1628
202011,47840,경상북도,성주군,50-54세,3677,2060,1617
202012,47840,경상북도,성주군,50-54세,3674,2061,1613
202101,47840,경상북도,성주군,50-54세,3689,2070,1619
202102,47840,경상북도,성주군,50-54세,3667,2058,1609
202103,47840,경상북도,성주군,50-54세,3642,2046,1596
202104,47840,경상북도,성주군,50-54세,3623,2034,1589
202105,47840,경상북도,성주군,50-54세,3605,2030,1575
202106,47840,경상북도,성주군,50-54세,3570,2005,1565
202007,47840,경상북도,성주군,55-59세,4896,2636,2260
202008,47840,경상북도,성주군,55-59세,4851,2614,2237
202009,47840,경상북도,성주군,55-59세,4841,2609,2232
202010,47840,경상북도,성주군,55-59세,4848,2618,2230
202011,47840,경상북도,성주군,55-59세,4848,2621,2227
202012,47840,경상북도,성주군,55-59세,4847,2605,2242
202101,47840,경상북도,성주군,55-59세,4770,2571,2199
202102,47840,경상북도,성주군,55-59세,4718,2540,2178
202103,47840,경상북도,성주군,55-59세,4686,2536,2150
202104,47840,경상북도,성주군,55-59세,4675,2513,2162
202105,47840,경상북도,성주군,55-59세,4626,2502,2124
202106,47840,경상북도,성주군,55-59세,4610,2496,2114
202007,47840,경상북도,성주군,60-64세,4972,2660,2312
202008,47840,경상북도,성주군,60-64세,5013,2697,2316
202009,47840,경상북도,성주군,60-64세,5027,2716,2311
202010,47840,경상북도,성주군,60-64세,5037,2733,2304
202011,47840,경상북도,성주군,60-64세,5074,2739,2335
202012,47840,경상북도,성주군,60-64세,5172,2798,2374
202101,47840,경상북도,성주군,60-64세,5205,2816,2389
202102,47840,경상북도,성주군,60-64세,5254,2842,2412
202103,47840,경상북도,성주군,60-64세,5326,2867,2459
202104,47840,경상북도,성주군,60-64세,5382,2906,2476
202105,47840,경상북도,성주군,60-64세,5397,2910,2487
202106,47840,경상북도,성주군,60-64세,5433,2941,2492
202007,47840,경상북도,성주군,65-69세,4060,2041,2019
202008,47840,경상북도,성주군,65-69세,4072,2046,2026
202009,47840,경상북도,성주군,65-69세,4088,2051,2037
202010,47840,경상북도,성주군,65-69세,4112,2058,2054
202011,47840,경상북도,성주군,65-69세,4120,2073,2047
202012,47840,경상북도,성주군,65-69세,4136,2077,2059
202101,47840,경상북도,성주군,65-69세,4162,2099,2063
202102,47840,경상북도,성주군,65-69세,4154,2101,2053
202103,47840,경상북도,성주군,65-69세,4200,2137,2063
202104,47840,경상북도,성주군,65-69세,4221,2151,2070
202105,47840,경상북도,성주군,65-69세,4243,2163,2080
202106,47840,경상북도,성주군,65-69세,4264,2173,2091
202007,47840,경상북도,성주군,70-74세,3153,1539,1614
202008,47840,경상북도,성주군,70-74세,3186,1550,1636
202009,47840,경상북도,성주군,70-74세,3224,1563,1661
202010,47840,경상북도,성주군,70-74세,3262,1583,1679
202011,47840,경상북도,성주군,70-74세,3288,1593,1695
202012,47840,경상북도,성주군,70-74세,3320,1617,1703
202101,47840,경상북도,성주군,70-74세,3347,1628,1719
202102,47840,경상북도,성주군,70-74세,3388,1647,1741
202103,47840,경상북도,성주군,70-74세,3400,1655,1745
202104,47840,경상북도,성주군,70-74세,3425,1664,1761
202105,47840,경상북도,성주군,70-74세,3423,1664,1759
202106,47840,경상북도,성주군,70-74세,3430,1670,1760
202007,47840,경상북도,성주군,75-79세,2656,1134,1522
202008,47840,경상북도,성주군,75-79세,2630,1125,1505
202009,47840,경상북도,성주군,75-79세,2592,1118,1474
202010,47840,경상북도,성주군,75-79세,2576,1109,1467
202011,47840,경상북도,성주군,75-79세,2544,1107,1437
202012,47840,경상북도,성주군,75-79세,2516,1096,1420
202101,47840,경상북도,성주군,75-79세,2496,1087,1409
202102,47840,경상북도,성주군,75-79세,2450,1076,1374
202103,47840,경상북도,성주군,75-79세,2447,1077,1370
202104,47840,경상북도,성주군,75-79세,2424,1068,1356
202105,47840,경상북도,성주군,75-79세,2432,1075,1357
202106,47840,경상북도,성주군,75-79세,2423,1067,1356
202007,47840,경상북도,성주군,80-84세,2187,784,1403
202008,47840,경상북도,성주군,80-84세,2184,784,1400
202009,47840,경상북도,성주군,80-84세,2183,777,1406
202010,47840,경상북도,성주군,80-84세,2178,776,1402
202011,47840,경상북도,성주군,80-84세,2176,766,1410
202012,47840,경상북도,성주군,80-84세,2173,768,1405
202101,47840,경상북도,성주군,80-84세,2167,773,1394
202102,47840,경상북도,성주군,80-84세,2175,773,1402
202103,47840,경상북도,성주군,80-84세,2164,772,1392
202104,47840,경상북도,성주군,80-84세,2162,785,1377
202105,47840,경상북도,성주군,80-84세,2172,796,1376
202106,47840,경상북도,성주군,80-84세,2168,803,1365
202007,47840,경상북도,성주군,85-89세,1256,332,924
202008,47840,경상북도,성주군,85-89세,1262,339,923
202009,47840,경상북도,성주군,85-89세,1276,347,929
202010,47840,경상북도,성주군,85-89세,1279,347,932
202011,47840,경상북도,성주군,85-89세,1299,353,946
202012,47840,경상북도,성주군,85-89세,1309,357,952
202101,47840,경상북도,성주군,85-89세,1319,357,962
202102,47840,경상북도,성주군,85-89세,1349,359,990
202103,47840,경상북도,성주군,85-89세,1354,359,995
202104,47840,경상북도,성주군,85-89세,1358,354,1004
202105,47840,경상북도,성주군,85-89세,1367,356,1011
202106,47840,경상북도,성주군,85-89세,1366,356,1010
202007,47840,경상북도,성주군,90-94세,381,93,288
202008,47840,경상북도,성주군,90-94세,396,95,301
202009,47840,경상북도,성주군,90-94세,403,96,307
202010,47840,경상북도,성주군,90-94세,413,97,316
202011,47840,경상북도,성주군,90-94세,415,100,315
202012,47840,경상북도,성주군,90-94세,415,97,318
202101,47840,경상북도,성주군,90-94세,421,100,321
202102,47840,경상북도,성주군,90-94세,426,104,322
202103,47840,경상북도,성주군,90-94세,422,97,325
202104,47840,경상북도,성주군,90-94세,426,96,330
202105,47840,경상북도,성주군,90-94세,424,94,330
202106,47840,경상북도,성주군,90-94세,433,95,338
202007,47840,경상북도,성주군,95-99세,80,13,67
202008,47840,경상북도,성주군,95-99세,80,14,66
202009,47840,경상북도,성주군,95-99세,76,13,63
202010,47840,경상북도,성주군,95-99세,78,13,65
202011,47840,경상북도,성주군,95-99세,76,13,63
202012,47840,경상북도,성주군,95-99세,74,13,61
202101,47840,경상북도,성주군,95-99세,78,13,65
202102,47840,경상북도,성주군,95-99세,80,13,67
202103,47840,경상북도,성주군,95-99세,79,13,66
202104,47840,경상북도,성주군,95-99세,77,13,64
202105,47840,경상북도,성주군,95-99세,78,14,64
202106,47840,경상북도,성주군,95-99세,80,14,66
202007,47840,경상북도,성주군,100+,26,6,20
202008,47840,경상북도,성주군,100+,27,6,21
202009,47840,경상북도,성주군,100+,27,6,21
202010,47840,경상북도,성주군,100+,27,6,21
202011,47840,경상북도,성주군,100+,28,6,22
202012,47840,경상북도,성주군,100+,28,6,22
202101,47840,경상북도,성주군,100+,27,6,21
202102,47840,경상북도,성주군,100+,27,6,21
202103,47840,경상북도,성주군,100+,11,1,10
202104,47840,경상북도,성주군,100+,11,1,10
202105,47840,경상북도,성주군,100+,9,0,9
202106,47840,경상북도,성주군,100+,10,0,10
202007,47850,경상북도,칠곡군,0-4세,4100,2087,2013
202008,47850,경상북도,칠곡군,0-4세,4020,2047,1973
202009,47850,경상북도,칠곡군,0-4세,3949,2008,1941
202010,47850,경상북도,칠곡군,0-4세,3891,1966,1925
202011,47850,경상북도,칠곡군,0-4세,3837,1943,1894
202012,47850,경상북도,칠곡군,0-4세,3802,1929,1873
202101,47850,경상북도,칠곡군,0-4세,3766,1917,1849
202102,47850,경상북도,칠곡군,0-4세,3713,1896,1817
202103,47850,경상북도,칠곡군,0-4세,3630,1857,1773
202104,47850,경상북도,칠곡군,0-4세,3562,1822,1740
202105,47850,경상북도,칠곡군,0-4세,3516,1803,1713
202106,47850,경상북도,칠곡군,0-4세,3461,1763,1698
202007,47850,경상북도,칠곡군,5-9세,5755,2992,2763
202008,47850,경상북도,칠곡군,5-9세,5752,2998,2754
202009,47850,경상북도,칠곡군,5-9세,5747,2990,2757
202010,47850,경상북도,칠곡군,5-9세,5718,2984,2734
202011,47850,경상북도,칠곡군,5-9세,5728,2982,2746
202012,47850,경상북도,칠곡군,5-9세,5722,2972,2750
202101,47850,경상북도,칠곡군,5-9세,5723,2988,2735
202102,47850,경상북도,칠곡군,5-9세,5699,2974,2725
202103,47850,경상북도,칠곡군,5-9세,5681,2964,2717
202104,47850,경상북도,칠곡군,5-9세,5660,2951,2709
202105,47850,경상북도,칠곡군,5-9세,5650,2940,2710
202106,47850,경상북도,칠곡군,5-9세,5629,2929,2700
202007,47850,경상북도,칠곡군,10-14세,5647,2939,2708
202008,47850,경상북도,칠곡군,10-14세,5647,2939,2708
202009,47850,경상북도,칠곡군,10-14세,5673,2954,2719
202010,47850,경상북도,칠곡군,10-14세,5676,2955,2721
202011,47850,경상북도,칠곡군,10-14세,5709,2979,2730
202012,47850,경상북도,칠곡군,10-14세,5704,2972,2732
202101,47850,경상북도,칠곡군,10-14세,5729,2969,2760
202102,47850,경상북도,칠곡군,10-14세,5744,2967,2777
202103,47850,경상북도,칠곡군,10-14세,5733,2954,2779
202104,47850,경상북도,칠곡군,10-14세,5736,2959,2777
202105,47850,경상북도,칠곡군,10-14세,5720,2949,2771
202106,47850,경상북도,칠곡군,10-14세,5733,2964,2769
202007,47850,경상북도,칠곡군,15-19세,5951,3185,2766
202008,47850,경상북도,칠곡군,15-19세,5922,3170,2752
202009,47850,경상북도,칠곡군,15-19세,5871,3148,2723
202010,47850,경상북도,칠곡군,15-19세,5866,3145,2721
202011,47850,경상북도,칠곡군,15-19세,5832,3123,2709
202012,47850,경상북도,칠곡군,15-19세,5837,3146,2691
202101,47850,경상북도,칠곡군,15-19세,5816,3127,2689
202102,47850,경상북도,칠곡군,15-19세,5793,3111,2682
202103,47850,경상북도,칠곡군,15-19세,5729,3090,2639
202104,47850,경상북도,칠곡군,15-19세,5703,3061,2642
202105,47850,경상북도,칠곡군,15-19세,5695,3056,2639
202106,47850,경상북도,칠곡군,15-19세,5686,3048,2638
202007,47850,경상북도,칠곡군,20-24세,6315,3648,2667
202008,47850,경상북도,칠곡군,20-24세,6280,3645,2635
202009,47850,경상북도,칠곡군,20-24세,6272,3641,2631
202010,47850,경상북도,칠곡군,20-24세,6280,3656,2624
202011,47850,경상북도,칠곡군,20-24세,6286,3680,2606
202012,47850,경상북도,칠곡군,20-24세,6261,3663,2598
202101,47850,경상북도,칠곡군,20-24세,6231,3649,2582
202102,47850,경상북도,칠곡군,20-24세,6166,3609,2557
202103,47850,경상북도,칠곡군,20-24세,6121,3594,2527
202104,47850,경상북도,칠곡군,20-24세,6096,3584,2512
202105,47850,경상북도,칠곡군,20-24세,6102,3591,2511
202106,47850,경상북도,칠곡군,20-24세,6059,3564,2495
202007,47850,경상북도,칠곡군,25-29세,5938,3233,2705
202008,47850,경상북도,칠곡군,25-29세,5882,3207,2675
202009,47850,경상북도,칠곡군,25-29세,5834,3196,2638
202010,47850,경상북도,칠곡군,25-29세,5864,3225,2639
202011,47850,경상북도,칠곡군,25-29세,5863,3227,2636
202012,47850,경상북도,칠곡군,25-29세,5771,3171,2600
202101,47850,경상북도,칠곡군,25-29세,5762,3164,2598
202102,47850,경상북도,칠곡군,25-29세,5738,3164,2574
202103,47850,경상북도,칠곡군,25-29세,5710,3138,2572
202104,47850,경상북도,칠곡군,25-29세,5729,3149,2580
202105,47850,경상북도,칠곡군,25-29세,5709,3142,2567
202106,47850,경상북도,칠곡군,25-29세,5693,3160,2533
202007,47850,경상북도,칠곡군,30-34세,6614,3669,2945
202008,47850,경상북도,칠곡군,30-34세,6559,3642,2917
202009,47850,경상북도,칠곡군,30-34세,6493,3593,2900
202010,47850,경상북도,칠곡군,30-34세,6428,3562,2866
202011,47850,경상북도,칠곡군,30-34세,6380,3521,2859
202012,47850,경상북도,칠곡군,30-34세,6231,3418,2813
202101,47850,경상북도,칠곡군,30-34세,6181,3382,2799
202102,47850,경상북도,칠곡군,30-34세,6104,3340,2764
202103,47850,경상북도,칠곡군,30-34세,6056,3329,2727
202104,47850,경상북도,칠곡군,30-34세,6011,3297,2714
202105,47850,경상북도,칠곡군,30-34세,5991,3288,2703
202106,47850,경상북도,칠곡군,30-34세,5986,3288,2698
202007,47850,경상북도,칠곡군,35-39세,9003,4886,4117
202008,47850,경상북도,칠곡군,35-39세,8891,4821,4070
202009,47850,경상북도,칠곡군,35-39세,8826,4793,4033
202010,47850,경상북도,칠곡군,35-39세,8746,4741,4005
202011,47850,경상북도,칠곡군,35-39세,8681,4713,3968
202012,47850,경상북도,칠곡군,35-39세,8645,4688,3957
202101,47850,경상북도,칠곡군,35-39세,8597,4655,3942
202102,47850,경상북도,칠곡군,35-39세,8513,4607,3906
202103,47850,경상북도,칠곡군,35-39세,8411,4547,3864
202104,47850,경상북도,칠곡군,35-39세,8350,4504,3846
202105,47850,경상북도,칠곡군,35-39세,8295,4494,3801
202106,47850,경상북도,칠곡군,35-39세,8259,4467,3792
202007,47850,경상북도,칠곡군,40-44세,9699,5188,4511
202008,47850,경상북도,칠곡군,40-44세,9693,5184,4509
202009,47850,경상북도,칠곡군,40-44세,9696,5181,4515
202010,47850,경상북도,칠곡군,40-44세,9764,5230,4534
202011,47850,경상북도,칠곡군,40-44세,9828,5245,4583
202012,47850,경상북도,칠곡군,40-44세,9808,5247,4561
202101,47850,경상북도,칠곡군,40-44세,9830,5263,4567
202102,47850,경상북도,칠곡군,40-44세,9855,5269,4586
202103,47850,경상북도,칠곡군,40-44세,9842,5264,4578
202104,47850,경상북도,칠곡군,40-44세,9845,5276,4569
202105,47850,경상북도,칠곡군,40-44세,9853,5282,4571
202106,47850,경상북도,칠곡군,40-44세,9882,5283,4599
202007,47850,경상북도,칠곡군,45-49세,10909,5965,4944
202008,47850,경상북도,칠곡군,45-49세,10885,5941,4944
202009,47850,경상북도,칠곡군,45-49세,10829,5901,4928
202010,47850,경상북도,칠곡군,45-49세,10769,5857,4912
202011,47850,경상북도,칠곡군,45-49세,10807,5883,4924
202012,47850,경상북도,칠곡군,45-49세,10852,5905,4947
202101,47850,경상북도,칠곡군,45-49세,10816,5871,4945
202102,47850,경상북도,칠곡군,45-49세,10813,5860,4953
202103,47850,경상북도,칠곡군,45-49세,10782,5836,4946
202104,47850,경상북도,칠곡군,45-49세,10796,5848,4948
202105,47850,경상북도,칠곡군,45-49세,10713,5790,4923
202106,47850,경상북도,칠곡군,45-49세,10658,5761,4897
202007,47850,경상북도,칠곡군,50-54세,10201,5488,4713
202008,47850,경상북도,칠곡군,50-54세,10190,5459,4731
202009,47850,경상북도,칠곡군,50-54세,10224,5480,4744
202010,47850,경상북도,칠곡군,50-54세,10271,5495,4776
202011,47850,경상북도,칠곡군,50-54세,10285,5503,4782
202012,47850,경상북도,칠곡군,50-54세,10281,5495,4786
202101,47850,경상북도,칠곡군,50-54세,10344,5537,4807
202102,47850,경상북도,칠곡군,50-54세,10406,5571,4835
202103,47850,경상북도,칠곡군,50-54세,10385,5571,4814
202104,47850,경상북도,칠곡군,50-54세,10390,5579,4811
202105,47850,경상북도,칠곡군,50-54세,10414,5588,4826
202106,47850,경상북도,칠곡군,50-54세,10453,5609,4844
202007,47850,경상북도,칠곡군,55-59세,9253,5085,4168
202008,47850,경상북도,칠곡군,55-59세,9278,5103,4175
202009,47850,경상북도,칠곡군,55-59세,9283,5111,4172
202010,47850,경상북도,칠곡군,55-59세,9308,5123,4185
202011,47850,경상북도,칠곡군,55-59세,9359,5156,4203
202012,47850,경상북도,칠곡군,55-59세,9344,5154,4190
202101,47850,경상북도,칠곡군,55-59세,9329,5137,4192
202102,47850,경상북도,칠곡군,55-59세,9338,5129,4209
202103,47850,경상북도,칠곡군,55-59세,9326,5107,4219
202104,47850,경상북도,칠곡군,55-59세,9311,5086,4225
202105,47850,경상북도,칠곡군,55-59세,9294,5085,4209
202106,47850,경상북도,칠곡군,55-59세,9259,5065,4194
202007,47850,경상북도,칠곡군,60-64세,7806,4138,3668
202008,47850,경상북도,칠곡군,60-64세,7833,4166,3667
202009,47850,경상북도,칠곡군,60-64세,7911,4211,3700
202010,47850,경상북도,칠곡군,60-64세,8014,4271,3743
202011,47850,경상북도,칠곡군,60-64세,8092,4313,3779
202012,47850,경상북도,칠곡군,60-64세,8165,4357,3808
202101,47850,경상북도,칠곡군,60-64세,8225,4394,3831
202102,47850,경상북도,칠곡군,60-64세,8298,4436,3862
202103,47850,경상북도,칠곡군,60-64세,8387,4501,3886
202104,47850,경상북도,칠곡군,60-64세,8444,4538,3906
202105,47850,경상북도,칠곡군,60-64세,8443,4553,3890
202106,47850,경상북도,칠곡군,60-64세,8555,4605,3950
202007,47850,경상북도,칠곡군,65-69세,5413,2705,2708
202008,47850,경상북도,칠곡군,65-69세,5460,2722,2738
202009,47850,경상북도,칠곡군,65-69세,5493,2733,2760
202010,47850,경상북도,칠곡군,65-69세,5533,2747,2786
202011,47850,경상북도,칠곡군,65-69세,5579,2771,2808
202012,47850,경상북도,칠곡군,65-69세,5593,2773,2820
202101,47850,경상북도,칠곡군,65-69세,5654,2809,2845
202102,47850,경상북도,칠곡군,65-69세,5697,2827,2870
202103,47850,경상북도,칠곡군,65-69세,5770,2860,2910
202104,47850,경상북도,칠곡군,65-69세,5842,2900,2942
202105,47850,경상북도,칠곡군,65-69세,5865,2920,2945
202106,47850,경상북도,칠곡군,65-69세,5908,2945,2963
202007,47850,경상북도,칠곡군,70-74세,3974,1879,2095
202008,47850,경상북도,칠곡군,70-74세,3994,1894,2100
202009,47850,경상북도,칠곡군,70-74세,4017,1920,2097
202010,47850,경상북도,칠곡군,70-74세,4045,1939,2106
202011,47850,경상북도,칠곡군,70-74세,4076,1952,2124
202012,47850,경상북도,칠곡군,70-74세,4126,1975,2151
202101,47850,경상북도,칠곡군,70-74세,4162,1994,2168
202102,47850,경상북도,칠곡군,70-74세,4196,2015,2181
202103,47850,경상북도,칠곡군,70-74세,4222,2021,2201
202104,47850,경상북도,칠곡군,70-74세,4230,2023,2207
202105,47850,경상북도,칠곡군,70-74세,4224,2029,2195
202106,47850,경상북도,칠곡군,70-74세,4245,2044,2201
202007,47850,경상북도,칠곡군,75-79세,3638,1395,2243
202008,47850,경상북도,칠곡군,75-79세,3623,1390,2233
202009,47850,경상북도,칠곡군,75-79세,3609,1382,2227
202010,47850,경상북도,칠곡군,75-79세,3592,1377,2215
202011,47850,경상북도,칠곡군,75-79세,3573,1382,2191
202012,47850,경상북도,칠곡군,75-79세,3551,1371,2180
202101,47850,경상북도,칠곡군,75-79세,3529,1361,2168
202102,47850,경상북도,칠곡군,75-79세,3500,1354,2146
202103,47850,경상북도,칠곡군,75-79세,3467,1347,2120
202104,47850,경상북도,칠곡군,75-79세,3433,1337,2096
202105,47850,경상북도,칠곡군,75-79세,3399,1315,2084
202106,47850,경상북도,칠곡군,75-79세,3384,1310,2074
202007,47850,경상북도,칠곡군,80-84세,2848,956,1892
202008,47850,경상북도,칠곡군,80-84세,2835,949,1886
202009,47850,경상북도,칠곡군,80-84세,2841,958,1883
202010,47850,경상북도,칠곡군,80-84세,2838,952,1886
202011,47850,경상북도,칠곡군,80-84세,2855,951,1904
202012,47850,경상북도,칠곡군,80-84세,2857,951,1906
202101,47850,경상북도,칠곡군,80-84세,2863,957,1906
202102,47850,경상북도,칠곡군,80-84세,2866,965,1901
202103,47850,경상북도,칠곡군,80-84세,2877,966,1911
202104,47850,경상북도,칠곡군,80-84세,2879,972,1907
202105,47850,경상북도,칠곡군,80-84세,2868,982,1886
202106,47850,경상북도,칠곡군,80-84세,2873,981,1892
202007,47850,경상북도,칠곡군,85-89세,1470,462,1008
202008,47850,경상북도,칠곡군,85-89세,1492,477,1015
202009,47850,경상북도,칠곡군,85-89세,1502,476,1026
202010,47850,경상북도,칠곡군,85-89세,1521,480,1041
202011,47850,경상북도,칠곡군,85-89세,1528,483,1045
202012,47850,경상북도,칠곡군,85-89세,1549,492,1057
202101,47850,경상북도,칠곡군,85-89세,1558,495,1063
202102,47850,경상북도,칠곡군,85-89세,1580,490,1090
202103,47850,경상북도,칠곡군,85-89세,1612,500,1112
202104,47850,경상북도,칠곡군,85-89세,1625,501,1124
202105,47850,경상북도,칠곡군,85-89세,1618,492,1126
202106,47850,경상북도,칠곡군,85-89세,1630,492,1138
202007,47850,경상북도,칠곡군,90-94세,489,126,363
202008,47850,경상북도,칠곡군,90-94세,492,124,368
202009,47850,경상북도,칠곡군,90-94세,487,121,366
202010,47850,경상북도,칠곡군,90-94세,496,127,369
202011,47850,경상북도,칠곡군,90-94세,496,123,373
202012,47850,경상북도,칠곡군,90-94세,504,124,380
202101,47850,경상북도,칠곡군,90-94세,504,125,379
202102,47850,경상북도,칠곡군,90-94세,513,130,383
202103,47850,경상북도,칠곡군,90-94세,513,129,384
202104,47850,경상북도,칠곡군,90-94세,526,134,392
202105,47850,경상북도,칠곡군,90-94세,531,130,401
202106,47850,경상북도,칠곡군,90-94세,536,132,404
202007,47850,경상북도,칠곡군,95-99세,114,17,97
202008,47850,경상북도,칠곡군,95-99세,121,18,103
202009,47850,경상북도,칠곡군,95-99세,122,19,103
202010,47850,경상북도,칠곡군,95-99세,120,19,101
202011,47850,경상북도,칠곡군,95-99세,116,17,99
202012,47850,경상북도,칠곡군,95-99세,114,17,97
202101,47850,경상북도,칠곡군,95-99세,118,17,101
202102,47850,경상북도,칠곡군,95-99세,120,19,101
202103,47850,경상북도,칠곡군,95-99세,108,16,92
202104,47850,경상북도,칠곡군,95-99세,109,17,92
202105,47850,경상북도,칠곡군,95-99세,107,19,88
202106,47850,경상북도,칠곡군,95-99세,105,18,87
202007,47850,경상북도,칠곡군,100+,40,7,33
202008,47850,경상북도,칠곡군,100+,40,7,33
202009,47850,경상북도,칠곡군,100+,40,7,33
202010,47850,경상북도,칠곡군,100+,40,7,33
202011,47850,경상북도,칠곡군,100+,41,8,33
202012,47850,경상북도,칠곡군,100+,41,8,33
202101,47850,경상북도,칠곡군,100+,40,8,32
202102,47850,경상북도,칠곡군,100+,39,8,31
202103,47850,경상북도,칠곡군,100+,19,2,17
202104,47850,경상북도,칠곡군,100+,20,2,18
202105,47850,경상북도,칠곡군,100+,22,2,20
202106,47850,경상북도,칠곡군,100+,22,2,20
202007,47900,경상북도,예천군,0-4세,2087,1025,1062
202008,47900,경상북도,예천군,0-4세,2058,1021,1037
202009,47900,경상북도,예천군,0-4세,2057,1021,1036
202010,47900,경상북도,예천군,0-4세,2039,1014,1025
202011,47900,경상북도,예천군,0-4세,2030,1015,1015
202012,47900,경상북도,예천군,0-4세,2030,1018,1012
202101,47900,경상북도,예천군,0-4세,2007,1010,997
202102,47900,경상북도,예천군,0-4세,2004,1003,1001
202103,47900,경상북도,예천군,0-4세,1969,985,984
202104,47900,경상북도,예천군,0-4세,1947,971,976
202105,47900,경상북도,예천군,0-4세,1947,966,981
202106,47900,경상북도,예천군,0-4세,1933,957,976
202007,47900,경상북도,예천군,5-9세,2578,1344,1234
202008,47900,경상북도,예천군,5-9세,2585,1352,1233
202009,47900,경상북도,예천군,5-9세,2573,1348,1225
202010,47900,경상북도,예천군,5-9세,2586,1359,1227
202011,47900,경상북도,예천군,5-9세,2595,1353,1242
202012,47900,경상북도,예천군,5-9세,2609,1346,1263
202101,47900,경상북도,예천군,5-9세,2595,1330,1265
202102,47900,경상북도,예천군,5-9세,2602,1329,1273
202103,47900,경상북도,예천군,5-9세,2629,1355,1274
202104,47900,경상북도,예천군,5-9세,2617,1340,1277
202105,47900,경상북도,예천군,5-9세,2619,1341,1278
202106,47900,경상북도,예천군,5-9세,2621,1342,1279
202007,47900,경상북도,예천군,10-14세,2298,1214,1084
202008,47900,경상북도,예천군,10-14세,2302,1215,1087
202009,47900,경상북도,예천군,10-14세,2308,1216,1092
202010,47900,경상북도,예천군,10-14세,2304,1216,1088
202011,47900,경상북도,예천군,10-14세,2308,1220,1088
202012,47900,경상북도,예천군,10-14세,2320,1224,1096
202101,47900,경상북도,예천군,10-14세,2356,1256,1100
202102,47900,경상북도,예천군,10-14세,2370,1258,1112
202103,47900,경상북도,예천군,10-14세,2364,1240,1124
202104,47900,경상북도,예천군,10-14세,2392,1251,1141
202105,47900,경상북도,예천군,10-14세,2397,1250,1147
202106,47900,경상북도,예천군,10-14세,2406,1245,1161
202007,47900,경상북도,예천군,15-19세,2087,1136,951
202008,47900,경상북도,예천군,15-19세,2064,1116,948
202009,47900,경상북도,예천군,15-19세,2043,1101,942
202010,47900,경상북도,예천군,15-19세,2039,1096,943
202011,47900,경상북도,예천군,15-19세,2032,1090,942
202012,47900,경상북도,예천군,15-19세,2026,1091,935
202101,47900,경상북도,예천군,15-19세,2039,1098,941
202102,47900,경상북도,예천군,15-19세,2041,1101,940
202103,47900,경상북도,예천군,15-19세,2024,1096,928
202104,47900,경상북도,예천군,15-19세,2022,1098,924
202105,47900,경상북도,예천군,15-19세,2024,1095,929
202106,47900,경상북도,예천군,15-19세,2020,1104,916
202007,47900,경상북도,예천군,20-24세,2109,1189,920
202008,47900,경상북도,예천군,20-24세,2102,1184,918
202009,47900,경상북도,예천군,20-24세,2092,1182,910
202010,47900,경상북도,예천군,20-24세,2093,1183,910
202011,47900,경상북도,예천군,20-24세,2114,1198,916
202012,47900,경상북도,예천군,20-24세,2114,1202,912
202101,47900,경상북도,예천군,20-24세,2108,1203,905
202102,47900,경상북도,예천군,20-24세,2101,1198,903
202103,47900,경상북도,예천군,20-24세,2084,1185,899
202104,47900,경상북도,예천군,20-24세,2090,1188,902
202105,47900,경상북도,예천군,20-24세,2102,1190,912
202106,47900,경상북도,예천군,20-24세,2090,1177,913
202007,47900,경상북도,예천군,25-29세,1993,1120,873
202008,47900,경상북도,예천군,25-29세,1967,1111,856
202009,47900,경상북도,예천군,25-29세,1971,1114,857
202010,47900,경상북도,예천군,25-29세,1983,1119,864
202011,47900,경상북도,예천군,25-29세,1998,1122,876
202012,47900,경상북도,예천군,25-29세,2000,1126,874
202101,47900,경상북도,예천군,25-29세,2008,1126,882
202102,47900,경상북도,예천군,25-29세,2025,1139,886
202103,47900,경상북도,예천군,25-29세,2013,1139,874
202104,47900,경상북도,예천군,25-29세,2007,1126,881
202105,47900,경상북도,예천군,25-29세,2013,1123,890
202106,47900,경상북도,예천군,25-29세,2004,1119,885
202007,47900,경상북도,예천군,30-34세,2387,1255,1132
202008,47900,경상북도,예천군,30-34세,2346,1237,1109
202009,47900,경상북도,예천군,30-34세,2347,1243,1104
202010,47900,경상북도,예천군,30-34세,2332,1230,1102
202011,47900,경상북도,예천군,30-34세,2343,1232,1111
202012,47900,경상북도,예천군,30-34세,2327,1219,1108
202101,47900,경상북도,예천군,30-34세,2339,1215,1124
202102,47900,경상북도,예천군,30-34세,2328,1206,1122
202103,47900,경상북도,예천군,30-34세,2330,1214,1116
202104,47900,경상북도,예천군,30-34세,2331,1214,1117
202105,47900,경상북도,예천군,30-34세,2348,1228,1120
202106,47900,경상북도,예천군,30-34세,2353,1226,1127
202007,47900,경상북도,예천군,35-39세,3217,1561,1656
202008,47900,경상북도,예천군,35-39세,3196,1551,1645
202009,47900,경상북도,예천군,35-39세,3156,1528,1628
202010,47900,경상북도,예천군,35-39세,3139,1528,1611
202011,47900,경상북도,예천군,35-39세,3135,1535,1600
202012,47900,경상북도,예천군,35-39세,3144,1539,1605
202101,47900,경상북도,예천군,35-39세,3123,1544,1579
202102,47900,경상북도,예천군,35-39세,3120,1541,1579
202103,47900,경상북도,예천군,35-39세,3097,1524,1573
202104,47900,경상북도,예천군,35-39세,3082,1509,1573
202105,47900,경상북도,예천군,35-39세,3065,1491,1574
202106,47900,경상북도,예천군,35-39세,3063,1492,1571
202007,47900,경상북도,예천군,40-44세,3521,1850,1671
202008,47900,경상북도,예천군,40-44세,3525,1855,1670
202009,47900,경상북도,예천군,40-44세,3532,1852,1680
202010,47900,경상북도,예천군,40-44세,3544,1856,1688
202011,47900,경상북도,예천군,40-44세,3561,1861,1700
202012,47900,경상북도,예천군,40-44세,3553,1862,1691
202101,47900,경상북도,예천군,40-44세,3565,1853,1712
202102,47900,경상북도,예천군,40-44세,3582,1855,1727
202103,47900,경상북도,예천군,40-44세,3580,1858,1722
202104,47900,경상북도,예천군,40-44세,3591,1864,1727
202105,47900,경상북도,예천군,40-44세,3616,1873,1743
202106,47900,경상북도,예천군,40-44세,3621,1879,1742
202007,47900,경상북도,예천군,45-49세,3567,2037,1530
202008,47900,경상북도,예천군,45-49세,3561,2032,1529
202009,47900,경상북도,예천군,45-49세,3531,2012,1519
202010,47900,경상북도,예천군,45-49세,3525,2013,1512
202011,47900,경상북도,예천군,45-49세,3522,2011,1511
202012,47900,경상북도,예천군,45-49세,3534,2011,1523
202101,47900,경상북도,예천군,45-49세,3544,2021,1523
202102,47900,경상북도,예천군,45-49세,3552,2009,1543
202103,47900,경상북도,예천군,45-49세,3547,1993,1554
202104,47900,경상북도,예천군,45-49세,3569,2012,1557
202105,47900,경상북도,예천군,45-49세,3545,2007,1538
202106,47900,경상북도,예천군,45-49세,3548,1999,1549
202007,47900,경상북도,예천군,50-54세,3776,2036,1740
202008,47900,경상북도,예천군,50-54세,3750,2030,1720
202009,47900,경상북도,예천군,50-54세,3765,2029,1736
202010,47900,경상북도,예천군,50-54세,3768,2024,1744
202011,47900,경상북도,예천군,50-54세,3774,2032,1742
202012,47900,경상북도,예천군,50-54세,3761,2022,1739
202101,47900,경상북도,예천군,50-54세,3772,2026,1746
202102,47900,경상북도,예천군,50-54세,3797,2046,1751
202103,47900,경상북도,예천군,50-54세,3749,2034,1715
202104,47900,경상북도,예천군,50-54세,3734,2019,1715
202105,47900,경상북도,예천군,50-54세,3754,2032,1722
202106,47900,경상북도,예천군,50-54세,3763,2041,1722
202007,47900,경상북도,예천군,55-59세,4362,2224,2138
202008,47900,경상북도,예천군,55-59세,4337,2208,2129
202009,47900,경상북도,예천군,55-59세,4316,2188,2128
202010,47900,경상북도,예천군,55-59세,4321,2192,2129
202011,47900,경상북도,예천군,55-59세,4318,2191,2127
202012,47900,경상북도,예천군,55-59세,4329,2183,2146
202101,47900,경상북도,예천군,55-59세,4295,2178,2117
202102,47900,경상북도,예천군,55-59세,4278,2175,2103
202103,47900,경상북도,예천군,55-59세,4236,2151,2085
202104,47900,경상북도,예천군,55-59세,4237,2159,2078
202105,47900,경상북도,예천군,55-59세,4221,2152,2069
202106,47900,경상북도,예천군,55-59세,4185,2126,2059
202007,47900,경상북도,예천군,60-64세,4928,2488,2440
202008,47900,경상북도,예천군,60-64세,4923,2496,2427
202009,47900,경상북도,예천군,60-64세,4963,2520,2443
202010,47900,경상북도,예천군,60-64세,4960,2518,2442
202011,47900,경상북도,예천군,60-64세,4994,2536,2458
202012,47900,경상북도,예천군,60-64세,5022,2558,2464
202101,47900,경상북도,예천군,60-64세,5062,2580,2482
202102,47900,경상북도,예천군,60-64세,5058,2580,2478
202103,47900,경상북도,예천군,60-64세,5089,2605,2484
202104,47900,경상북도,예천군,60-64세,5105,2608,2497
202105,47900,경상북도,예천군,60-64세,5119,2619,2500
202106,47900,경상북도,예천군,60-64세,5156,2639,2517
202007,47900,경상북도,예천군,65-69세,4245,2032,2213
202008,47900,경상북도,예천군,65-69세,4263,2041,2222
202009,47900,경상북도,예천군,65-69세,4285,2060,2225
202010,47900,경상북도,예천군,65-69세,4329,2090,2239
202011,47900,경상북도,예천군,65-69세,4361,2101,2260
202012,47900,경상북도,예천군,65-69세,4400,2127,2273
202101,47900,경상북도,예천군,65-69세,4427,2137,2290
202102,47900,경상북도,예천군,65-69세,4472,2156,2316
202103,47900,경상북도,예천군,65-69세,4490,2175,2315
202104,47900,경상북도,예천군,65-69세,4532,2188,2344
202105,47900,경상북도,예천군,65-69세,4537,2195,2342
202106,47900,경상북도,예천군,65-69세,4543,2208,2335
202007,47900,경상북도,예천군,70-74세,3397,1619,1778
202008,47900,경상북도,예천군,70-74세,3406,1617,1789
202009,47900,경상북도,예천군,70-74세,3425,1623,1802
202010,47900,경상북도,예천군,70-74세,3445,1626,1819
202011,47900,경상북도,예천군,70-74세,3457,1631,1826
202012,47900,경상북도,예천군,70-74세,3466,1631,1835
202101,47900,경상북도,예천군,70-74세,3495,1647,1848
202102,47900,경상북도,예천군,70-74세,3518,1671,1847
202103,47900,경상북도,예천군,70-74세,3542,1677,1865
202104,47900,경상북도,예천군,70-74세,3558,1691,1867
202105,47900,경상북도,예천군,70-74세,3586,1695,1891
202106,47900,경상북도,예천군,70-74세,3591,1692,1899
202007,47900,경상북도,예천군,75-79세,3552,1468,2084
202008,47900,경상북도,예천군,75-79세,3522,1460,2062
202009,47900,경상북도,예천군,75-79세,3488,1443,2045
202010,47900,경상북도,예천군,75-79세,3453,1434,2019
202011,47900,경상북도,예천군,75-79세,3428,1427,2001
202012,47900,경상북도,예천군,75-79세,3361,1400,1961
202101,47900,경상북도,예천군,75-79세,3300,1378,1922
202102,47900,경상북도,예천군,75-79세,3255,1364,1891
202103,47900,경상북도,예천군,75-79세,3194,1346,1848
202104,47900,경상북도,예천군,75-79세,3143,1321,1822
202105,47900,경상북도,예천군,75-79세,3139,1322,1817
202106,47900,경상북도,예천군,75-79세,3132,1320,1812
202007,47900,경상북도,예천군,80-84세,3159,1141,2018
202008,47900,경상북도,예천군,80-84세,3145,1134,2011
202009,47900,경상북도,예천군,80-84세,3130,1125,2005
202010,47900,경상북도,예천군,80-84세,3135,1123,2012
202011,47900,경상북도,예천군,80-84세,3117,1113,2004
202012,47900,경상북도,예천군,80-84세,3116,1124,1992
202101,47900,경상북도,예천군,80-84세,3134,1127,2007
202102,47900,경상북도,예천군,80-84세,3118,1123,1995
202103,47900,경상북도,예천군,80-84세,3139,1131,2008
202104,47900,경상북도,예천군,80-84세,3141,1136,2005
202105,47900,경상북도,예천군,80-84세,3130,1129,2001
202106,47900,경상북도,예천군,80-84세,3120,1128,1992
202007,47900,경상북도,예천군,85-89세,1720,514,1206
202008,47900,경상북도,예천군,85-89세,1726,508,1218
202009,47900,경상북도,예천군,85-89세,1745,521,1224
202010,47900,경상북도,예천군,85-89세,1749,525,1224
202011,47900,경상북도,예천군,85-89세,1777,538,1239
202012,47900,경상북도,예천군,85-89세,1811,546,1265
202101,47900,경상북도,예천군,85-89세,1838,555,1283
202102,47900,경상북도,예천군,85-89세,1876,564,1312
202103,47900,경상북도,예천군,85-89세,1885,561,1324
202104,47900,경상북도,예천군,85-89세,1921,572,1349
202105,47900,경상북도,예천군,85-89세,1935,577,1358
202106,47900,경상북도,예천군,85-89세,1931,576,1355
202007,47900,경상북도,예천군,90-94세,520,84,436
202008,47900,경상북도,예천군,90-94세,537,89,448
202009,47900,경상북도,예천군,90-94세,543,91,452
202010,47900,경상북도,예천군,90-94세,547,92,455
202011,47900,경상북도,예천군,90-94세,549,94,455
202012,47900,경상북도,예천군,90-94세,549,93,456
202101,47900,경상북도,예천군,90-94세,559,97,462
202102,47900,경상북도,예천군,90-94세,565,94,471
202103,47900,경상북도,예천군,90-94세,556,95,461
202104,47900,경상북도,예천군,90-94세,562,100,462
202105,47900,경상북도,예천군,90-94세,567,103,464
202106,47900,경상북도,예천군,90-94세,568,100,468
202007,47900,경상북도,예천군,95-99세,115,28,87
202008,47900,경상북도,예천군,95-99세,109,27,82
202009,47900,경상북도,예천군,95-99세,112,28,84
202010,47900,경상북도,예천군,95-99세,112,28,84
202011,47900,경상북도,예천군,95-99세,111,27,84
202012,47900,경상북도,예천군,95-99세,107,27,80
202101,47900,경상북도,예천군,95-99세,109,27,82
202102,47900,경상북도,예천군,95-99세,112,26,86
202103,47900,경상북도,예천군,95-99세,107,25,82
202104,47900,경상북도,예천군,95-99세,111,24,87
202105,47900,경상북도,예천군,95-99세,113,26,87
202106,47900,경상북도,예천군,95-99세,114,27,87
202007,47900,경상북도,예천군,100+,34,4,30
202008,47900,경상북도,예천군,100+,33,4,29
202009,47900,경상북도,예천군,100+,34,3,31
202010,47900,경상북도,예천군,100+,34,3,31
202011,47900,경상북도,예천군,100+,34,3,31
202012,47900,경상북도,예천군,100+,34,3,31
202101,47900,경상북도,예천군,100+,34,3,31
202102,47900,경상북도,예천군,100+,33,3,30
202103,47900,경상북도,예천군,100+,25,2,23
202104,47900,경상북도,예천군,100+,24,2,22
202105,47900,경상북도,예천군,100+,23,2,21
202106,47900,경상북도,예천군,100+,22,1,21
202007,47920,경상북도,봉화군,0-4세,653,333,320
202008,47920,경상북도,봉화군,0-4세,643,324,319
202009,47920,경상북도,봉화군,0-4세,631,318,313
202010,47920,경상북도,봉화군,0-4세,628,310,318
202011,47920,경상북도,봉화군,0-4세,621,305,316
202012,47920,경상북도,봉화군,0-4세,625,309,316
202101,47920,경상북도,봉화군,0-4세,610,300,310
202102,47920,경상북도,봉화군,0-4세,600,293,307
202103,47920,경상북도,봉화군,0-4세,589,289,300
202104,47920,경상북도,봉화군,0-4세,583,284,299
202105,47920,경상북도,봉화군,0-4세,573,278,295
202106,47920,경상북도,봉화군,0-4세,563,274,289
202007,47920,경상북도,봉화군,5-9세,803,420,383
202008,47920,경상북도,봉화군,5-9세,804,426,378
202009,47920,경상북도,봉화군,5-9세,795,421,374
202010,47920,경상북도,봉화군,5-9세,793,421,372
202011,47920,경상북도,봉화군,5-9세,777,412,365
202012,47920,경상북도,봉화군,5-9세,760,404,356
202101,47920,경상북도,봉화군,5-9세,752,400,352
202102,47920,경상북도,봉화군,5-9세,747,395,352
202103,47920,경상북도,봉화군,5-9세,753,398,355
202104,47920,경상북도,봉화군,5-9세,747,395,352
202105,47920,경상북도,봉화군,5-9세,739,393,346
202106,47920,경상북도,봉화군,5-9세,736,395,341
202007,47920,경상북도,봉화군,10-14세,839,431,408
202008,47920,경상북도,봉화군,10-14세,837,429,408
202009,47920,경상북도,봉화군,10-14세,847,436,411
202010,47920,경상북도,봉화군,10-14세,845,439,406
202011,47920,경상북도,봉화군,10-14세,857,445,412
202012,47920,경상북도,봉화군,10-14세,870,449,421
202101,47920,경상북도,봉화군,10-14세,874,452,422
202102,47920,경상북도,봉화군,10-14세,872,450,422
202103,47920,경상북도,봉화군,10-14세,859,449,410
202104,47920,경상북도,봉화군,10-14세,859,442,417
202105,47920,경상북도,봉화군,10-14세,855,438,417
202106,47920,경상북도,봉화군,10-14세,845,432,413
202007,47920,경상북도,봉화군,15-19세,1054,584,470
202008,47920,경상북도,봉화군,15-19세,1044,579,465
202009,47920,경상북도,봉화군,15-19세,1026,569,457
202010,47920,경상북도,봉화군,15-19세,1013,559,454
202011,47920,경상북도,봉화군,15-19세,1002,555,447
202012,47920,경상북도,봉화군,15-19세,997,553,444
202101,47920,경상북도,봉화군,15-19세,989,549,440
202102,47920,경상북도,봉화군,15-19세,972,542,430
202103,47920,경상북도,봉화군,15-19세,986,532,454
202104,47920,경상북도,봉화군,15-19세,998,537,461
202105,47920,경상북도,봉화군,15-19세,999,538,461
202106,47920,경상북도,봉화군,15-19세,1007,541,466
202007,47920,경상북도,봉화군,20-24세,1139,658,481
202008,47920,경상북도,봉화군,20-24세,1124,651,473
202009,47920,경상북도,봉화군,20-24세,1115,647,468
202010,47920,경상북도,봉화군,20-24세,1124,654,470
202011,47920,경상북도,봉화군,20-24세,1116,649,467
202012,47920,경상북도,봉화군,20-24세,1099,634,465
202101,47920,경상북도,봉화군,20-24세,1085,629,456
202102,47920,경상북도,봉화군,20-24세,1062,619,443
202103,47920,경상북도,봉화군,20-24세,1033,612,421
202104,47920,경상북도,봉화군,20-24세,1028,614,414
202105,47920,경상북도,봉화군,20-24세,1031,617,414
202106,47920,경상북도,봉화군,20-24세,1025,612,413
202007,47920,경상북도,봉화군,25-29세,938,556,382
202008,47920,경상북도,봉화군,25-29세,921,546,375
202009,47920,경상북도,봉화군,25-29세,921,545,376
202010,47920,경상북도,봉화군,25-29세,906,534,372
202011,47920,경상북도,봉화군,25-29세,914,535,379
202012,47920,경상북도,봉화군,25-29세,909,543,366
202101,47920,경상북도,봉화군,25-29세,899,540,359
202102,47920,경상북도,봉화군,25-29세,893,541,352
202103,47920,경상북도,봉화군,25-29세,877,536,341
202104,47920,경상북도,봉화군,25-29세,883,537,346
202105,47920,경상북도,봉화군,25-29세,874,530,344
202106,47920,경상북도,봉화군,25-29세,874,529,345
202007,47920,경상북도,봉화군,30-34세,889,500,389
202008,47920,경상북도,봉화군,30-34세,882,498,384
202009,47920,경상북도,봉화군,30-34세,876,491,385
202010,47920,경상북도,봉화군,30-34세,886,499,387
202011,47920,경상북도,봉화군,30-34세,868,486,382
202012,47920,경상북도,봉화군,30-34세,859,484,375
202101,47920,경상북도,봉화군,30-34세,844,482,362
202102,47920,경상북도,봉화군,30-34세,828,471,357
202103,47920,경상북도,봉화군,30-34세,832,472,360
202104,47920,경상북도,봉화군,30-34세,835,476,359
202105,47920,경상북도,봉화군,30-34세,823,472,351
202106,47920,경상북도,봉화군,30-34세,813,471,342
202007,47920,경상북도,봉화군,35-39세,1144,604,540
202008,47920,경상북도,봉화군,35-39세,1125,592,533
202009,47920,경상북도,봉화군,35-39세,1116,588,528
202010,47920,경상북도,봉화군,35-39세,1114,588,526
202011,47920,경상북도,봉화군,35-39세,1094,580,514
202012,47920,경상북도,봉화군,35-39세,1085,569,516
202101,47920,경상북도,봉화군,35-39세,1067,564,503
202102,47920,경상북도,봉화군,35-39세,1064,563,501
202103,47920,경상북도,봉화군,35-39세,1049,556,493
202104,47920,경상북도,봉화군,35-39세,1039,551,488
202105,47920,경상북도,봉화군,35-39세,1037,548,489
202106,47920,경상북도,봉화군,35-39세,1029,535,494
202007,47920,경상북도,봉화군,40-44세,1383,820,563
202008,47920,경상북도,봉화군,40-44세,1379,811,568
202009,47920,경상북도,봉화군,40-44세,1370,803,567
202010,47920,경상북도,봉화군,40-44세,1358,800,558
202011,47920,경상북도,봉화군,40-44세,1353,787,566
202012,47920,경상북도,봉화군,40-44세,1339,781,558
202101,47920,경상북도,봉화군,40-44세,1347,778,569
202102,47920,경상북도,봉화군,40-44세,1346,772,574
202103,47920,경상북도,봉화군,40-44세,1347,769,578
202104,47920,경상북도,봉화군,40-44세,1340,765,575
202105,47920,경상북도,봉화군,40-44세,1324,756,568
202106,47920,경상북도,봉화군,40-44세,1323,761,562
202007,47920,경상북도,봉화군,45-49세,1905,1112,793
202008,47920,경상북도,봉화군,45-49세,1908,1111,797
202009,47920,경상북도,봉화군,45-49세,1895,1107,788
202010,47920,경상북도,봉화군,45-49세,1894,1104,790
202011,47920,경상북도,봉화군,45-49세,1895,1111,784
202012,47920,경상북도,봉화군,45-49세,1892,1111,781
202101,47920,경상북도,봉화군,45-49세,1859,1089,770
202102,47920,경상북도,봉화군,45-49세,1838,1079,759
202103,47920,경상북도,봉화군,45-49세,1827,1075,752
202104,47920,경상북도,봉화군,45-49세,1823,1076,747
202105,47920,경상북도,봉화군,45-49세,1810,1071,739
202106,47920,경상북도,봉화군,45-49세,1798,1069,729
202007,47920,경상북도,봉화군,50-54세,2546,1380,1166
202008,47920,경상북도,봉화군,50-54세,2514,1372,1142
202009,47920,경상북도,봉화군,50-54세,2525,1378,1147
202010,47920,경상북도,봉화군,50-54세,2524,1385,1139
202011,47920,경상북도,봉화군,50-54세,2508,1373,1135
202012,47920,경상북도,봉화군,50-54세,2482,1359,1123
202101,47920,경상북도,봉화군,50-54세,2489,1367,1122
202102,47920,경상북도,봉화군,50-54세,2482,1373,1109
202103,47920,경상북도,봉화군,50-54세,2460,1356,1104
202104,47920,경상북도,봉화군,50-54세,2444,1339,1105
202105,47920,경상북도,봉화군,50-54세,2429,1326,1103
202106,47920,경상북도,봉화군,50-54세,2420,1323,1097
202007,47920,경상북도,봉화군,55-59세,3329,1778,1551
202008,47920,경상북도,봉화군,55-59세,3351,1792,1559
202009,47920,경상북도,봉화군,55-59세,3312,1772,1540
202010,47920,경상북도,봉화군,55-59세,3293,1767,1526
202011,47920,경상북도,봉화군,55-59세,3295,1767,1528
202012,47920,경상북도,봉화군,55-59세,3287,1761,1526
202101,47920,경상북도,봉화군,55-59세,3257,1742,1515
202102,47920,경상북도,봉화군,55-59세,3251,1733,1518
202103,47920,경상북도,봉화군,55-59세,3209,1715,1494
202104,47920,경상북도,봉화군,55-59세,3213,1725,1488
202105,47920,경상북도,봉화군,55-59세,3182,1715,1467
202106,47920,경상북도,봉화군,55-59세,3152,1692,1460
202007,47920,경상북도,봉화군,60-64세,3701,1944,1757
202008,47920,경상북도,봉화군,60-64세,3690,1931,1759
202009,47920,경상북도,봉화군,60-64세,3694,1922,1772
202010,47920,경상북도,봉화군,60-64세,3710,1925,1785
202011,47920,경상북도,봉화군,60-64세,3713,1925,1788
202012,47920,경상북도,봉화군,60-64세,3723,1930,1793
202101,47920,경상북도,봉화군,60-64세,3734,1932,1802
202102,47920,경상북도,봉화군,60-64세,3754,1944,1810
202103,47920,경상북도,봉화군,60-64세,3771,1955,1816
202104,47920,경상북도,봉화군,60-64세,3796,1965,1831
202105,47920,경상북도,봉화군,60-64세,3807,1971,1836
202106,47920,경상북도,봉화군,60-64세,3823,1982,1841
202007,47920,경상북도,봉화군,65-69세,2982,1525,1457
202008,47920,경상북도,봉화군,65-69세,3012,1545,1467
202009,47920,경상북도,봉화군,65-69세,3045,1563,1482
202010,47920,경상북도,봉화군,65-69세,3070,1587,1483
202011,47920,경상북도,봉화군,65-69세,3077,1583,1494
202012,47920,경상북도,봉화군,65-69세,3103,1601,1502
202101,47920,경상북도,봉화군,65-69세,3122,1618,1504
202102,47920,경상북도,봉화군,65-69세,3121,1616,1505
202103,47920,경상북도,봉화군,65-69세,3150,1631,1519
202104,47920,경상북도,봉화군,65-69세,3163,1647,1516
202105,47920,경상북도,봉화군,65-69세,3180,1658,1522
202106,47920,경상북도,봉화군,65-69세,3212,1680,1532
202007,47920,경상북도,봉화군,70-74세,2321,1141,1180
202008,47920,경상북도,봉화군,70-74세,2336,1147,1189
202009,47920,경상북도,봉화군,70-74세,2359,1165,1194
202010,47920,경상북도,봉화군,70-74세,2366,1162,1204
202011,47920,경상북도,봉화군,70-74세,2386,1182,1204
202012,47920,경상북도,봉화군,70-74세,2411,1195,1216
202101,47920,경상북도,봉화군,70-74세,2437,1207,1230
202102,47920,경상북도,봉화군,70-74세,2452,1212,1240
202103,47920,경상북도,봉화군,70-74세,2469,1221,1248
202104,47920,경상북도,봉화군,70-74세,2483,1228,1255
202105,47920,경상북도,봉화군,70-74세,2492,1231,1261
202106,47920,경상북도,봉화군,70-74세,2489,1226,1263
202007,47920,경상북도,봉화군,75-79세,2455,988,1467
202008,47920,경상북도,봉화군,75-79세,2421,976,1445
202009,47920,경상북도,봉화군,75-79세,2394,954,1440
202010,47920,경상북도,봉화군,75-79세,2379,951,1428
202011,47920,경상북도,봉화군,75-79세,2352,942,1410
202012,47920,경상북도,봉화군,75-79세,2322,925,1397
202101,47920,경상북도,봉화군,75-79세,2285,905,1380
202102,47920,경상북도,봉화군,75-79세,2245,901,1344
202103,47920,경상북도,봉화군,75-79세,2212,887,1325
202104,47920,경상북도,봉화군,75-79세,2184,887,1297
202105,47920,경상북도,봉화군,75-79세,2163,883,1280
202106,47920,경상북도,봉화군,75-79세,2154,879,1275
202007,47920,경상북도,봉화군,80-84세,2084,764,1320
202008,47920,경상북도,봉화군,80-84세,2094,765,1329
202009,47920,경상북도,봉화군,80-84세,2083,772,1311
202010,47920,경상북도,봉화군,80-84세,2086,772,1314
202011,47920,경상북도,봉화군,80-84세,2079,764,1315
202012,47920,경상북도,봉화군,80-84세,2072,763,1309
202101,47920,경상북도,봉화군,80-84세,2068,767,1301
202102,47920,경상북도,봉화군,80-84세,2087,771,1316
202103,47920,경상북도,봉화군,80-84세,2085,776,1309
202104,47920,경상북도,봉화군,80-84세,2087,772,1315
202105,47920,경상북도,봉화군,80-84세,2091,769,1322
202106,47920,경상북도,봉화군,80-84세,2092,774,1318
202007,47920,경상북도,봉화군,85-89세,1100,348,752
202008,47920,경상북도,봉화군,85-89세,1102,344,758
202009,47920,경상북도,봉화군,85-89세,1109,349,760
202010,47920,경상북도,봉화군,85-89세,1107,345,762
202011,47920,경상북도,봉화군,85-89세,1112,352,760
202012,47920,경상북도,봉화군,85-89세,1126,356,770
202101,47920,경상북도,봉화군,85-89세,1152,368,784
202102,47920,경상북도,봉화군,85-89세,1164,369,795
202103,47920,경상북도,봉화군,85-89세,1177,381,796
202104,47920,경상북도,봉화군,85-89세,1181,376,805
202105,47920,경상북도,봉화군,85-89세,1198,384,814
202106,47920,경상북도,봉화군,85-89세,1202,384,818
202007,47920,경상북도,봉화군,90-94세,380,97,283
202008,47920,경상북도,봉화군,90-94세,379,98,281
202009,47920,경상북도,봉화군,90-94세,387,102,285
202010,47920,경상북도,봉화군,90-94세,394,104,290
202011,47920,경상북도,봉화군,90-94세,399,106,293
202012,47920,경상북도,봉화군,90-94세,397,106,291
202101,47920,경상북도,봉화군,90-94세,398,108,290
202102,47920,경상북도,봉화군,90-94세,394,108,286
202103,47920,경상북도,봉화군,90-94세,399,111,288
202104,47920,경상북도,봉화군,90-94세,402,112,290
202105,47920,경상북도,봉화군,90-94세,394,110,284
202106,47920,경상북도,봉화군,90-94세,388,107,281
202007,47920,경상북도,봉화군,95-99세,105,17,88
202008,47920,경상북도,봉화군,95-99세,106,16,90
202009,47920,경상북도,봉화군,95-99세,107,15,92
202010,47920,경상북도,봉화군,95-99세,106,14,92
202011,47920,경상북도,봉화군,95-99세,108,14,94
202012,47920,경상북도,봉화군,95-99세,106,15,91
202101,47920,경상북도,봉화군,95-99세,109,15,94
202102,47920,경상북도,봉화군,95-99세,114,16,98
202103,47920,경상북도,봉화군,95-99세,118,15,103
202104,47920,경상북도,봉화군,95-99세,117,14,103
202105,47920,경상북도,봉화군,95-99세,116,13,103
202106,47920,경상북도,봉화군,95-99세,113,13,100
202007,47920,경상북도,봉화군,100+,27,5,22
202008,47920,경상북도,봉화군,100+,29,5,24
202009,47920,경상북도,봉화군,100+,30,5,25
202010,47920,경상북도,봉화군,100+,29,5,24
202011,47920,경상북도,봉화군,100+,29,5,24
202012,47920,경상북도,봉화군,100+,30,5,25
202101,47920,경상북도,봉화군,100+,30,5,25
202102,47920,경상북도,봉화군,100+,31,5,26
202103,47920,경상북도,봉화군,100+,30,4,26
202104,47920,경상북도,봉화군,100+,31,4,27
202105,47920,경상북도,봉화군,100+,25,1,24
202106,47920,경상북도,봉화군,100+,26,1,25
202007,47930,경상북도,울진군,0-4세,1319,668,651
202008,47930,경상북도,울진군,0-4세,1311,659,652
202009,47930,경상북도,울진군,0-4세,1321,665,656
202010,47930,경상북도,울진군,0-4세,1303,655,648
202011,47930,경상북도,울진군,0-4세,1298,651,647
202012,47930,경상북도,울진군,0-4세,1285,648,637
202101,47930,경상북도,울진군,0-4세,1273,650,623
202102,47930,경상북도,울진군,0-4세,1240,640,600
202103,47930,경상북도,울진군,0-4세,1218,638,580
202104,47930,경상북도,울진군,0-4세,1210,640,570
202105,47930,경상북도,울진군,0-4세,1203,636,567
202106,47930,경상북도,울진군,0-4세,1203,637,566
202007,47930,경상북도,울진군,5-9세,1642,841,801
202008,47930,경상북도,울진군,5-9세,1636,840,796
202009,47930,경상북도,울진군,5-9세,1640,846,794
202010,47930,경상북도,울진군,5-9세,1643,845,798
202011,47930,경상북도,울진군,5-9세,1636,839,797
202012,47930,경상북도,울진군,5-9세,1648,846,802
202101,47930,경상북도,울진군,5-9세,1633,835,798
202102,47930,경상북도,울진군,5-9세,1619,821,798
202103,47930,경상북도,울진군,5-9세,1612,825,787
202104,47930,경상북도,울진군,5-9세,1614,823,791
202105,47930,경상북도,울진군,5-9세,1613,819,794
202106,47930,경상북도,울진군,5-9세,1599,813,786
202007,47930,경상북도,울진군,10-14세,1706,928,778
202008,47930,경상북도,울진군,10-14세,1706,922,784
202009,47930,경상북도,울진군,10-14세,1696,920,776
202010,47930,경상북도,울진군,10-14세,1699,921,778
202011,47930,경상북도,울진군,10-14세,1685,914,771
202012,47930,경상북도,울진군,10-14세,1678,915,763
202101,47930,경상북도,울진군,10-14세,1679,913,766
202102,47930,경상북도,울진군,10-14세,1667,901,766
202103,47930,경상북도,울진군,10-14세,1666,892,774
202104,47930,경상북도,울진군,10-14세,1669,895,774
202105,47930,경상북도,울진군,10-14세,1665,885,780
202106,47930,경상북도,울진군,10-14세,1673,890,783
202007,47930,경상북도,울진군,15-19세,2132,1165,967
202008,47930,경상북도,울진군,15-19세,2112,1150,962
202009,47930,경상북도,울진군,15-19세,2096,1136,960
202010,47930,경상북도,울진군,15-19세,2093,1139,954
202011,47930,경상북도,울진군,15-19세,2096,1148,948
202012,47930,경상북도,울진군,15-19세,2075,1133,942
202101,47930,경상북도,울진군,15-19세,2061,1114,947
202102,47930,경상북도,울진군,15-19세,2026,1100,926
202103,47930,경상북도,울진군,15-19세,2015,1089,926
202104,47930,경상북도,울진군,15-19세,1995,1075,920
202105,47930,경상북도,울진군,15-19세,1985,1077,908
202106,47930,경상북도,울진군,15-19세,1976,1069,907
202007,47930,경상북도,울진군,20-24세,2371,1379,992
202008,47930,경상북도,울진군,20-24세,2373,1376,997
202009,47930,경상북도,울진군,20-24세,2378,1385,993
202010,47930,경상북도,울진군,20-24세,2372,1370,1002
202011,47930,경상북도,울진군,20-24세,2356,1359,997
202012,47930,경상북도,울진군,20-24세,2342,1359,983
202101,47930,경상북도,울진군,20-24세,2346,1359,987
202102,47930,경상북도,울진군,20-24세,2318,1349,969
202103,47930,경상북도,울진군,20-24세,2280,1329,951
202104,47930,경상북도,울진군,20-24세,2284,1324,960
202105,47930,경상북도,울진군,20-24세,2279,1311,968
202106,47930,경상북도,울진군,20-24세,2289,1316,973
202007,47930,경상북도,울진군,25-29세,2126,1273,853
202008,47930,경상북도,울진군,25-29세,2122,1273,849
202009,47930,경상북도,울진군,25-29세,2136,1285,851
202010,47930,경상북도,울진군,25-29세,2146,1297,849
202011,47930,경상북도,울진군,25-29세,2142,1306,836
202012,47930,경상북도,울진군,25-29세,2143,1307,836
202101,47930,경상북도,울진군,25-29세,2130,1303,827
202102,47930,경상북도,울진군,25-29세,2109,1294,815
202103,47930,경상북도,울진군,25-29세,2101,1297,804
202104,47930,경상북도,울진군,25-29세,2099,1305,794
202105,47930,경상북도,울진군,25-29세,2098,1307,791
202106,47930,경상북도,울진군,25-29세,2109,1308,801
202007,47930,경상북도,울진군,30-34세,1985,1127,858
202008,47930,경상북도,울진군,30-34세,1991,1133,858
202009,47930,경상북도,울진군,30-34세,1991,1133,858
202010,47930,경상북도,울진군,30-34세,1983,1122,861
202011,47930,경상북도,울진군,30-34세,1981,1119,862
202012,47930,경상북도,울진군,30-34세,1981,1120,861
202101,47930,경상북도,울진군,30-34세,1986,1126,860
202102,47930,경상북도,울진군,30-34세,1960,1113,847
202103,47930,경상북도,울진군,30-34세,1956,1114,842
202104,47930,경상북도,울진군,30-34세,1950,1115,835
202105,47930,경상북도,울진군,30-34세,1955,1120,835
202106,47930,경상북도,울진군,30-34세,1947,1112,835
202007,47930,경상북도,울진군,35-39세,2393,1260,1133
202008,47930,경상북도,울진군,35-39세,2367,1243,1124
202009,47930,경상북도,울진군,35-39세,2354,1236,1118
202010,47930,경상북도,울진군,35-39세,2331,1230,1101
202011,47930,경상북도,울진군,35-39세,2316,1217,1099
202012,47930,경상북도,울진군,35-39세,2309,1214,1095
202101,47930,경상북도,울진군,35-39세,2307,1211,1096
202102,47930,경상북도,울진군,35-39세,2284,1194,1090
202103,47930,경상북도,울진군,35-39세,2248,1176,1072
202104,47930,경상북도,울진군,35-39세,2231,1169,1062
202105,47930,경상북도,울진군,35-39세,2211,1160,1051
202106,47930,경상북도,울진군,35-39세,2183,1148,1035
202007,47930,경상북도,울진군,40-44세,2750,1468,1282
202008,47930,경상북도,울진군,40-44세,2758,1478,1280
202009,47930,경상북도,울진군,40-44세,2767,1479,1288
202010,47930,경상북도,울진군,40-44세,2780,1481,1299
202011,47930,경상북도,울진군,40-44세,2798,1498,1300
202012,47930,경상북도,울진군,40-44세,2803,1498,1305
202101,47930,경상북도,울진군,40-44세,2778,1479,1299
202102,47930,경상북도,울진군,40-44세,2743,1463,1280
202103,47930,경상북도,울진군,40-44세,2723,1453,1270
202104,47930,경상북도,울진군,40-44세,2713,1441,1272
202105,47930,경상북도,울진군,40-44세,2733,1450,1283
202106,47930,경상북도,울진군,40-44세,2742,1455,1287
202007,47930,경상북도,울진군,45-49세,3573,1996,1577
202008,47930,경상북도,울진군,45-49세,3557,1990,1567
202009,47930,경상북도,울진군,45-49세,3552,1988,1564
202010,47930,경상북도,울진군,45-49세,3526,1970,1556
202011,47930,경상북도,울진군,45-49세,3482,1938,1544
202012,47930,경상북도,울진군,45-49세,3460,1937,1523
202101,47930,경상북도,울진군,45-49세,3453,1936,1517
202102,47930,경상북도,울진군,45-49세,3430,1932,1498
202103,47930,경상북도,울진군,45-49세,3414,1918,1496
202104,47930,경상북도,울진군,45-49세,3397,1911,1486
202105,47930,경상북도,울진군,45-49세,3369,1894,1475
202106,47930,경상북도,울진군,45-49세,3343,1880,1463
202007,47930,경상북도,울진군,50-54세,4056,2223,1833
202008,47930,경상북도,울진군,50-54세,4059,2226,1833
202009,47930,경상북도,울진군,50-54세,4032,2214,1818
202010,47930,경상북도,울진군,50-54세,4041,2229,1812
202011,47930,경상북도,울진군,50-54세,4075,2264,1811
202012,47930,경상북도,울진군,50-54세,4073,2263,1810
202101,47930,경상북도,울진군,50-54세,4089,2278,1811
202102,47930,경상북도,울진군,50-54세,4095,2264,1831
202103,47930,경상북도,울진군,50-54세,4084,2266,1818
202104,47930,경상북도,울진군,50-54세,4075,2264,1811
202105,47930,경상북도,울진군,50-54세,4076,2258,1818
202106,47930,경상북도,울진군,50-54세,4070,2258,1812
202007,47930,경상북도,울진군,55-59세,4626,2457,2169
202008,47930,경상북도,울진군,55-59세,4620,2456,2164
202009,47930,경상북도,울진군,55-59세,4611,2457,2154
202010,47930,경상북도,울진군,55-59세,4586,2438,2148
202011,47930,경상북도,울진군,55-59세,4562,2416,2146
202012,47930,경상북도,울진군,55-59세,4569,2415,2154
202101,47930,경상북도,울진군,55-59세,4513,2380,2133
202102,47930,경상북도,울진군,55-59세,4471,2360,2111
202103,47930,경상북도,울진군,55-59세,4442,2371,2071
202104,47930,경상북도,울진군,55-59세,4435,2379,2056
202105,47930,경상북도,울진군,55-59세,4418,2382,2036
202106,47930,경상북도,울진군,55-59세,4361,2361,2000
202007,47930,경상북도,울진군,60-64세,4591,2280,2311
202008,47930,경상북도,울진군,60-64세,4612,2292,2320
202009,47930,경상북도,울진군,60-64세,4646,2304,2342
202010,47930,경상북도,울진군,60-64세,4659,2320,2339
202011,47930,경상북도,울진군,60-64세,4689,2350,2339
202012,47930,경상북도,울진군,60-64세,4707,2372,2335
202101,47930,경상북도,울진군,60-64세,4759,2395,2364
202102,47930,경상북도,울진군,60-64세,4790,2417,2373
202103,47930,경상북도,울진군,60-64세,4802,2416,2386
202104,47930,경상북도,울진군,60-64세,4830,2425,2405
202105,47930,경상북도,울진군,60-64세,4862,2450,2412
202106,47930,경상북도,울진군,60-64세,4875,2457,2418
202007,47930,경상북도,울진군,65-69세,3379,1634,1745
202008,47930,경상북도,울진군,65-69세,3407,1641,1766
202009,47930,경상북도,울진군,65-69세,3425,1660,1765
202010,47930,경상북도,울진군,65-69세,3440,1667,1773
202011,47930,경상북도,울진군,65-69세,3472,1684,1788
202012,47930,경상북도,울진군,65-69세,3496,1689,1807
202101,47930,경상북도,울진군,65-69세,3496,1686,1810
202102,47930,경상북도,울진군,65-69세,3535,1705,1830
202103,47930,경상북도,울진군,65-69세,3624,1744,1880
202104,47930,경상북도,울진군,65-69세,3655,1749,1906
202105,47930,경상북도,울진군,65-69세,3678,1763,1915
202106,47930,경상북도,울진군,65-69세,3712,1790,1922
202007,47930,경상북도,울진군,70-74세,2793,1355,1438
202008,47930,경상북도,울진군,70-74세,2795,1365,1430
202009,47930,경상북도,울진군,70-74세,2820,1376,1444
202010,47930,경상북도,울진군,70-74세,2847,1390,1457
202011,47930,경상북도,울진군,70-74세,2861,1391,1470
202012,47930,경상북도,울진군,70-74세,2875,1400,1475
202101,47930,경상북도,울진군,70-74세,2912,1425,1487
202102,47930,경상북도,울진군,70-74세,2914,1422,1492
202103,47930,경상북도,울진군,70-74세,2885,1407,1478
202104,47930,경상북도,울진군,70-74세,2863,1389,1474
202105,47930,경상북도,울진군,70-74세,2859,1380,1479
202106,47930,경상북도,울진군,70-74세,2843,1367,1476
202007,47930,경상북도,울진군,75-79세,2948,1110,1838
202008,47930,경상북도,울진군,75-79세,2941,1110,1831
202009,47930,경상북도,울진군,75-79세,2918,1103,1815
202010,47930,경상북도,울진군,75-79세,2871,1092,1779
202011,47930,경상북도,울진군,75-79세,2842,1077,1765
202012,47930,경상북도,울진군,75-79세,2804,1051,1753
202101,47930,경상북도,울진군,75-79세,2774,1047,1727
202102,47930,경상북도,울진군,75-79세,2741,1034,1707
202103,47930,경상북도,울진군,75-79세,2755,1042,1713
202104,47930,경상북도,울진군,75-79세,2743,1043,1700
202105,47930,경상북도,울진군,75-79세,2714,1047,1667
202106,47930,경상북도,울진군,75-79세,2712,1054,1658
202007,47930,경상북도,울진군,80-84세,2464,823,1641
202008,47930,경상북도,울진군,80-84세,2442,810,1632
202009,47930,경상북도,울진군,80-84세,2435,804,1631
202010,47930,경상북도,울진군,80-84세,2451,804,1647
202011,47930,경상북도,울진군,80-84세,2446,806,1640
202012,47930,경상북도,울진군,80-84세,2447,812,1635
202101,47930,경상북도,울진군,80-84세,2447,804,1643
202102,47930,경상북도,울진군,80-84세,2465,817,1648
202103,47930,경상북도,울진군,80-84세,2457,818,1639
202104,47930,경상북도,울진군,80-84세,2470,825,1645
202105,47930,경상북도,울진군,80-84세,2482,821,1661
202106,47930,경상북도,울진군,80-84세,2471,815,1656
202007,47930,경상북도,울진군,85-89세,1306,329,977
202008,47930,경상북도,울진군,85-89세,1332,338,994
202009,47930,경상북도,울진군,85-89세,1337,340,997
202010,47930,경상북도,울진군,85-89세,1348,343,1005
202011,47930,경상북도,울진군,85-89세,1353,344,1009
202012,47930,경상북도,울진군,85-89세,1365,356,1009
202101,47930,경상북도,울진군,85-89세,1378,366,1012
202102,47930,경상북도,울진군,85-89세,1387,370,1017
202103,47930,경상북도,울진군,85-89세,1402,375,1027
202104,47930,경상북도,울진군,85-89세,1409,377,1032
202105,47930,경상북도,울진군,85-89세,1424,378,1046
202106,47930,경상북도,울진군,85-89세,1409,368,1041
202007,47930,경상북도,울진군,90-94세,502,76,426
202008,47930,경상북도,울진군,90-94세,507,80,427
202009,47930,경상북도,울진군,90-94세,519,88,431
202010,47930,경상북도,울진군,90-94세,520,90,430
202011,47930,경상북도,울진군,90-94세,517,91,426
202012,47930,경상북도,울진군,90-94세,518,92,426
202101,47930,경상북도,울진군,90-94세,519,91,428
202102,47930,경상북도,울진군,90-94세,524,93,431
202103,47930,경상북도,울진군,90-94세,532,94,438
202104,47930,경상북도,울진군,90-94세,534,98,436
202105,47930,경상북도,울진군,90-94세,538,99,439
202106,47930,경상북도,울진군,90-94세,547,102,445
202007,47930,경상북도,울진군,95-99세,110,15,95
202008,47930,경상북도,울진군,95-99세,111,15,96
202009,47930,경상북도,울진군,95-99세,115,15,100
202010,47930,경상북도,울진군,95-99세,120,14,106
202011,47930,경상북도,울진군,95-99세,119,12,107
202012,47930,경상북도,울진군,95-99세,122,12,110
202101,47930,경상북도,울진군,95-99세,126,12,114
202102,47930,경상북도,울진군,95-99세,126,12,114
202103,47930,경상북도,울진군,95-99세,129,11,118
202104,47930,경상북도,울진군,95-99세,134,12,122
202105,47930,경상북도,울진군,95-99세,134,13,121
202106,47930,경상북도,울진군,95-99세,128,13,115
202007,47930,경상북도,울진군,100+,17,2,15
202008,47930,경상북도,울진군,100+,17,2,15
202009,47930,경상북도,울진군,100+,17,2,15
202010,47930,경상북도,울진군,100+,17,2,15
202011,47930,경상북도,울진군,100+,17,2,15
202012,47930,경상북도,울진군,100+,16,2,14
202101,47930,경상북도,울진군,100+,16,2,14
202102,47930,경상북도,울진군,100+,16,2,14
202103,47930,경상북도,울진군,100+,16,3,13
202104,47930,경상북도,울진군,100+,17,3,14
202105,47930,경상북도,울진군,100+,17,2,15
202106,47930,경상북도,울진군,100+,14,0,14
202007,47940,경상북도,울릉군,0-4세,175,103,72
202008,47940,경상북도,울릉군,0-4세,172,100,72
202009,47940,경상북도,울릉군,0-4세,175,104,71
202010,47940,경상북도,울릉군,0-4세,174,101,73
202011,47940,경상북도,울릉군,0-4세,170,98,72
202012,47940,경상북도,울릉군,0-4세,170,96,74
202101,47940,경상북도,울릉군,0-4세,166,92,74
202102,47940,경상북도,울릉군,0-4세,169,91,78
202103,47940,경상북도,울릉군,0-4세,167,93,74
202104,47940,경상북도,울릉군,0-4세,164,91,73
202105,47940,경상북도,울릉군,0-4세,159,87,72
202106,47940,경상북도,울릉군,0-4세,158,87,71
202007,47940,경상북도,울릉군,5-9세,250,117,133
202008,47940,경상북도,울릉군,5-9세,245,114,131
202009,47940,경상북도,울릉군,5-9세,241,115,126
202010,47940,경상북도,울릉군,5-9세,234,114,120
202011,47940,경상북도,울릉군,5-9세,229,111,118
202012,47940,경상북도,울릉군,5-9세,222,107,115
202101,47940,경상북도,울릉군,5-9세,222,108,114
202102,47940,경상북도,울릉군,5-9세,225,111,114
202103,47940,경상북도,울릉군,5-9세,225,109,116
202104,47940,경상북도,울릉군,5-9세,228,110,118
202105,47940,경상북도,울릉군,5-9세,232,112,120
202106,47940,경상북도,울릉군,5-9세,241,114,127
202007,47940,경상북도,울릉군,10-14세,229,113,116
202008,47940,경상북도,울릉군,10-14세,226,111,115
202009,47940,경상북도,울릉군,10-14세,228,110,118
202010,47940,경상북도,울릉군,10-14세,229,111,118
202011,47940,경상북도,울릉군,10-14세,230,113,117
202012,47940,경상북도,울릉군,10-14세,229,113,116
202101,47940,경상북도,울릉군,10-14세,227,114,113
202102,47940,경상북도,울릉군,10-14세,226,114,112
202103,47940,경상북도,울릉군,10-14세,226,115,111
202104,47940,경상북도,울릉군,10-14세,224,115,109
202105,47940,경상북도,울릉군,10-14세,226,116,110
202106,47940,경상북도,울릉군,10-14세,228,117,111
202007,47940,경상북도,울릉군,15-19세,247,124,123
202008,47940,경상북도,울릉군,15-19세,246,125,121
202009,47940,경상북도,울릉군,15-19세,246,125,121
202010,47940,경상북도,울릉군,15-19세,242,121,121
202011,47940,경상북도,울릉군,15-19세,238,122,116
202012,47940,경상북도,울릉군,15-19세,234,120,114
202101,47940,경상북도,울릉군,15-19세,227,119,108
202102,47940,경상북도,울릉군,15-19세,220,115,105
202103,47940,경상북도,울릉군,15-19세,226,115,111
202104,47940,경상북도,울릉군,15-19세,221,112,109
202105,47940,경상북도,울릉군,15-19세,222,113,109
202106,47940,경상북도,울릉군,15-19세,222,114,108
202007,47940,경상북도,울릉군,20-24세,392,229,163
202008,47940,경상북도,울릉군,20-24세,386,222,164
202009,47940,경상북도,울릉군,20-24세,390,222,168
202010,47940,경상북도,울릉군,20-24세,396,223,173
202011,47940,경상북도,울릉군,20-24세,394,221,173
202012,47940,경상북도,울릉군,20-24세,400,227,173
202101,47940,경상북도,울릉군,20-24세,398,224,174
202102,47940,경상북도,울릉군,20-24세,387,220,167
202103,47940,경상북도,울릉군,20-24세,372,212,160
202104,47940,경상북도,울릉군,20-24세,378,217,161
202105,47940,경상북도,울릉군,20-24세,380,217,163
202106,47940,경상북도,울릉군,20-24세,380,217,163
202007,47940,경상북도,울릉군,25-29세,454,276,178
202008,47940,경상북도,울릉군,25-29세,445,273,172
202009,47940,경상북도,울릉군,25-29세,442,271,171
202010,47940,경상북도,울릉군,25-29세,457,291,166
202011,47940,경상북도,울릉군,25-29세,442,283,159
202012,47940,경상북도,울릉군,25-29세,433,279,154
202101,47940,경상북도,울릉군,25-29세,428,272,156
202102,47940,경상북도,울릉군,25-29세,439,285,154
202103,47940,경상북도,울릉군,25-29세,436,281,155
202104,47940,경상북도,울릉군,25-29세,446,289,157
202105,47940,경상북도,울릉군,25-29세,440,285,155
202106,47940,경상북도,울릉군,25-29세,429,282,147
202007,47940,경상북도,울릉군,30-34세,388,241,147
202008,47940,경상북도,울릉군,30-34세,383,235,148
202009,47940,경상북도,울릉군,30-34세,377,235,142
202010,47940,경상북도,울릉군,30-34세,370,231,139
202011,47940,경상북도,울릉군,30-34세,363,229,134
202012,47940,경상북도,울릉군,30-34세,364,225,139
202101,47940,경상북도,울릉군,30-34세,360,227,133
202102,47940,경상북도,울릉군,30-34세,376,235,141
202103,47940,경상북도,울릉군,30-34세,376,237,139
202104,47940,경상북도,울릉군,30-34세,375,236,139
202105,47940,경상북도,울릉군,30-34세,373,235,138
202106,47940,경상북도,울릉군,30-34세,377,232,145
202007,47940,경상북도,울릉군,35-39세,545,314,231
202008,47940,경상북도,울릉군,35-39세,533,310,223
202009,47940,경상북도,울릉군,35-39세,523,304,219
202010,47940,경상북도,울릉군,35-39세,519,305,214
202011,47940,경상북도,울릉군,35-39세,505,298,207
202012,47940,경상북도,울릉군,35-39세,488,286,202
202101,47940,경상북도,울릉군,35-39세,485,281,204
202102,47940,경상북도,울릉군,35-39세,481,285,196
202103,47940,경상북도,울릉군,35-39세,479,287,192
202104,47940,경상북도,울릉군,35-39세,476,285,191
202105,47940,경상북도,울릉군,35-39세,477,287,190
202106,47940,경상북도,울릉군,35-39세,476,285,191
202007,47940,경상북도,울릉군,40-44세,580,344,236
202008,47940,경상북도,울릉군,40-44세,570,335,235
202009,47940,경상북도,울릉군,40-44세,570,337,233
202010,47940,경상북도,울릉군,40-44세,565,332,233
202011,47940,경상북도,울릉군,40-44세,564,332,232
202012,47940,경상북도,울릉군,40-44세,551,331,220
202101,47940,경상북도,울릉군,40-44세,546,329,217
202102,47940,경상북도,울릉군,40-44세,540,330,210
202103,47940,경상북도,울릉군,40-44세,539,324,215
202104,47940,경상북도,울릉군,40-44세,542,325,217
202105,47940,경상북도,울릉군,40-44세,542,328,214
202106,47940,경상북도,울릉군,40-44세,548,333,215
202007,47940,경상북도,울릉군,45-49세,745,478,267
202008,47940,경상북도,울릉군,45-49세,746,480,266
202009,47940,경상북도,울릉군,45-49세,745,473,272
202010,47940,경상북도,울릉군,45-49세,742,474,268
202011,47940,경상북도,울릉군,45-49세,733,464,269
202012,47940,경상북도,울릉군,45-49세,739,460,279
202101,47940,경상북도,울릉군,45-49세,741,461,280
202102,47940,경상북도,울릉군,45-49세,738,455,283
202103,47940,경상북도,울릉군,45-49세,718,441,277
202104,47940,경상북도,울릉군,45-49세,714,443,271
202105,47940,경상북도,울릉군,45-49세,711,439,272
202106,47940,경상북도,울릉군,45-49세,712,438,274
202007,47940,경상북도,울릉군,50-54세,892,527,365
202008,47940,경상북도,울릉군,50-54세,891,529,362
202009,47940,경상북도,울릉군,50-54세,880,521,359
202010,47940,경상북도,울릉군,50-54세,880,521,359
202011,47940,경상북도,울릉군,50-54세,880,525,355
202012,47940,경상북도,울릉군,50-54세,861,513,348
202101,47940,경상북도,울릉군,50-54세,856,510,346
202102,47940,경상북도,울릉군,50-54세,856,517,339
202103,47940,경상북도,울릉군,50-54세,853,518,335
202104,47940,경상북도,울릉군,50-54세,852,517,335
202105,47940,경상북도,울릉군,50-54세,852,516,336
202106,47940,경상북도,울릉군,50-54세,854,522,332
202007,47940,경상북도,울릉군,55-59세,994,552,442
202008,47940,경상북도,울릉군,55-59세,992,552,440
202009,47940,경상북도,울릉군,55-59세,989,555,434
202010,47940,경상북도,울릉군,55-59세,998,567,431
202011,47940,경상북도,울릉군,55-59세,993,567,426
202012,47940,경상북도,울릉군,55-59세,987,566,421
202101,47940,경상북도,울릉군,55-59세,974,561,413
202102,47940,경상북도,울릉군,55-59세,970,557,413
202103,47940,경상북도,울릉군,55-59세,964,554,410
202104,47940,경상북도,울릉군,55-59세,959,551,408
202105,47940,경상북도,울릉군,55-59세,950,549,401
202106,47940,경상북도,울릉군,55-59세,939,541,398
202007,47940,경상북도,울릉군,60-64세,995,540,455
202008,47940,경상북도,울릉군,60-64세,1005,543,462
202009,47940,경상북도,울릉군,60-64세,1009,542,467
202010,47940,경상북도,울릉군,60-64세,1010,540,470
202011,47940,경상북도,울릉군,60-64세,1008,533,475
202012,47940,경상북도,울릉군,60-64세,1013,534,479
202101,47940,경상북도,울릉군,60-64세,1008,531,477
202102,47940,경상북도,울릉군,60-64세,1021,544,477
202103,47940,경상북도,울릉군,60-64세,1026,546,480
202104,47940,경상북도,울릉군,60-64세,1031,549,482
202105,47940,경상북도,울릉군,60-64세,1038,551,487
202106,47940,경상북도,울릉군,60-64세,1037,548,489
202007,47940,경상북도,울릉군,65-69세,750,387,363
202008,47940,경상북도,울릉군,65-69세,752,391,361
202009,47940,경상북도,울릉군,65-69세,754,396,358
202010,47940,경상북도,울릉군,65-69세,759,399,360
202011,47940,경상북도,울릉군,65-69세,751,397,354
202012,47940,경상북도,울릉군,65-69세,753,401,352
202101,47940,경상북도,울릉군,65-69세,759,397,362
202102,47940,경상북도,울릉군,65-69세,757,397,360
202103,47940,경상북도,울릉군,65-69세,752,394,358
202104,47940,경상북도,울릉군,65-69세,758,396,362
202105,47940,경상북도,울릉군,65-69세,759,402,357
202106,47940,경상북도,울릉군,65-69세,746,391,355
202007,47940,경상북도,울릉군,70-74세,561,272,289
202008,47940,경상북도,울릉군,70-74세,567,279,288
202009,47940,경상북도,울릉군,70-74세,571,278,293
202010,47940,경상북도,울릉군,70-74세,573,275,298
202011,47940,경상북도,울릉군,70-74세,579,278,301
202012,47940,경상북도,울릉군,70-74세,577,274,303
202101,47940,경상북도,울릉군,70-74세,580,280,300
202102,47940,경상북도,울릉군,70-74세,583,279,304
202103,47940,경상북도,울릉군,70-74세,593,287,306
202104,47940,경상북도,울릉군,70-74세,593,290,303
202105,47940,경상북도,울릉군,70-74세,602,294,308
202106,47940,경상북도,울릉군,70-74세,602,293,309
202007,47940,경상북도,울릉군,75-79세,470,198,272
202008,47940,경상북도,울릉군,75-79세,471,197,274
202009,47940,경상북도,울릉군,75-79세,467,198,269
202010,47940,경상북도,울릉군,75-79세,467,202,265
202011,47940,경상북도,울릉군,75-79세,465,201,264
202012,47940,경상북도,울릉군,75-79세,468,205,263
202101,47940,경상북도,울릉군,75-79세,470,205,265
202102,47940,경상북도,울릉군,75-79세,466,204,262
202103,47940,경상북도,울릉군,75-79세,464,204,260
202104,47940,경상북도,울릉군,75-79세,466,204,262
202105,47940,경상북도,울릉군,75-79세,459,200,259
202106,47940,경상북도,울릉군,75-79세,451,198,253
202007,47940,경상북도,울릉군,80-84세,325,143,182
202008,47940,경상북도,울릉군,80-84세,324,140,184
202009,47940,경상북도,울릉군,80-84세,325,140,185
202010,47940,경상북도,울릉군,80-84세,326,139,187
202011,47940,경상북도,울릉군,80-84세,324,138,186
202012,47940,경상북도,울릉군,80-84세,322,133,189
202101,47940,경상북도,울릉군,80-84세,321,134,187
202102,47940,경상북도,울릉군,80-84세,325,137,188
202103,47940,경상북도,울릉군,80-84세,325,136,189
202104,47940,경상북도,울릉군,80-84세,332,138,194
202105,47940,경상북도,울릉군,80-84세,331,138,193
202106,47940,경상북도,울릉군,80-84세,326,138,188
202007,47940,경상북도,울릉군,85-89세,169,54,115
202008,47940,경상북도,울릉군,85-89세,169,56,113
202009,47940,경상북도,울릉군,85-89세,173,57,116
202010,47940,경상북도,울릉군,85-89세,171,58,113
202011,47940,경상북도,울릉군,85-89세,170,56,114
202012,47940,경상북도,울릉군,85-89세,176,59,117
202101,47940,경상북도,울릉군,85-89세,176,61,115
202102,47940,경상북도,울릉군,85-89세,176,62,114
202103,47940,경상북도,울릉군,85-89세,184,64,120
202104,47940,경상북도,울릉군,85-89세,181,66,115
202105,47940,경상북도,울릉군,85-89세,181,67,114
202106,47940,경상북도,울릉군,85-89세,178,63,115
202007,47940,경상북도,울릉군,90-94세,59,17,42
202008,47940,경상북도,울릉군,90-94세,58,16,42
202009,47940,경상북도,울릉군,90-94세,56,16,40
202010,47940,경상북도,울릉군,90-94세,57,16,41
202011,47940,경상북도,울릉군,90-94세,59,17,42
202012,47940,경상북도,울릉군,90-94세,60,18,42
202101,47940,경상북도,울릉군,90-94세,61,17,44
202102,47940,경상북도,울릉군,90-94세,62,16,46
202103,47940,경상북도,울릉군,90-94세,61,16,45
202104,47940,경상북도,울릉군,90-94세,63,17,46
202105,47940,경상북도,울릉군,90-94세,66,17,49
202106,47940,경상북도,울릉군,90-94세,65,16,49
202007,47940,경상북도,울릉군,95-99세,19,5,14
202008,47940,경상북도,울릉군,95-99세,19,5,14
202009,47940,경상북도,울릉군,95-99세,19,5,14
202010,47940,경상북도,울릉군,95-99세,19,5,14
202011,47940,경상북도,울릉군,95-99세,19,5,14
202012,47940,경상북도,울릉군,95-99세,18,4,14
202101,47940,경상북도,울릉군,95-99세,18,5,13
202102,47940,경상북도,울릉군,95-99세,21,6,15
202103,47940,경상북도,울릉군,95-99세,19,6,13
202104,47940,경상북도,울릉군,95-99세,18,5,13
202105,47940,경상북도,울릉군,95-99세,18,5,13
202106,47940,경상북도,울릉군,95-99세,18,6,12
202007,47940,경상북도,울릉군,100+,11,5,6
202008,47940,경상북도,울릉군,100+,11,5,6
202009,47940,경상북도,울릉군,100+,11,5,6
202010,47940,경상북도,울릉군,100+,12,5,7
202011,47940,경상북도,울릉군,100+,12,5,7
202012,47940,경상북도,울릉군,100+,12,5,7
202101,47940,경상북도,울릉군,100+,12,5,7
202102,47940,경상북도,울릉군,100+,12,5,7
202103,47940,경상북도,울릉군,100+,14,5,9
202104,47940,경상북도,울릉군,100+,14,5,9
202105,47940,경상북도,울릉군,100+,14,5,9
202106,47940,경상북도,울릉군,100+,3,0,3
202007,48121,경상남도,창원시 의창구,0-4세,9798,5028,4770
202008,48121,경상남도,창원시 의창구,0-4세,9770,5019,4751
202009,48121,경상남도,창원시 의창구,0-4세,9665,4958,4707
202010,48121,경상남도,창원시 의창구,0-4세,9534,4882,4652
202011,48121,경상남도,창원시 의창구,0-4세,9447,4835,4612
202012,48121,경상남도,창원시 의창구,0-4세,9387,4812,4575
202101,48121,경상남도,창원시 의창구,0-4세,9235,4725,4510
202102,48121,경상남도,창원시 의창구,0-4세,9125,4664,4461
202103,48121,경상남도,창원시 의창구,0-4세,9020,4622,4398
202104,48121,경상남도,창원시 의창구,0-4세,8940,4600,4340
202105,48121,경상남도,창원시 의창구,0-4세,8901,4574,4327
202106,48121,경상남도,창원시 의창구,0-4세,8850,4555,4295
202007,48121,경상남도,창원시 의창구,5-9세,12254,6316,5938
202008,48121,경상남도,창원시 의창구,5-9세,12222,6283,5939
202009,48121,경상남도,창원시 의창구,5-9세,12229,6287,5942
202010,48121,경상남도,창원시 의창구,5-9세,12203,6292,5911
202011,48121,경상남도,창원시 의창구,5-9세,12141,6256,5885
202012,48121,경상남도,창원시 의창구,5-9세,12104,6230,5874
202101,48121,경상남도,창원시 의창구,5-9세,12084,6214,5870
202102,48121,경상남도,창원시 의창구,5-9세,12038,6188,5850
202103,48121,경상남도,창원시 의창구,5-9세,12045,6184,5861
202104,48121,경상남도,창원시 의창구,5-9세,11999,6145,5854
202105,48121,경상남도,창원시 의창구,5-9세,11973,6126,5847
202106,48121,경상남도,창원시 의창구,5-9세,11941,6112,5829
202007,48121,경상남도,창원시 의창구,10-14세,11287,5849,5438
202008,48121,경상남도,창원시 의창구,10-14세,11304,5845,5459
202009,48121,경상남도,창원시 의창구,10-14세,11350,5873,5477
202010,48121,경상남도,창원시 의창구,10-14세,11397,5886,5511
202011,48121,경상남도,창원시 의창구,10-14세,11419,5898,5521
202012,48121,경상남도,창원시 의창구,10-14세,11462,5912,5550
202101,48121,경상남도,창원시 의창구,10-14세,11453,5917,5536
202102,48121,경상남도,창원시 의창구,10-14세,11461,5915,5546
202103,48121,경상남도,창원시 의창구,10-14세,11513,5931,5582
202104,48121,경상남도,창원시 의창구,10-14세,11542,5956,5586
202105,48121,경상남도,창원시 의창구,10-14세,11551,5973,5578
202106,48121,경상남도,창원시 의창구,10-14세,11564,5977,5587
202007,48121,경상남도,창원시 의창구,15-19세,12633,6747,5886
202008,48121,경상남도,창원시 의창구,15-19세,12563,6727,5836
202009,48121,경상남도,창원시 의창구,15-19세,12469,6662,5807
202010,48121,경상남도,창원시 의창구,15-19세,12367,6624,5743
202011,48121,경상남도,창원시 의창구,15-19세,12245,6580,5665
202012,48121,경상남도,창원시 의창구,15-19세,12187,6558,5629
202101,48121,경상남도,창원시 의창구,15-19세,12078,6497,5581
202102,48121,경상남도,창원시 의창구,15-19세,11987,6471,5516
202103,48121,경상남도,창원시 의창구,15-19세,11783,6386,5397
202104,48121,경상남도,창원시 의창구,15-19세,11661,6314,5347
202105,48121,경상남도,창원시 의창구,15-19세,11608,6281,5327
202106,48121,경상남도,창원시 의창구,15-19세,11548,6248,5300
202007,48121,경상남도,창원시 의창구,20-24세,17927,9962,7965
202008,48121,경상남도,창원시 의창구,20-24세,17876,9934,7942
202009,48121,경상남도,창원시 의창구,20-24세,17793,9907,7886
202010,48121,경상남도,창원시 의창구,20-24세,17725,9857,7868
202011,48121,경상남도,창원시 의창구,20-24세,17614,9782,7832
202012,48121,경상남도,창원시 의창구,20-24세,17477,9722,7755
202101,48121,경상남도,창원시 의창구,20-24세,17384,9646,7738
202102,48121,경상남도,창원시 의창구,20-24세,17235,9549,7686
202103,48121,경상남도,창원시 의창구,20-24세,17097,9460,7637
202104,48121,경상남도,창원시 의창구,20-24세,17052,9445,7607
202105,48121,경상남도,창원시 의창구,20-24세,16938,9376,7562
202106,48121,경상남도,창원시 의창구,20-24세,16846,9301,7545
202007,48121,경상남도,창원시 의창구,25-29세,18545,10247,8298
202008,48121,경상남도,창원시 의창구,25-29세,18541,10265,8276
202009,48121,경상남도,창원시 의창구,25-29세,18547,10288,8259
202010,48121,경상남도,창원시 의창구,25-29세,18567,10320,8247
202011,48121,경상남도,창원시 의창구,25-29세,18506,10287,8219
202012,48121,경상남도,창원시 의창구,25-29세,18422,10248,8174
202101,48121,경상남도,창원시 의창구,25-29세,18304,10211,8093
202102,48121,경상남도,창원시 의창구,25-29세,18210,10152,8058
202103,48121,경상남도,창원시 의창구,25-29세,18227,10187,8040
202104,48121,경상남도,창원시 의창구,25-29세,18130,10130,8000
202105,48121,경상남도,창원시 의창구,25-29세,18148,10140,8008
202106,48121,경상남도,창원시 의창구,25-29세,18143,10152,7991
202007,48121,경상남도,창원시 의창구,30-34세,16061,8693,7368
202008,48121,경상남도,창원시 의창구,30-34세,16077,8700,7377
202009,48121,경상남도,창원시 의창구,30-34세,16057,8690,7367
202010,48121,경상남도,창원시 의창구,30-34세,16044,8662,7382
202011,48121,경상남도,창원시 의창구,30-34세,16010,8664,7346
202012,48121,경상남도,창원시 의창구,30-34세,15998,8645,7353
202101,48121,경상남도,창원시 의창구,30-34세,15962,8580,7382
202102,48121,경상남도,창원시 의창구,30-34세,15999,8615,7384
202103,48121,경상남도,창원시 의창구,30-34세,16048,8623,7425
202104,48121,경상남도,창원시 의창구,30-34세,16059,8627,7432
202105,48121,경상남도,창원시 의창구,30-34세,16027,8612,7415
202106,48121,경상남도,창원시 의창구,30-34세,15990,8594,7396
202007,48121,경상남도,창원시 의창구,35-39세,19871,10272,9599
202008,48121,경상남도,창원시 의창구,35-39세,19812,10246,9566
202009,48121,경상남도,창원시 의창구,35-39세,19721,10186,9535
202010,48121,경상남도,창원시 의창구,35-39세,19623,10146,9477
202011,48121,경상남도,창원시 의창구,35-39세,19455,10060,9395
202012,48121,경상남도,창원시 의창구,35-39세,19338,10043,9295
202101,48121,경상남도,창원시 의창구,35-39세,19172,9993,9179
202102,48121,경상남도,창원시 의창구,35-39세,19017,9946,9071
202103,48121,경상남도,창원시 의창구,35-39세,18904,9885,9019
202104,48121,경상남도,창원시 의창구,35-39세,18815,9825,8990
202105,48121,경상남도,창원시 의창구,35-39세,18733,9784,8949
202106,48121,경상남도,창원시 의창구,35-39세,18566,9702,8864
202007,48121,경상남도,창원시 의창구,40-44세,19166,9950,9216
202008,48121,경상남도,창원시 의창구,40-44세,19242,9972,9270
202009,48121,경상남도,창원시 의창구,40-44세,19336,10027,9309
202010,48121,경상남도,창원시 의창구,40-44세,19412,10061,9351
202011,48121,경상남도,창원시 의창구,40-44세,19471,10084,9387
202012,48121,경상남도,창원시 의창구,40-44세,19423,10043,9380
202101,48121,경상남도,창원시 의창구,40-44세,19399,10060,9339
202102,48121,경상남도,창원시 의창구,40-44세,19369,10049,9320
202103,48121,경상남도,창원시 의창구,40-44세,19318,10024,9294
202104,48121,경상남도,창원시 의창구,40-44세,19278,10013,9265
202105,48121,경상남도,창원시 의창구,40-44세,19322,10034,9288
202106,48121,경상남도,창원시 의창구,40-44세,19442,10099,9343
202007,48121,경상남도,창원시 의창구,45-49세,22212,10892,11320
202008,48121,경상남도,창원시 의창구,45-49세,22128,10855,11273
202009,48121,경상남도,창원시 의창구,45-49세,21934,10760,11174
202010,48121,경상남도,창원시 의창구,45-49세,21776,10699,11077
202011,48121,경상남도,창원시 의창구,45-49세,21662,10644,11018
202012,48121,경상남도,창원시 의창구,45-49세,21633,10653,10980
202101,48121,경상남도,창원시 의창구,45-49세,21570,10610,10960
202102,48121,경상남도,창원시 의창구,45-49세,21432,10538,10894
202103,48121,경상남도,창원시 의창구,45-49세,21330,10507,10823
202104,48121,경상남도,창원시 의창구,45-49세,21293,10502,10791
202105,48121,경상남도,창원시 의창구,45-49세,21186,10441,10745
202106,48121,경상남도,창원시 의창구,45-49세,21095,10378,10717
202007,48121,경상남도,창원시 의창구,50-54세,25679,12299,13380
202008,48121,경상남도,창원시 의창구,50-54세,25690,12304,13386
202009,48121,경상남도,창원시 의창구,50-54세,25705,12313,13392
202010,48121,경상남도,창원시 의창구,50-54세,25716,12316,13400
202011,48121,경상남도,창원시 의창구,50-54세,25690,12296,13394
202012,48121,경상남도,창원시 의창구,50-54세,25540,12219,13321
202101,48121,경상남도,창원시 의창구,50-54세,25534,12215,13319
202102,48121,경상남도,창원시 의창구,50-54세,25482,12198,13284
202103,48121,경상남도,창원시 의창구,50-54세,25286,12116,13170
202104,48121,경상남도,창원시 의창구,50-54세,25184,12026,13158
202105,48121,경상남도,창원시 의창구,50-54세,25149,12019,13130
202106,48121,경상남도,창원시 의창구,50-54세,25123,12021,13102
202007,48121,경상남도,창원시 의창구,55-59세,25166,12803,12363
202008,48121,경상남도,창원시 의창구,55-59세,25106,12765,12341
202009,48121,경상남도,창원시 의창구,55-59세,25026,12710,12316
202010,48121,경상남도,창원시 의창구,55-59세,24989,12696,12293
202011,48121,경상남도,창원시 의창구,55-59세,24938,12642,12296
202012,48121,경상남도,창원시 의창구,55-59세,25045,12643,12402
202101,48121,경상남도,창원시 의창구,55-59세,24901,12577,12324
202102,48121,경상남도,창원시 의창구,55-59세,24830,12522,12308
202103,48121,경상남도,창원시 의창구,55-59세,24804,12486,12318
202104,48121,경상남도,창원시 의창구,55-59세,24769,12478,12291
202105,48121,경상남도,창원시 의창구,55-59세,24579,12382,12197
202106,48121,경상남도,창원시 의창구,55-59세,24394,12284,12110
202007,48121,경상남도,창원시 의창구,60-64세,20496,10438,10058
202008,48121,경상남도,창원시 의창구,60-64세,20623,10508,10115
202009,48121,경상남도,창원시 의창구,60-64세,20782,10612,10170
202010,48121,경상남도,창원시 의창구,60-64세,20972,10711,10261
202011,48121,경상남도,창원시 의창구,60-64세,21126,10797,10329
202012,48121,경상남도,창원시 의창구,60-64세,21171,10838,10333
202101,48121,경상남도,창원시 의창구,60-64세,21369,10937,10432
202102,48121,경상남도,창원시 의창구,60-64세,21539,11017,10522
202103,48121,경상남도,창원시 의창구,60-64세,21716,11098,10618
202104,48121,경상남도,창원시 의창구,60-64세,21850,11161,10689
202105,48121,경상남도,창원시 의창구,60-64세,22027,11235,10792
202106,48121,경상남도,창원시 의창구,60-64세,22154,11312,10842
202007,48121,경상남도,창원시 의창구,65-69세,12724,6447,6277
202008,48121,경상남도,창원시 의창구,65-69세,12896,6520,6376
202009,48121,경상남도,창원시 의창구,65-69세,13026,6554,6472
202010,48121,경상남도,창원시 의창구,65-69세,13118,6585,6533
202011,48121,경상남도,창원시 의창구,65-69세,13215,6649,6566
202012,48121,경상남도,창원시 의창구,65-69세,13359,6738,6621
202101,48121,경상남도,창원시 의창구,65-69세,13450,6783,6667
202102,48121,경상남도,창원시 의창구,65-69세,13561,6837,6724
202103,48121,경상남도,창원시 의창구,65-69세,13740,6919,6821
202104,48121,경상남도,창원시 의창구,65-69세,13853,6964,6889
202105,48121,경상남도,창원시 의창구,65-69세,13935,7018,6917
202106,48121,경상남도,창원시 의창구,65-69세,14062,7064,6998
202007,48121,경상남도,창원시 의창구,70-74세,7720,3904,3816
202008,48121,경상남도,창원시 의창구,70-74세,7730,3901,3829
202009,48121,경상남도,창원시 의창구,70-74세,7778,3930,3848
202010,48121,경상남도,창원시 의창구,70-74세,7874,3971,3903
202011,48121,경상남도,창원시 의창구,70-74세,7971,4017,3954
202012,48121,경상남도,창원시 의창구,70-74세,8034,4021,4013
202101,48121,경상남도,창원시 의창구,70-74세,8124,4066,4058
202102,48121,경상남도,창원시 의창구,70-74세,8195,4107,4088
202103,48121,경상남도,창원시 의창구,70-74세,8264,4141,4123
202104,48121,경상남도,창원시 의창구,70-74세,8344,4188,4156
202105,48121,경상남도,창원시 의창구,70-74세,8409,4212,4197
202106,48121,경상남도,창원시 의창구,70-74세,8433,4232,4201
202007,48121,경상남도,창원시 의창구,75-79세,5420,2308,3112
202008,48121,경상남도,창원시 의창구,75-79세,5422,2324,3098
202009,48121,경상남도,창원시 의창구,75-79세,5399,2325,3074
202010,48121,경상남도,창원시 의창구,75-79세,5372,2321,3051
202011,48121,경상남도,창원시 의창구,75-79세,5344,2320,3024
202012,48121,경상남도,창원시 의창구,75-79세,5304,2316,2988
202101,48121,경상남도,창원시 의창구,75-79세,5273,2300,2973
202102,48121,경상남도,창원시 의창구,75-79세,5258,2297,2961
202103,48121,경상남도,창원시 의창구,75-79세,5240,2292,2948
202104,48121,경상남도,창원시 의창구,75-79세,5191,2283,2908
202105,48121,경상남도,창원시 의창구,75-79세,5196,2293,2903
202106,48121,경상남도,창원시 의창구,75-79세,5216,2297,2919
202007,48121,경상남도,창원시 의창구,80-84세,3674,1247,2427
202008,48121,경상남도,창원시 의창구,80-84세,3686,1242,2444
202009,48121,경상남도,창원시 의창구,80-84세,3687,1233,2454
202010,48121,경상남도,창원시 의창구,80-84세,3693,1237,2456
202011,48121,경상남도,창원시 의창구,80-84세,3692,1234,2458
202012,48121,경상남도,창원시 의창구,80-84세,3698,1233,2465
202101,48121,경상남도,창원시 의창구,80-84세,3695,1245,2450
202102,48121,경상남도,창원시 의창구,80-84세,3726,1258,2468
202103,48121,경상남도,창원시 의창구,80-84세,3724,1272,2452
202104,48121,경상남도,창원시 의창구,80-84세,3734,1273,2461
202105,48121,경상남도,창원시 의창구,80-84세,3736,1275,2461
202106,48121,경상남도,창원시 의창구,80-84세,3742,1279,2463
202007,48121,경상남도,창원시 의창구,85-89세,1949,493,1456
202008,48121,경상남도,창원시 의창구,85-89세,1945,494,1451
202009,48121,경상남도,창원시 의창구,85-89세,1956,509,1447
202010,48121,경상남도,창원시 의창구,85-89세,1977,513,1464
202011,48121,경상남도,창원시 의창구,85-89세,1989,520,1469
202012,48121,경상남도,창원시 의창구,85-89세,2015,529,1486
202101,48121,경상남도,창원시 의창구,85-89세,2029,545,1484
202102,48121,경상남도,창원시 의창구,85-89세,2038,550,1488
202103,48121,경상남도,창원시 의창구,85-89세,2045,547,1498
202104,48121,경상남도,창원시 의창구,85-89세,2064,555,1509
202105,48121,경상남도,창원시 의창구,85-89세,2063,551,1512
202106,48121,경상남도,창원시 의창구,85-89세,2055,554,1501
202007,48121,경상남도,창원시 의창구,90-94세,640,109,531
202008,48121,경상남도,창원시 의창구,90-94세,645,112,533
202009,48121,경상남도,창원시 의창구,90-94세,654,112,542
202010,48121,경상남도,창원시 의창구,90-94세,640,112,528
202011,48121,경상남도,창원시 의창구,90-94세,649,114,535
202012,48121,경상남도,창원시 의창구,90-94세,650,114,536
202101,48121,경상남도,창원시 의창구,90-94세,659,117,542
202102,48121,경상남도,창원시 의창구,90-94세,664,119,545
202103,48121,경상남도,창원시 의창구,90-94세,677,126,551
202104,48121,경상남도,창원시 의창구,90-94세,692,128,564
202105,48121,경상남도,창원시 의창구,90-94세,700,132,568
202106,48121,경상남도,창원시 의창구,90-94세,694,130,564
202007,48121,경상남도,창원시 의창구,95-99세,117,21,96
202008,48121,경상남도,창원시 의창구,95-99세,118,21,97
202009,48121,경상남도,창원시 의창구,95-99세,120,20,100
202010,48121,경상남도,창원시 의창구,95-99세,124,22,102
202011,48121,경상남도,창원시 의창구,95-99세,122,21,101
202012,48121,경상남도,창원시 의창구,95-99세,125,21,104
202101,48121,경상남도,창원시 의창구,95-99세,134,21,113
202102,48121,경상남도,창원시 의창구,95-99세,136,20,116
202103,48121,경상남도,창원시 의창구,95-99세,135,18,117
202104,48121,경상남도,창원시 의창구,95-99세,136,18,118
202105,48121,경상남도,창원시 의창구,95-99세,136,17,119
202106,48121,경상남도,창원시 의창구,95-99세,137,18,119
202007,48121,경상남도,창원시 의창구,100+,34,6,28
202008,48121,경상남도,창원시 의창구,100+,36,6,30
202009,48121,경상남도,창원시 의창구,100+,37,6,31
202010,48121,경상남도,창원시 의창구,100+,38,6,32
202011,48121,경상남도,창원시 의창구,100+,37,6,31
202012,48121,경상남도,창원시 의창구,100+,36,6,30
202101,48121,경상남도,창원시 의창구,100+,36,6,30
202102,48121,경상남도,창원시 의창구,100+,37,7,30
202103,48121,경상남도,창원시 의창구,100+,37,7,30
202104,48121,경상남도,창원시 의창구,100+,37,7,30
202105,48121,경상남도,창원시 의창구,100+,29,5,24
202106,48121,경상남도,창원시 의창구,100+,23,5,18
202007,48123,경상남도,창원시 성산구,0-4세,7236,3698,3538
202008,48123,경상남도,창원시 성산구,0-4세,7157,3643,3514
202009,48123,경상남도,창원시 성산구,0-4세,7066,3602,3464
202010,48123,경상남도,창원시 성산구,0-4세,6964,3547,3417
202011,48123,경상남도,창원시 성산구,0-4세,6857,3486,3371
202012,48123,경상남도,창원시 성산구,0-4세,6805,3467,3338
202101,48123,경상남도,창원시 성산구,0-4세,6688,3407,3281
202102,48123,경상남도,창원시 성산구,0-4세,6559,3341,3218
202103,48123,경상남도,창원시 성산구,0-4세,6463,3300,3163
202104,48123,경상남도,창원시 성산구,0-4세,6403,3268,3135
202105,48123,경상남도,창원시 성산구,0-4세,6332,3229,3103
202106,48123,경상남도,창원시 성산구,0-4세,6254,3195,3059
202007,48123,경상남도,창원시 성산구,5-9세,9932,5116,4816
202008,48123,경상남도,창원시 성산구,5-9세,9885,5091,4794
202009,48123,경상남도,창원시 성산구,5-9세,9840,5072,4768
202010,48123,경상남도,창원시 성산구,5-9세,9835,5056,4779
202011,48123,경상남도,창원시 성산구,5-9세,9816,5067,4749
202012,48123,경상남도,창원시 성산구,5-9세,9752,5024,4728
202101,48123,경상남도,창원시 성산구,5-9세,9724,4996,4728
202102,48123,경상남도,창원시 성산구,5-9세,9678,4975,4703
202103,48123,경상남도,창원시 성산구,5-9세,9653,4959,4694
202104,48123,경상남도,창원시 성산구,5-9세,9569,4912,4657
202105,48123,경상남도,창원시 성산구,5-9세,9529,4893,4636
202106,48123,경상남도,창원시 성산구,5-9세,9481,4866,4615
202007,48123,경상남도,창원시 성산구,10-14세,10764,5654,5110
202008,48123,경상남도,창원시 성산구,10-14세,10777,5665,5112
202009,48123,경상남도,창원시 성산구,10-14세,10790,5664,5126
202010,48123,경상남도,창원시 성산구,10-14세,10811,5676,5135
202011,48123,경상남도,창원시 성산구,10-14세,10802,5652,5150
202012,48123,경상남도,창원시 성산구,10-14세,10779,5664,5115
202101,48123,경상남도,창원시 성산구,10-14세,10750,5661,5089
202102,48123,경상남도,창원시 성산구,10-14세,10748,5668,5080
202103,48123,경상남도,창원시 성산구,10-14세,10706,5630,5076
202104,48123,경상남도,창원시 성산구,10-14세,10730,5640,5090
202105,48123,경상남도,창원시 성산구,10-14세,10671,5610,5061
202106,48123,경상남도,창원시 성산구,10-14세,10663,5589,5074
202007,48123,경상남도,창원시 성산구,15-19세,12857,6822,6035
202008,48123,경상남도,창원시 성산구,15-19세,12747,6768,5979
202009,48123,경상남도,창원시 성산구,15-19세,12658,6701,5957
202010,48123,경상남도,창원시 성산구,15-19세,12509,6615,5894
202011,48123,경상남도,창원시 성산구,15-19세,12417,6563,5854
202012,48123,경상남도,창원시 성산구,15-19세,12332,6520,5812
202101,48123,경상남도,창원시 성산구,15-19세,12199,6441,5758
202102,48123,경상남도,창원시 성산구,15-19세,12045,6349,5696
202103,48123,경상남도,창원시 성산구,15-19세,11883,6274,5609
202104,48123,경상남도,창원시 성산구,15-19세,11814,6249,5565
202105,48123,경상남도,창원시 성산구,15-19세,11792,6237,5555
202106,48123,경상남도,창원시 성산구,15-19세,11695,6204,5491
202007,48123,경상남도,창원시 성산구,20-24세,16124,8994,7130
202008,48123,경상남도,창원시 성산구,20-24세,15990,8934,7056
202009,48123,경상남도,창원시 성산구,20-24세,15888,8886,7002
202010,48123,경상남도,창원시 성산구,20-24세,15859,8874,6985
202011,48123,경상남도,창원시 성산구,20-24세,15741,8823,6918
202012,48123,경상남도,창원시 성산구,20-24세,15686,8782,6904
202101,48123,경상남도,창원시 성산구,20-24세,15613,8724,6889
202102,48123,경상남도,창원시 성산구,20-24세,15495,8660,6835
202103,48123,경상남도,창원시 성산구,20-24세,15363,8595,6768
202104,48123,경상남도,창원시 성산구,20-24세,15288,8544,6744
202105,48123,경상남도,창원시 성산구,20-24세,15185,8486,6699
202106,48123,경상남도,창원시 성산구,20-24세,15147,8489,6658
202007,48123,경상남도,창원시 성산구,25-29세,16745,9261,7484
202008,48123,경상남도,창원시 성산구,25-29세,16715,9264,7451
202009,48123,경상남도,창원시 성산구,25-29세,16727,9300,7427
202010,48123,경상남도,창원시 성산구,25-29세,16705,9303,7402
202011,48123,경상남도,창원시 성산구,25-29세,16719,9284,7435
202012,48123,경상남도,창원시 성산구,25-29세,16660,9242,7418
202101,48123,경상남도,창원시 성산구,25-29세,16593,9211,7382
202102,48123,경상남도,창원시 성산구,25-29세,16539,9201,7338
202103,48123,경상남도,창원시 성산구,25-29세,16462,9201,7261
202104,48123,경상남도,창원시 성산구,25-29세,16504,9263,7241
202105,48123,경상남도,창원시 성산구,25-29세,16496,9282,7214
202106,48123,경상남도,창원시 성산구,25-29세,16508,9279,7229
202007,48123,경상남도,창원시 성산구,30-34세,14718,8071,6647
202008,48123,경상남도,창원시 성산구,30-34세,14676,8072,6604
202009,48123,경상남도,창원시 성산구,30-34세,14599,8048,6551
202010,48123,경상남도,창원시 성산구,30-34세,14517,7995,6522
202011,48123,경상남도,창원시 성산구,30-34세,14453,7966,6487
202012,48123,경상남도,창원시 성산구,30-34세,14368,7913,6455
202101,48123,경상남도,창원시 성산구,30-34세,14405,7955,6450
202102,48123,경상남도,창원시 성산구,30-34세,14399,7941,6458
202103,48123,경상남도,창원시 성산구,30-34세,14369,7912,6457
202104,48123,경상남도,창원시 성산구,30-34세,14367,7894,6473
202105,48123,경상남도,창원시 성산구,30-34세,14416,7919,6497
202106,48123,경상남도,창원시 성산구,30-34세,14475,7961,6514
202007,48123,경상남도,창원시 성산구,35-39세,15320,7910,7410
202008,48123,경상남도,창원시 성산구,35-39세,15239,7874,7365
202009,48123,경상남도,창원시 성산구,35-39세,15143,7810,7333
202010,48123,경상남도,창원시 성산구,35-39세,15105,7793,7312
202011,48123,경상남도,창원시 성산구,35-39세,15057,7791,7266
202012,48123,경상남도,창원시 성산구,35-39세,14968,7748,7220
202101,48123,경상남도,창원시 성산구,35-39세,14830,7656,7174
202102,48123,경상남도,창원시 성산구,35-39세,14734,7617,7117
202103,48123,경상남도,창원시 성산구,35-39세,14656,7592,7064
202104,48123,경상남도,창원시 성산구,35-39세,14552,7555,6997
202105,48123,경상남도,창원시 성산구,35-39세,14459,7507,6952
202106,48123,경상남도,창원시 성산구,35-39세,14324,7450,6874
202007,48123,경상남도,창원시 성산구,40-44세,16131,7903,8228
202008,48123,경상남도,창원시 성산구,40-44세,16128,7897,8231
202009,48123,경상남도,창원시 성산구,40-44세,16160,7936,8224
202010,48123,경상남도,창원시 성산구,40-44세,16203,7954,8249
202011,48123,경상남도,창원시 성산구,40-44세,16182,7958,8224
202012,48123,경상남도,창원시 성산구,40-44세,16097,7951,8146
202101,48123,경상남도,창원시 성산구,40-44세,16064,7959,8105
202102,48123,경상남도,창원시 성산구,40-44세,16046,7941,8105
202103,48123,경상남도,창원시 성산구,40-44세,15988,7919,8069
202104,48123,경상남도,창원시 성산구,40-44세,15940,7893,8047
202105,48123,경상남도,창원시 성산구,40-44세,15945,7906,8039
202106,48123,경상남도,창원시 성산구,40-44세,16012,7924,8088
202007,48123,경상남도,창원시 성산구,45-49세,20325,9511,10814
202008,48123,경상남도,창원시 성산구,45-49세,20247,9506,10741
202009,48123,경상남도,창원시 성산구,45-49세,20060,9405,10655
202010,48123,경상남도,창원시 성산구,45-49세,19880,9338,10542
202011,48123,경상남도,창원시 성산구,45-49세,19733,9277,10456
202012,48123,경상남도,창원시 성산구,45-49세,19642,9209,10433
202101,48123,경상남도,창원시 성산구,45-49세,19497,9125,10372
202102,48123,경상남도,창원시 성산구,45-49세,19371,9070,10301
202103,48123,경상남도,창원시 성산구,45-49세,19193,8997,10196
202104,48123,경상남도,창원시 성산구,45-49세,19149,8978,10171
202105,48123,경상남도,창원시 성산구,45-49세,18990,8920,10070
202106,48123,경상남도,창원시 성산구,45-49세,18865,8867,9998
202007,48123,경상남도,창원시 성산구,50-54세,22334,10612,11722
202008,48123,경상남도,창원시 성산구,50-54세,22306,10561,11745
202009,48123,경상남도,창원시 성산구,50-54세,22311,10566,11745
202010,48123,경상남도,창원시 성산구,50-54세,22320,10559,11761
202011,48123,경상남도,창원시 성산구,50-54세,22333,10541,11792
202012,48123,경상남도,창원시 성산구,50-54세,22223,10500,11723
202101,48123,경상남도,창원시 성산구,50-54세,22192,10474,11718
202102,48123,경상남도,창원시 성산구,50-54세,22156,10435,11721
202103,48123,경상남도,창원시 성산구,50-54세,22114,10393,11721
202104,48123,경상남도,창원시 성산구,50-54세,22099,10384,11715
202105,48123,경상남도,창원시 성산구,50-54세,22139,10402,11737
202106,48123,경상남도,창원시 성산구,50-54세,22162,10430,11732
202007,48123,경상남도,창원시 성산구,55-59세,21411,10854,10557
202008,48123,경상남도,창원시 성산구,55-59세,21373,10826,10547
202009,48123,경상남도,창원시 성산구,55-59세,21314,10766,10548
202010,48123,경상남도,창원시 성산구,55-59세,21265,10715,10550
202011,48123,경상남도,창원시 성산구,55-59세,21187,10670,10517
202012,48123,경상남도,창원시 성산구,55-59세,21209,10655,10554
202101,48123,경상남도,창원시 성산구,55-59세,21099,10604,10495
202102,48123,경상남도,창원시 성산구,55-59세,21062,10589,10473
202103,48123,경상남도,창원시 성산구,55-59세,20991,10532,10459
202104,48123,경상남도,창원시 성산구,55-59세,20893,10464,10429
202105,48123,경상남도,창원시 성산구,55-59세,20773,10400,10373
202106,48123,경상남도,창원시 성산구,55-59세,20625,10316,10309
202007,48123,경상남도,창원시 성산구,60-64세,14929,8088,6841
202008,48123,경상남도,창원시 성산구,60-64세,15050,8168,6882
202009,48123,경상남도,창원시 성산구,60-64세,15242,8261,6981
202010,48123,경상남도,창원시 성산구,60-64세,15404,8347,7057
202011,48123,경상남도,창원시 성산구,60-64세,15599,8446,7153
202012,48123,경상남도,창원시 성산구,60-64세,15709,8504,7205
202101,48123,경상남도,창원시 성산구,60-64세,15891,8588,7303
202102,48123,경상남도,창원시 성산구,60-64세,16028,8646,7382
202103,48123,경상남도,창원시 성산구,60-64세,16283,8791,7492
202104,48123,경상남도,창원시 성산구,60-64세,16395,8843,7552
202105,48123,경상남도,창원시 성산구,60-64세,16597,8911,7686
202106,48123,경상남도,창원시 성산구,60-64세,16810,9018,7792
202007,48123,경상남도,창원시 성산구,65-69세,7720,4091,3629
202008,48123,경상남도,창원시 성산구,65-69세,7805,4117,3688
202009,48123,경상남도,창원시 성산구,65-69세,7861,4158,3703
202010,48123,경상남도,창원시 성산구,65-69세,7960,4198,3762
202011,48123,경상남도,창원시 성산구,65-69세,8026,4234,3792
202012,48123,경상남도,창원시 성산구,65-69세,8067,4248,3819
202101,48123,경상남도,창원시 성산구,65-69세,8156,4291,3865
202102,48123,경상남도,창원시 성산구,65-69세,8238,4332,3906
202103,48123,경상남도,창원시 성산구,65-69세,8329,4366,3963
202104,48123,경상남도,창원시 성산구,65-69세,8421,4414,4007
202105,48123,경상남도,창원시 성산구,65-69세,8490,4457,4033
202106,48123,경상남도,창원시 성산구,65-69세,8546,4478,4068
202007,48123,경상남도,창원시 성산구,70-74세,4159,2112,2047
202008,48123,경상남도,창원시 성산구,70-74세,4183,2132,2051
202009,48123,경상남도,창원시 성산구,70-74세,4210,2144,2066
202010,48123,경상남도,창원시 성산구,70-74세,4243,2164,2079
202011,48123,경상남도,창원시 성산구,70-74세,4289,2182,2107
202012,48123,경상남도,창원시 성산구,70-74세,4348,2224,2124
202101,48123,경상남도,창원시 성산구,70-74세,4413,2248,2165
202102,48123,경상남도,창원시 성산구,70-74세,4457,2281,2176
202103,48123,경상남도,창원시 성산구,70-74세,4503,2298,2205
202104,48123,경상남도,창원시 성산구,70-74세,4554,2323,2231
202105,48123,경상남도,창원시 성산구,70-74세,4582,2335,2247
202106,48123,경상남도,창원시 성산구,70-74세,4603,2337,2266
202007,48123,경상남도,창원시 성산구,75-79세,2600,1091,1509
202008,48123,경상남도,창원시 성산구,75-79세,2584,1093,1491
202009,48123,경상남도,창원시 성산구,75-79세,2561,1087,1474
202010,48123,경상남도,창원시 성산구,75-79세,2560,1079,1481
202011,48123,경상남도,창원시 성산구,75-79세,2535,1066,1469
202012,48123,경상남도,창원시 성산구,75-79세,2529,1058,1471
202101,48123,경상남도,창원시 성산구,75-79세,2527,1068,1459
202102,48123,경상남도,창원시 성산구,75-79세,2529,1062,1467
202103,48123,경상남도,창원시 성산구,75-79세,2515,1074,1441
202104,48123,경상남도,창원시 성산구,75-79세,2515,1074,1441
202105,48123,경상남도,창원시 성산구,75-79세,2514,1082,1432
202106,48123,경상남도,창원시 성산구,75-79세,2524,1085,1439
202007,48123,경상남도,창원시 성산구,80-84세,1876,584,1292
202008,48123,경상남도,창원시 성산구,80-84세,1873,585,1288
202009,48123,경상남도,창원시 성산구,80-84세,1877,591,1286
202010,48123,경상남도,창원시 성산구,80-84세,1870,597,1273
202011,48123,경상남도,창원시 성산구,80-84세,1882,606,1276
202012,48123,경상남도,창원시 성산구,80-84세,1886,612,1274
202101,48123,경상남도,창원시 성산구,80-84세,1886,615,1271
202102,48123,경상남도,창원시 성산구,80-84세,1883,621,1262
202103,48123,경상남도,창원시 성산구,80-84세,1892,621,1271
202104,48123,경상남도,창원시 성산구,80-84세,1899,621,1278
202105,48123,경상남도,창원시 성산구,80-84세,1905,627,1278
202106,48123,경상남도,창원시 성산구,80-84세,1910,633,1277
202007,48123,경상남도,창원시 성산구,85-89세,1024,234,790
202008,48123,경상남도,창원시 성산구,85-89세,1030,233,797
202009,48123,경상남도,창원시 성산구,85-89세,1046,235,811
202010,48123,경상남도,창원시 성산구,85-89세,1054,238,816
202011,48123,경상남도,창원시 성산구,85-89세,1056,238,818
202012,48123,경상남도,창원시 성산구,85-89세,1052,236,816
202101,48123,경상남도,창원시 성산구,85-89세,1080,244,836
202102,48123,경상남도,창원시 성산구,85-89세,1085,245,840
202103,48123,경상남도,창원시 성산구,85-89세,1106,253,853
202104,48123,경상남도,창원시 성산구,85-89세,1113,259,854
202105,48123,경상남도,창원시 성산구,85-89세,1122,259,863
202106,48123,경상남도,창원시 성산구,85-89세,1121,259,862
202007,48123,경상남도,창원시 성산구,90-94세,359,65,294
202008,48123,경상남도,창원시 성산구,90-94세,362,67,295
202009,48123,경상남도,창원시 성산구,90-94세,365,65,300
202010,48123,경상남도,창원시 성산구,90-94세,363,65,298
202011,48123,경상남도,창원시 성산구,90-94세,360,62,298
202012,48123,경상남도,창원시 성산구,90-94세,361,63,298
202101,48123,경상남도,창원시 성산구,90-94세,361,60,301
202102,48123,경상남도,창원시 성산구,90-94세,369,64,305
202103,48123,경상남도,창원시 성산구,90-94세,368,63,305
202104,48123,경상남도,창원시 성산구,90-94세,367,62,305
202105,48123,경상남도,창원시 성산구,90-94세,372,62,310
202106,48123,경상남도,창원시 성산구,90-94세,370,61,309
202007,48123,경상남도,창원시 성산구,95-99세,73,17,56
202008,48123,경상남도,창원시 성산구,95-99세,71,17,54
202009,48123,경상남도,창원시 성산구,95-99세,73,16,57
202010,48123,경상남도,창원시 성산구,95-99세,76,16,60
202011,48123,경상남도,창원시 성산구,95-99세,78,17,61
202012,48123,경상남도,창원시 성산구,95-99세,77,16,61
202101,48123,경상남도,창원시 성산구,95-99세,79,16,63
202102,48123,경상남도,창원시 성산구,95-99세,77,15,62
202103,48123,경상남도,창원시 성산구,95-99세,79,15,64
202104,48123,경상남도,창원시 성산구,95-99세,80,16,64
202105,48123,경상남도,창원시 성산구,95-99세,76,15,61
202106,48123,경상남도,창원시 성산구,95-99세,73,14,59
202007,48123,경상남도,창원시 성산구,100+,21,6,15
202008,48123,경상남도,창원시 성산구,100+,20,6,14
202009,48123,경상남도,창원시 성산구,100+,20,6,14
202010,48123,경상남도,창원시 성산구,100+,20,6,14
202011,48123,경상남도,창원시 성산구,100+,21,6,15
202012,48123,경상남도,창원시 성산구,100+,20,6,14
202101,48123,경상남도,창원시 성산구,100+,20,6,14
202102,48123,경상남도,창원시 성산구,100+,22,7,15
202103,48123,경상남도,창원시 성산구,100+,10,2,8
202104,48123,경상남도,창원시 성산구,100+,10,2,8
202105,48123,경상남도,창원시 성산구,100+,11,2,9
202106,48123,경상남도,창원시 성산구,100+,12,2,10
202007,48125,경상남도,창원시 마산합포구,0-4세,5162,2707,2455
202008,48125,경상남도,창원시 마산합포구,0-4세,5153,2706,2447
202009,48125,경상남도,창원시 마산합포구,0-4세,5119,2692,2427
202010,48125,경상남도,창원시 마산합포구,0-4세,5046,2664,2382
202011,48125,경상남도,창원시 마산합포구,0-4세,5033,2651,2382
202012,48125,경상남도,창원시 마산합포구,0-4세,5079,2669,2410
202101,48125,경상남도,창원시 마산합포구,0-4세,5120,2688,2432
202102,48125,경상남도,창원시 마산합포구,0-4세,5212,2745,2467
202103,48125,경상남도,창원시 마산합포구,0-4세,5263,2770,2493
202104,48125,경상남도,창원시 마산합포구,0-4세,5307,2793,2514
202105,48125,경상남도,창원시 마산합포구,0-4세,5314,2792,2522
202106,48125,경상남도,창원시 마산합포구,0-4세,5362,2805,2557
202007,48125,경상남도,창원시 마산합포구,5-9세,7423,3843,3580
202008,48125,경상남도,창원시 마산합포구,5-9세,7456,3842,3614
202009,48125,경상남도,창원시 마산합포구,5-9세,7473,3854,3619
202010,48125,경상남도,창원시 마산합포구,5-9세,7481,3860,3621
202011,48125,경상남도,창원시 마산합포구,5-9세,7486,3866,3620
202012,48125,경상남도,창원시 마산합포구,5-9세,7560,3909,3651
202101,48125,경상남도,창원시 마산합포구,5-9세,7641,3948,3693
202102,48125,경상남도,창원시 마산합포구,5-9세,7817,4040,3777
202103,48125,경상남도,창원시 마산합포구,5-9세,7866,4049,3817
202104,48125,경상남도,창원시 마산합포구,5-9세,7882,4069,3813
202105,48125,경상남도,창원시 마산합포구,5-9세,7911,4077,3834
202106,48125,경상남도,창원시 마산합포구,5-9세,7926,4093,3833
202007,48125,경상남도,창원시 마산합포구,10-14세,6706,3428,3278
202008,48125,경상남도,창원시 마산합포구,10-14세,6718,3450,3268
202009,48125,경상남도,창원시 마산합포구,10-14세,6731,3450,3281
202010,48125,경상남도,창원시 마산합포구,10-14세,6743,3459,3284
202011,48125,경상남도,창원시 마산합포구,10-14세,6768,3461,3307
202012,48125,경상남도,창원시 마산합포구,10-14세,6827,3498,3329
202101,48125,경상남도,창원시 마산합포구,10-14세,6946,3545,3401
202102,48125,경상남도,창원시 마산합포구,10-14세,7005,3583,3422
202103,48125,경상남도,창원시 마산합포구,10-14세,7069,3619,3450
202104,48125,경상남도,창원시 마산합포구,10-14세,7149,3658,3491
202105,48125,경상남도,창원시 마산합포구,10-14세,7215,3700,3515
202106,48125,경상남도,창원시 마산합포구,10-14세,7294,3739,3555
202007,48125,경상남도,창원시 마산합포구,15-19세,7121,3775,3346
202008,48125,경상남도,창원시 마산합포구,15-19세,7058,3729,3329
202009,48125,경상남도,창원시 마산합포구,15-19세,7049,3726,3323
202010,48125,경상남도,창원시 마산합포구,15-19세,7001,3675,3326
202011,48125,경상남도,창원시 마산합포구,15-19세,6959,3647,3312
202012,48125,경상남도,창원시 마산합포구,15-19세,6937,3644,3293
202101,48125,경상남도,창원시 마산합포구,15-19세,6883,3615,3268
202102,48125,경상남도,창원시 마산합포구,15-19세,6908,3620,3288
202103,48125,경상남도,창원시 마산합포구,15-19세,6881,3608,3273
202104,48125,경상남도,창원시 마산합포구,15-19세,6868,3601,3267
202105,48125,경상남도,창원시 마산합포구,15-19세,6821,3579,3242
202106,48125,경상남도,창원시 마산합포구,15-19세,6824,3570,3254
202007,48125,경상남도,창원시 마산합포구,20-24세,9838,5445,4393
202008,48125,경상남도,창원시 마산합포구,20-24세,9802,5430,4372
202009,48125,경상남도,창원시 마산합포구,20-24세,9745,5399,4346
202010,48125,경상남도,창원시 마산합포구,20-24세,9698,5374,4324
202011,48125,경상남도,창원시 마산합포구,20-24세,9682,5369,4313
202012,48125,경상남도,창원시 마산합포구,20-24세,9660,5364,4296
202101,48125,경상남도,창원시 마산합포구,20-24세,9709,5417,4292
202102,48125,경상남도,창원시 마산합포구,20-24세,9722,5423,4299
202103,48125,경상남도,창원시 마산합포구,20-24세,9704,5413,4291
202104,48125,경상남도,창원시 마산합포구,20-24세,9683,5402,4281
202105,48125,경상남도,창원시 마산합포구,20-24세,9674,5394,4280
202106,48125,경상남도,창원시 마산합포구,20-24세,9678,5400,4278
202007,48125,경상남도,창원시 마산합포구,25-29세,9227,5122,4105
202008,48125,경상남도,창원시 마산합포구,25-29세,9244,5113,4131
202009,48125,경상남도,창원시 마산합포구,25-29세,9218,5095,4123
202010,48125,경상남도,창원시 마산합포구,25-29세,9243,5116,4127
202011,48125,경상남도,창원시 마산합포구,25-29세,9208,5116,4092
202012,48125,경상남도,창원시 마산합포구,25-29세,9262,5138,4124
202101,48125,경상남도,창원시 마산합포구,25-29세,9280,5110,4170
202102,48125,경상남도,창원시 마산합포구,25-29세,9314,5128,4186
202103,48125,경상남도,창원시 마산합포구,25-29세,9440,5170,4270
202104,48125,경상남도,창원시 마산합포구,25-29세,9484,5199,4285
202105,48125,경상남도,창원시 마산합포구,25-29세,9521,5204,4317
202106,48125,경상남도,창원시 마산합포구,25-29세,9559,5239,4320
202007,48125,경상남도,창원시 마산합포구,30-34세,8599,4581,4018
202008,48125,경상남도,창원시 마산합포구,30-34세,8573,4583,3990
202009,48125,경상남도,창원시 마산합포구,30-34세,8591,4601,3990
202010,48125,경상남도,창원시 마산합포구,30-34세,8561,4591,3970
202011,48125,경상남도,창원시 마산합포구,30-34세,8500,4536,3964
202012,48125,경상남도,창원시 마산합포구,30-34세,8536,4549,3987
202101,48125,경상남도,창원시 마산합포구,30-34세,8622,4606,4016
202102,48125,경상남도,창원시 마산합포구,30-34세,8748,4684,4064
202103,48125,경상남도,창원시 마산합포구,30-34세,8910,4771,4139
202104,48125,경상남도,창원시 마산합포구,30-34세,9056,4820,4236
202105,48125,경상남도,창원시 마산합포구,30-34세,9142,4876,4266
202106,48125,경상남도,창원시 마산합포구,30-34세,9242,4915,4327
202007,48125,경상남도,창원시 마산합포구,35-39세,11973,6312,5661
202008,48125,경상남도,창원시 마산합포구,35-39세,11978,6312,5666
202009,48125,경상남도,창원시 마산합포구,35-39세,11936,6307,5629
202010,48125,경상남도,창원시 마산합포구,35-39세,11851,6250,5601
202011,48125,경상남도,창원시 마산합포구,35-39세,11890,6258,5632
202012,48125,경상남도,창원시 마산합포구,35-39세,11949,6310,5639
202101,48125,경상남도,창원시 마산합포구,35-39세,12023,6340,5683
202102,48125,경상남도,창원시 마산합포구,35-39세,12107,6375,5732
202103,48125,경상남도,창원시 마산합포구,35-39세,12161,6409,5752
202104,48125,경상남도,창원시 마산합포구,35-39세,12166,6420,5746
202105,48125,경상남도,창원시 마산합포구,35-39세,12094,6393,5701
202106,48125,경상남도,창원시 마산합포구,35-39세,12118,6390,5728
202007,48125,경상남도,창원시 마산합포구,40-44세,12344,6559,5785
202008,48125,경상남도,창원시 마산합포구,40-44세,12362,6571,5791
202009,48125,경상남도,창원시 마산합포구,40-44세,12382,6577,5805
202010,48125,경상남도,창원시 마산합포구,40-44세,12441,6600,5841
202011,48125,경상남도,창원시 마산합포구,40-44세,12456,6639,5817
202012,48125,경상남도,창원시 마산합포구,40-44세,12535,6684,5851
202101,48125,경상남도,창원시 마산합포구,40-44세,12658,6754,5904
202102,48125,경상남도,창원시 마산합포구,40-44세,12904,6902,6002
202103,48125,경상남도,창원시 마산합포구,40-44세,12956,6919,6037
202104,48125,경상남도,창원시 마산합포구,40-44세,13080,6993,6087
202105,48125,경상남도,창원시 마산합포구,40-44세,13219,7051,6168
202106,48125,경상남도,창원시 마산합포구,40-44세,13371,7135,6236
202007,48125,경상남도,창원시 마산합포구,45-49세,13295,6917,6378
202008,48125,경상남도,창원시 마산합포구,45-49세,13275,6913,6362
202009,48125,경상남도,창원시 마산합포구,45-49세,13221,6881,6340
202010,48125,경상남도,창원시 마산합포구,45-49세,13135,6830,6305
202011,48125,경상남도,창원시 마산합포구,45-49세,13084,6788,6296
202012,48125,경상남도,창원시 마산합포구,45-49세,13116,6774,6342
202101,48125,경상남도,창원시 마산합포구,45-49세,13143,6781,6362
202102,48125,경상남도,창원시 마산합포구,45-49세,13197,6826,6371
202103,48125,경상남도,창원시 마산합포구,45-49세,13244,6863,6381
202104,48125,경상남도,창원시 마산합포구,45-49세,13262,6865,6397
202105,48125,경상남도,창원시 마산합포구,45-49세,13208,6851,6357
202106,48125,경상남도,창원시 마산합포구,45-49세,13216,6853,6363
202007,48125,경상남도,창원시 마산합포구,50-54세,14315,7325,6990
202008,48125,경상남도,창원시 마산합포구,50-54세,14316,7309,7007
202009,48125,경상남도,창원시 마산합포구,50-54세,14327,7327,7000
202010,48125,경상남도,창원시 마산합포구,50-54세,14354,7346,7008
202011,48125,경상남도,창원시 마산합포구,50-54세,14410,7368,7042
202012,48125,경상남도,창원시 마산합포구,50-54세,14426,7391,7035
202101,48125,경상남도,창원시 마산합포구,50-54세,14498,7413,7085
202102,48125,경상남도,창원시 마산합포구,50-54세,14559,7437,7122
202103,48125,경상남도,창원시 마산합포구,50-54세,14588,7435,7153
202104,48125,경상남도,창원시 마산합포구,50-54세,14607,7431,7176
202105,48125,경상남도,창원시 마산합포구,50-54세,14656,7439,7217
202106,48125,경상남도,창원시 마산합포구,50-54세,14742,7473,7269
202007,48125,경상남도,창원시 마산합포구,55-59세,15291,7376,7915
202008,48125,경상남도,창원시 마산합포구,55-59세,15212,7343,7869
202009,48125,경상남도,창원시 마산합포구,55-59세,15157,7316,7841
202010,48125,경상남도,창원시 마산합포구,55-59세,15120,7313,7807
202011,48125,경상남도,창원시 마산합포구,55-59세,15104,7307,7797
202012,48125,경상남도,창원시 마산합포구,55-59세,15100,7297,7803
202101,48125,경상남도,창원시 마산합포구,55-59세,15074,7326,7748
202102,48125,경상남도,창원시 마산합포구,55-59세,15030,7312,7718
202103,48125,경상남도,창원시 마산합포구,55-59세,14965,7295,7670
202104,48125,경상남도,창원시 마산합포구,55-59세,14927,7313,7614
202105,48125,경상남도,창원시 마산합포구,55-59세,14846,7290,7556
202106,48125,경상남도,창원시 마산합포구,55-59세,14752,7252,7500
202007,48125,경상남도,창원시 마산합포구,60-64세,16528,7823,8705
202008,48125,경상남도,창원시 마산합포구,60-64세,16590,7855,8735
202009,48125,경상남도,창원시 마산합포구,60-64세,16643,7885,8758
202010,48125,경상남도,창원시 마산합포구,60-64세,16662,7880,8782
202011,48125,경상남도,창원시 마산합포구,60-64세,16705,7922,8783
202012,48125,경상남도,창원시 마산합포구,60-64세,16831,8004,8827
202101,48125,경상남도,창원시 마산합포구,60-64세,16861,7998,8863
202102,48125,경상남도,창원시 마산합포구,60-64세,16932,8027,8905
202103,48125,경상남도,창원시 마산합포구,60-64세,17042,8092,8950
202104,48125,경상남도,창원시 마산합포구,60-64세,17120,8119,9001
202105,48125,경상남도,창원시 마산합포구,60-64세,17226,8166,9060
202106,48125,경상남도,창원시 마산합포구,60-64세,17320,8208,9112
202007,48125,경상남도,창원시 마산합포구,65-69세,12702,6039,6663
202008,48125,경상남도,창원시 마산합포구,65-69세,12817,6087,6730
202009,48125,경상남도,창원시 마산합포구,65-69세,12912,6125,6787
202010,48125,경상남도,창원시 마산합포구,65-69세,12989,6161,6828
202011,48125,경상남도,창원시 마산합포구,65-69세,13070,6188,6882
202012,48125,경상남도,창원시 마산합포구,65-69세,13197,6235,6962
202101,48125,경상남도,창원시 마산합포구,65-69세,13314,6298,7016
202102,48125,경상남도,창원시 마산합포구,65-69세,13438,6362,7076
202103,48125,경상남도,창원시 마산합포구,65-69세,13565,6413,7152
202104,48125,경상남도,창원시 마산합포구,65-69세,13654,6445,7209
202105,48125,경상남도,창원시 마산합포구,65-69세,13708,6480,7228
202106,48125,경상남도,창원시 마산합포구,65-69세,13815,6526,7289
202007,48125,경상남도,창원시 마산합포구,70-74세,9275,4296,4979
202008,48125,경상남도,창원시 마산합포구,70-74세,9310,4314,4996
202009,48125,경상남도,창원시 마산합포구,70-74세,9370,4335,5035
202010,48125,경상남도,창원시 마산합포구,70-74세,9468,4385,5083
202011,48125,경상남도,창원시 마산합포구,70-74세,9563,4420,5143
202012,48125,경상남도,창원시 마산합포구,70-74세,9675,4473,5202
202101,48125,경상남도,창원시 마산합포구,70-74세,9796,4528,5268
202102,48125,경상남도,창원시 마산합포구,70-74세,9880,4550,5330
202103,48125,경상남도,창원시 마산합포구,70-74세,9938,4580,5358
202104,48125,경상남도,창원시 마산합포구,70-74세,10005,4609,5396
202105,48125,경상남도,창원시 마산합포구,70-74세,10003,4611,5392
202106,48125,경상남도,창원시 마산합포구,70-74세,10016,4618,5398
202007,48125,경상남도,창원시 마산합포구,75-79세,7155,3032,4123
202008,48125,경상남도,창원시 마산합포구,75-79세,7133,3012,4121
202009,48125,경상남도,창원시 마산합포구,75-79세,7100,3001,4099
202010,48125,경상남도,창원시 마산합포구,75-79세,7054,2989,4065
202011,48125,경상남도,창원시 마산합포구,75-79세,6977,2948,4029
202012,48125,경상남도,창원시 마산합포구,75-79세,6894,2932,3962
202101,48125,경상남도,창원시 마산합포구,75-79세,6845,2906,3939
202102,48125,경상남도,창원시 마산합포구,75-79세,6817,2916,3901
202103,48125,경상남도,창원시 마산합포구,75-79세,6842,2930,3912
202104,48125,경상남도,창원시 마산합포구,75-79세,6824,2922,3902
202105,48125,경상남도,창원시 마산합포구,75-79세,6777,2911,3866
202106,48125,경상남도,창원시 마산합포구,75-79세,6796,2914,3882
202007,48125,경상남도,창원시 마산합포구,80-84세,4552,1585,2967
202008,48125,경상남도,창원시 마산합포구,80-84세,4582,1602,2980
202009,48125,경상남도,창원시 마산합포구,80-84세,4600,1618,2982
202010,48125,경상남도,창원시 마산합포구,80-84세,4620,1630,2990
202011,48125,경상남도,창원시 마산합포구,80-84세,4641,1654,2987
202012,48125,경상남도,창원시 마산합포구,80-84세,4692,1670,3022
202101,48125,경상남도,창원시 마산합포구,80-84세,4751,1699,3052
202102,48125,경상남도,창원시 마산합포구,80-84세,4777,1713,3064
202103,48125,경상남도,창원시 마산합포구,80-84세,4786,1724,3062
202104,48125,경상남도,창원시 마산합포구,80-84세,4794,1736,3058
202105,48125,경상남도,창원시 마산합포구,80-84세,4817,1738,3079
202106,48125,경상남도,창원시 마산합포구,80-84세,4841,1760,3081
202007,48125,경상남도,창원시 마산합포구,85-89세,2281,650,1631
202008,48125,경상남도,창원시 마산합포구,85-89세,2284,653,1631
202009,48125,경상남도,창원시 마산합포구,85-89세,2302,658,1644
202010,48125,경상남도,창원시 마산합포구,85-89세,2312,654,1658
202011,48125,경상남도,창원시 마산합포구,85-89세,2338,654,1684
202012,48125,경상남도,창원시 마산합포구,85-89세,2365,661,1704
202101,48125,경상남도,창원시 마산합포구,85-89세,2383,676,1707
202102,48125,경상남도,창원시 마산합포구,85-89세,2423,692,1731
202103,48125,경상남도,창원시 마산합포구,85-89세,2434,702,1732
202104,48125,경상남도,창원시 마산합포구,85-89세,2452,713,1739
202105,48125,경상남도,창원시 마산합포구,85-89세,2441,703,1738
202106,48125,경상남도,창원시 마산합포구,85-89세,2441,696,1745
202007,48125,경상남도,창원시 마산합포구,90-94세,774,153,621
202008,48125,경상남도,창원시 마산합포구,90-94세,782,154,628
202009,48125,경상남도,창원시 마산합포구,90-94세,799,154,645
202010,48125,경상남도,창원시 마산합포구,90-94세,815,165,650
202011,48125,경상남도,창원시 마산합포구,90-94세,821,163,658
202012,48125,경상남도,창원시 마산합포구,90-94세,832,169,663
202101,48125,경상남도,창원시 마산합포구,90-94세,845,169,676
202102,48125,경상남도,창원시 마산합포구,90-94세,864,174,690
202103,48125,경상남도,창원시 마산합포구,90-94세,880,177,703
202104,48125,경상남도,창원시 마산합포구,90-94세,870,170,700
202105,48125,경상남도,창원시 마산합포구,90-94세,867,170,697
202106,48125,경상남도,창원시 마산합포구,90-94세,864,165,699
202007,48125,경상남도,창원시 마산합포구,95-99세,165,27,138
202008,48125,경상남도,창원시 마산합포구,95-99세,169,29,140
202009,48125,경상남도,창원시 마산합포구,95-99세,176,30,146
202010,48125,경상남도,창원시 마산합포구,95-99세,169,29,140
202011,48125,경상남도,창원시 마산합포구,95-99세,169,30,139
202012,48125,경상남도,창원시 마산합포구,95-99세,174,30,144
202101,48125,경상남도,창원시 마산합포구,95-99세,173,29,144
202102,48125,경상남도,창원시 마산합포구,95-99세,180,29,151
202103,48125,경상남도,창원시 마산합포구,95-99세,183,30,153
202104,48125,경상남도,창원시 마산합포구,95-99세,189,35,154
202105,48125,경상남도,창원시 마산합포구,95-99세,174,30,144
202106,48125,경상남도,창원시 마산합포구,95-99세,174,31,143
202007,48125,경상남도,창원시 마산합포구,100+,65,16,49
202008,48125,경상남도,창원시 마산합포구,100+,65,16,49
202009,48125,경상남도,창원시 마산합포구,100+,65,16,49
202010,48125,경상남도,창원시 마산합포구,100+,67,17,50
202011,48125,경상남도,창원시 마산합포구,100+,69,17,52
202012,48125,경상남도,창원시 마산합포구,100+,69,17,52
202101,48125,경상남도,창원시 마산합포구,100+,71,17,54
202102,48125,경상남도,창원시 마산합포구,100+,71,17,54
202103,48125,경상남도,창원시 마산합포구,100+,56,10,46
202104,48125,경상남도,창원시 마산합포구,100+,55,10,45
202105,48125,경상남도,창원시 마산합포구,100+,23,3,20
202106,48125,경상남도,창원시 마산합포구,100+,23,3,20
202007,48127,경상남도,창원시 마산회원구,0-4세,5449,2776,2673
202008,48127,경상남도,창원시 마산회원구,0-4세,5383,2761,2622
202009,48127,경상남도,창원시 마산회원구,0-4세,5369,2739,2630
202010,48127,경상남도,창원시 마산회원구,0-4세,5314,2695,2619
202011,48127,경상남도,창원시 마산회원구,0-4세,5277,2673,2604
202012,48127,경상남도,창원시 마산회원구,0-4세,5192,2634,2558
202101,48127,경상남도,창원시 마산회원구,0-4세,5116,2610,2506
202102,48127,경상남도,창원시 마산회원구,0-4세,5027,2554,2473
202103,48127,경상남도,창원시 마산회원구,0-4세,4972,2526,2446
202104,48127,경상남도,창원시 마산회원구,0-4세,4916,2488,2428
202105,48127,경상남도,창원시 마산회원구,0-4세,4854,2462,2392
202106,48127,경상남도,창원시 마산회원구,0-4세,4815,2446,2369
202007,48127,경상남도,창원시 마산회원구,5-9세,8321,4368,3953
202008,48127,경상남도,창원시 마산회원구,5-9세,8286,4348,3938
202009,48127,경상남도,창원시 마산회원구,5-9세,8245,4328,3917
202010,48127,경상남도,창원시 마산회원구,5-9세,8253,4331,3922
202011,48127,경상남도,창원시 마산회원구,5-9세,8249,4327,3922
202012,48127,경상남도,창원시 마산회원구,5-9세,8214,4287,3927
202101,48127,경상남도,창원시 마산회원구,5-9세,8162,4252,3910
202102,48127,경상남도,창원시 마산회원구,5-9세,8080,4194,3886
202103,48127,경상남도,창원시 마산회원구,5-9세,8021,4168,3853
202104,48127,경상남도,창원시 마산회원구,5-9세,7947,4124,3823
202105,48127,경상남도,창원시 마산회원구,5-9세,7911,4107,3804
202106,48127,경상남도,창원시 마산회원구,5-9세,7860,4081,3779
202007,48127,경상남도,창원시 마산회원구,10-14세,8851,4636,4215
202008,48127,경상남도,창원시 마산회원구,10-14세,8861,4648,4213
202009,48127,경상남도,창원시 마산회원구,10-14세,8827,4623,4204
202010,48127,경상남도,창원시 마산회원구,10-14세,8812,4620,4192
202011,48127,경상남도,창원시 마산회원구,10-14세,8811,4620,4191
202012,48127,경상남도,창원시 마산회원구,10-14세,8801,4612,4189
202101,48127,경상남도,창원시 마산회원구,10-14세,8773,4600,4173
202102,48127,경상남도,창원시 마산회원구,10-14세,8708,4559,4149
202103,48127,경상남도,창원시 마산회원구,10-14세,8714,4554,4160
202104,48127,경상남도,창원시 마산회원구,10-14세,8742,4565,4177
202105,48127,경상남도,창원시 마산회원구,10-14세,8723,4548,4175
202106,48127,경상남도,창원시 마산회원구,10-14세,8729,4546,4183
202007,48127,경상남도,창원시 마산회원구,15-19세,9693,5087,4606
202008,48127,경상남도,창원시 마산회원구,15-19세,9624,5051,4573
202009,48127,경상남도,창원시 마산회원구,15-19세,9581,5026,4555
202010,48127,경상남도,창원시 마산회원구,15-19세,9552,5007,4545
202011,48127,경상남도,창원시 마산회원구,15-19세,9512,4981,4531
202012,48127,경상남도,창원시 마산회원구,15-19세,9449,4952,4497
202101,48127,경상남도,창원시 마산회원구,15-19세,9362,4888,4474
202102,48127,경상남도,창원시 마산회원구,15-19세,9296,4859,4437
202103,48127,경상남도,창원시 마산회원구,15-19세,9180,4800,4380
202104,48127,경상남도,창원시 마산회원구,15-19세,9128,4780,4348
202105,48127,경상남도,창원시 마산회원구,15-19세,9143,4800,4343
202106,48127,경상남도,창원시 마산회원구,15-19세,9095,4762,4333
202007,48127,경상남도,창원시 마산회원구,20-24세,11682,6452,5230
202008,48127,경상남도,창원시 마산회원구,20-24세,11590,6410,5180
202009,48127,경상남도,창원시 마산회원구,20-24세,11517,6383,5134
202010,48127,경상남도,창원시 마산회원구,20-24세,11522,6391,5131
202011,48127,경상남도,창원시 마산회원구,20-24세,11507,6387,5120
202012,48127,경상남도,창원시 마산회원구,20-24세,11433,6344,5089
202101,48127,경상남도,창원시 마산회원구,20-24세,11356,6302,5054
202102,48127,경상남도,창원시 마산회원구,20-24세,11197,6214,4983
202103,48127,경상남도,창원시 마산회원구,20-24세,11078,6148,4930
202104,48127,경상남도,창원시 마산회원구,20-24세,11017,6125,4892
202105,48127,경상남도,창원시 마산회원구,20-24세,11003,6113,4890
202106,48127,경상남도,창원시 마산회원구,20-24세,10921,6070,4851
202007,48127,경상남도,창원시 마산회원구,25-29세,10905,5961,4944
202008,48127,경상남도,창원시 마산회원구,25-29세,10870,5937,4933
202009,48127,경상남도,창원시 마산회원구,25-29세,10912,5941,4971
202010,48127,경상남도,창원시 마산회원구,25-29세,10940,5974,4966
202011,48127,경상남도,창원시 마산회원구,25-29세,10933,5963,4970
202012,48127,경상남도,창원시 마산회원구,25-29세,10920,5994,4926
202101,48127,경상남도,창원시 마산회원구,25-29세,10872,5977,4895
202102,48127,경상남도,창원시 마산회원구,25-29세,10830,5968,4862
202103,48127,경상남도,창원시 마산회원구,25-29세,10808,5973,4835
202104,48127,경상남도,창원시 마산회원구,25-29세,10803,5955,4848
202105,48127,경상남도,창원시 마산회원구,25-29세,10758,5937,4821
202106,48127,경상남도,창원시 마산회원구,25-29세,10732,5944,4788
202007,48127,경상남도,창원시 마산회원구,30-34세,9608,5134,4474
202008,48127,경상남도,창원시 마산회원구,30-34세,9554,5114,4440
202009,48127,경상남도,창원시 마산회원구,30-34세,9546,5100,4446
202010,48127,경상남도,창원시 마산회원구,30-34세,9579,5103,4476
202011,48127,경상남도,창원시 마산회원구,30-34세,9551,5103,4448
202012,48127,경상남도,창원시 마산회원구,30-34세,9465,5054,4411
202101,48127,경상남도,창원시 마산회원구,30-34세,9426,5020,4406
202102,48127,경상남도,창원시 마산회원구,30-34세,9347,4977,4370
202103,48127,경상남도,창원시 마산회원구,30-34세,9343,4977,4366
202104,48127,경상남도,창원시 마산회원구,30-34세,9295,4949,4346
202105,48127,경상남도,창원시 마산회원구,30-34세,9259,4920,4339
202106,48127,경상남도,창원시 마산회원구,30-34세,9288,4949,4339
202007,48127,경상남도,창원시 마산회원구,35-39세,12751,6680,6071
202008,48127,경상남도,창원시 마산회원구,35-39세,12552,6577,5975
202009,48127,경상남도,창원시 마산회원구,35-39세,12519,6579,5940
202010,48127,경상남도,창원시 마산회원구,35-39세,12450,6539,5911
202011,48127,경상남도,창원시 마산회원구,35-39세,12428,6532,5896
202012,48127,경상남도,창원시 마산회원구,35-39세,12354,6467,5887
202101,48127,경상남도,창원시 마산회원구,35-39세,12245,6400,5845
202102,48127,경상남도,창원시 마산회원구,35-39세,12079,6326,5753
202103,48127,경상남도,창원시 마산회원구,35-39세,11987,6269,5718
202104,48127,경상남도,창원시 마산회원구,35-39세,11841,6194,5647
202105,48127,경상남도,창원시 마산회원구,35-39세,11755,6138,5617
202106,48127,경상남도,창원시 마산회원구,35-39세,11642,6070,5572
202007,48127,경상남도,창원시 마산회원구,40-44세,14115,7166,6949
202008,48127,경상남도,창원시 마산회원구,40-44세,14162,7207,6955
202009,48127,경상남도,창원시 마산회원구,40-44세,14165,7189,6976
202010,48127,경상남도,창원시 마산회원구,40-44세,14212,7226,6986
202011,48127,경상남도,창원시 마산회원구,40-44세,14217,7238,6979
202012,48127,경상남도,창원시 마산회원구,40-44세,14143,7218,6925
202101,48127,경상남도,창원시 마산회원구,40-44세,14062,7195,6867
202102,48127,경상남도,창원시 마산회원구,40-44세,14062,7190,6872
202103,48127,경상남도,창원시 마산회원구,40-44세,13981,7160,6821
202104,48127,경상남도,창원시 마산회원구,40-44세,14009,7184,6825
202105,48127,경상남도,창원시 마산회원구,40-44세,14045,7202,6843
202106,48127,경상남도,창원시 마산회원구,40-44세,14103,7225,6878
202007,48127,경상남도,창원시 마산회원구,45-49세,16396,8278,8118
202008,48127,경상남도,창원시 마산회원구,45-49세,16305,8225,8080
202009,48127,경상남도,창원시 마산회원구,45-49세,16252,8216,8036
202010,48127,경상남도,창원시 마산회원구,45-49세,16189,8183,8006
202011,48127,경상남도,창원시 마산회원구,45-49세,16173,8155,8018
202012,48127,경상남도,창원시 마산회원구,45-49세,16085,8119,7966
202101,48127,경상남도,창원시 마산회원구,45-49세,15987,8075,7912
202102,48127,경상남도,창원시 마산회원구,45-49세,15886,8022,7864
202103,48127,경상남도,창원시 마산회원구,45-49세,15819,8009,7810
202104,48127,경상남도,창원시 마산회원구,45-49세,15753,7985,7768
202105,48127,경상남도,창원시 마산회원구,45-49세,15654,7938,7716
202106,48127,경상남도,창원시 마산회원구,45-49세,15569,7904,7665
202007,48127,경상남도,창원시 마산회원구,50-54세,17527,8825,8702
202008,48127,경상남도,창원시 마산회원구,50-54세,17525,8834,8691
202009,48127,경상남도,창원시 마산회원구,50-54세,17525,8810,8715
202010,48127,경상남도,창원시 마산회원구,50-54세,17527,8825,8702
202011,48127,경상남도,창원시 마산회원구,50-54세,17500,8819,8681
202012,48127,경상남도,창원시 마산회원구,50-54세,17454,8806,8648
202101,48127,경상남도,창원시 마산회원구,50-54세,17452,8798,8654
202102,48127,경상남도,창원시 마산회원구,50-54세,17399,8766,8633
202103,48127,경상남도,창원시 마산회원구,50-54세,17275,8686,8589
202104,48127,경상남도,창원시 마산회원구,50-54세,17211,8637,8574
202105,48127,경상남도,창원시 마산회원구,50-54세,17218,8628,8590
202106,48127,경상남도,창원시 마산회원구,50-54세,17261,8645,8616
202007,48127,경상남도,창원시 마산회원구,55-59세,17362,8587,8775
202008,48127,경상남도,창원시 마산회원구,55-59세,17227,8522,8705
202009,48127,경상남도,창원시 마산회원구,55-59세,17180,8526,8654
202010,48127,경상남도,창원시 마산회원구,55-59세,17154,8501,8653
202011,48127,경상남도,창원시 마산회원구,55-59세,17091,8455,8636
202012,48127,경상남도,창원시 마산회원구,55-59세,17073,8411,8662
202101,48127,경상남도,창원시 마산회원구,55-59세,16994,8356,8638
202102,48127,경상남도,창원시 마산회원구,55-59세,16951,8349,8602
202103,48127,경상남도,창원시 마산회원구,55-59세,16961,8363,8598
202104,48127,경상남도,창원시 마산회원구,55-59세,16864,8327,8537
202105,48127,경상남도,창원시 마산회원구,55-59세,16702,8271,8431
202106,48127,경상남도,창원시 마산회원구,55-59세,16564,8192,8372
202007,48127,경상남도,창원시 마산회원구,60-64세,16706,7915,8791
202008,48127,경상남도,창원시 마산회원구,60-64세,16710,7910,8800
202009,48127,경상남도,창원시 마산회원구,60-64세,16770,7923,8847
202010,48127,경상남도,창원시 마산회원구,60-64세,16839,7974,8865
202011,48127,경상남도,창원시 마산회원구,60-64세,16919,8041,8878
202012,48127,경상남도,창원시 마산회원구,60-64세,16984,8081,8903
202101,48127,경상남도,창원시 마산회원구,60-64세,17030,8121,8909
202102,48127,경상남도,창원시 마산회원구,60-64세,17134,8174,8960
202103,48127,경상남도,창원시 마산회원구,60-64세,17176,8202,8974
202104,48127,경상남도,창원시 마산회원구,60-64세,17221,8245,8976
202105,48127,경상남도,창원시 마산회원구,60-64세,17300,8261,9039
202106,48127,경상남도,창원시 마산회원구,60-64세,17365,8307,9058
202007,48127,경상남도,창원시 마산회원구,65-69세,12427,5938,6489
202008,48127,경상남도,창원시 마산회원구,65-69세,12555,6010,6545
202009,48127,경상남도,창원시 마산회원구,65-69세,12700,6079,6621
202010,48127,경상남도,창원시 마산회원구,65-69세,12825,6138,6687
202011,48127,경상남도,창원시 마산회원구,65-69세,12902,6189,6713
202012,48127,경상남도,창원시 마산회원구,65-69세,12977,6221,6756
202101,48127,경상남도,창원시 마산회원구,65-69세,13044,6252,6792
202102,48127,경상남도,창원시 마산회원구,65-69세,13046,6245,6801
202103,48127,경상남도,창원시 마산회원구,65-69세,13137,6275,6862
202104,48127,경상남도,창원시 마산회원구,65-69세,13210,6289,6921
202105,48127,경상남도,창원시 마산회원구,65-69세,13274,6317,6957
202106,48127,경상남도,창원시 마산회원구,65-69세,13334,6349,6985
202007,48127,경상남도,창원시 마산회원구,70-74세,8589,4027,4562
202008,48127,경상남도,창원시 마산회원구,70-74세,8648,4047,4601
202009,48127,경상남도,창원시 마산회원구,70-74세,8687,4068,4619
202010,48127,경상남도,창원시 마산회원구,70-74세,8726,4073,4653
202011,48127,경상남도,창원시 마산회원구,70-74세,8828,4104,4724
202012,48127,경상남도,창원시 마산회원구,70-74세,8890,4125,4765
202101,48127,경상남도,창원시 마산회원구,70-74세,8995,4169,4826
202102,48127,경상남도,창원시 마산회원구,70-74세,9115,4214,4901
202103,48127,경상남도,창원시 마산회원구,70-74세,9145,4215,4930
202104,48127,경상남도,창원시 마산회원구,70-74세,9142,4209,4933
202105,48127,경상남도,창원시 마산회원구,70-74세,9158,4211,4947
202106,48127,경상남도,창원시 마산회원구,70-74세,9196,4220,4976
202007,48127,경상남도,창원시 마산회원구,75-79세,5980,2611,3369
202008,48127,경상남도,창원시 마산회원구,75-79세,5973,2613,3360
202009,48127,경상남도,창원시 마산회원구,75-79세,5948,2609,3339
202010,48127,경상남도,창원시 마산회원구,75-79세,5949,2616,3333
202011,48127,경상남도,창원시 마산회원구,75-79세,5933,2614,3319
202012,48127,경상남도,창원시 마산회원구,75-79세,5896,2601,3295
202101,48127,경상남도,창원시 마산회원구,75-79세,5859,2579,3280
202102,48127,경상남도,창원시 마산회원구,75-79세,5840,2587,3253
202103,48127,경상남도,창원시 마산회원구,75-79세,5861,2605,3256
202104,48127,경상남도,창원시 마산회원구,75-79세,5861,2604,3257
202105,48127,경상남도,창원시 마산회원구,75-79세,5846,2605,3241
202106,48127,경상남도,창원시 마산회원구,75-79세,5836,2614,3222
202007,48127,경상남도,창원시 마산회원구,80-84세,3625,1398,2227
202008,48127,경상남도,창원시 마산회원구,80-84세,3627,1403,2224
202009,48127,경상남도,창원시 마산회원구,80-84세,3641,1414,2227
202010,48127,경상남도,창원시 마산회원구,80-84세,3627,1403,2224
202011,48127,경상남도,창원시 마산회원구,80-84세,3660,1412,2248
202012,48127,경상남도,창원시 마산회원구,80-84세,3690,1427,2263
202101,48127,경상남도,창원시 마산회원구,80-84세,3710,1451,2259
202102,48127,경상남도,창원시 마산회원구,80-84세,3753,1468,2285
202103,48127,경상남도,창원시 마산회원구,80-84세,3776,1477,2299
202104,48127,경상남도,창원시 마산회원구,80-84세,3793,1494,2299
202105,48127,경상남도,창원시 마산회원구,80-84세,3820,1505,2315
202106,48127,경상남도,창원시 마산회원구,80-84세,3858,1518,2340
202007,48127,경상남도,창원시 마산회원구,85-89세,1550,423,1127
202008,48127,경상남도,창원시 마산회원구,85-89세,1569,427,1142
202009,48127,경상남도,창원시 마산회원구,85-89세,1589,433,1156
202010,48127,경상남도,창원시 마산회원구,85-89세,1606,446,1160
202011,48127,경상남도,창원시 마산회원구,85-89세,1618,455,1163
202012,48127,경상남도,창원시 마산회원구,85-89세,1641,464,1177
202101,48127,경상남도,창원시 마산회원구,85-89세,1664,473,1191
202102,48127,경상남도,창원시 마산회원구,85-89세,1679,480,1199
202103,48127,경상남도,창원시 마산회원구,85-89세,1723,505,1218
202104,48127,경상남도,창원시 마산회원구,85-89세,1738,504,1234
202105,48127,경상남도,창원시 마산회원구,85-89세,1736,506,1230
202106,48127,경상남도,창원시 마산회원구,85-89세,1737,508,1229
202007,48127,경상남도,창원시 마산회원구,90-94세,461,93,368
202008,48127,경상남도,창원시 마산회원구,90-94세,456,92,364
202009,48127,경상남도,창원시 마산회원구,90-94세,465,94,371
202010,48127,경상남도,창원시 마산회원구,90-94세,476,93,383
202011,48127,경상남도,창원시 마산회원구,90-94세,478,94,384
202012,48127,경상남도,창원시 마산회원구,90-94세,485,98,387
202101,48127,경상남도,창원시 마산회원구,90-94세,488,95,393
202102,48127,경상남도,창원시 마산회원구,90-94세,491,93,398
202103,48127,경상남도,창원시 마산회원구,90-94세,497,91,406
202104,48127,경상남도,창원시 마산회원구,90-94세,504,91,413
202105,48127,경상남도,창원시 마산회원구,90-94세,502,93,409
202106,48127,경상남도,창원시 마산회원구,90-94세,499,94,405
202007,48127,경상남도,창원시 마산회원구,95-99세,96,16,80
202008,48127,경상남도,창원시 마산회원구,95-99세,102,17,85
202009,48127,경상남도,창원시 마산회원구,95-99세,104,17,87
202010,48127,경상남도,창원시 마산회원구,95-99세,103,18,85
202011,48127,경상남도,창원시 마산회원구,95-99세,100,16,84
202012,48127,경상남도,창원시 마산회원구,95-99세,98,14,84
202101,48127,경상남도,창원시 마산회원구,95-99세,95,15,80
202102,48127,경상남도,창원시 마산회원구,95-99세,102,17,85
202103,48127,경상남도,창원시 마산회원구,95-99세,104,20,84
202104,48127,경상남도,창원시 마산회원구,95-99세,105,20,85
202105,48127,경상남도,창원시 마산회원구,95-99세,101,17,84
202106,48127,경상남도,창원시 마산회원구,95-99세,102,17,85
202007,48127,경상남도,창원시 마산회원구,100+,38,8,30
202008,48127,경상남도,창원시 마산회원구,100+,39,8,31
202009,48127,경상남도,창원시 마산회원구,100+,40,8,32
202010,48127,경상남도,창원시 마산회원구,100+,42,8,34
202011,48127,경상남도,창원시 마산회원구,100+,43,8,35
202012,48127,경상남도,창원시 마산회원구,100+,45,9,36
202101,48127,경상남도,창원시 마산회원구,100+,47,9,38
202102,48127,경상남도,창원시 마산회원구,100+,46,9,37
202103,48127,경상남도,창원시 마산회원구,100+,35,7,28
202104,48127,경상남도,창원시 마산회원구,100+,34,6,28
202105,48127,경상남도,창원시 마산회원구,100+,22,2,20
202106,48127,경상남도,창원시 마산회원구,100+,19,2,17
202007,48129,경상남도,창원시 진해구,0-4세,8339,4307,4032
202008,48129,경상남도,창원시 진해구,0-4세,8256,4268,3988
202009,48129,경상남도,창원시 진해구,0-4세,8195,4226,3969
202010,48129,경상남도,창원시 진해구,0-4세,8074,4161,3913
202011,48129,경상남도,창원시 진해구,0-4세,7996,4107,3889
202012,48129,경상남도,창원시 진해구,0-4세,7892,4061,3831
202101,48129,경상남도,창원시 진해구,0-4세,7786,4007,3779
202102,48129,경상남도,창원시 진해구,0-4세,7696,3956,3740
202103,48129,경상남도,창원시 진해구,0-4세,7606,3930,3676
202104,48129,경상남도,창원시 진해구,0-4세,7508,3884,3624
202105,48129,경상남도,창원시 진해구,0-4세,7458,3843,3615
202106,48129,경상남도,창원시 진해구,0-4세,7411,3829,3582
202007,48129,경상남도,창원시 진해구,5-9세,11559,6041,5518
202008,48129,경상남도,창원시 진해구,5-9세,11543,6040,5503
202009,48129,경상남도,창원시 진해구,5-9세,11516,6029,5487
202010,48129,경상남도,창원시 진해구,5-9세,11470,6002,5468
202011,48129,경상남도,창원시 진해구,5-9세,11457,5982,5475
202012,48129,경상남도,창원시 진해구,5-9세,11485,6000,5485
202101,48129,경상남도,창원시 진해구,5-9세,11440,5970,5470
202102,48129,경상남도,창원시 진해구,5-9세,11386,5953,5433
202103,48129,경상남도,창원시 진해구,5-9세,11362,5955,5407
202104,48129,경상남도,창원시 진해구,5-9세,11355,5967,5388
202105,48129,경상남도,창원시 진해구,5-9세,11294,5946,5348
202106,48129,경상남도,창원시 진해구,5-9세,11279,5928,5351
202007,48129,경상남도,창원시 진해구,10-14세,10926,5554,5372
202008,48129,경상남도,창원시 진해구,10-14세,10932,5550,5382
202009,48129,경상남도,창원시 진해구,10-14세,10987,5593,5394
202010,48129,경상남도,창원시 진해구,10-14세,11029,5623,5406
202011,48129,경상남도,창원시 진해구,10-14세,11059,5647,5412
202012,48129,경상남도,창원시 진해구,10-14세,11087,5659,5428
202101,48129,경상남도,창원시 진해구,10-14세,11128,5654,5474
202102,48129,경상남도,창원시 진해구,10-14세,11096,5627,5469
202103,48129,경상남도,창원시 진해구,10-14세,11139,5631,5508
202104,48129,경상남도,창원시 진해구,10-14세,11161,5626,5535
202105,48129,경상남도,창원시 진해구,10-14세,11213,5653,5560
202106,48129,경상남도,창원시 진해구,10-14세,11275,5674,5601
202007,48129,경상남도,창원시 진해구,15-19세,10063,5339,4724
202008,48129,경상남도,창원시 진해구,15-19세,10027,5326,4701
202009,48129,경상남도,창원시 진해구,15-19세,9962,5284,4678
202010,48129,경상남도,창원시 진해구,15-19세,9954,5285,4669
202011,48129,경상남도,창원시 진해구,15-19세,9913,5261,4652
202012,48129,경상남도,창원시 진해구,15-19세,9866,5220,4646
202101,48129,경상남도,창원시 진해구,15-19세,9868,5229,4639
202102,48129,경상남도,창원시 진해구,15-19세,9830,5229,4601
202103,48129,경상남도,창원시 진해구,15-19세,9807,5235,4572
202104,48129,경상남도,창원시 진해구,15-19세,9783,5212,4571
202105,48129,경상남도,창원시 진해구,15-19세,9766,5213,4553
202106,48129,경상남도,창원시 진해구,15-19세,9776,5221,4555
202007,48129,경상남도,창원시 진해구,20-24세,10172,5721,4451
202008,48129,경상남도,창원시 진해구,20-24세,10179,5721,4458
202009,48129,경상남도,창원시 진해구,20-24세,10181,5709,4472
202010,48129,경상남도,창원시 진해구,20-24세,10172,5690,4482
202011,48129,경상남도,창원시 진해구,20-24세,10136,5653,4483
202012,48129,경상남도,창원시 진해구,20-24세,10177,5683,4494
202101,48129,경상남도,창원시 진해구,20-24세,10146,5665,4481
202102,48129,경상남도,창원시 진해구,20-24세,10136,5677,4459
202103,48129,경상남도,창원시 진해구,20-24세,10067,5632,4435
202104,48129,경상남도,창원시 진해구,20-24세,10076,5658,4418
202105,48129,경상남도,창원시 진해구,20-24세,10119,5670,4449
202106,48129,경상남도,창원시 진해구,20-24세,10141,5691,4450
202007,48129,경상남도,창원시 진해구,25-29세,10203,5778,4425
202008,48129,경상남도,창원시 진해구,25-29세,10191,5777,4414
202009,48129,경상남도,창원시 진해구,25-29세,10195,5809,4386
202010,48129,경상남도,창원시 진해구,25-29세,10254,5862,4392
202011,48129,경상남도,창원시 진해구,25-29세,10305,5900,4405
202012,48129,경상남도,창원시 진해구,25-29세,10343,5913,4430
202101,48129,경상남도,창원시 진해구,25-29세,10400,5966,4434
202102,48129,경상남도,창원시 진해구,25-29세,10343,5948,4395
202103,48129,경상남도,창원시 진해구,25-29세,10367,5989,4378
202104,48129,경상남도,창원시 진해구,25-29세,10387,6003,4384
202105,48129,경상남도,창원시 진해구,25-29세,10378,5996,4382
202106,48129,경상남도,창원시 진해구,25-29세,10449,6043,4406
202007,48129,경상남도,창원시 진해구,30-34세,11242,5935,5307
202008,48129,경상남도,창원시 진해구,30-34세,11150,5876,5274
202009,48129,경상남도,창원시 진해구,30-34세,11101,5845,5256
202010,48129,경상남도,창원시 진해구,30-34세,10965,5799,5166
202011,48129,경상남도,창원시 진해구,30-34세,10942,5792,5150
202012,48129,경상남도,창원시 진해구,30-34세,10906,5785,5121
202101,48129,경상남도,창원시 진해구,30-34세,10858,5774,5084
202102,48129,경상남도,창원시 진해구,30-34세,10768,5737,5031
202103,48129,경상남도,창원시 진해구,30-34세,10736,5696,5040
202104,48129,경상남도,창원시 진해구,30-34세,10722,5709,5013
202105,48129,경상남도,창원시 진해구,30-34세,10750,5738,5012
202106,48129,경상남도,창원시 진해구,30-34세,10778,5753,5025
202007,48129,경상남도,창원시 진해구,35-39세,16594,8608,7986
202008,48129,경상남도,창원시 진해구,35-39세,16499,8572,7927
202009,48129,경상남도,창원시 진해구,35-39세,16407,8529,7878
202010,48129,경상남도,창원시 진해구,35-39세,16315,8467,7848
202011,48129,경상남도,창원시 진해구,35-39세,16197,8402,7795
202012,48129,경상남도,창원시 진해구,35-39세,16126,8377,7749
202101,48129,경상남도,창원시 진해구,35-39세,15982,8277,7705
202102,48129,경상남도,창원시 진해구,35-39세,15851,8207,7644
202103,48129,경상남도,창원시 진해구,35-39세,15710,8148,7562
202104,48129,경상남도,창원시 진해구,35-39세,15601,8094,7507
202105,48129,경상남도,창원시 진해구,35-39세,15485,8039,7446
202106,48129,경상남도,창원시 진해구,35-39세,15426,8021,7405
202007,48129,경상남도,창원시 진해구,40-44세,17482,9093,8389
202008,48129,경상남도,창원시 진해구,40-44세,17471,9089,8382
202009,48129,경상남도,창원시 진해구,40-44세,17493,9107,8386
202010,48129,경상남도,창원시 진해구,40-44세,17563,9125,8438
202011,48129,경상남도,창원시 진해구,40-44세,17686,9188,8498
202012,48129,경상남도,창원시 진해구,40-44세,17655,9175,8480
202101,48129,경상남도,창원시 진해구,40-44세,17724,9245,8479
202102,48129,경상남도,창원시 진해구,40-44세,17756,9251,8505
202103,48129,경상남도,창원시 진해구,40-44세,17799,9248,8551
202104,48129,경상남도,창원시 진해구,40-44세,17845,9267,8578
202105,48129,경상남도,창원시 진해구,40-44세,17879,9289,8590
202106,48129,경상남도,창원시 진해구,40-44세,18014,9340,8674
202007,48129,경상남도,창원시 진해구,45-49세,17557,9443,8114
202008,48129,경상남도,창원시 진해구,45-49세,17546,9414,8132
202009,48129,경상남도,창원시 진해구,45-49세,17511,9372,8139
202010,48129,경상남도,창원시 진해구,45-49세,17481,9368,8113
202011,48129,경상남도,창원시 진해구,45-49세,17410,9337,8073
202012,48129,경상남도,창원시 진해구,45-49세,17463,9356,8107
202101,48129,경상남도,창원시 진해구,45-49세,17492,9374,8118
202102,48129,경상남도,창원시 진해구,45-49세,17479,9361,8118
202103,48129,경상남도,창원시 진해구,45-49세,17496,9368,8128
202104,48129,경상남도,창원시 진해구,45-49세,17524,9377,8147
202105,48129,경상남도,창원시 진해구,45-49세,17488,9352,8136
202106,48129,경상남도,창원시 진해구,45-49세,17498,9351,8147
202007,48129,경상남도,창원시 진해구,50-54세,14519,7649,6870
202008,48129,경상남도,창원시 진해구,50-54세,14584,7691,6893
202009,48129,경상남도,창원시 진해구,50-54세,14689,7759,6930
202010,48129,경상남도,창원시 진해구,50-54세,14782,7827,6955
202011,48129,경상남도,창원시 진해구,50-54세,14870,7894,6976
202012,48129,경상남도,창원시 진해구,50-54세,14884,7934,6950
202101,48129,경상남도,창원시 진해구,50-54세,15013,7994,7019
202102,48129,경상남도,창원시 진해구,50-54세,15143,8085,7058
202103,48129,경상남도,창원시 진해구,50-54세,15113,8075,7038
202104,48129,경상남도,창원시 진해구,50-54세,15172,8113,7059
202105,48129,경상남도,창원시 진해구,50-54세,15298,8186,7112
202106,48129,경상남도,창원시 진해구,50-54세,15404,8232,7172
202007,48129,경상남도,창원시 진해구,55-59세,13720,6856,6864
202008,48129,경상남도,창원시 진해구,55-59세,13649,6821,6828
202009,48129,경상남도,창원시 진해구,55-59세,13580,6790,6790
202010,48129,경상남도,창원시 진해구,55-59세,13557,6789,6768
202011,48129,경상남도,창원시 진해구,55-59세,13547,6771,6776
202012,48129,경상남도,창원시 진해구,55-59세,13554,6779,6775
202101,48129,경상남도,창원시 진해구,55-59세,13456,6747,6709
202102,48129,경상남도,창원시 진해구,55-59세,13452,6738,6714
202103,48129,경상남도,창원시 진해구,55-59세,13473,6756,6717
202104,48129,경상남도,창원시 진해구,55-59세,13465,6768,6697
202105,48129,경상남도,창원시 진해구,55-59세,13397,6749,6648
202106,48129,경상남도,창원시 진해구,55-59세,13354,6760,6594
202007,48129,경상남도,창원시 진해구,60-64세,13260,6451,6809
202008,48129,경상남도,창원시 진해구,60-64세,13366,6521,6845
202009,48129,경상남도,창원시 진해구,60-64세,13443,6555,6888
202010,48129,경상남도,창원시 진해구,60-64세,13464,6544,6920
202011,48129,경상남도,창원시 진해구,60-64세,13542,6584,6958
202012,48129,경상남도,창원시 진해구,60-64세,13593,6597,6996
202101,48129,경상남도,창원시 진해구,60-64세,13693,6632,7061
202102,48129,경상남도,창원시 진해구,60-64세,13737,6666,7071
202103,48129,경상남도,창원시 진해구,60-64세,13804,6704,7100
202104,48129,경상남도,창원시 진해구,60-64세,13852,6728,7124
202105,48129,경상남도,창원시 진해구,60-64세,13926,6769,7157
202106,48129,경상남도,창원시 진해구,60-64세,14013,6802,7211
202007,48129,경상남도,창원시 진해구,65-69세,9530,4661,4869
202008,48129,경상남도,창원시 진해구,65-69세,9625,4707,4918
202009,48129,경상남도,창원시 진해구,65-69세,9703,4747,4956
202010,48129,경상남도,창원시 진해구,65-69세,9820,4812,5008
202011,48129,경상남도,창원시 진해구,65-69세,9885,4841,5044
202012,48129,경상남도,창원시 진해구,65-69세,9985,4897,5088
202101,48129,경상남도,창원시 진해구,65-69세,10093,4949,5144
202102,48129,경상남도,창원시 진해구,65-69세,10149,4983,5166
202103,48129,경상남도,창원시 진해구,65-69세,10252,5029,5223
202104,48129,경상남도,창원시 진해구,65-69세,10327,5053,5274
202105,48129,경상남도,창원시 진해구,65-69세,10385,5078,5307
202106,48129,경상남도,창원시 진해구,65-69세,10438,5095,5343
202007,48129,경상남도,창원시 진해구,70-74세,6613,3130,3483
202008,48129,경상남도,창원시 진해구,70-74세,6628,3134,3494
202009,48129,경상남도,창원시 진해구,70-74세,6668,3163,3505
202010,48129,경상남도,창원시 진해구,70-74세,6692,3177,3515
202011,48129,경상남도,창원시 진해구,70-74세,6781,3224,3557
202012,48129,경상남도,창원시 진해구,70-74세,6845,3235,3610
202101,48129,경상남도,창원시 진해구,70-74세,6892,3265,3627
202102,48129,경상남도,창원시 진해구,70-74세,6939,3279,3660
202103,48129,경상남도,창원시 진해구,70-74세,6976,3281,3695
202104,48129,경상남도,창원시 진해구,70-74세,7034,3310,3724
202105,48129,경상남도,창원시 진해구,70-74세,7060,3320,3740
202106,48129,경상남도,창원시 진해구,70-74세,7077,3313,3764
202007,48129,경상남도,창원시 진해구,75-79세,5050,2123,2927
202008,48129,경상남도,창원시 진해구,75-79세,5049,2121,2928
202009,48129,경상남도,창원시 진해구,75-79세,5037,2111,2926
202010,48129,경상남도,창원시 진해구,75-79세,5021,2105,2916
202011,48129,경상남도,창원시 진해구,75-79세,4964,2086,2878
202012,48129,경상남도,창원시 진해구,75-79세,4954,2084,2870
202101,48129,경상남도,창원시 진해구,75-79세,4940,2079,2861
202102,48129,경상남도,창원시 진해구,75-79세,4913,2070,2843
202103,48129,경상남도,창원시 진해구,75-79세,4927,2077,2850
202104,48129,경상남도,창원시 진해구,75-79세,4915,2064,2851
202105,48129,경상남도,창원시 진해구,75-79세,4914,2067,2847
202106,48129,경상남도,창원시 진해구,75-79세,4947,2092,2855
202007,48129,경상남도,창원시 진해구,80-84세,3500,1320,2180
202008,48129,경상남도,창원시 진해구,80-84세,3498,1315,2183
202009,48129,경상남도,창원시 진해구,80-84세,3480,1315,2165
202010,48129,경상남도,창원시 진해구,80-84세,3500,1326,2174
202011,48129,경상남도,창원시 진해구,80-84세,3521,1333,2188
202012,48129,경상남도,창원시 진해구,80-84세,3528,1337,2191
202101,48129,경상남도,창원시 진해구,80-84세,3550,1341,2209
202102,48129,경상남도,창원시 진해구,80-84세,3583,1350,2233
202103,48129,경상남도,창원시 진해구,80-84세,3587,1356,2231
202104,48129,경상남도,창원시 진해구,80-84세,3587,1365,2222
202105,48129,경상남도,창원시 진해구,80-84세,3588,1371,2217
202106,48129,경상남도,창원시 진해구,80-84세,3599,1369,2230
202007,48129,경상남도,창원시 진해구,85-89세,1696,478,1218
202008,48129,경상남도,창원시 진해구,85-89세,1713,492,1221
202009,48129,경상남도,창원시 진해구,85-89세,1729,499,1230
202010,48129,경상남도,창원시 진해구,85-89세,1736,502,1234
202011,48129,경상남도,창원시 진해구,85-89세,1747,506,1241
202012,48129,경상남도,창원시 진해구,85-89세,1760,513,1247
202101,48129,경상남도,창원시 진해구,85-89세,1787,532,1255
202102,48129,경상남도,창원시 진해구,85-89세,1803,535,1268
202103,48129,경상남도,창원시 진해구,85-89세,1821,543,1278
202104,48129,경상남도,창원시 진해구,85-89세,1844,557,1287
202105,48129,경상남도,창원시 진해구,85-89세,1852,555,1297
202106,48129,경상남도,창원시 진해구,85-89세,1860,560,1300
202007,48129,경상남도,창원시 진해구,90-94세,503,107,396
202008,48129,경상남도,창원시 진해구,90-94세,512,105,407
202009,48129,경상남도,창원시 진해구,90-94세,528,107,421
202010,48129,경상남도,창원시 진해구,90-94세,532,106,426
202011,48129,경상남도,창원시 진해구,90-94세,536,106,430
202012,48129,경상남도,창원시 진해구,90-94세,528,107,421
202101,48129,경상남도,창원시 진해구,90-94세,542,108,434
202102,48129,경상남도,창원시 진해구,90-94세,551,111,440
202103,48129,경상남도,창원시 진해구,90-94세,561,114,447
202104,48129,경상남도,창원시 진해구,90-94세,563,113,450
202105,48129,경상남도,창원시 진해구,90-94세,572,113,459
202106,48129,경상남도,창원시 진해구,90-94세,568,113,455
202007,48129,경상남도,창원시 진해구,95-99세,94,18,76
202008,48129,경상남도,창원시 진해구,95-99세,92,18,74
202009,48129,경상남도,창원시 진해구,95-99세,96,18,78
202010,48129,경상남도,창원시 진해구,95-99세,97,18,79
202011,48129,경상남도,창원시 진해구,95-99세,100,19,81
202012,48129,경상남도,창원시 진해구,95-99세,106,19,87
202101,48129,경상남도,창원시 진해구,95-99세,108,20,88
202102,48129,경상남도,창원시 진해구,95-99세,113,21,92
202103,48129,경상남도,창원시 진해구,95-99세,112,21,91
202104,48129,경상남도,창원시 진해구,95-99세,114,21,93
202105,48129,경상남도,창원시 진해구,95-99세,114,20,94
202106,48129,경상남도,창원시 진해구,95-99세,112,17,95
202007,48129,경상남도,창원시 진해구,100+,19,5,14
202008,48129,경상남도,창원시 진해구,100+,20,5,15
202009,48129,경상남도,창원시 진해구,100+,20,5,15
202010,48129,경상남도,창원시 진해구,100+,20,5,15
202011,48129,경상남도,창원시 진해구,100+,18,5,13
202012,48129,경상남도,창원시 진해구,100+,18,5,13
202101,48129,경상남도,창원시 진해구,100+,18,5,13
202102,48129,경상남도,창원시 진해구,100+,18,5,13
202103,48129,경상남도,창원시 진해구,100+,17,4,13
202104,48129,경상남도,창원시 진해구,100+,17,4,13
202105,48129,경상남도,창원시 진해구,100+,11,2,9
202106,48129,경상남도,창원시 진해구,100+,11,2,9
202007,48170,경상남도,진주시,0-4세,11912,6128,5784
202008,48170,경상남도,진주시,0-4세,11849,6096,5753
202009,48170,경상남도,진주시,0-4세,11765,6050,5715
202010,48170,경상남도,진주시,0-4세,11702,6011,5691
202011,48170,경상남도,진주시,0-4세,11630,5972,5658
202012,48170,경상남도,진주시,0-4세,11575,5947,5628
202101,48170,경상남도,진주시,0-4세,11459,5901,5558
202102,48170,경상남도,진주시,0-4세,11347,5845,5502
202103,48170,경상남도,진주시,0-4세,11272,5807,5465
202104,48170,경상남도,진주시,0-4세,11168,5775,5393
202105,48170,경상남도,진주시,0-4세,11072,5725,5347
202106,48170,경상남도,진주시,0-4세,10973,5676,5297
202007,48170,경상남도,진주시,5-9세,16976,8880,8096
202008,48170,경상남도,진주시,5-9세,16971,8883,8088
202009,48170,경상남도,진주시,5-9세,16945,8855,8090
202010,48170,경상남도,진주시,5-9세,16861,8805,8056
202011,48170,경상남도,진주시,5-9세,16848,8794,8054
202012,48170,경상남도,진주시,5-9세,16821,8784,8037
202101,48170,경상남도,진주시,5-9세,16697,8702,7995
202102,48170,경상남도,진주시,5-9세,16646,8688,7958
202103,48170,경상남도,진주시,5-9세,16575,8640,7935
202104,48170,경상남도,진주시,5-9세,16540,8579,7961
202105,48170,경상남도,진주시,5-9세,16545,8565,7980
202106,48170,경상남도,진주시,5-9세,16508,8550,7958
202007,48170,경상남도,진주시,10-14세,17012,8881,8131
202008,48170,경상남도,진주시,10-14세,17048,8886,8162
202009,48170,경상남도,진주시,10-14세,17116,8920,8196
202010,48170,경상남도,진주시,10-14세,17186,8956,8230
202011,48170,경상남도,진주시,10-14세,17215,8968,8247
202012,48170,경상남도,진주시,10-14세,17309,9014,8295
202101,48170,경상남도,진주시,10-14세,17400,9086,8314
202102,48170,경상남도,진주시,10-14세,17427,9088,8339
202103,48170,경상남도,진주시,10-14세,17452,9115,8337
202104,48170,경상남도,진주시,10-14세,17483,9153,8330
202105,48170,경상남도,진주시,10-14세,17494,9149,8345
202106,48170,경상남도,진주시,10-14세,17507,9149,8358
202007,48170,경상남도,진주시,15-19세,18569,9878,8691
202008,48170,경상남도,진주시,15-19세,18405,9806,8599
202009,48170,경상남도,진주시,15-19세,18292,9763,8529
202010,48170,경상남도,진주시,15-19세,18180,9705,8475
202011,48170,경상남도,진주시,15-19세,18000,9622,8378
202012,48170,경상남도,진주시,15-19세,17916,9583,8333
202101,48170,경상남도,진주시,15-19세,17845,9537,8308
202102,48170,경상남도,진주시,15-19세,17715,9459,8256
202103,48170,경상남도,진주시,15-19세,17454,9288,8166
202104,48170,경상남도,진주시,15-19세,17376,9227,8149
202105,48170,경상남도,진주시,15-19세,17295,9188,8107
202106,48170,경상남도,진주시,15-19세,17231,9145,8086
202007,48170,경상남도,진주시,20-24세,23481,12843,10638
202008,48170,경상남도,진주시,20-24세,23445,12823,10622
202009,48170,경상남도,진주시,20-24세,23451,12781,10670
202010,48170,경상남도,진주시,20-24세,23415,12764,10651
202011,48170,경상남도,진주시,20-24세,23376,12726,10650
202012,48170,경상남도,진주시,20-24세,23331,12708,10623
202101,48170,경상남도,진주시,20-24세,23254,12663,10591
202102,48170,경상남도,진주시,20-24세,23164,12626,10538
202103,48170,경상남도,진주시,20-24세,23022,12543,10479
202104,48170,경상남도,진주시,20-24세,22984,12512,10472
202105,48170,경상남도,진주시,20-24세,22978,12511,10467
202106,48170,경상남도,진주시,20-24세,22934,12486,10448
202007,48170,경상남도,진주시,25-29세,21290,11857,9433
202008,48170,경상남도,진주시,25-29세,21319,11881,9438
202009,48170,경상남도,진주시,25-29세,21437,11914,9523
202010,48170,경상남도,진주시,25-29세,21565,11987,9578
202011,48170,경상남도,진주시,25-29세,21690,12051,9639
202012,48170,경상남도,진주시,25-29세,21812,12117,9695
202101,48170,경상남도,진주시,25-29세,21793,12116,9677
202102,48170,경상남도,진주시,25-29세,21729,12054,9675
202103,48170,경상남도,진주시,25-29세,21805,12114,9691
202104,48170,경상남도,진주시,25-29세,21858,12157,9701
202105,48170,경상남도,진주시,25-29세,21965,12210,9755
202106,48170,경상남도,진주시,25-29세,21974,12216,9758
202007,48170,경상남도,진주시,30-34세,18826,9919,8907
202008,48170,경상남도,진주시,30-34세,18836,9923,8913
202009,48170,경상남도,진주시,30-34세,18894,9974,8920
202010,48170,경상남도,진주시,30-34세,18879,9962,8917
202011,48170,경상남도,진주시,30-34세,18823,9959,8864
202012,48170,경상남도,진주시,30-34세,18811,9954,8857
202101,48170,경상남도,진주시,30-34세,18766,9938,8828
202102,48170,경상남도,진주시,30-34세,18787,9948,8839
202103,48170,경상남도,진주시,30-34세,18781,9955,8826
202104,48170,경상남도,진주시,30-34세,18798,9980,8818
202105,48170,경상남도,진주시,30-34세,18842,10023,8819
202106,48170,경상남도,진주시,30-34세,18840,10027,8813
202007,48170,경상남도,진주시,35-39세,23240,11550,11690
202008,48170,경상남도,진주시,35-39세,23150,11486,11664
202009,48170,경상남도,진주시,35-39세,23076,11452,11624
202010,48170,경상남도,진주시,35-39세,22969,11399,11570
202011,48170,경상남도,진주시,35-39세,22903,11353,11550
202012,48170,경상남도,진주시,35-39세,22837,11313,11524
202101,48170,경상남도,진주시,35-39세,22811,11317,11494
202102,48170,경상남도,진주시,35-39세,22615,11242,11373
202103,48170,경상남도,진주시,35-39세,22496,11209,11287
202104,48170,경상남도,진주시,35-39세,22415,11161,11254
202105,48170,경상남도,진주시,35-39세,22317,11111,11206
202106,48170,경상남도,진주시,35-39세,22222,11082,11140
202007,48170,경상남도,진주시,40-44세,25182,12510,12672
202008,48170,경상남도,진주시,40-44세,25180,12523,12657
202009,48170,경상남도,진주시,40-44세,25300,12572,12728
202010,48170,경상남도,진주시,40-44세,25427,12639,12788
202011,48170,경상남도,진주시,40-44세,25407,12619,12788
202012,48170,경상남도,진주시,40-44세,25276,12584,12692
202101,48170,경상남도,진주시,40-44세,25203,12515,12688
202102,48170,경상남도,진주시,40-44세,25247,12555,12692
202103,48170,경상남도,진주시,40-44세,25092,12481,12611
202104,48170,경상남도,진주시,40-44세,25112,12510,12602
202105,48170,경상남도,진주시,40-44세,25143,12526,12617
202106,48170,경상남도,진주시,40-44세,25238,12553,12685
202007,48170,경상남도,진주시,45-49세,29398,14690,14708
202008,48170,경상남도,진주시,45-49세,29344,14639,14705
202009,48170,경상남도,진주시,45-49세,29137,14558,14579
202010,48170,경상남도,진주시,45-49세,28960,14472,14488
202011,48170,경상남도,진주시,45-49세,28905,14415,14490
202012,48170,경상남도,진주시,45-49세,29022,14473,14549
202101,48170,경상남도,진주시,45-49세,29008,14481,14527
202102,48170,경상남도,진주시,45-49세,28846,14393,14453
202103,48170,경상남도,진주시,45-49세,28706,14319,14387
202104,48170,경상남도,진주시,45-49세,28676,14308,14368
202105,48170,경상남도,진주시,45-49세,28542,14252,14290
202106,48170,경상남도,진주시,45-49세,28447,14194,14253
202007,48170,경상남도,진주시,50-54세,29663,14728,14935
202008,48170,경상남도,진주시,50-54세,29745,14778,14967
202009,48170,경상남도,진주시,50-54세,29873,14802,15071
202010,48170,경상남도,진주시,50-54세,30038,14890,15148
202011,48170,경상남도,진주시,50-54세,30100,14915,15185
202012,48170,경상남도,진주시,50-54세,29982,14840,15142
202101,48170,경상남도,진주시,50-54세,30085,14875,15210
202102,48170,경상남도,진주시,50-54세,30135,14903,15232
202103,48170,경상남도,진주시,50-54세,30052,14856,15196
202104,48170,경상남도,진주시,50-54세,30077,14855,15222
202105,48170,경상남도,진주시,50-54세,30241,14922,15319
202106,48170,경상남도,진주시,50-54세,30340,14988,15352
202007,48170,경상남도,진주시,55-59세,28133,13730,14403
202008,48170,경상남도,진주시,55-59세,28041,13702,14339
202009,48170,경상남도,진주시,55-59세,27992,13703,14289
202010,48170,경상남도,진주시,55-59세,27877,13643,14234
202011,48170,경상남도,진주시,55-59세,27791,13629,14162
202012,48170,경상남도,진주시,55-59세,27809,13627,14182
202101,48170,경상남도,진주시,55-59세,27596,13547,14049
202102,48170,경상남도,진주시,55-59세,27513,13529,13984
202103,48170,경상남도,진주시,55-59세,27315,13429,13886
202104,48170,경상남도,진주시,55-59세,27105,13337,13768
202105,48170,경상남도,진주시,55-59세,26871,13225,13646
202106,48170,경상남도,진주시,55-59세,26630,13131,13499
202007,48170,경상남도,진주시,60-64세,25735,12536,13199
202008,48170,경상남도,진주시,60-64세,25833,12563,13270
202009,48170,경상남도,진주시,60-64세,25955,12618,13337
202010,48170,경상남도,진주시,60-64세,26142,12690,13452
202011,48170,경상남도,진주시,60-64세,26330,12751,13579
202012,48170,경상남도,진주시,60-64세,26563,12845,13718
202101,48170,경상남도,진주시,60-64세,26781,12961,13820
202102,48170,경상남도,진주시,60-64세,27038,13063,13975
202103,48170,경상남도,진주시,60-64세,27311,13213,14098
202104,48170,경상남도,진주시,60-64세,27574,13328,14246
202105,48170,경상남도,진주시,60-64세,27792,13434,14358
202106,48170,경상남도,진주시,60-64세,27999,13522,14477
202007,48170,경상남도,진주시,65-69세,18451,8622,9829
202008,48170,경상남도,진주시,65-69세,18591,8686,9905
202009,48170,경상남도,진주시,65-69세,18796,8782,10014
202010,48170,경상남도,진주시,65-69세,18922,8862,10060
202011,48170,경상남도,진주시,65-69세,19051,8924,10127
202012,48170,경상남도,진주시,65-69세,19205,9016,10189
202101,48170,경상남도,진주시,65-69세,19352,9065,10287
202102,48170,경상남도,진주시,65-69세,19435,9103,10332
202103,48170,경상남도,진주시,65-69세,19566,9182,10384
202104,48170,경상남도,진주시,65-69세,19669,9229,10440
202105,48170,경상남도,진주시,65-69세,19837,9328,10509
202106,48170,경상남도,진주시,65-69세,19926,9356,10570
202007,48170,경상남도,진주시,70-74세,14114,6443,7671
202008,48170,경상남도,진주시,70-74세,14157,6455,7702
202009,48170,경상남도,진주시,70-74세,14217,6482,7735
202010,48170,경상남도,진주시,70-74세,14270,6499,7771
202011,48170,경상남도,진주시,70-74세,14331,6522,7809
202012,48170,경상남도,진주시,70-74세,14459,6575,7884
202101,48170,경상남도,진주시,70-74세,14567,6633,7934
202102,48170,경상남도,진주시,70-74세,14634,6650,7984
202103,48170,경상남도,진주시,70-74세,14684,6645,8039
202104,48170,경상남도,진주시,70-74세,14755,6688,8067
202105,48170,경상남도,진주시,70-74세,14801,6699,8102
202106,48170,경상남도,진주시,70-74세,14809,6703,8106
202007,48170,경상남도,진주시,75-79세,11418,4706,6712
202008,48170,경상남도,진주시,75-79세,11394,4692,6702
202009,48170,경상남도,진주시,75-79세,11319,4665,6654
202010,48170,경상남도,진주시,75-79세,11273,4656,6617
202011,48170,경상남도,진주시,75-79세,11226,4647,6579
202012,48170,경상남도,진주시,75-79세,11106,4591,6515
202101,48170,경상남도,진주시,75-79세,11044,4561,6483
202102,48170,경상남도,진주시,75-79세,10994,4548,6446
202103,48170,경상남도,진주시,75-79세,10971,4545,6426
202104,48170,경상남도,진주시,75-79세,10921,4525,6396
202105,48170,경상남도,진주시,75-79세,10920,4538,6382
202106,48170,경상남도,진주시,75-79세,10945,4556,6389
202007,48170,경상남도,진주시,80-84세,8045,2647,5398
202008,48170,경상남도,진주시,80-84세,8041,2671,5370
202009,48170,경상남도,진주시,80-84세,8068,2694,5374
202010,48170,경상남도,진주시,80-84세,8089,2702,5387
202011,48170,경상남도,진주시,80-84세,8113,2709,5404
202012,48170,경상남도,진주시,80-84세,8113,2720,5393
202101,48170,경상남도,진주시,80-84세,8162,2755,5407
202102,48170,경상남도,진주시,80-84세,8231,2793,5438
202103,48170,경상남도,진주시,80-84세,8226,2803,5423
202104,48170,경상남도,진주시,80-84세,8242,2808,5434
202105,48170,경상남도,진주시,80-84세,8270,2825,5445
202106,48170,경상남도,진주시,80-84세,8289,2843,5446
202007,48170,경상남도,진주시,85-89세,4091,1034,3057
202008,48170,경상남도,진주시,85-89세,4128,1038,3090
202009,48170,경상남도,진주시,85-89세,4166,1044,3122
202010,48170,경상남도,진주시,85-89세,4187,1046,3141
202011,48170,경상남도,진주시,85-89세,4219,1069,3150
202012,48170,경상남도,진주시,85-89세,4301,1097,3204
202101,48170,경상남도,진주시,85-89세,4337,1094,3243
202102,48170,경상남도,진주시,85-89세,4356,1105,3251
202103,48170,경상남도,진주시,85-89세,4385,1103,3282
202104,48170,경상남도,진주시,85-89세,4420,1120,3300
202105,48170,경상남도,진주시,85-89세,4465,1133,3332
202106,48170,경상남도,진주시,85-89세,4506,1137,3369
202007,48170,경상남도,진주시,90-94세,1374,250,1124
202008,48170,경상남도,진주시,90-94세,1371,246,1125
202009,48170,경상남도,진주시,90-94세,1381,243,1138
202010,48170,경상남도,진주시,90-94세,1393,245,1148
202011,48170,경상남도,진주시,90-94세,1411,246,1165
202012,48170,경상남도,진주시,90-94세,1420,242,1178
202101,48170,경상남도,진주시,90-94세,1428,250,1178
202102,48170,경상남도,진주시,90-94세,1467,259,1208
202103,48170,경상남도,진주시,90-94세,1475,262,1213
202104,48170,경상남도,진주시,90-94세,1489,266,1223
202105,48170,경상남도,진주시,90-94세,1491,269,1222
202106,48170,경상남도,진주시,90-94세,1493,276,1217
202007,48170,경상남도,진주시,95-99세,313,53,260
202008,48170,경상남도,진주시,95-99세,320,53,267
202009,48170,경상남도,진주시,95-99세,324,56,268
202010,48170,경상남도,진주시,95-99세,328,56,272
202011,48170,경상남도,진주시,95-99세,330,56,274
202012,48170,경상남도,진주시,95-99세,334,57,277
202101,48170,경상남도,진주시,95-99세,339,55,284
202102,48170,경상남도,진주시,95-99세,327,51,276
202103,48170,경상남도,진주시,95-99세,314,48,266
202104,48170,경상남도,진주시,95-99세,315,50,265
202105,48170,경상남도,진주시,95-99세,315,48,267
202106,48170,경상남도,진주시,95-99세,316,47,269
202007,48170,경상남도,진주시,100+,94,22,72
202008,48170,경상남도,진주시,100+,94,22,72
202009,48170,경상남도,진주시,100+,94,22,72
202010,48170,경상남도,진주시,100+,96,21,75
202011,48170,경상남도,진주시,100+,96,21,75
202012,48170,경상남도,진주시,100+,94,20,74
202101,48170,경상남도,진주시,100+,95,20,75
202102,48170,경상남도,진주시,100+,97,22,75
202103,48170,경상남도,진주시,100+,80,16,64
202104,48170,경상남도,진주시,100+,79,16,63
202105,48170,경상남도,진주시,100+,78,16,62
202106,48170,경상남도,진주시,100+,77,16,61
202007,48220,경상남도,통영시,0-4세,3672,1831,1841
202008,48220,경상남도,통영시,0-4세,3610,1812,1798
202009,48220,경상남도,통영시,0-4세,3575,1782,1793
202010,48220,경상남도,통영시,0-4세,3504,1743,1761
202011,48220,경상남도,통영시,0-4세,3460,1717,1743
202012,48220,경상남도,통영시,0-4세,3412,1699,1713
202101,48220,경상남도,통영시,0-4세,3353,1676,1677
202102,48220,경상남도,통영시,0-4세,3313,1653,1660
202103,48220,경상남도,통영시,0-4세,3257,1624,1633
202104,48220,경상남도,통영시,0-4세,3215,1603,1612
202105,48220,경상남도,통영시,0-4세,3154,1576,1578
202106,48220,경상남도,통영시,0-4세,3085,1544,1541
202007,48220,경상남도,통영시,5-9세,6485,3276,3209
202008,48220,경상남도,통영시,5-9세,6453,3251,3202
202009,48220,경상남도,통영시,5-9세,6408,3239,3169
202010,48220,경상남도,통영시,5-9세,6343,3197,3146
202011,48220,경상남도,통영시,5-9세,6287,3169,3118
202012,48220,경상남도,통영시,5-9세,6248,3155,3093
202101,48220,경상남도,통영시,5-9세,6207,3135,3072
202102,48220,경상남도,통영시,5-9세,6149,3096,3053
202103,48220,경상남도,통영시,5-9세,6089,3051,3038
202104,48220,경상남도,통영시,5-9세,6017,3026,2991
202105,48220,경상남도,통영시,5-9세,5997,3012,2985
202106,48220,경상남도,통영시,5-9세,5977,3016,2961
202007,48220,경상남도,통영시,10-14세,6618,3424,3194
202008,48220,경상남도,통영시,10-14세,6619,3406,3213
202009,48220,경상남도,통영시,10-14세,6635,3402,3233
202010,48220,경상남도,통영시,10-14세,6676,3433,3243
202011,48220,경상남도,통영시,10-14세,6704,3453,3251
202012,48220,경상남도,통영시,10-14세,6723,3453,3270
202101,48220,경상남도,통영시,10-14세,6739,3451,3288
202102,48220,경상남도,통영시,10-14세,6717,3444,3273
202103,48220,경상남도,통영시,10-14세,6737,3463,3274
202104,48220,경상남도,통영시,10-14세,6744,3463,3281
202105,48220,경상남도,통영시,10-14세,6754,3467,3287
202106,48220,경상남도,통영시,10-14세,6774,3471,3303
202007,48220,경상남도,통영시,15-19세,6303,3287,3016
202008,48220,경상남도,통영시,15-19세,6268,3272,2996
202009,48220,경상남도,통영시,15-19세,6261,3277,2984
202010,48220,경상남도,통영시,15-19세,6197,3244,2953
202011,48220,경상남도,통영시,15-19세,6145,3220,2925
202012,48220,경상남도,통영시,15-19세,6125,3208,2917
202101,48220,경상남도,통영시,15-19세,6093,3190,2903
202102,48220,경상남도,통영시,15-19세,6034,3150,2884
202103,48220,경상남도,통영시,15-19세,5941,3108,2833
202104,48220,경상남도,통영시,15-19세,5935,3095,2840
202105,48220,경상남도,통영시,15-19세,5901,3077,2824
202106,48220,경상남도,통영시,15-19세,5895,3073,2822
202007,48220,경상남도,통영시,20-24세,6289,3518,2771
202008,48220,경상남도,통영시,20-24세,6271,3520,2751
202009,48220,경상남도,통영시,20-24세,6240,3510,2730
202010,48220,경상남도,통영시,20-24세,6246,3520,2726
202011,48220,경상남도,통영시,20-24세,6234,3509,2725
202012,48220,경상남도,통영시,20-24세,6160,3493,2667
202101,48220,경상남도,통영시,20-24세,6147,3513,2634
202102,48220,경상남도,통영시,20-24세,6090,3488,2602
202103,48220,경상남도,통영시,20-24세,6001,3425,2576
202104,48220,경상남도,통영시,20-24세,5973,3412,2561
202105,48220,경상남도,통영시,20-24세,5962,3407,2555
202106,48220,경상남도,통영시,20-24세,5941,3400,2541
202007,48220,경상남도,통영시,25-29세,5118,2765,2353
202008,48220,경상남도,통영시,25-29세,5060,2738,2322
202009,48220,경상남도,통영시,25-29세,5047,2731,2316
202010,48220,경상남도,통영시,25-29세,5039,2738,2301
202011,48220,경상남도,통영시,25-29세,5050,2745,2305
202012,48220,경상남도,통영시,25-29세,5063,2735,2328
202101,48220,경상남도,통영시,25-29세,5024,2720,2304
202102,48220,경상남도,통영시,25-29세,5001,2708,2293
202103,48220,경상남도,통영시,25-29세,4961,2698,2263
202104,48220,경상남도,통영시,25-29세,4938,2673,2265
202105,48220,경상남도,통영시,25-29세,4930,2668,2262
202106,48220,경상남도,통영시,25-29세,4907,2664,2243
202007,48220,경상남도,통영시,30-34세,5601,2933,2668
202008,48220,경상남도,통영시,30-34세,5558,2921,2637
202009,48220,경상남도,통영시,30-34세,5524,2897,2627
202010,48220,경상남도,통영시,30-34세,5469,2863,2606
202011,48220,경상남도,통영시,30-34세,5410,2835,2575
202012,48220,경상남도,통영시,30-34세,5345,2805,2540
202101,48220,경상남도,통영시,30-34세,5294,2764,2530
202102,48220,경상남도,통영시,30-34세,5219,2722,2497
202103,48220,경상남도,통영시,30-34세,5165,2698,2467
202104,48220,경상남도,통영시,30-34세,5158,2692,2466
202105,48220,경상남도,통영시,30-34세,5105,2636,2469
202106,48220,경상남도,통영시,30-34세,5077,2621,2456
202007,48220,경상남도,통영시,35-39세,8959,4571,4388
202008,48220,경상남도,통영시,35-39세,8856,4522,4334
202009,48220,경상남도,통영시,35-39세,8754,4477,4277
202010,48220,경상남도,통영시,35-39세,8640,4409,4231
202011,48220,경상남도,통영시,35-39세,8560,4371,4189
202012,48220,경상남도,통영시,35-39세,8475,4316,4159
202101,48220,경상남도,통영시,35-39세,8392,4262,4130
202102,48220,경상남도,통영시,35-39세,8257,4197,4060
202103,48220,경상남도,통영시,35-39세,8129,4144,3985
202104,48220,경상남도,통영시,35-39세,8063,4103,3960
202105,48220,경상남도,통영시,35-39세,7971,4067,3904
202106,48220,경상남도,통영시,35-39세,7918,4045,3873
202007,48220,경상남도,통영시,40-44세,10184,5494,4690
202008,48220,경상남도,통영시,40-44세,10165,5462,4703
202009,48220,경상남도,통영시,40-44세,10184,5466,4718
202010,48220,경상남도,통영시,40-44세,10208,5476,4732
202011,48220,경상남도,통영시,40-44세,10178,5434,4744
202012,48220,경상남도,통영시,40-44세,10125,5396,4729
202101,48220,경상남도,통영시,40-44세,10122,5415,4707
202102,48220,경상남도,통영시,40-44세,10113,5396,4717
202103,48220,경상남도,통영시,40-44세,10031,5350,4681
202104,48220,경상남도,통영시,40-44세,9992,5320,4672
202105,48220,경상남도,통영시,40-44세,9976,5312,4664
202106,48220,경상남도,통영시,40-44세,9997,5309,4688
202007,48220,경상남도,통영시,45-49세,11414,6180,5234
202008,48220,경상남도,통영시,45-49세,11387,6164,5223
202009,48220,경상남도,통영시,45-49세,11321,6136,5185
202010,48220,경상남도,통영시,45-49세,11250,6099,5151
202011,48220,경상남도,통영시,45-49세,11236,6111,5125
202012,48220,경상남도,통영시,45-49세,11206,6110,5096
202101,48220,경상남도,통영시,45-49세,11183,6085,5098
202102,48220,경상남도,통영시,45-49세,11137,6065,5072
202103,48220,경상남도,통영시,45-49세,11066,6010,5056
202104,48220,경상남도,통영시,45-49세,11066,6012,5054
202105,48220,경상남도,통영시,45-49세,11039,5982,5057
202106,48220,경상남도,통영시,45-49세,10957,5947,5010
202007,48220,경상남도,통영시,50-54세,11111,5822,5289
202008,48220,경상남도,통영시,50-54세,11146,5852,5294
202009,48220,경상남도,통영시,50-54세,11191,5869,5322
202010,48220,경상남도,통영시,50-54세,11295,5934,5361
202011,48220,경상남도,통영시,50-54세,11317,5945,5372
202012,48220,경상남도,통영시,50-54세,11306,5942,5364
202101,48220,경상남도,통영시,50-54세,11312,5949,5363
202102,48220,경상남도,통영시,50-54세,11287,5937,5350
202103,48220,경상남도,통영시,50-54세,11221,5937,5284
202104,48220,경상남도,통영시,50-54세,11204,5934,5270
202105,48220,경상남도,통영시,50-54세,11240,5960,5280
202106,48220,경상남도,통영시,50-54세,11247,5962,5285
202007,48220,경상남도,통영시,55-59세,11583,5756,5827
202008,48220,경상남도,통영시,55-59세,11465,5694,5771
202009,48220,경상남도,통영시,55-59세,11374,5679,5695
202010,48220,경상남도,통영시,55-59세,11278,5644,5634
202011,48220,경상남도,통영시,55-59세,11201,5602,5599
202012,48220,경상남도,통영시,55-59세,11168,5586,5582
202101,48220,경상남도,통영시,55-59세,11074,5540,5534
202102,48220,경상남도,통영시,55-59세,11077,5548,5529
202103,48220,경상남도,통영시,55-59세,10975,5505,5470
202104,48220,경상남도,통영시,55-59세,10937,5495,5442
202105,48220,경상남도,통영시,55-59세,10868,5470,5398
202106,48220,경상남도,통영시,55-59세,10797,5443,5354
202007,48220,경상남도,통영시,60-64세,11482,5629,5853
202008,48220,경상남도,통영시,60-64세,11543,5677,5866
202009,48220,경상남도,통영시,60-64세,11614,5686,5928
202010,48220,경상남도,통영시,60-64세,11679,5718,5961
202011,48220,경상남도,통영시,60-64세,11753,5748,6005
202012,48220,경상남도,통영시,60-64세,11800,5766,6034
202101,48220,경상남도,통영시,60-64세,11878,5791,6087
202102,48220,경상남도,통영시,60-64세,11918,5824,6094
202103,48220,경상남도,통영시,60-64세,11933,5822,6111
202104,48220,경상남도,통영시,60-64세,11967,5838,6129
202105,48220,경상남도,통영시,60-64세,11983,5852,6131
202106,48220,경상남도,통영시,60-64세,12067,5902,6165
202007,48220,경상남도,통영시,65-69세,8362,4089,4273
202008,48220,경상남도,통영시,65-69세,8463,4123,4340
202009,48220,경상남도,통영시,65-69세,8565,4172,4393
202010,48220,경상남도,통영시,65-69세,8617,4195,4422
202011,48220,경상남도,통영시,65-69세,8662,4219,4443
202012,48220,경상남도,통영시,65-69세,8689,4233,4456
202101,48220,경상남도,통영시,65-69세,8752,4262,4490
202102,48220,경상남도,통영시,65-69세,8801,4281,4520
202103,48220,경상남도,통영시,65-69세,8839,4302,4537
202104,48220,경상남도,통영시,65-69세,8877,4320,4557
202105,48220,경상남도,통영시,65-69세,8945,4338,4607
202106,48220,경상남도,통영시,65-69세,8974,4342,4632
202007,48220,경상남도,통영시,70-74세,6126,2958,3168
202008,48220,경상남도,통영시,70-74세,6122,2956,3166
202009,48220,경상남도,통영시,70-74세,6139,2962,3177
202010,48220,경상남도,통영시,70-74세,6189,2978,3211
202011,48220,경상남도,통영시,70-74세,6236,3007,3229
202012,48220,경상남도,통영시,70-74세,6311,3043,3268
202101,48220,경상남도,통영시,70-74세,6378,3081,3297
202102,48220,경상남도,통영시,70-74세,6449,3112,3337
202103,48220,경상남도,통영시,70-74세,6511,3139,3372
202104,48220,경상남도,통영시,70-74세,6585,3168,3417
202105,48220,경상남도,통영시,70-74세,6639,3205,3434
202106,48220,경상남도,통영시,70-74세,6664,3219,3445
202007,48220,경상남도,통영시,75-79세,4980,2036,2944
202008,48220,경상남도,통영시,75-79세,4963,2027,2936
202009,48220,경상남도,통영시,75-79세,4912,2014,2898
202010,48220,경상남도,통영시,75-79세,4870,2003,2867
202011,48220,경상남도,통영시,75-79세,4809,1982,2827
202012,48220,경상남도,통영시,75-79세,4757,1964,2793
202101,48220,경상남도,통영시,75-79세,4721,1957,2764
202102,48220,경상남도,통영시,75-79세,4671,1933,2738
202103,48220,경상남도,통영시,75-79세,4628,1919,2709
202104,48220,경상남도,통영시,75-79세,4596,1909,2687
202105,48220,경상남도,통영시,75-79세,4566,1884,2682
202106,48220,경상남도,통영시,75-79세,4550,1877,2673
202007,48220,경상남도,통영시,80-84세,3108,1036,2072
202008,48220,경상남도,통영시,80-84세,3110,1044,2066
202009,48220,경상남도,통영시,80-84세,3128,1046,2082
202010,48220,경상남도,통영시,80-84세,3139,1049,2090
202011,48220,경상남도,통영시,80-84세,3158,1055,2103
202012,48220,경상남도,통영시,80-84세,3176,1065,2111
202101,48220,경상남도,통영시,80-84세,3180,1062,2118
202102,48220,경상남도,통영시,80-84세,3205,1089,2116
202103,48220,경상남도,통영시,80-84세,3226,1091,2135
202104,48220,경상남도,통영시,80-84세,3237,1085,2152
202105,48220,경상남도,통영시,80-84세,3248,1098,2150
202106,48220,경상남도,통영시,80-84세,3265,1104,2161
202007,48220,경상남도,통영시,85-89세,1526,396,1130
202008,48220,경상남도,통영시,85-89세,1530,387,1143
202009,48220,경상남도,통영시,85-89세,1547,394,1153
202010,48220,경상남도,통영시,85-89세,1555,400,1155
202011,48220,경상남도,통영시,85-89세,1553,404,1149
202012,48220,경상남도,통영시,85-89세,1560,407,1153
202101,48220,경상남도,통영시,85-89세,1582,416,1166
202102,48220,경상남도,통영시,85-89세,1620,423,1197
202103,48220,경상남도,통영시,85-89세,1622,430,1192
202104,48220,경상남도,통영시,85-89세,1630,440,1190
202105,48220,경상남도,통영시,85-89세,1646,447,1199
202106,48220,경상남도,통영시,85-89세,1651,449,1202
202007,48220,경상남도,통영시,90-94세,510,102,408
202008,48220,경상남도,통영시,90-94세,513,108,405
202009,48220,경상남도,통영시,90-94세,516,110,406
202010,48220,경상남도,통영시,90-94세,512,110,402
202011,48220,경상남도,통영시,90-94세,516,110,406
202012,48220,경상남도,통영시,90-94세,518,107,411
202101,48220,경상남도,통영시,90-94세,516,109,407
202102,48220,경상남도,통영시,90-94세,522,110,412
202103,48220,경상남도,통영시,90-94세,534,109,425
202104,48220,경상남도,통영시,90-94세,539,112,427
202105,48220,경상남도,통영시,90-94세,542,110,432
202106,48220,경상남도,통영시,90-94세,546,111,435
202007,48220,경상남도,통영시,95-99세,100,14,86
202008,48220,경상남도,통영시,95-99세,98,13,85
202009,48220,경상남도,통영시,95-99세,103,13,90
202010,48220,경상남도,통영시,95-99세,103,13,90
202011,48220,경상남도,통영시,95-99세,99,12,87
202012,48220,경상남도,통영시,95-99세,98,11,87
202101,48220,경상남도,통영시,95-99세,109,12,97
202102,48220,경상남도,통영시,95-99세,112,14,98
202103,48220,경상남도,통영시,95-99세,106,14,92
202104,48220,경상남도,통영시,95-99세,109,14,95
202105,48220,경상남도,통영시,95-99세,104,14,90
202106,48220,경상남도,통영시,95-99세,107,14,93
202007,48220,경상남도,통영시,100+,27,8,19
202008,48220,경상남도,통영시,100+,26,8,18
202009,48220,경상남도,통영시,100+,26,8,18
202010,48220,경상남도,통영시,100+,26,8,18
202011,48220,경상남도,통영시,100+,27,8,19
202012,48220,경상남도,통영시,100+,28,8,20
202101,48220,경상남도,통영시,100+,28,8,20
202102,48220,경상남도,통영시,100+,28,8,20
202103,48220,경상남도,통영시,100+,16,4,12
202104,48220,경상남도,통영시,100+,16,4,12
202105,48220,경상남도,통영시,100+,17,3,14
202106,48220,경상남도,통영시,100+,17,3,14
202007,48240,경상남도,사천시,0-4세,3436,1806,1630
202008,48240,경상남도,사천시,0-4세,3409,1794,1615
202009,48240,경상남도,사천시,0-4세,3377,1774,1603
202010,48240,경상남도,사천시,0-4세,3328,1751,1577
202011,48240,경상남도,사천시,0-4세,3291,1721,1570
202012,48240,경상남도,사천시,0-4세,3252,1699,1553
202101,48240,경상남도,사천시,0-4세,3224,1684,1540
202102,48240,경상남도,사천시,0-4세,3198,1665,1533
202103,48240,경상남도,사천시,0-4세,3183,1662,1521
202104,48240,경상남도,사천시,0-4세,3153,1636,1517
202105,48240,경상남도,사천시,0-4세,3100,1612,1488
202106,48240,경상남도,사천시,0-4세,3091,1605,1486
202007,48240,경상남도,사천시,5-9세,5005,2609,2396
202008,48240,경상남도,사천시,5-9세,4989,2603,2386
202009,48240,경상남도,사천시,5-9세,4965,2591,2374
202010,48240,경상남도,사천시,5-9세,4952,2578,2374
202011,48240,경상남도,사천시,5-9세,4915,2555,2360
202012,48240,경상남도,사천시,5-9세,4878,2532,2346
202101,48240,경상남도,사천시,5-9세,4843,2513,2330
202102,48240,경상남도,사천시,5-9세,4836,2505,2331
202103,48240,경상남도,사천시,5-9세,4807,2489,2318
202104,48240,경상남도,사천시,5-9세,4807,2492,2315
202105,48240,경상남도,사천시,5-9세,4793,2475,2318
202106,48240,경상남도,사천시,5-9세,4784,2466,2318
202007,48240,경상남도,사천시,10-14세,5254,2661,2593
202008,48240,경상남도,사천시,10-14세,5276,2673,2603
202009,48240,경상남도,사천시,10-14세,5298,2685,2613
202010,48240,경상남도,사천시,10-14세,5310,2690,2620
202011,48240,경상남도,사천시,10-14세,5340,2710,2630
202012,48240,경상남도,사천시,10-14세,5352,2723,2629
202101,48240,경상남도,사천시,10-14세,5374,2745,2629
202102,48240,경상남도,사천시,10-14세,5362,2731,2631
202103,48240,경상남도,사천시,10-14세,5342,2726,2616
202104,48240,경상남도,사천시,10-14세,5341,2731,2610
202105,48240,경상남도,사천시,10-14세,5373,2743,2630
202106,48240,경상남도,사천시,10-14세,5375,2753,2622
202007,48240,경상남도,사천시,15-19세,5105,2678,2427
202008,48240,경상남도,사천시,15-19세,5073,2651,2422
202009,48240,경상남도,사천시,15-19세,5049,2642,2407
202010,48240,경상남도,사천시,15-19세,5016,2623,2393
202011,48240,경상남도,사천시,15-19세,4969,2598,2371
202012,48240,경상남도,사천시,15-19세,4929,2577,2352
202101,48240,경상남도,사천시,15-19세,4904,2556,2348
202102,48240,경상남도,사천시,15-19세,4868,2539,2329
202103,48240,경상남도,사천시,15-19세,4812,2508,2304
202104,48240,경상남도,사천시,15-19세,4823,2520,2303
202105,48240,경상남도,사천시,15-19세,4799,2517,2282
202106,48240,경상남도,사천시,15-19세,4802,2518,2284
202007,48240,경상남도,사천시,20-24세,5619,3300,2319
202008,48240,경상남도,사천시,20-24세,5577,3270,2307
202009,48240,경상남도,사천시,20-24세,5557,3234,2323
202010,48240,경상남도,사천시,20-24세,5532,3219,2313
202011,48240,경상남도,사천시,20-24세,5537,3229,2308
202012,48240,경상남도,사천시,20-24세,5503,3199,2304
202101,48240,경상남도,사천시,20-24세,5488,3200,2288
202102,48240,경상남도,사천시,20-24세,5426,3181,2245
202103,48240,경상남도,사천시,20-24세,5389,3154,2235
202104,48240,경상남도,사천시,20-24세,5356,3127,2229
202105,48240,경상남도,사천시,20-24세,5357,3135,2222
202106,48240,경상남도,사천시,20-24세,5358,3131,2227
202007,48240,경상남도,사천시,25-29세,5253,3198,2055
202008,48240,경상남도,사천시,25-29세,5290,3219,2071
202009,48240,경상남도,사천시,25-29세,5295,3228,2067
202010,48240,경상남도,사천시,25-29세,5279,3221,2058
202011,48240,경상남도,사천시,25-29세,5252,3206,2046
202012,48240,경상남도,사천시,25-29세,5266,3224,2042
202101,48240,경상남도,사천시,25-29세,5270,3219,2051
202102,48240,경상남도,사천시,25-29세,5198,3190,2008
202103,48240,경상남도,사천시,25-29세,5208,3192,2016
202104,48240,경상남도,사천시,25-29세,5212,3178,2034
202105,48240,경상남도,사천시,25-29세,5215,3190,2025
202106,48240,경상남도,사천시,25-29세,5228,3202,2026
202007,48240,경상남도,사천시,30-34세,5053,2813,2240
202008,48240,경상남도,사천시,30-34세,5062,2820,2242
202009,48240,경상남도,사천시,30-34세,5056,2826,2230
202010,48240,경상남도,사천시,30-34세,5036,2824,2212
202011,48240,경상남도,사천시,30-34세,5010,2814,2196
202012,48240,경상남도,사천시,30-34세,4986,2818,2168
202101,48240,경상남도,사천시,30-34세,5000,2827,2173
202102,48240,경상남도,사천시,30-34세,4971,2790,2181
202103,48240,경상남도,사천시,30-34세,4914,2765,2149
202104,48240,경상남도,사천시,30-34세,4897,2759,2138
202105,48240,경상남도,사천시,30-34세,4882,2735,2147
202106,48240,경상남도,사천시,30-34세,4863,2727,2136
202007,48240,경상남도,사천시,35-39세,7190,3716,3474
202008,48240,경상남도,사천시,35-39세,7148,3700,3448
202009,48240,경상남도,사천시,35-39세,7100,3673,3427
202010,48240,경상남도,사천시,35-39세,7029,3631,3398
202011,48240,경상남도,사천시,35-39세,6944,3587,3357
202012,48240,경상남도,사천시,35-39세,6905,3571,3334
202101,48240,경상남도,사천시,35-39세,6805,3536,3269
202102,48240,경상남도,사천시,35-39세,6773,3556,3217
202103,48240,경상남도,사천시,35-39세,6715,3523,3192
202104,48240,경상남도,사천시,35-39세,6653,3485,3168
202105,48240,경상남도,사천시,35-39세,6604,3459,3145
202106,48240,경상남도,사천시,35-39세,6584,3453,3131
202007,48240,경상남도,사천시,40-44세,8293,4356,3937
202008,48240,경상남도,사천시,40-44세,8306,4366,3940
202009,48240,경상남도,사천시,40-44세,8328,4382,3946
202010,48240,경상남도,사천시,40-44세,8332,4382,3950
202011,48240,경상남도,사천시,40-44세,8386,4401,3985
202012,48240,경상남도,사천시,40-44세,8320,4359,3961
202101,48240,경상남도,사천시,40-44세,8316,4353,3963
202102,48240,경상남도,사천시,40-44세,8314,4346,3968
202103,48240,경상남도,사천시,40-44세,8284,4335,3949
202104,48240,경상남도,사천시,40-44세,8285,4327,3958
202105,48240,경상남도,사천시,40-44세,8285,4336,3949
202106,48240,경상남도,사천시,40-44세,8329,4355,3974
202007,48240,경상남도,사천시,45-49세,9561,5182,4379
202008,48240,경상남도,사천시,45-49세,9567,5166,4401
202009,48240,경상남도,사천시,45-49세,9545,5142,4403
202010,48240,경상남도,사천시,45-49세,9485,5113,4372
202011,48240,경상남도,사천시,45-49세,9453,5106,4347
202012,48240,경상남도,사천시,45-49세,9432,5095,4337
202101,48240,경상남도,사천시,45-49세,9400,5061,4339
202102,48240,경상남도,사천시,45-49세,9347,5029,4318
202103,48240,경상남도,사천시,45-49세,9297,5012,4285
202104,48240,경상남도,사천시,45-49세,9292,5008,4284
202105,48240,경상남도,사천시,45-49세,9249,4982,4267
202106,48240,경상남도,사천시,45-49세,9200,4970,4230
202007,48240,경상남도,사천시,50-54세,9317,4993,4324
202008,48240,경상남도,사천시,50-54세,9352,5024,4328
202009,48240,경상남도,사천시,50-54세,9369,5033,4336
202010,48240,경상남도,사천시,50-54세,9429,5058,4371
202011,48240,경상남도,사천시,50-54세,9452,5061,4391
202012,48240,경상남도,사천시,50-54세,9459,5057,4402
202101,48240,경상남도,사천시,50-54세,9496,5095,4401
202102,48240,경상남도,사천시,50-54세,9532,5127,4405
202103,48240,경상남도,사천시,50-54세,9450,5076,4374
202104,48240,경상남도,사천시,50-54세,9433,5082,4351
202105,48240,경상남도,사천시,50-54세,9460,5081,4379
202106,48240,경상남도,사천시,50-54세,9481,5086,4395
202007,48240,경상남도,사천시,55-59세,9178,4743,4435
202008,48240,경상남도,사천시,55-59세,9128,4713,4415
202009,48240,경상남도,사천시,55-59세,9102,4703,4399
202010,48240,경상남도,사천시,55-59세,9040,4689,4351
202011,48240,경상남도,사천시,55-59세,9038,4712,4326
202012,48240,경상남도,사천시,55-59세,9043,4729,4314
202101,48240,경상남도,사천시,55-59세,8956,4686,4270
202102,48240,경상남도,사천시,55-59세,8915,4662,4253
202103,48240,경상남도,사천시,55-59세,8932,4682,4250
202104,48240,경상남도,사천시,55-59세,8894,4670,4224
202105,48240,경상남도,사천시,55-59세,8816,4636,4180
202106,48240,경상남도,사천시,55-59세,8715,4594,4121
202007,48240,경상남도,사천시,60-64세,8982,4400,4582
202008,48240,경상남도,사천시,60-64세,9006,4403,4603
202009,48240,경상남도,사천시,60-64세,9064,4424,4640
202010,48240,경상남도,사천시,60-64세,9120,4436,4684
202011,48240,경상남도,사천시,60-64세,9146,4439,4707
202012,48240,경상남도,사천시,60-64세,9176,4439,4737
202101,48240,경상남도,사천시,60-64세,9250,4487,4763
202102,48240,경상남도,사천시,60-64세,9336,4526,4810
202103,48240,경상남도,사천시,60-64세,9341,4534,4807
202104,48240,경상남도,사천시,60-64세,9412,4570,4842
202105,48240,경상남도,사천시,60-64세,9485,4616,4869
202106,48240,경상남도,사천시,60-64세,9591,4660,4931
202007,48240,경상남도,사천시,65-69세,7004,3319,3685
202008,48240,경상남도,사천시,65-69세,7105,3375,3730
202009,48240,경상남도,사천시,65-69세,7180,3415,3765
202010,48240,경상남도,사천시,65-69세,7231,3441,3790
202011,48240,경상남도,사천시,65-69세,7293,3476,3817
202012,48240,경상남도,사천시,65-69세,7358,3526,3832
202101,48240,경상남도,사천시,65-69세,7399,3533,3866
202102,48240,경상남도,사천시,65-69세,7435,3559,3876
202103,48240,경상남도,사천시,65-69세,7453,3577,3876
202104,48240,경상남도,사천시,65-69세,7450,3570,3880
202105,48240,경상남도,사천시,65-69세,7483,3593,3890
202106,48240,경상남도,사천시,65-69세,7502,3616,3886
202007,48240,경상남도,사천시,70-74세,5746,2619,3127
202008,48240,경상남도,사천시,70-74세,5745,2626,3119
202009,48240,경상남도,사천시,70-74세,5751,2633,3118
202010,48240,경상남도,사천시,70-74세,5779,2642,3137
202011,48240,경상남도,사천시,70-74세,5810,2655,3155
202012,48240,경상남도,사천시,70-74세,5843,2664,3179
202101,48240,경상남도,사천시,70-74세,5879,2694,3185
202102,48240,경상남도,사천시,70-74세,5909,2703,3206
202103,48240,경상남도,사천시,70-74세,5926,2725,3201
202104,48240,경상남도,사천시,70-74세,5978,2749,3229
202105,48240,경상남도,사천시,70-74세,5990,2754,3236
202106,48240,경상남도,사천시,70-74세,6009,2752,3257
202007,48240,경상남도,사천시,75-79세,4978,1946,3032
202008,48240,경상남도,사천시,75-79세,4952,1937,3015
202009,48240,경상남도,사천시,75-79세,4915,1918,2997
202010,48240,경상남도,사천시,75-79세,4886,1913,2973
202011,48240,경상남도,사천시,75-79세,4850,1898,2952
202012,48240,경상남도,사천시,75-79세,4799,1880,2919
202101,48240,경상남도,사천시,75-79세,4764,1861,2903
202102,48240,경상남도,사천시,75-79세,4765,1876,2889
202103,48240,경상남도,사천시,75-79세,4758,1868,2890
202104,48240,경상남도,사천시,75-79세,4731,1859,2872
202105,48240,경상남도,사천시,75-79세,4736,1854,2882
202106,48240,경상남도,사천시,75-79세,4722,1857,2865
202007,48240,경상남도,사천시,80-84세,3704,1243,2461
202008,48240,경상남도,사천시,80-84세,3703,1242,2461
202009,48240,경상남도,사천시,80-84세,3735,1255,2480
202010,48240,경상남도,사천시,80-84세,3764,1262,2502
202011,48240,경상남도,사천시,80-84세,3756,1259,2497
202012,48240,경상남도,사천시,80-84세,3778,1270,2508
202101,48240,경상남도,사천시,80-84세,3776,1277,2499
202102,48240,경상남도,사천시,80-84세,3772,1286,2486
202103,48240,경상남도,사천시,80-84세,3773,1289,2484
202104,48240,경상남도,사천시,80-84세,3784,1296,2488
202105,48240,경상남도,사천시,80-84세,3782,1290,2492
202106,48240,경상남도,사천시,80-84세,3804,1291,2513
202007,48240,경상남도,사천시,85-89세,1915,483,1432
202008,48240,경상남도,사천시,85-89세,1939,491,1448
202009,48240,경상남도,사천시,85-89세,1937,493,1444
202010,48240,경상남도,사천시,85-89세,1948,498,1450
202011,48240,경상남도,사천시,85-89세,1968,506,1462
202012,48240,경상남도,사천시,85-89세,1988,511,1477
202101,48240,경상남도,사천시,85-89세,2010,524,1486
202102,48240,경상남도,사천시,85-89세,2054,532,1522
202103,48240,경상남도,사천시,85-89세,2070,533,1537
202104,48240,경상남도,사천시,85-89세,2095,543,1552
202105,48240,경상남도,사천시,85-89세,2098,552,1546
202106,48240,경상남도,사천시,85-89세,2104,550,1554
202007,48240,경상남도,사천시,90-94세,649,106,543
202008,48240,경상남도,사천시,90-94세,653,108,545
202009,48240,경상남도,사천시,90-94세,649,109,540
202010,48240,경상남도,사천시,90-94세,651,110,541
202011,48240,경상남도,사천시,90-94세,661,112,549
202012,48240,경상남도,사천시,90-94세,670,115,555
202101,48240,경상남도,사천시,90-94세,674,112,562
202102,48240,경상남도,사천시,90-94세,679,114,565
202103,48240,경상남도,사천시,90-94세,686,113,573
202104,48240,경상남도,사천시,90-94세,699,114,585
202105,48240,경상남도,사천시,90-94세,702,116,586
202106,48240,경상남도,사천시,90-94세,713,123,590
202007,48240,경상남도,사천시,95-99세,129,16,113
202008,48240,경상남도,사천시,95-99세,129,15,114
202009,48240,경상남도,사천시,95-99세,138,15,123
202010,48240,경상남도,사천시,95-99세,135,15,120
202011,48240,경상남도,사천시,95-99세,132,14,118
202012,48240,경상남도,사천시,95-99세,136,13,123
202101,48240,경상남도,사천시,95-99세,144,13,131
202102,48240,경상남도,사천시,95-99세,144,13,131
202103,48240,경상남도,사천시,95-99세,136,15,121
202104,48240,경상남도,사천시,95-99세,141,15,126
202105,48240,경상남도,사천시,95-99세,140,14,126
202106,48240,경상남도,사천시,95-99세,136,14,122
202007,48240,경상남도,사천시,100+,30,7,23
202008,48240,경상남도,사천시,100+,31,8,23
202009,48240,경상남도,사천시,100+,32,8,24
202010,48240,경상남도,사천시,100+,31,9,22
202011,48240,경상남도,사천시,100+,31,9,22
202012,48240,경상남도,사천시,100+,32,9,23
202101,48240,경상남도,사천시,100+,33,9,24
202102,48240,경상남도,사천시,100+,34,9,25
202103,48240,경상남도,사천시,100+,25,7,18
202104,48240,경상남도,사천시,100+,25,7,18
202105,48240,경상남도,사천시,100+,22,6,16
202106,48240,경상남도,사천시,100+,23,6,17
202007,48250,경상남도,김해시,0-4세,21101,10873,10228
202008,48250,경상남도,김해시,0-4세,20880,10737,10143
202009,48250,경상남도,김해시,0-4세,20656,10636,10020
202010,48250,경상남도,김해시,0-4세,20467,10542,9925
202011,48250,경상남도,김해시,0-4세,20320,10458,9862
202012,48250,경상남도,김해시,0-4세,20162,10375,9787
202101,48250,경상남도,김해시,0-4세,19893,10212,9681
202102,48250,경상남도,김해시,0-4세,19739,10147,9592
202103,48250,경상남도,김해시,0-4세,19511,10028,9483
202104,48250,경상남도,김해시,0-4세,19286,9910,9376
202105,48250,경상남도,김해시,0-4세,18978,9766,9212
202106,48250,경상남도,김해시,0-4세,18732,9644,9088
202007,48250,경상남도,김해시,5-9세,29607,15000,14607
202008,48250,경상남도,김해시,5-9세,29545,14969,14576
202009,48250,경상남도,김해시,5-9세,29480,14921,14559
202010,48250,경상남도,김해시,5-9세,29290,14822,14468
202011,48250,경상남도,김해시,5-9세,29177,14789,14388
202012,48250,경상남도,김해시,5-9세,29147,14763,14384
202101,48250,경상남도,김해시,5-9세,29032,14713,14319
202102,48250,경상남도,김해시,5-9세,28955,14652,14303
202103,48250,경상남도,김해시,5-9세,28857,14625,14232
202104,48250,경상남도,김해시,5-9세,28810,14601,14209
202105,48250,경상남도,김해시,5-9세,28766,14587,14179
202106,48250,경상남도,김해시,5-9세,28684,14545,14139
202007,48250,경상남도,김해시,10-14세,30095,15495,14600
202008,48250,경상남도,김해시,10-14세,30115,15485,14630
202009,48250,경상남도,김해시,10-14세,30174,15488,14686
202010,48250,경상남도,김해시,10-14세,30289,15555,14734
202011,48250,경상남도,김해시,10-14세,30422,15618,14804
202012,48250,경상남도,김해시,10-14세,30388,15597,14791
202101,48250,경상남도,김해시,10-14세,30454,15624,14830
202102,48250,경상남도,김해시,10-14세,30442,15623,14819
202103,48250,경상남도,김해시,10-14세,30497,15649,14848
202104,48250,경상남도,김해시,10-14세,30559,15667,14892
202105,48250,경상남도,김해시,10-14세,30573,15647,14926
202106,48250,경상남도,김해시,10-14세,30534,15617,14917
202007,48250,경상남도,김해시,15-19세,31763,16767,14996
202008,48250,경상남도,김해시,15-19세,31643,16706,14937
202009,48250,경상남도,김해시,15-19세,31501,16651,14850
202010,48250,경상남도,김해시,15-19세,31305,16539,14766
202011,48250,경상남도,김해시,15-19세,31067,16395,14672
202012,48250,경상남도,김해시,15-19세,30881,16260,14621
202101,48250,경상남도,김해시,15-19세,30709,16181,14528
202102,48250,경상남도,김해시,15-19세,30556,16096,14460
202103,48250,경상남도,김해시,15-19세,30277,15938,14339
202104,48250,경상남도,김해시,15-19세,30111,15828,14283
202105,48250,경상남도,김해시,15-19세,30063,15821,14242
202106,48250,경상남도,김해시,15-19세,29977,15770,14207
202007,48250,경상남도,김해시,20-24세,36467,19892,16575
202008,48250,경상남도,김해시,20-24세,36360,19832,16528
202009,48250,경상남도,김해시,20-24세,36239,19776,16463
202010,48250,경상남도,김해시,20-24세,36308,19805,16503
202011,48250,경상남도,김해시,20-24세,36249,19785,16464
202012,48250,경상남도,김해시,20-24세,36136,19766,16370
202101,48250,경상남도,김해시,20-24세,36027,19690,16337
202102,48250,경상남도,김해시,20-24세,35935,19665,16270
202103,48250,경상남도,김해시,20-24세,35741,19598,16143
202104,48250,경상남도,김해시,20-24세,35649,19585,16064
202105,48250,경상남도,김해시,20-24세,35579,19512,16067
202106,48250,경상남도,김해시,20-24세,35496,19428,16068
202007,48250,경상남도,김해시,25-29세,32628,17578,15050
202008,48250,경상남도,김해시,25-29세,32707,17628,15079
202009,48250,경상남도,김해시,25-29세,32741,17638,15103
202010,48250,경상남도,김해시,25-29세,32781,17674,15107
202011,48250,경상남도,김해시,25-29세,32879,17794,15085
202012,48250,경상남도,김해시,25-29세,32975,17875,15100
202101,48250,경상남도,김해시,25-29세,32944,17874,15070
202102,48250,경상남도,김해시,25-29세,32907,17836,15071
202103,48250,경상남도,김해시,25-29세,32908,17849,15059
202104,48250,경상남도,김해시,25-29세,32914,17867,15047
202105,48250,경상남도,김해시,25-29세,32853,17833,15020
202106,48250,경상남도,김해시,25-29세,32794,17841,14953
202007,48250,경상남도,김해시,30-34세,29883,15580,14303
202008,48250,경상남도,김해시,30-34세,29887,15566,14321
202009,48250,경상남도,김해시,30-34세,29787,15543,14244
202010,48250,경상남도,김해시,30-34세,29773,15540,14233
202011,48250,경상남도,김해시,30-34세,29678,15498,14180
202012,48250,경상남도,김해시,30-34세,29539,15444,14095
202101,48250,경상남도,김해시,30-34세,29533,15417,14116
202102,48250,경상남도,김해시,30-34세,29425,15370,14055
202103,48250,경상남도,김해시,30-34세,29508,15421,14087
202104,48250,경상남도,김해시,30-34세,29558,15444,14114
202105,48250,경상남도,김해시,30-34세,29527,15462,14065
202106,48250,경상남도,김해시,30-34세,29506,15454,14052
202007,48250,경상남도,김해시,35-39세,41317,21026,20291
202008,48250,경상남도,김해시,35-39세,41060,20920,20140
202009,48250,경상남도,김해시,35-39세,40731,20763,19968
202010,48250,경상남도,김해시,35-39세,40339,20550,19789
202011,48250,경상남도,김해시,35-39세,40116,20463,19653
202012,48250,경상남도,김해시,35-39세,40015,20425,19590
202101,48250,경상남도,김해시,35-39세,39725,20301,19424
202102,48250,경상남도,김해시,35-39세,39396,20122,19274
202103,48250,경상남도,김해시,35-39세,38997,19867,19130
202104,48250,경상남도,김해시,35-39세,38711,19736,18975
202105,48250,경상남도,김해시,35-39세,38453,19581,18872
202106,48250,경상남도,김해시,35-39세,38132,19437,18695
202007,48250,경상남도,김해시,40-44세,45292,22529,22763
202008,48250,경상남도,김해시,40-44세,45250,22511,22739
202009,48250,경상남도,김해시,40-44세,45401,22610,22791
202010,48250,경상남도,김해시,40-44세,45537,22686,22851
202011,48250,경상남도,김해시,40-44세,45591,22704,22887
202012,48250,경상남도,김해시,40-44세,45496,22717,22779
202101,48250,경상남도,김해시,40-44세,45496,22682,22814
202102,48250,경상남도,김해시,40-44세,45613,22799,22814
202103,48250,경상남도,김해시,40-44세,45436,22775,22661
202104,48250,경상남도,김해시,40-44세,45427,22768,22659
202105,48250,경상남도,김해시,40-44세,45489,22826,22663
202106,48250,경상남도,김해시,40-44세,45647,22879,22768
202007,48250,경상남도,김해시,45-49세,53963,26803,27160
202008,48250,경상남도,김해시,45-49세,53805,26689,27116
202009,48250,경상남도,김해시,45-49세,53535,26523,27012
202010,48250,경상남도,김해시,45-49세,53250,26369,26881
202011,48250,경상남도,김해시,45-49세,53048,26286,26762
202012,48250,경상남도,김해시,45-49세,52975,26231,26744
202101,48250,경상남도,김해시,45-49세,52812,26177,26635
202102,48250,경상남도,김해시,45-49세,52635,26038,26597
202103,48250,경상남도,김해시,45-49세,52402,25895,26507
202104,48250,경상남도,김해시,45-49세,52335,25850,26485
202105,48250,경상남도,김해시,45-49세,51946,25632,26314
202106,48250,경상남도,김해시,45-49세,51633,25497,26136
202007,48250,경상남도,김해시,50-54세,51882,26408,25474
202008,48250,경상남도,김해시,50-54세,52030,26484,25546
202009,48250,경상남도,김해시,50-54세,52225,26525,25700
202010,48250,경상남도,김해시,50-54세,52485,26639,25846
202011,48250,경상남도,김해시,50-54세,52656,26726,25930
202012,48250,경상남도,김해시,50-54세,52595,26667,25928
202101,48250,경상남도,김해시,50-54세,52968,26825,26143
202102,48250,경상남도,김해시,50-54세,53198,26918,26280
202103,48250,경상남도,김해시,50-54세,52948,26756,26192
202104,48250,경상남도,김해시,50-54세,53004,26743,26261
202105,48250,경상남도,김해시,50-54세,53265,26902,26363
202106,48250,경상남도,김해시,50-54세,53424,26972,26452
202007,48250,경상남도,김해시,55-59세,43955,22986,20969
202008,48250,경상남도,김해시,55-59세,44020,23037,20983
202009,48250,경상남도,김해시,55-59세,44050,23051,20999
202010,48250,경상남도,김해시,55-59세,44091,23049,21042
202011,48250,경상남도,김해시,55-59세,44186,23067,21119
202012,48250,경상남도,김해시,55-59세,44360,23143,21217
202101,48250,경상남도,김해시,55-59세,44214,23067,21147
202102,48250,경상남도,김해시,55-59세,44234,23062,21172
202103,48250,경상남도,김해시,55-59세,44251,23105,21146
202104,48250,경상남도,김해시,55-59세,44226,23129,21097
202105,48250,경상남도,김해시,55-59세,44207,23081,21126
202106,48250,경상남도,김해시,55-59세,44013,22985,21028
202007,48250,경상남도,김해시,60-64세,34620,17929,16691
202008,48250,경상남도,김해시,60-64세,34876,18042,16834
202009,48250,경상남도,김해시,60-64세,35098,18175,16923
202010,48250,경상남도,김해시,60-64세,35308,18306,17002
202011,48250,경상남도,김해시,60-64세,35503,18413,17090
202012,48250,경상남도,김해시,60-64세,35812,18555,17257
202101,48250,경상남도,김해시,60-64세,36176,18778,17398
202102,48250,경상남도,김해시,60-64세,36541,18961,17580
202103,48250,경상남도,김해시,60-64세,36847,19128,17719
202104,48250,경상남도,김해시,60-64세,37136,19253,17883
202105,48250,경상남도,김해시,60-64세,37436,19406,18030
202106,48250,경상남도,김해시,60-64세,37733,19554,18179
202007,48250,경상남도,김해시,65-69세,21451,10635,10816
202008,48250,경상남도,김해시,65-69세,21646,10741,10905
202009,48250,경상남도,김해시,65-69세,21930,10886,11044
202010,48250,경상남도,김해시,65-69세,22122,10971,11151
202011,48250,경상남도,김해시,65-69세,22304,11063,11241
202012,48250,경상남도,김해시,65-69세,22494,11160,11334
202101,48250,경상남도,김해시,65-69세,22762,11291,11471
202102,48250,경상남도,김해시,65-69세,22940,11410,11530
202103,48250,경상남도,김해시,65-69세,23061,11473,11588
202104,48250,경상남도,김해시,65-69세,23210,11572,11638
202105,48250,경상남도,김해시,65-69세,23404,11689,11715
202106,48250,경상남도,김해시,65-69세,23553,11764,11789
202007,48250,경상남도,김해시,70-74세,14618,6661,7957
202008,48250,경상남도,김해시,70-74세,14656,6681,7975
202009,48250,경상남도,김해시,70-74세,14799,6758,8041
202010,48250,경상남도,김해시,70-74세,14920,6833,8087
202011,48250,경상남도,김해시,70-74세,15059,6878,8181
202012,48250,경상남도,김해시,70-74세,15253,6958,8295
202101,48250,경상남도,김해시,70-74세,15374,7008,8366
202102,48250,경상남도,김해시,70-74세,15507,7055,8452
202103,48250,경상남도,김해시,70-74세,15532,7075,8457
202104,48250,경상남도,김해시,70-74세,15611,7116,8495
202105,48250,경상남도,김해시,70-74세,15698,7168,8530
202106,48250,경상남도,김해시,70-74세,15732,7184,8548
202007,48250,경상남도,김해시,75-79세,11395,4561,6834
202008,48250,경상남도,김해시,75-79세,11403,4565,6838
202009,48250,경상남도,김해시,75-79세,11347,4549,6798
202010,48250,경상남도,김해시,75-79세,11296,4539,6757
202011,48250,경상남도,김해시,75-79세,11219,4513,6706
202012,48250,경상남도,김해시,75-79세,11144,4491,6653
202101,48250,경상남도,김해시,75-79세,11112,4498,6614
202102,48250,경상남도,김해시,75-79세,11023,4495,6528
202103,48250,경상남도,김해시,75-79세,10962,4486,6476
202104,48250,경상남도,김해시,75-79세,10939,4473,6466
202105,48250,경상남도,김해시,75-79세,10920,4477,6443
202106,48250,경상남도,김해시,75-79세,10932,4491,6441
202007,48250,경상남도,김해시,80-84세,7526,2552,4974
202008,48250,경상남도,김해시,80-84세,7528,2554,4974
202009,48250,경상남도,김해시,80-84세,7568,2567,5001
202010,48250,경상남도,김해시,80-84세,7616,2580,5036
202011,48250,경상남도,김해시,80-84세,7649,2598,5051
202012,48250,경상남도,김해시,80-84세,7689,2612,5077
202101,48250,경상남도,김해시,80-84세,7718,2625,5093
202102,48250,경상남도,김해시,80-84세,7793,2656,5137
202103,48250,경상남도,김해시,80-84세,7794,2649,5145
202104,48250,경상남도,김해시,80-84세,7812,2659,5153
202105,48250,경상남도,김해시,80-84세,7847,2666,5181
202106,48250,경상남도,김해시,80-84세,7875,2662,5213
202007,48250,경상남도,김해시,85-89세,3659,918,2741
202008,48250,경상남도,김해시,85-89세,3673,923,2750
202009,48250,경상남도,김해시,85-89세,3703,944,2759
202010,48250,경상남도,김해시,85-89세,3715,960,2755
202011,48250,경상남도,김해시,85-89세,3734,952,2782
202012,48250,경상남도,김해시,85-89세,3778,972,2806
202101,48250,경상남도,김해시,85-89세,3829,985,2844
202102,48250,경상남도,김해시,85-89세,3876,993,2883
202103,48250,경상남도,김해시,85-89세,3868,991,2877
202104,48250,경상남도,김해시,85-89세,3906,1007,2899
202105,48250,경상남도,김해시,85-89세,3927,1016,2911
202106,48250,경상남도,김해시,85-89세,3935,1022,2913
202007,48250,경상남도,김해시,90-94세,1126,225,901
202008,48250,경상남도,김해시,90-94세,1147,228,919
202009,48250,경상남도,김해시,90-94세,1159,225,934
202010,48250,경상남도,김해시,90-94세,1174,227,947
202011,48250,경상남도,김해시,90-94세,1182,235,947
202012,48250,경상남도,김해시,90-94세,1183,238,945
202101,48250,경상남도,김해시,90-94세,1200,241,959
202102,48250,경상남도,김해시,90-94세,1219,234,985
202103,48250,경상남도,김해시,90-94세,1203,227,976
202104,48250,경상남도,김해시,90-94세,1216,227,989
202105,48250,경상남도,김해시,90-94세,1227,225,1002
202106,48250,경상남도,김해시,90-94세,1243,226,1017
202007,48250,경상남도,김해시,95-99세,230,41,189
202008,48250,경상남도,김해시,95-99세,228,42,186
202009,48250,경상남도,김해시,95-99세,229,42,187
202010,48250,경상남도,김해시,95-99세,224,40,184
202011,48250,경상남도,김해시,95-99세,224,39,185
202012,48250,경상남도,김해시,95-99세,228,38,190
202101,48250,경상남도,김해시,95-99세,227,38,189
202102,48250,경상남도,김해시,95-99세,229,40,189
202103,48250,경상남도,김해시,95-99세,212,33,179
202104,48250,경상남도,김해시,95-99세,213,31,182
202105,48250,경상남도,김해시,95-99세,211,30,181
202106,48250,경상남도,김해시,95-99세,214,33,181
202007,48250,경상남도,김해시,100+,77,23,54
202008,48250,경상남도,김해시,100+,79,23,56
202009,48250,경상남도,김해시,100+,82,24,58
202010,48250,경상남도,김해시,100+,86,25,61
202011,48250,경상남도,김해시,100+,87,25,62
202012,48250,경상남도,김해시,100+,88,26,62
202101,48250,경상남도,김해시,100+,91,26,65
202102,48250,경상남도,김해시,100+,91,26,65
202103,48250,경상남도,김해시,100+,51,13,38
202104,48250,경상남도,김해시,100+,53,13,40
202105,48250,경상남도,김해시,100+,54,13,41
202106,48250,경상남도,김해시,100+,52,12,40
202007,48270,경상남도,밀양시,0-4세,2498,1266,1232
202008,48270,경상남도,밀양시,0-4세,2483,1255,1228
202009,48270,경상남도,밀양시,0-4세,2445,1238,1207
202010,48270,경상남도,밀양시,0-4세,2423,1226,1197
202011,48270,경상남도,밀양시,0-4세,2387,1204,1183
202012,48270,경상남도,밀양시,0-4세,2366,1189,1177
202101,48270,경상남도,밀양시,0-4세,2328,1169,1159
202102,48270,경상남도,밀양시,0-4세,2285,1151,1134
202103,48270,경상남도,밀양시,0-4세,2276,1157,1119
202104,48270,경상남도,밀양시,0-4세,2244,1138,1106
202105,48270,경상남도,밀양시,0-4세,2240,1136,1104
202106,48270,경상남도,밀양시,0-4세,2237,1137,1100
202007,48270,경상남도,밀양시,5-9세,3264,1673,1591
202008,48270,경상남도,밀양시,5-9세,3271,1676,1595
202009,48270,경상남도,밀양시,5-9세,3259,1660,1599
202010,48270,경상남도,밀양시,5-9세,3239,1659,1580
202011,48270,경상남도,밀양시,5-9세,3240,1659,1581
202012,48270,경상남도,밀양시,5-9세,3254,1667,1587
202101,48270,경상남도,밀양시,5-9세,3253,1672,1581
202102,48270,경상남도,밀양시,5-9세,3236,1667,1569
202103,48270,경상남도,밀양시,5-9세,3221,1666,1555
202104,48270,경상남도,밀양시,5-9세,3214,1659,1555
202105,48270,경상남도,밀양시,5-9세,3208,1654,1554
202106,48270,경상남도,밀양시,5-9세,3184,1636,1548
202007,48270,경상남도,밀양시,10-14세,3712,1907,1805
202008,48270,경상남도,밀양시,10-14세,3720,1920,1800
202009,48270,경상남도,밀양시,10-14세,3712,1929,1783
202010,48270,경상남도,밀양시,10-14세,3748,1945,1803
202011,48270,경상남도,밀양시,10-14세,3755,1945,1810
202012,48270,경상남도,밀양시,10-14세,3737,1938,1799
202101,48270,경상남도,밀양시,10-14세,3720,1931,1789
202102,48270,경상남도,밀양시,10-14세,3715,1922,1793
202103,48270,경상남도,밀양시,10-14세,3717,1914,1803
202104,48270,경상남도,밀양시,10-14세,3736,1932,1804
202105,48270,경상남도,밀양시,10-14세,3744,1937,1807
202106,48270,경상남도,밀양시,10-14세,3733,1926,1807
202007,48270,경상남도,밀양시,15-19세,4268,2291,1977
202008,48270,경상남도,밀양시,15-19세,4231,2262,1969
202009,48270,경상남도,밀양시,15-19세,4203,2237,1966
202010,48270,경상남도,밀양시,15-19세,4146,2212,1934
202011,48270,경상남도,밀양시,15-19세,4112,2195,1917
202012,48270,경상남도,밀양시,15-19세,4092,2179,1913
202101,48270,경상남도,밀양시,15-19세,4084,2169,1915
202102,48270,경상남도,밀양시,15-19세,4064,2159,1905
202103,48270,경상남도,밀양시,15-19세,4016,2140,1876
202104,48270,경상남도,밀양시,15-19세,3977,2109,1868
202105,48270,경상남도,밀양시,15-19세,3940,2092,1848
202106,48270,경상남도,밀양시,15-19세,3925,2094,1831
202007,48270,경상남도,밀양시,20-24세,4864,2743,2121
202008,48270,경상남도,밀양시,20-24세,4863,2741,2122
202009,48270,경상남도,밀양시,20-24세,4862,2738,2124
202010,48270,경상남도,밀양시,20-24세,4872,2752,2120
202011,48270,경상남도,밀양시,20-24세,4864,2736,2128
202012,48270,경상남도,밀양시,20-24세,4870,2741,2129
202101,48270,경상남도,밀양시,20-24세,4843,2741,2102
202102,48270,경상남도,밀양시,20-24세,4760,2720,2040
202103,48270,경상남도,밀양시,20-24세,4702,2689,2013
202104,48270,경상남도,밀양시,20-24세,4662,2673,1989
202105,48270,경상남도,밀양시,20-24세,4654,2652,2002
202106,48270,경상남도,밀양시,20-24세,4631,2632,1999
202007,48270,경상남도,밀양시,25-29세,4337,2565,1772
202008,48270,경상남도,밀양시,25-29세,4309,2542,1767
202009,48270,경상남도,밀양시,25-29세,4329,2553,1776
202010,48270,경상남도,밀양시,25-29세,4339,2548,1791
202011,48270,경상남도,밀양시,25-29세,4339,2552,1787
202012,48270,경상남도,밀양시,25-29세,4344,2555,1789
202101,48270,경상남도,밀양시,25-29세,4298,2516,1782
202102,48270,경상남도,밀양시,25-29세,4271,2492,1779
202103,48270,경상남도,밀양시,25-29세,4269,2516,1753
202104,48270,경상남도,밀양시,25-29세,4288,2528,1760
202105,48270,경상남도,밀양시,25-29세,4256,2532,1724
202106,48270,경상남도,밀양시,25-29세,4273,2535,1738
202007,48270,경상남도,밀양시,30-34세,3895,2077,1818
202008,48270,경상남도,밀양시,30-34세,3870,2068,1802
202009,48270,경상남도,밀양시,30-34세,3852,2064,1788
202010,48270,경상남도,밀양시,30-34세,3844,2055,1789
202011,48270,경상남도,밀양시,30-34세,3849,2043,1806
202012,48270,경상남도,밀양시,30-34세,3839,2053,1786
202101,48270,경상남도,밀양시,30-34세,3812,2057,1755
202102,48270,경상남도,밀양시,30-34세,3772,2042,1730
202103,48270,경상남도,밀양시,30-34세,3782,2046,1736
202104,48270,경상남도,밀양시,30-34세,3782,2041,1741
202105,48270,경상남도,밀양시,30-34세,3778,2033,1745
202106,48270,경상남도,밀양시,30-34세,3760,2026,1734
202007,48270,경상남도,밀양시,35-39세,5156,2707,2449
202008,48270,경상남도,밀양시,35-39세,5157,2715,2442
202009,48270,경상남도,밀양시,35-39세,5149,2712,2437
202010,48270,경상남도,밀양시,35-39세,5114,2687,2427
202011,48270,경상남도,밀양시,35-39세,5088,2667,2421
202012,48270,경상남도,밀양시,35-39세,5068,2648,2420
202101,48270,경상남도,밀양시,35-39세,5038,2632,2406
202102,48270,경상남도,밀양시,35-39세,5018,2608,2410
202103,48270,경상남도,밀양시,35-39세,4972,2594,2378
202104,48270,경상남도,밀양시,35-39세,4940,2577,2363
202105,48270,경상남도,밀양시,35-39세,4911,2575,2336
202106,48270,경상남도,밀양시,35-39세,4881,2560,2321
202007,48270,경상남도,밀양시,40-44세,5815,3078,2737
202008,48270,경상남도,밀양시,40-44세,5791,3063,2728
202009,48270,경상남도,밀양시,40-44세,5774,3046,2728
202010,48270,경상남도,밀양시,40-44세,5776,3040,2736
202011,48270,경상남도,밀양시,40-44세,5772,3048,2724
202012,48270,경상남도,밀양시,40-44세,5741,3015,2726
202101,48270,경상남도,밀양시,40-44세,5749,3021,2728
202102,48270,경상남도,밀양시,40-44세,5780,3041,2739
202103,48270,경상남도,밀양시,40-44세,5768,3034,2734
202104,48270,경상남도,밀양시,40-44세,5801,3045,2756
202105,48270,경상남도,밀양시,40-44세,5830,3051,2779
202106,48270,경상남도,밀양시,40-44세,5868,3073,2795
202007,48270,경상남도,밀양시,45-49세,7339,3881,3458
202008,48270,경상남도,밀양시,45-49세,7307,3867,3440
202009,48270,경상남도,밀양시,45-49세,7268,3845,3423
202010,48270,경상남도,밀양시,45-49세,7238,3852,3386
202011,48270,경상남도,밀양시,45-49세,7205,3841,3364
202012,48270,경상남도,밀양시,45-49세,7201,3845,3356
202101,48270,경상남도,밀양시,45-49세,7142,3809,3333
202102,48270,경상남도,밀양시,45-49세,7084,3781,3303
202103,48270,경상남도,밀양시,45-49세,7066,3770,3296
202104,48270,경상남도,밀양시,45-49세,7045,3757,3288
202105,48270,경상남도,밀양시,45-49세,6976,3732,3244
202106,48270,경상남도,밀양시,45-49세,6951,3716,3235
202007,48270,경상남도,밀양시,50-54세,8701,4460,4241
202008,48270,경상남도,밀양시,50-54세,8693,4465,4228
202009,48270,경상남도,밀양시,50-54세,8693,4478,4215
202010,48270,경상남도,밀양시,50-54세,8708,4478,4230
202011,48270,경상남도,밀양시,50-54세,8679,4454,4225
202012,48270,경상남도,밀양시,50-54세,8644,4446,4198
202101,48270,경상남도,밀양시,50-54세,8683,4469,4214
202102,48270,경상남도,밀양시,50-54세,8656,4449,4207
202103,48270,경상남도,밀양시,50-54세,8593,4421,4172
202104,48270,경상남도,밀양시,50-54세,8591,4418,4173
202105,48270,경상남도,밀양시,50-54세,8598,4415,4183
202106,48270,경상남도,밀양시,50-54세,8588,4402,4186
202007,48270,경상남도,밀양시,55-59세,10337,5167,5170
202008,48270,경상남도,밀양시,55-59세,10281,5130,5151
202009,48270,경상남도,밀양시,55-59세,10208,5096,5112
202010,48270,경상남도,밀양시,55-59세,10146,5070,5076
202011,48270,경상남도,밀양시,55-59세,10116,5054,5062
202012,48270,경상남도,밀양시,55-59세,10092,5035,5057
202101,48270,경상남도,밀양시,55-59세,10034,4998,5036
202102,48270,경상남도,밀양시,55-59세,10014,4973,5041
202103,48270,경상남도,밀양시,55-59세,9998,4973,5025
202104,48270,경상남도,밀양시,55-59세,9961,4961,5000
202105,48270,경상남도,밀양시,55-59세,9865,4931,4934
202106,48270,경상남도,밀양시,55-59세,9748,4884,4864
202007,48270,경상남도,밀양시,60-64세,11486,5632,5854
202008,48270,경상남도,밀양시,60-64세,11526,5655,5871
202009,48270,경상남도,밀양시,60-64세,11598,5696,5902
202010,48270,경상남도,밀양시,60-64세,11642,5707,5935
202011,48270,경상남도,밀양시,60-64세,11678,5737,5941
202012,48270,경상남도,밀양시,60-64세,11696,5763,5933
202101,48270,경상남도,밀양시,60-64세,11716,5764,5952
202102,48270,경상남도,밀양시,60-64세,11749,5796,5953
202103,48270,경상남도,밀양시,60-64세,11759,5793,5966
202104,48270,경상남도,밀양시,60-64세,11801,5823,5978
202105,48270,경상남도,밀양시,60-64세,11819,5839,5980
202106,48270,경상남도,밀양시,60-64세,11884,5871,6013
202007,48270,경상남도,밀양시,65-69세,9081,4358,4723
202008,48270,경상남도,밀양시,65-69세,9162,4392,4770
202009,48270,경상남도,밀양시,65-69세,9239,4439,4800
202010,48270,경상남도,밀양시,65-69세,9319,4486,4833
202011,48270,경상남도,밀양시,65-69세,9361,4502,4859
202012,48270,경상남도,밀양시,65-69세,9406,4510,4896
202101,48270,경상남도,밀양시,65-69세,9448,4530,4918
202102,48270,경상남도,밀양시,65-69세,9483,4564,4919
202103,48270,경상남도,밀양시,65-69세,9558,4618,4940
202104,48270,경상남도,밀양시,65-69세,9637,4653,4984
202105,48270,경상남도,밀양시,65-69세,9629,4664,4965
202106,48270,경상남도,밀양시,65-69세,9700,4709,4991
202007,48270,경상남도,밀양시,70-74세,6712,3115,3597
202008,48270,경상남도,밀양시,70-74세,6724,3131,3593
202009,48270,경상남도,밀양시,70-74세,6737,3129,3608
202010,48270,경상남도,밀양시,70-74세,6801,3159,3642
202011,48270,경상남도,밀양시,70-74세,6870,3185,3685
202012,48270,경상남도,밀양시,70-74세,6957,3224,3733
202101,48270,경상남도,밀양시,70-74세,7022,3267,3755
202102,48270,경상남도,밀양시,70-74세,7085,3283,3802
202103,48270,경상남도,밀양시,70-74세,7131,3314,3817
202104,48270,경상남도,밀양시,70-74세,7158,3340,3818
202105,48270,경상남도,밀양시,70-74세,7182,3354,3828
202106,48270,경상남도,밀양시,70-74세,7209,3354,3855
202007,48270,경상남도,밀양시,75-79세,5839,2302,3537
202008,48270,경상남도,밀양시,75-79세,5835,2306,3529
202009,48270,경상남도,밀양시,75-79세,5810,2298,3512
202010,48270,경상남도,밀양시,75-79세,5772,2280,3492
202011,48270,경상남도,밀양시,75-79세,5752,2278,3474
202012,48270,경상남도,밀양시,75-79세,5693,2261,3432
202101,48270,경상남도,밀양시,75-79세,5665,2249,3416
202102,48270,경상남도,밀양시,75-79세,5630,2247,3383
202103,48270,경상남도,밀양시,75-79세,5625,2237,3388
202104,48270,경상남도,밀양시,75-79세,5606,2232,3374
202105,48270,경상남도,밀양시,75-79세,5559,2220,3339
202106,48270,경상남도,밀양시,75-79세,5534,2221,3313
202007,48270,경상남도,밀양시,80-84세,4487,1445,3042
202008,48270,경상남도,밀양시,80-84세,4470,1443,3027
202009,48270,경상남도,밀양시,80-84세,4446,1440,3006
202010,48270,경상남도,밀양시,80-84세,4454,1443,3011
202011,48270,경상남도,밀양시,80-84세,4443,1437,3006
202012,48270,경상남도,밀양시,80-84세,4444,1444,3000
202101,48270,경상남도,밀양시,80-84세,4424,1445,2979
202102,48270,경상남도,밀양시,80-84세,4433,1457,2976
202103,48270,경상남도,밀양시,80-84세,4441,1456,2985
202104,48270,경상남도,밀양시,80-84세,4446,1458,2988
202105,48270,경상남도,밀양시,80-84세,4446,1451,2995
202106,48270,경상남도,밀양시,80-84세,4469,1455,3014
202007,48270,경상남도,밀양시,85-89세,2381,647,1734
202008,48270,경상남도,밀양시,85-89세,2395,649,1746
202009,48270,경상남도,밀양시,85-89세,2398,650,1748
202010,48270,경상남도,밀양시,85-89세,2404,646,1758
202011,48270,경상남도,밀양시,85-89세,2413,658,1755
202012,48270,경상남도,밀양시,85-89세,2434,663,1771
202101,48270,경상남도,밀양시,85-89세,2463,666,1797
202102,48270,경상남도,밀양시,85-89세,2499,674,1825
202103,48270,경상남도,밀양시,85-89세,2538,692,1846
202104,48270,경상남도,밀양시,85-89세,2563,704,1859
202105,48270,경상남도,밀양시,85-89세,2562,702,1860
202106,48270,경상남도,밀양시,85-89세,2562,700,1862
202007,48270,경상남도,밀양시,90-94세,732,141,591
202008,48270,경상남도,밀양시,90-94세,743,145,598
202009,48270,경상남도,밀양시,90-94세,753,148,605
202010,48270,경상남도,밀양시,90-94세,742,149,593
202011,48270,경상남도,밀양시,90-94세,748,149,599
202012,48270,경상남도,밀양시,90-94세,764,152,612
202101,48270,경상남도,밀양시,90-94세,777,157,620
202102,48270,경상남도,밀양시,90-94세,779,158,621
202103,48270,경상남도,밀양시,90-94세,775,154,621
202104,48270,경상남도,밀양시,90-94세,778,154,624
202105,48270,경상남도,밀양시,90-94세,777,157,620
202106,48270,경상남도,밀양시,90-94세,771,156,615
202007,48270,경상남도,밀양시,95-99세,149,22,127
202008,48270,경상남도,밀양시,95-99세,150,21,129
202009,48270,경상남도,밀양시,95-99세,152,22,130
202010,48270,경상남도,밀양시,95-99세,152,21,131
202011,48270,경상남도,밀양시,95-99세,150,21,129
202012,48270,경상남도,밀양시,95-99세,141,19,122
202101,48270,경상남도,밀양시,95-99세,140,20,120
202102,48270,경상남도,밀양시,95-99세,137,21,116
202103,48270,경상남도,밀양시,95-99세,121,16,105
202104,48270,경상남도,밀양시,95-99세,127,17,110
202105,48270,경상남도,밀양시,95-99세,131,17,114
202106,48270,경상남도,밀양시,95-99세,134,17,117
202007,48270,경상남도,밀양시,100+,46,7,39
202008,48270,경상남도,밀양시,100+,45,7,38
202009,48270,경상남도,밀양시,100+,45,7,38
202010,48270,경상남도,밀양시,100+,45,7,38
202011,48270,경상남도,밀양시,100+,47,9,38
202012,48270,경상남도,밀양시,100+,48,9,39
202101,48270,경상남도,밀양시,100+,48,9,39
202102,48270,경상남도,밀양시,100+,47,9,38
202103,48270,경상남도,밀양시,100+,26,6,20
202104,48270,경상남도,밀양시,100+,26,5,21
202105,48270,경상남도,밀양시,100+,28,5,23
202106,48270,경상남도,밀양시,100+,28,5,23
202007,48310,경상남도,거제시,0-4세,11282,5834,5448
202008,48310,경상남도,거제시,0-4세,11168,5785,5383
202009,48310,경상남도,거제시,0-4세,11001,5706,5295
202010,48310,경상남도,거제시,0-4세,10802,5610,5192
202011,48310,경상남도,거제시,0-4세,10646,5532,5114
202012,48310,경상남도,거제시,0-4세,10469,5442,5027
202101,48310,경상남도,거제시,0-4세,10272,5327,4945
202102,48310,경상남도,거제시,0-4세,10088,5235,4853
202103,48310,경상남도,거제시,0-4세,9915,5152,4763
202104,48310,경상남도,거제시,0-4세,9755,5078,4677
202105,48310,경상남도,거제시,0-4세,9581,4990,4591
202106,48310,경상남도,거제시,0-4세,9451,4927,4524
202007,48310,경상남도,거제시,5-9세,16427,8459,7968
202008,48310,경상남도,거제시,5-9세,16339,8409,7930
202009,48310,경상남도,거제시,5-9세,16313,8413,7900
202010,48310,경상남도,거제시,5-9세,16306,8413,7893
202011,48310,경상남도,거제시,5-9세,16289,8393,7896
202012,48310,경상남도,거제시,5-9세,16247,8381,7866
202101,48310,경상남도,거제시,5-9세,16194,8374,7820
202102,48310,경상남도,거제시,5-9세,16100,8329,7771
202103,48310,경상남도,거제시,5-9세,16050,8278,7772
202104,48310,경상남도,거제시,5-9세,15984,8240,7744
202105,48310,경상남도,거제시,5-9세,15956,8223,7733
202106,48310,경상남도,거제시,5-9세,15884,8203,7681
202007,48310,경상남도,거제시,10-14세,14288,7465,6823
202008,48310,경상남도,거제시,10-14세,14354,7512,6842
202009,48310,경상남도,거제시,10-14세,14435,7533,6902
202010,48310,경상남도,거제시,10-14세,14498,7532,6966
202011,48310,경상남도,거제시,10-14세,14542,7543,6999
202012,48310,경상남도,거제시,10-14세,14592,7558,7034
202101,48310,경상남도,거제시,10-14세,14646,7578,7068
202102,48310,경상남도,거제시,10-14세,14635,7560,7075
202103,48310,경상남도,거제시,10-14세,14718,7630,7088
202104,48310,경상남도,거제시,10-14세,14790,7657,7133
202105,48310,경상남도,거제시,10-14세,14800,7656,7144
202106,48310,경상남도,거제시,10-14세,14878,7679,7199
202007,48310,경상남도,거제시,15-19세,13635,7247,6388
202008,48310,경상남도,거제시,15-19세,13581,7219,6362
202009,48310,경상남도,거제시,15-19세,13525,7196,6329
202010,48310,경상남도,거제시,15-19세,13430,7151,6279
202011,48310,경상남도,거제시,15-19세,13401,7133,6268
202012,48310,경상남도,거제시,15-19세,13371,7093,6278
202101,48310,경상남도,거제시,15-19세,13308,7067,6241
202102,48310,경상남도,거제시,15-19세,13233,7042,6191
202103,48310,경상남도,거제시,15-19세,13116,6984,6132
202104,48310,경상남도,거제시,15-19세,13055,6935,6120
202105,48310,경상남도,거제시,15-19세,12993,6895,6098
202106,48310,경상남도,거제시,15-19세,12959,6875,6084
202007,48310,경상남도,거제시,20-24세,13310,7573,5737
202008,48310,경상남도,거제시,20-24세,13216,7541,5675
202009,48310,경상남도,거제시,20-24세,13198,7520,5678
202010,48310,경상남도,거제시,20-24세,13273,7563,5710
202011,48310,경상남도,거제시,20-24세,13276,7588,5688
202012,48310,경상남도,거제시,20-24세,13242,7606,5636
202101,48310,경상남도,거제시,20-24세,13204,7569,5635
202102,48310,경상남도,거제시,20-24세,13076,7501,5575
202103,48310,경상남도,거제시,20-24세,12937,7406,5531
202104,48310,경상남도,거제시,20-24세,12939,7420,5519
202105,48310,경상남도,거제시,20-24세,12921,7394,5527
202106,48310,경상남도,거제시,20-24세,12859,7355,5504
202007,48310,경상남도,거제시,25-29세,11248,6229,5019
202008,48310,경상남도,거제시,25-29세,11263,6243,5020
202009,48310,경상남도,거제시,25-29세,11212,6218,4994
202010,48310,경상남도,거제시,25-29세,11214,6221,4993
202011,48310,경상남도,거제시,25-29세,11163,6188,4975
202012,48310,경상남도,거제시,25-29세,11108,6152,4956
202101,48310,경상남도,거제시,25-29세,11066,6139,4927
202102,48310,경상남도,거제시,25-29세,11006,6122,4884
202103,48310,경상남도,거제시,25-29세,10940,6101,4839
202104,48310,경상남도,거제시,25-29세,10873,6068,4805
202105,48310,경상남도,거제시,25-29세,10819,6010,4809
202106,48310,경상남도,거제시,25-29세,10770,6000,4770
202007,48310,경상남도,거제시,30-34세,14571,7646,6925
202008,48310,경상남도,거제시,30-34세,14455,7602,6853
202009,48310,경상남도,거제시,30-34세,14297,7483,6814
202010,48310,경상남도,거제시,30-34세,14104,7393,6711
202011,48310,경상남도,거제시,30-34세,13915,7267,6648
202012,48310,경상남도,거제시,30-34세,13732,7176,6556
202101,48310,경상남도,거제시,30-34세,13548,7071,6477
202102,48310,경상남도,거제시,30-34세,13359,6936,6423
202103,48310,경상남도,거제시,30-34세,13232,6838,6394
202104,48310,경상남도,거제시,30-34세,13135,6792,6343
202105,48310,경상남도,거제시,30-34세,13002,6731,6271
202106,48310,경상남도,거제시,30-34세,12912,6679,6233
202007,48310,경상남도,거제시,35-39세,23649,12690,10959
202008,48310,경상남도,거제시,35-39세,23454,12545,10909
202009,48310,경상남도,거제시,35-39세,23301,12449,10852
202010,48310,경상남도,거제시,35-39세,23118,12321,10797
202011,48310,경상남도,거제시,35-39세,22962,12225,10737
202012,48310,경상남도,거제시,35-39세,22908,12176,10732
202101,48310,경상남도,거제시,35-39세,22792,12102,10690
202102,48310,경상남도,거제시,35-39세,22571,11989,10582
202103,48310,경상남도,거제시,35-39세,22382,11890,10492
202104,48310,경상남도,거제시,35-39세,22158,11749,10409
202105,48310,경상남도,거제시,35-39세,21958,11636,10322
202106,48310,경상남도,거제시,35-39세,21772,11510,10262
202007,48310,경상남도,거제시,40-44세,23257,12647,10610
202008,48310,경상남도,거제시,40-44세,23349,12700,10649
202009,48310,경상남도,거제시,40-44세,23451,12751,10700
202010,48310,경상남도,거제시,40-44세,23562,12805,10757
202011,48310,경상남도,거제시,40-44세,23599,12849,10750
202012,48310,경상남도,거제시,40-44세,23553,12816,10737
202101,48310,경상남도,거제시,40-44세,23523,12786,10737
202102,48310,경상남도,거제시,40-44세,23522,12804,10718
202103,48310,경상남도,거제시,40-44세,23440,12751,10689
202104,48310,경상남도,거제시,40-44세,23449,12745,10704
202105,48310,경상남도,거제시,40-44세,23535,12789,10746
202106,48310,경상남도,거제시,40-44세,23663,12876,10787
202007,48310,경상남도,거제시,45-49세,24295,13299,10996
202008,48310,경상남도,거제시,45-49세,24247,13285,10962
202009,48310,경상남도,거제시,45-49세,24124,13210,10914
202010,48310,경상남도,거제시,45-49세,24018,13135,10883
202011,48310,경상남도,거제시,45-49세,24025,13119,10906
202012,48310,경상남도,거제시,45-49세,24082,13146,10936
202101,48310,경상남도,거제시,45-49세,24127,13158,10969
202102,48310,경상남도,거제시,45-49세,24131,13139,10992
202103,48310,경상남도,거제시,45-49세,24056,13073,10983
202104,48310,경상남도,거제시,45-49세,24039,13043,10996
202105,48310,경상남도,거제시,45-49세,23870,12930,10940
202106,48310,경상남도,거제시,45-49세,23783,12859,10924
202007,48310,경상남도,거제시,50-54세,21091,11567,9524
202008,48310,경상남도,거제시,50-54세,21183,11602,9581
202009,48310,경상남도,거제시,50-54세,21302,11679,9623
202010,48310,경상남도,거제시,50-54세,21389,11732,9657
202011,48310,경상남도,거제시,50-54세,21460,11740,9720
202012,48310,경상남도,거제시,50-54세,21480,11759,9721
202101,48310,경상남도,거제시,50-54세,21541,11796,9745
202102,48310,경상남도,거제시,50-54세,21636,11860,9776
202103,48310,경상남도,거제시,50-54세,21564,11841,9723
202104,48310,경상남도,거제시,50-54세,21592,11841,9751
202105,48310,경상남도,거제시,50-54세,21707,11885,9822
202106,48310,경상남도,거제시,50-54세,21779,11917,9862
202007,48310,경상남도,거제시,55-59세,17752,9069,8683
202008,48310,경상남도,거제시,55-59세,17669,9031,8638
202009,48310,경상남도,거제시,55-59세,17651,9034,8617
202010,48310,경상남도,거제시,55-59세,17726,9097,8629
202011,48310,경상남도,거제시,55-59세,17739,9140,8599
202012,48310,경상남도,거제시,55-59세,17793,9172,8621
202101,48310,경상남도,거제시,55-59세,17732,9182,8550
202102,48310,경상남도,거제시,55-59세,17756,9215,8541
202103,48310,경상남도,거제시,55-59세,17726,9256,8470
202104,48310,경상남도,거제시,55-59세,17723,9311,8412
202105,48310,경상남도,거제시,55-59세,17642,9327,8315
202106,48310,경상남도,거제시,55-59세,17583,9310,8273
202007,48310,경상남도,거제시,60-64세,15790,8381,7409
202008,48310,경상남도,거제시,60-64세,15904,8428,7476
202009,48310,경상남도,거제시,60-64세,16043,8477,7566
202010,48310,경상남도,거제시,60-64세,16163,8514,7649
202011,48310,경상남도,거제시,60-64세,16274,8546,7728
202012,48310,경상남도,거제시,60-64세,16308,8543,7765
202101,48310,경상남도,거제시,60-64세,16479,8603,7876
202102,48310,경상남도,거제시,60-64세,16652,8677,7975
202103,48310,경상남도,거제시,60-64세,16744,8729,8015
202104,48310,경상남도,거제시,60-64세,16857,8762,8095
202105,48310,경상남도,거제시,60-64세,16963,8812,8151
202106,48310,경상남도,거제시,60-64세,17074,8865,8209
202007,48310,경상남도,거제시,65-69세,9653,4865,4788
202008,48310,경상남도,거제시,65-69세,9784,4938,4846
202009,48310,경상남도,거제시,65-69세,9912,5005,4907
202010,48310,경상남도,거제시,65-69세,9998,5056,4942
202011,48310,경상남도,거제시,65-69세,10084,5106,4978
202012,48310,경상남도,거제시,65-69세,10236,5199,5037
202101,48310,경상남도,거제시,65-69세,10374,5266,5108
202102,48310,경상남도,거제시,65-69세,10458,5302,5156
202103,48310,경상남도,거제시,65-69세,10538,5323,5215
202104,48310,경상남도,거제시,65-69세,10643,5370,5273
202105,48310,경상남도,거제시,65-69세,10750,5414,5336
202106,48310,경상남도,거제시,65-69세,10808,5443,5365
202007,48310,경상남도,거제시,70-74세,6113,3125,2988
202008,48310,경상남도,거제시,70-74세,6122,3135,2987
202009,48310,경상남도,거제시,70-74세,6168,3168,3000
202010,48310,경상남도,거제시,70-74세,6252,3206,3046
202011,48310,경상남도,거제시,70-74세,6320,3241,3079
202012,48310,경상남도,거제시,70-74세,6390,3281,3109
202101,48310,경상남도,거제시,70-74세,6450,3314,3136
202102,48310,경상남도,거제시,70-74세,6524,3356,3168
202103,48310,경상남도,거제시,70-74세,6584,3388,3196
202104,48310,경상남도,거제시,70-74세,6660,3419,3241
202105,48310,경상남도,거제시,70-74세,6716,3460,3256
202106,48310,경상남도,거제시,70-74세,6740,3469,3271
202007,48310,경상남도,거제시,75-79세,4590,1892,2698
202008,48310,경상남도,거제시,75-79세,4595,1883,2712
202009,48310,경상남도,거제시,75-79세,4562,1872,2690
202010,48310,경상남도,거제시,75-79세,4532,1861,2671
202011,48310,경상남도,거제시,75-79세,4495,1856,2639
202012,48310,경상남도,거제시,75-79세,4436,1845,2591
202101,48310,경상남도,거제시,75-79세,4392,1830,2562
202102,48310,경상남도,거제시,75-79세,4355,1821,2534
202103,48310,경상남도,거제시,75-79세,4340,1816,2524
202104,48310,경상남도,거제시,75-79세,4338,1825,2513
202105,48310,경상남도,거제시,75-79세,4337,1824,2513
202106,48310,경상남도,거제시,75-79세,4344,1831,2513
202007,48310,경상남도,거제시,80-84세,3126,1028,2098
202008,48310,경상남도,거제시,80-84세,3125,1034,2091
202009,48310,경상남도,거제시,80-84세,3117,1026,2091
202010,48310,경상남도,거제시,80-84세,3113,1030,2083
202011,48310,경상남도,거제시,80-84세,3117,1029,2088
202012,48310,경상남도,거제시,80-84세,3126,1034,2092
202101,48310,경상남도,거제시,80-84세,3137,1049,2088
202102,48310,경상남도,거제시,80-84세,3165,1063,2102
202103,48310,경상남도,거제시,80-84세,3152,1063,2089
202104,48310,경상남도,거제시,80-84세,3165,1070,2095
202105,48310,경상남도,거제시,80-84세,3173,1078,2095
202106,48310,경상남도,거제시,80-84세,3190,1082,2108
202007,48310,경상남도,거제시,85-89세,1768,440,1328
202008,48310,경상남도,거제시,85-89세,1773,449,1324
202009,48310,경상남도,거제시,85-89세,1785,455,1330
202010,48310,경상남도,거제시,85-89세,1802,457,1345
202011,48310,경상남도,거제시,85-89세,1809,456,1353
202012,48310,경상남도,거제시,85-89세,1838,460,1378
202101,48310,경상남도,거제시,85-89세,1855,466,1389
202102,48310,경상남도,거제시,85-89세,1880,483,1397
202103,48310,경상남도,거제시,85-89세,1892,480,1412
202104,48310,경상남도,거제시,85-89세,1913,489,1424
202105,48310,경상남도,거제시,85-89세,1915,487,1428
202106,48310,경상남도,거제시,85-89세,1909,491,1418
202007,48310,경상남도,거제시,90-94세,642,99,543
202008,48310,경상남도,거제시,90-94세,645,100,545
202009,48310,경상남도,거제시,90-94세,650,96,554
202010,48310,경상남도,거제시,90-94세,648,99,549
202011,48310,경상남도,거제시,90-94세,657,100,557
202012,48310,경상남도,거제시,90-94세,659,104,555
202101,48310,경상남도,거제시,90-94세,668,107,561
202102,48310,경상남도,거제시,90-94세,671,103,568
202103,48310,경상남도,거제시,90-94세,662,100,562
202104,48310,경상남도,거제시,90-94세,668,104,564
202105,48310,경상남도,거제시,90-94세,680,110,570
202106,48310,경상남도,거제시,90-94세,677,108,569
202007,48310,경상남도,거제시,95-99세,129,24,105
202008,48310,경상남도,거제시,95-99세,132,24,108
202009,48310,경상남도,거제시,95-99세,139,26,113
202010,48310,경상남도,거제시,95-99세,140,26,114
202011,48310,경상남도,거제시,95-99세,135,25,110
202012,48310,경상남도,거제시,95-99세,138,26,112
202101,48310,경상남도,거제시,95-99세,139,26,113
202102,48310,경상남도,거제시,95-99세,144,27,117
202103,48310,경상남도,거제시,95-99세,138,22,116
202104,48310,경상남도,거제시,95-99세,139,23,116
202105,48310,경상남도,거제시,95-99세,139,23,116
202106,48310,경상남도,거제시,95-99세,136,23,113
202007,48310,경상남도,거제시,100+,44,7,37
202008,48310,경상남도,거제시,100+,44,8,36
202009,48310,경상남도,거제시,100+,45,8,37
202010,48310,경상남도,거제시,100+,45,8,37
202011,48310,경상남도,거제시,100+,48,9,39
202012,48310,경상남도,거제시,100+,46,9,37
202101,48310,경상남도,거제시,100+,45,9,36
202102,48310,경상남도,거제시,100+,46,10,36
202103,48310,경상남도,거제시,100+,28,9,19
202104,48310,경상남도,거제시,100+,27,9,18
202105,48310,경상남도,거제시,100+,27,9,18
202106,48310,경상남도,거제시,100+,29,8,21
202007,48330,경상남도,양산시,0-4세,15731,8073,7658
202008,48330,경상남도,양산시,0-4세,15627,8008,7619
202009,48330,경상남도,양산시,0-4세,15429,7917,7512
202010,48330,경상남도,양산시,0-4세,15259,7816,7443
202011,48330,경상남도,양산시,0-4세,15094,7721,7373
202012,48330,경상남도,양산시,0-4세,14959,7661,7298
202101,48330,경상남도,양산시,0-4세,14796,7575,7221
202102,48330,경상남도,양산시,0-4세,14665,7531,7134
202103,48330,경상남도,양산시,0-4세,14531,7448,7083
202104,48330,경상남도,양산시,0-4세,14413,7401,7012
202105,48330,경상남도,양산시,0-4세,14257,7313,6944
202106,48330,경상남도,양산시,0-4세,14139,7246,6893
202007,48330,경상남도,양산시,5-9세,19838,10116,9722
202008,48330,경상남도,양산시,5-9세,19790,10090,9700
202009,48330,경상남도,양산시,5-9세,19783,10087,9696
202010,48330,경상남도,양산시,5-9세,19695,10057,9638
202011,48330,경상남도,양산시,5-9세,19663,10038,9625
202012,48330,경상남도,양산시,5-9세,19638,10019,9619
202101,48330,경상남도,양산시,5-9세,19601,9983,9618
202102,48330,경상남도,양산시,5-9세,19610,9967,9643
202103,48330,경상남도,양산시,5-9세,19613,9970,9643
202104,48330,경상남도,양산시,5-9세,19605,9956,9649
202105,48330,경상남도,양산시,5-9세,19603,9956,9647
202106,48330,경상남도,양산시,5-9세,19591,9959,9632
202007,48330,경상남도,양산시,10-14세,17126,8742,8384
202008,48330,경상남도,양산시,10-14세,17226,8798,8428
202009,48330,경상남도,양산시,10-14세,17274,8809,8465
202010,48330,경상남도,양산시,10-14세,17379,8885,8494
202011,48330,경상남도,양산시,10-14세,17468,8942,8526
202012,48330,경상남도,양산시,10-14세,17515,8970,8545
202101,48330,경상남도,양산시,10-14세,17617,9042,8575
202102,48330,경상남도,양산시,10-14세,17674,9073,8601
202103,48330,경상남도,양산시,10-14세,17786,9123,8663
202104,48330,경상남도,양산시,10-14세,17891,9167,8724
202105,48330,경상남도,양산시,10-14세,17951,9197,8754
202106,48330,경상남도,양산시,10-14세,18011,9206,8805
202007,48330,경상남도,양산시,15-19세,17112,8891,8221
202008,48330,경상남도,양산시,15-19세,17053,8869,8184
202009,48330,경상남도,양산시,15-19세,17023,8836,8187
202010,48330,경상남도,양산시,15-19세,16941,8779,8162
202011,48330,경상남도,양산시,15-19세,16795,8678,8117
202012,48330,경상남도,양산시,15-19세,16765,8628,8137
202101,48330,경상남도,양산시,15-19세,16737,8611,8126
202102,48330,경상남도,양산시,15-19세,16728,8616,8112
202103,48330,경상남도,양산시,15-19세,16716,8638,8078
202104,48330,경상남도,양산시,15-19세,16614,8577,8037
202105,48330,경상남도,양산시,15-19세,16542,8514,8028
202106,48330,경상남도,양산시,15-19세,16522,8489,8033
202007,48330,경상남도,양산시,20-24세,19983,10809,9174
202008,48330,경상남도,양산시,20-24세,19936,10775,9161
202009,48330,경상남도,양산시,20-24세,19933,10761,9172
202010,48330,경상남도,양산시,20-24세,19918,10722,9196
202011,48330,경상남도,양산시,20-24세,19889,10717,9172
202012,48330,경상남도,양산시,20-24세,19862,10739,9123
202101,48330,경상남도,양산시,20-24세,19754,10672,9082
202102,48330,경상남도,양산시,20-24세,19623,10613,9010
202103,48330,경상남도,양산시,20-24세,19533,10591,8942
202104,48330,경상남도,양산시,20-24세,19518,10577,8941
202105,48330,경상남도,양산시,20-24세,19466,10556,8910
202106,48330,경상남도,양산시,20-24세,19378,10535,8843
202007,48330,경상남도,양산시,25-29세,20871,11067,9804
202008,48330,경상남도,양산시,25-29세,20795,11029,9766
202009,48330,경상남도,양산시,25-29세,20829,11071,9758
202010,48330,경상남도,양산시,25-29세,20903,11121,9782
202011,48330,경상남도,양산시,25-29세,20897,11093,9804
202012,48330,경상남도,양산시,25-29세,20969,11130,9839
202101,48330,경상남도,양산시,25-29세,20931,11101,9830
202102,48330,경상남도,양산시,25-29세,20938,11070,9868
202103,48330,경상남도,양산시,25-29세,20926,11088,9838
202104,48330,경상남도,양산시,25-29세,20908,11092,9816
202105,48330,경상남도,양산시,25-29세,20865,11100,9765
202106,48330,경상남도,양산시,25-29세,20791,11078,9713
202007,48330,경상남도,양산시,30-34세,21182,10826,10356
202008,48330,경상남도,양산시,30-34세,21132,10828,10304
202009,48330,경상남도,양산시,30-34세,21066,10767,10299
202010,48330,경상남도,양산시,30-34세,20894,10722,10172
202011,48330,경상남도,양산시,30-34세,20794,10671,10123
202012,48330,경상남도,양산시,30-34세,20734,10653,10081
202101,48330,경상남도,양산시,30-34세,20687,10620,10067
202102,48330,경상남도,양산시,30-34세,20623,10595,10028
202103,48330,경상남도,양산시,30-34세,20691,10609,10082
202104,48330,경상남도,양산시,30-34세,20765,10690,10075
202105,48330,경상남도,양산시,30-34세,20791,10679,10112
202106,48330,경상남도,양산시,30-34세,20867,10715,10152
202007,48330,경상남도,양산시,35-39세,29472,15129,14343
202008,48330,경상남도,양산시,35-39세,29264,15032,14232
202009,48330,경상남도,양산시,35-39세,29063,14942,14121
202010,48330,경상남도,양산시,35-39세,28802,14799,14003
202011,48330,경상남도,양산시,35-39세,28585,14681,13904
202012,48330,경상남도,양산시,35-39세,28485,14638,13847
202101,48330,경상남도,양산시,35-39세,28241,14527,13714
202102,48330,경상남도,양산시,35-39세,27952,14395,13557
202103,48330,경상남도,양산시,35-39세,27807,14305,13502
202104,48330,경상남도,양산시,35-39세,27704,14242,13462
202105,48330,경상남도,양산시,35-39세,27481,14135,13346
202106,48330,경상남도,양산시,35-39세,27330,14063,13267
202007,48330,경상남도,양산시,40-44세,29444,15004,14440
202008,48330,경상남도,양산시,40-44세,29541,15053,14488
202009,48330,경상남도,양산시,40-44세,29698,15133,14565
202010,48330,경상남도,양산시,40-44세,29890,15221,14669
202011,48330,경상남도,양산시,40-44세,30047,15303,14744
202012,48330,경상남도,양산시,40-44세,30062,15293,14769
202101,48330,경상남도,양산시,40-44세,30135,15319,14816
202102,48330,경상남도,양산시,40-44세,30298,15433,14865
202103,48330,경상남도,양산시,40-44세,30318,15472,14846
202104,48330,경상남도,양산시,40-44세,30450,15528,14922
202105,48330,경상남도,양산시,40-44세,30576,15588,14988
202106,48330,경상남도,양산시,40-44세,30725,15659,15066
202007,48330,경상남도,양산시,45-49세,30943,15723,15220
202008,48330,경상남도,양산시,45-49세,30946,15701,15245
202009,48330,경상남도,양산시,45-49세,30796,15608,15188
202010,48330,경상남도,양산시,45-49세,30765,15597,15168
202011,48330,경상남도,양산시,45-49세,30695,15548,15147
202012,48330,경상남도,양산시,45-49세,30719,15576,15143
202101,48330,경상남도,양산시,45-49세,30778,15593,15185
202102,48330,경상남도,양산시,45-49세,30808,15576,15232
202103,48330,경상남도,양산시,45-49세,30807,15579,15228
202104,48330,경상남도,양산시,45-49세,30755,15551,15204
202105,48330,경상남도,양산시,45-49세,30566,15466,15100
202106,48330,경상남도,양산시,45-49세,30492,15425,15067
202007,48330,경상남도,양산시,50-54세,30527,15200,15327
202008,48330,경상남도,양산시,50-54세,30566,15210,15356
202009,48330,경상남도,양산시,50-54세,30686,15269,15417
202010,48330,경상남도,양산시,50-54세,30685,15260,15425
202011,48330,경상남도,양산시,50-54세,30707,15260,15447
202012,48330,경상남도,양산시,50-54세,30703,15273,15430
202101,48330,경상남도,양산시,50-54세,30835,15342,15493
202102,48330,경상남도,양산시,50-54세,30938,15422,15516
202103,48330,경상남도,양산시,50-54세,30834,15361,15473
202104,48330,경상남도,양산시,50-54세,30883,15333,15550
202105,48330,경상남도,양산시,50-54세,31034,15400,15634
202106,48330,경상남도,양산시,50-54세,31134,15448,15686
202007,48330,경상남도,양산시,55-59세,27942,14268,13674
202008,48330,경상남도,양산시,55-59세,27914,14268,13646
202009,48330,경상남도,양산시,55-59세,27900,14278,13622
202010,48330,경상남도,양산시,55-59세,27898,14305,13593
202011,48330,경상남도,양산시,55-59세,27904,14324,13580
202012,48330,경상남도,양산시,55-59세,28023,14362,13661
202101,48330,경상남도,양산시,55-59세,27868,14268,13600
202102,48330,경상남도,양산시,55-59세,27888,14276,13612
202103,48330,경상남도,양산시,55-59세,27831,14283,13548
202104,48330,경상남도,양산시,55-59세,27816,14312,13504
202105,48330,경상남도,양산시,55-59세,27757,14281,13476
202106,48330,경상남도,양산시,55-59세,27635,14228,13407
202007,48330,경상남도,양산시,60-64세,24468,12139,12329
202008,48330,경상남도,양산시,60-64세,24618,12219,12399
202009,48330,경상남도,양산시,60-64세,24795,12312,12483
202010,48330,경상남도,양산시,60-64세,24964,12380,12584
202011,48330,경상남도,양산시,60-64세,25088,12432,12656
202012,48330,경상남도,양산시,60-64세,25300,12529,12771
202101,48330,경상남도,양산시,60-64세,25582,12689,12893
202102,48330,경상남도,양산시,60-64세,25805,12812,12993
202103,48330,경상남도,양산시,60-64세,26085,12932,13153
202104,48330,경상남도,양산시,60-64세,26307,13054,13253
202105,48330,경상남도,양산시,60-64세,26547,13158,13389
202106,48330,경상남도,양산시,60-64세,26795,13278,13517
202007,48330,경상남도,양산시,65-69세,16715,8088,8627
202008,48330,경상남도,양산시,65-69세,16875,8151,8724
202009,48330,경상남도,양산시,65-69세,17034,8221,8813
202010,48330,경상남도,양산시,65-69세,17180,8265,8915
202011,48330,경상남도,양산시,65-69세,17340,8355,8985
202012,48330,경상남도,양산시,65-69세,17485,8429,9056
202101,48330,경상남도,양산시,65-69세,17691,8523,9168
202102,48330,경상남도,양산시,65-69세,17747,8548,9199
202103,48330,경상남도,양산시,65-69세,17912,8642,9270
202104,48330,경상남도,양산시,65-69세,18086,8715,9371
202105,48330,경상남도,양산시,65-69세,18228,8766,9462
202106,48330,경상남도,양산시,65-69세,18353,8813,9540
202007,48330,경상남도,양산시,70-74세,11627,5367,6260
202008,48330,경상남도,양산시,70-74세,11670,5387,6283
202009,48330,경상남도,양산시,70-74세,11777,5439,6338
202010,48330,경상남도,양산시,70-74세,11893,5494,6399
202011,48330,경상남도,양산시,70-74세,11995,5545,6450
202012,48330,경상남도,양산시,70-74세,12143,5616,6527
202101,48330,경상남도,양산시,70-74세,12246,5678,6568
202102,48330,경상남도,양산시,70-74세,12396,5740,6656
202103,48330,경상남도,양산시,70-74세,12414,5740,6674
202104,48330,경상남도,양산시,70-74세,12482,5769,6713
202105,48330,경상남도,양산시,70-74세,12575,5826,6749
202106,48330,경상남도,양산시,70-74세,12609,5846,6763
202007,48330,경상남도,양산시,75-79세,9063,3887,5176
202008,48330,경상남도,양산시,75-79세,9080,3904,5176
202009,48330,경상남도,양산시,75-79세,9045,3895,5150
202010,48330,경상남도,양산시,75-79세,9040,3891,5149
202011,48330,경상남도,양산시,75-79세,8981,3870,5111
202012,48330,경상남도,양산시,75-79세,8940,3852,5088
202101,48330,경상남도,양산시,75-79세,8885,3841,5044
202102,48330,경상남도,양산시,75-79세,8839,3829,5010
202103,48330,경상남도,양산시,75-79세,8857,3845,5012
202104,48330,경상남도,양산시,75-79세,8866,3851,5015
202105,48330,경상남도,양산시,75-79세,8887,3864,5023
202106,48330,경상남도,양산시,75-79세,8936,3888,5048
202007,48330,경상남도,양산시,80-84세,5802,2110,3692
202008,48330,경상남도,양산시,80-84세,5838,2119,3719
202009,48330,경상남도,양산시,80-84세,5893,2142,3751
202010,48330,경상남도,양산시,80-84세,5914,2160,3754
202011,48330,경상남도,양산시,80-84세,5938,2159,3779
202012,48330,경상남도,양산시,80-84세,5960,2157,3803
202101,48330,경상남도,양산시,80-84세,6020,2190,3830
202102,48330,경상남도,양산시,80-84세,6070,2218,3852
202103,48330,경상남도,양산시,80-84세,6089,2217,3872
202104,48330,경상남도,양산시,80-84세,6097,2224,3873
202105,48330,경상남도,양산시,80-84세,6108,2228,3880
202106,48330,경상남도,양산시,80-84세,6176,2255,3921
202007,48330,경상남도,양산시,85-89세,2713,815,1898
202008,48330,경상남도,양산시,85-89세,2721,820,1901
202009,48330,경상남도,양산시,85-89세,2742,830,1912
202010,48330,경상남도,양산시,85-89세,2768,843,1925
202011,48330,경상남도,양산시,85-89세,2786,852,1934
202012,48330,경상남도,양산시,85-89세,2821,873,1948
202101,48330,경상남도,양산시,85-89세,2847,883,1964
202102,48330,경상남도,양산시,85-89세,2893,894,1999
202103,48330,경상남도,양산시,85-89세,2928,902,2026
202104,48330,경상남도,양산시,85-89세,2967,911,2056
202105,48330,경상남도,양산시,85-89세,2989,914,2075
202106,48330,경상남도,양산시,85-89세,2998,918,2080
202007,48330,경상남도,양산시,90-94세,856,189,667
202008,48330,경상남도,양산시,90-94세,860,190,670
202009,48330,경상남도,양산시,90-94세,863,195,668
202010,48330,경상남도,양산시,90-94세,874,195,679
202011,48330,경상남도,양산시,90-94세,880,199,681
202012,48330,경상남도,양산시,90-94세,887,200,687
202101,48330,경상남도,양산시,90-94세,909,205,704
202102,48330,경상남도,양산시,90-94세,920,212,708
202103,48330,경상남도,양산시,90-94세,916,209,707
202104,48330,경상남도,양산시,90-94세,927,216,711
202105,48330,경상남도,양산시,90-94세,946,222,724
202106,48330,경상남도,양산시,90-94세,961,224,737
202007,48330,경상남도,양산시,95-99세,177,29,148
202008,48330,경상남도,양산시,95-99세,181,27,154
202009,48330,경상남도,양산시,95-99세,186,26,160
202010,48330,경상남도,양산시,95-99세,189,28,161
202011,48330,경상남도,양산시,95-99세,192,29,163
202012,48330,경상남도,양산시,95-99세,200,32,168
202101,48330,경상남도,양산시,95-99세,201,32,169
202102,48330,경상남도,양산시,95-99세,206,32,174
202103,48330,경상남도,양산시,95-99세,203,30,173
202104,48330,경상남도,양산시,95-99세,205,31,174
202105,48330,경상남도,양산시,95-99세,213,31,182
202106,48330,경상남도,양산시,95-99세,209,32,177
202007,48330,경상남도,양산시,100+,59,10,49
202008,48330,경상남도,양산시,100+,58,10,48
202009,48330,경상남도,양산시,100+,59,11,48
202010,48330,경상남도,양산시,100+,59,11,48
202011,48330,경상남도,양산시,100+,59,11,48
202012,48330,경상남도,양산시,100+,59,11,48
202101,48330,경상남도,양산시,100+,60,11,49
202102,48330,경상남도,양산시,100+,61,11,50
202103,48330,경상남도,양산시,100+,33,3,30
202104,48330,경상남도,양산시,100+,32,3,29
202105,48330,경상남도,양산시,100+,33,3,30
202106,48330,경상남도,양산시,100+,34,3,31
202007,48720,경상남도,의령군,0-4세,484,217,267
202008,48720,경상남도,의령군,0-4세,478,218,260
202009,48720,경상남도,의령군,0-4세,473,216,257
202010,48720,경상남도,의령군,0-4세,476,221,255
202011,48720,경상남도,의령군,0-4세,471,218,253
202012,48720,경상남도,의령군,0-4세,463,211,252
202101,48720,경상남도,의령군,0-4세,459,209,250
202102,48720,경상남도,의령군,0-4세,460,211,249
202103,48720,경상남도,의령군,0-4세,457,211,246
202104,48720,경상남도,의령군,0-4세,453,207,246
202105,48720,경상남도,의령군,0-4세,447,205,242
202106,48720,경상남도,의령군,0-4세,440,207,233
202007,48720,경상남도,의령군,5-9세,639,353,286
202008,48720,경상남도,의령군,5-9세,643,356,287
202009,48720,경상남도,의령군,5-9세,637,353,284
202010,48720,경상남도,의령군,5-9세,631,349,282
202011,48720,경상남도,의령군,5-9세,619,345,274
202012,48720,경상남도,의령군,5-9세,611,337,274
202101,48720,경상남도,의령군,5-9세,601,334,267
202102,48720,경상남도,의령군,5-9세,596,330,266
202103,48720,경상남도,의령군,5-9세,596,325,271
202104,48720,경상남도,의령군,5-9세,590,322,268
202105,48720,경상남도,의령군,5-9세,590,327,263
202106,48720,경상남도,의령군,5-9세,597,330,267
202007,48720,경상남도,의령군,10-14세,670,362,308
202008,48720,경상남도,의령군,10-14세,675,360,315
202009,48720,경상남도,의령군,10-14세,680,359,321
202010,48720,경상남도,의령군,10-14세,687,361,326
202011,48720,경상남도,의령군,10-14세,674,356,318
202012,48720,경상남도,의령군,10-14세,674,354,320
202101,48720,경상남도,의령군,10-14세,679,357,322
202102,48720,경상남도,의령군,10-14세,674,350,324
202103,48720,경상남도,의령군,10-14세,682,354,328
202104,48720,경상남도,의령군,10-14세,683,358,325
202105,48720,경상남도,의령군,10-14세,685,355,330
202106,48720,경상남도,의령군,10-14세,680,347,333
202007,48720,경상남도,의령군,15-19세,896,483,413
202008,48720,경상남도,의령군,15-19세,875,472,403
202009,48720,경상남도,의령군,15-19세,868,470,398
202010,48720,경상남도,의령군,15-19세,857,470,387
202011,48720,경상남도,의령군,15-19세,865,475,390
202012,48720,경상남도,의령군,15-19세,848,465,383
202101,48720,경상남도,의령군,15-19세,826,446,380
202102,48720,경상남도,의령군,15-19세,825,448,377
202103,48720,경상남도,의령군,15-19세,808,442,366
202104,48720,경상남도,의령군,15-19세,799,437,362
202105,48720,경상남도,의령군,15-19세,799,436,363
202106,48720,경상남도,의령군,15-19세,781,426,355
202007,48720,경상남도,의령군,20-24세,1077,596,481
202008,48720,경상남도,의령군,20-24세,1069,586,483
202009,48720,경상남도,의령군,20-24세,1068,578,490
202010,48720,경상남도,의령군,20-24세,1073,579,494
202011,48720,경상남도,의령군,20-24세,1070,576,494
202012,48720,경상남도,의령군,20-24세,1079,591,488
202101,48720,경상남도,의령군,20-24세,1056,587,469
202102,48720,경상남도,의령군,20-24세,1021,573,448
202103,48720,경상남도,의령군,20-24세,1014,568,446
202104,48720,경상남도,의령군,20-24세,1001,558,443
202105,48720,경상남도,의령군,20-24세,1000,561,439
202106,48720,경상남도,의령군,20-24세,985,554,431
202007,48720,경상남도,의령군,25-29세,978,569,409
202008,48720,경상남도,의령군,25-29세,981,572,409
202009,48720,경상남도,의령군,25-29세,971,568,403
202010,48720,경상남도,의령군,25-29세,976,574,402
202011,48720,경상남도,의령군,25-29세,983,577,406
202012,48720,경상남도,의령군,25-29세,985,576,409
202101,48720,경상남도,의령군,25-29세,981,568,413
202102,48720,경상남도,의령군,25-29세,987,567,420
202103,48720,경상남도,의령군,25-29세,978,565,413
202104,48720,경상남도,의령군,25-29세,989,569,420
202105,48720,경상남도,의령군,25-29세,964,553,411
202106,48720,경상남도,의령군,25-29세,964,550,414
202007,48720,경상남도,의령군,30-34세,836,448,388
202008,48720,경상남도,의령군,30-34세,826,443,383
202009,48720,경상남도,의령군,30-34세,818,436,382
202010,48720,경상남도,의령군,30-34세,813,433,380
202011,48720,경상남도,의령군,30-34세,805,429,376
202012,48720,경상남도,의령군,30-34세,799,434,365
202101,48720,경상남도,의령군,30-34세,794,435,359
202102,48720,경상남도,의령군,30-34세,786,431,355
202103,48720,경상남도,의령군,30-34세,785,429,356
202104,48720,경상남도,의령군,30-34세,785,428,357
202105,48720,경상남도,의령군,30-34세,792,432,360
202106,48720,경상남도,의령군,30-34세,780,424,356
202007,48720,경상남도,의령군,35-39세,971,509,462
202008,48720,경상남도,의령군,35-39세,968,511,457
202009,48720,경상남도,의령군,35-39세,950,495,455
202010,48720,경상남도,의령군,35-39세,954,497,457
202011,48720,경상남도,의령군,35-39세,942,495,447
202012,48720,경상남도,의령군,35-39세,945,491,454
202101,48720,경상남도,의령군,35-39세,942,486,456
202102,48720,경상남도,의령군,35-39세,946,487,459
202103,48720,경상남도,의령군,35-39세,935,479,456
202104,48720,경상남도,의령군,35-39세,928,480,448
202105,48720,경상남도,의령군,35-39세,923,487,436
202106,48720,경상남도,의령군,35-39세,912,485,427
202007,48720,경상남도,의령군,40-44세,1211,697,514
202008,48720,경상남도,의령군,40-44세,1202,690,512
202009,48720,경상남도,의령군,40-44세,1203,691,512
202010,48720,경상남도,의령군,40-44세,1198,683,515
202011,48720,경상남도,의령군,40-44세,1203,685,518
202012,48720,경상남도,의령군,40-44세,1181,669,512
202101,48720,경상남도,의령군,40-44세,1179,672,507
202102,48720,경상남도,의령군,40-44세,1176,666,510
202103,48720,경상남도,의령군,40-44세,1153,660,493
202104,48720,경상남도,의령군,40-44세,1153,656,497
202105,48720,경상남도,의령군,40-44세,1150,649,501
202106,48720,경상남도,의령군,40-44세,1153,647,506
202007,48720,경상남도,의령군,45-49세,1736,1013,723
202008,48720,경상남도,의령군,45-49세,1733,1010,723
202009,48720,경상남도,의령군,45-49세,1721,1000,721
202010,48720,경상남도,의령군,45-49세,1702,994,708
202011,48720,경상남도,의령군,45-49세,1679,980,699
202012,48720,경상남도,의령군,45-49세,1688,978,710
202101,48720,경상남도,의령군,45-49세,1690,979,711
202102,48720,경상남도,의령군,45-49세,1686,983,703
202103,48720,경상남도,의령군,45-49세,1669,972,697
202104,48720,경상남도,의령군,45-49세,1647,960,687
202105,48720,경상남도,의령군,45-49세,1634,950,684
202106,48720,경상남도,의령군,45-49세,1606,933,673
202007,48720,경상남도,의령군,50-54세,2086,1181,905
202008,48720,경상남도,의령군,50-54세,2074,1169,905
202009,48720,경상남도,의령군,50-54세,2086,1184,902
202010,48720,경상남도,의령군,50-54세,2105,1199,906
202011,48720,경상남도,의령군,50-54세,2105,1203,902
202012,48720,경상남도,의령군,50-54세,2093,1196,897
202101,48720,경상남도,의령군,50-54세,2085,1194,891
202102,48720,경상남도,의령군,50-54세,2101,1197,904
202103,48720,경상남도,의령군,50-54세,2069,1186,883
202104,48720,경상남도,의령군,50-54세,2067,1178,889
202105,48720,경상남도,의령군,50-54세,2088,1194,894
202106,48720,경상남도,의령군,50-54세,2087,1200,887
202007,48720,경상남도,의령군,55-59세,2567,1364,1203
202008,48720,경상남도,의령군,55-59세,2566,1376,1190
202009,48720,경상남도,의령군,55-59세,2555,1374,1181
202010,48720,경상남도,의령군,55-59세,2545,1378,1167
202011,48720,경상남도,의령군,55-59세,2536,1365,1171
202012,48720,경상남도,의령군,55-59세,2564,1381,1183
202101,48720,경상남도,의령군,55-59세,2537,1373,1164
202102,48720,경상남도,의령군,55-59세,2502,1363,1139
202103,48720,경상남도,의령군,55-59세,2479,1360,1119
202104,48720,경상남도,의령군,55-59세,2466,1349,1117
202105,48720,경상남도,의령군,55-59세,2432,1323,1109
202106,48720,경상남도,의령군,55-59세,2407,1311,1096
202007,48720,경상남도,의령군,60-64세,2898,1555,1343
202008,48720,경상남도,의령군,60-64세,2914,1557,1357
202009,48720,경상남도,의령군,60-64세,2928,1565,1363
202010,48720,경상남도,의령군,60-64세,2947,1572,1375
202011,48720,경상남도,의령군,60-64세,2951,1582,1369
202012,48720,경상남도,의령군,60-64세,2949,1587,1362
202101,48720,경상남도,의령군,60-64세,3005,1618,1387
202102,48720,경상남도,의령군,60-64세,3048,1638,1410
202103,48720,경상남도,의령군,60-64세,3084,1653,1431
202104,48720,경상남도,의령군,60-64세,3102,1667,1435
202105,48720,경상남도,의령군,60-64세,3140,1693,1447
202106,48720,경상남도,의령군,60-64세,3154,1700,1454
202007,48720,경상남도,의령군,65-69세,2362,1203,1159
202008,48720,경상남도,의령군,65-69세,2384,1220,1164
202009,48720,경상남도,의령군,65-69세,2392,1226,1166
202010,48720,경상남도,의령군,65-69세,2405,1230,1175
202011,48720,경상남도,의령군,65-69세,2415,1236,1179
202012,48720,경상남도,의령군,65-69세,2432,1247,1185
202101,48720,경상남도,의령군,65-69세,2455,1257,1198
202102,48720,경상남도,의령군,65-69세,2456,1256,1200
202103,48720,경상남도,의령군,65-69세,2459,1263,1196
202104,48720,경상남도,의령군,65-69세,2465,1262,1203
202105,48720,경상남도,의령군,65-69세,2493,1290,1203
202106,48720,경상남도,의령군,65-69세,2501,1296,1205
202007,48720,경상남도,의령군,70-74세,1935,906,1029
202008,48720,경상남도,의령군,70-74세,1953,913,1040
202009,48720,경상남도,의령군,70-74세,1959,916,1043
202010,48720,경상남도,의령군,70-74세,1966,923,1043
202011,48720,경상남도,의령군,70-74세,1988,939,1049
202012,48720,경상남도,의령군,70-74세,1993,941,1052
202101,48720,경상남도,의령군,70-74세,2002,944,1058
202102,48720,경상남도,의령군,70-74세,2008,951,1057
202103,48720,경상남도,의령군,70-74세,2021,957,1064
202104,48720,경상남도,의령군,70-74세,2033,963,1070
202105,48720,경상남도,의령군,70-74세,2025,956,1069
202106,48720,경상남도,의령군,70-74세,2028,953,1075
202007,48720,경상남도,의령군,75-79세,2125,745,1380
202008,48720,경상남도,의령군,75-79세,2096,736,1360
202009,48720,경상남도,의령군,75-79세,2078,735,1343
202010,48720,경상남도,의령군,75-79세,2067,730,1337
202011,48720,경상남도,의령군,75-79세,2052,720,1332
202012,48720,경상남도,의령군,75-79세,2013,706,1307
202101,48720,경상남도,의령군,75-79세,1983,698,1285
202102,48720,경상남도,의령군,75-79세,1955,689,1266
202103,48720,경상남도,의령군,75-79세,1940,687,1253
202104,48720,경상남도,의령군,75-79세,1913,677,1236
202105,48720,경상남도,의령군,75-79세,1904,679,1225
202106,48720,경상남도,의령군,75-79세,1887,675,1212
202007,48720,경상남도,의령군,80-84세,1891,592,1299
202008,48720,경상남도,의령군,80-84세,1899,596,1303
202009,48720,경상남도,의령군,80-84세,1894,597,1297
202010,48720,경상남도,의령군,80-84세,1899,600,1299
202011,48720,경상남도,의령군,80-84세,1896,598,1298
202012,48720,경상남도,의령군,80-84세,1914,612,1302
202101,48720,경상남도,의령군,80-84세,1917,620,1297
202102,48720,경상남도,의령군,80-84세,1926,632,1294
202103,48720,경상남도,의령군,80-84세,1911,624,1287
202104,48720,경상남도,의령군,80-84세,1901,623,1278
202105,48720,경상남도,의령군,80-84세,1902,622,1280
202106,48720,경상남도,의령군,80-84세,1895,620,1275
202007,48720,경상남도,의령군,85-89세,1096,269,827
202008,48720,경상남도,의령군,85-89세,1103,277,826
202009,48720,경상남도,의령군,85-89세,1113,274,839
202010,48720,경상남도,의령군,85-89세,1117,271,846
202011,48720,경상남도,의령군,85-89세,1126,277,849
202012,48720,경상남도,의령군,85-89세,1132,272,860
202101,48720,경상남도,의령군,85-89세,1134,273,861
202102,48720,경상남도,의령군,85-89세,1149,274,875
202103,48720,경상남도,의령군,85-89세,1168,279,889
202104,48720,경상남도,의령군,85-89세,1177,279,898
202105,48720,경상남도,의령군,85-89세,1183,282,901
202106,48720,경상남도,의령군,85-89세,1195,282,913
202007,48720,경상남도,의령군,90-94세,373,79,294
202008,48720,경상남도,의령군,90-94세,372,77,295
202009,48720,경상남도,의령군,90-94세,373,77,296
202010,48720,경상남도,의령군,90-94세,374,78,296
202011,48720,경상남도,의령군,90-94세,367,76,291
202012,48720,경상남도,의령군,90-94세,361,78,283
202101,48720,경상남도,의령군,90-94세,373,79,294
202102,48720,경상남도,의령군,90-94세,374,79,295
202103,48720,경상남도,의령군,90-94세,383,83,300
202104,48720,경상남도,의령군,90-94세,394,82,312
202105,48720,경상남도,의령군,90-94세,399,81,318
202106,48720,경상남도,의령군,90-94세,398,81,317
202007,48720,경상남도,의령군,95-99세,62,11,51
202008,48720,경상남도,의령군,95-99세,64,12,52
202009,48720,경상남도,의령군,95-99세,63,13,50
202010,48720,경상남도,의령군,95-99세,63,13,50
202011,48720,경상남도,의령군,95-99세,62,12,50
202012,48720,경상남도,의령군,95-99세,67,12,55
202101,48720,경상남도,의령군,95-99세,72,15,57
202102,48720,경상남도,의령군,95-99세,74,14,60
202103,48720,경상남도,의령군,95-99세,71,13,58
202104,48720,경상남도,의령군,95-99세,72,13,59
202105,48720,경상남도,의령군,95-99세,71,13,58
202106,48720,경상남도,의령군,95-99세,70,13,57
202007,48720,경상남도,의령군,100+,9,2,7
202008,48720,경상남도,의령군,100+,8,2,6
202009,48720,경상남도,의령군,100+,9,2,7
202010,48720,경상남도,의령군,100+,9,2,7
202011,48720,경상남도,의령군,100+,9,2,7
202012,48720,경상남도,의령군,100+,9,2,7
202101,48720,경상남도,의령군,100+,8,2,6
202102,48720,경상남도,의령군,100+,7,2,5
202103,48720,경상남도,의령군,100+,7,1,6
202104,48720,경상남도,의령군,100+,6,1,5
202105,48720,경상남도,의령군,100+,6,1,5
202106,48720,경상남도,의령군,100+,6,1,5
202007,48730,경상남도,함안군,0-4세,1665,839,826
202008,48730,경상남도,함안군,0-4세,1631,822,809
202009,48730,경상남도,함안군,0-4세,1600,813,787
202010,48730,경상남도,함안군,0-4세,1571,803,768
202011,48730,경상남도,함안군,0-4세,1528,782,746
202012,48730,경상남도,함안군,0-4세,1504,768,736
202101,48730,경상남도,함안군,0-4세,1461,740,721
202102,48730,경상남도,함안군,0-4세,1436,736,700
202103,48730,경상남도,함안군,0-4세,1415,720,695
202104,48730,경상남도,함안군,0-4세,1390,704,686
202105,48730,경상남도,함안군,0-4세,1369,692,677
202106,48730,경상남도,함안군,0-4세,1344,690,654
202007,48730,경상남도,함안군,5-9세,2647,1321,1326
202008,48730,경상남도,함안군,5-9세,2638,1321,1317
202009,48730,경상남도,함안군,5-9세,2632,1316,1316
202010,48730,경상남도,함안군,5-9세,2618,1295,1323
202011,48730,경상남도,함안군,5-9세,2595,1288,1307
202012,48730,경상남도,함안군,5-9세,2594,1279,1315
202101,48730,경상남도,함안군,5-9세,2557,1270,1287
202102,48730,경상남도,함안군,5-9세,2534,1257,1277
202103,48730,경상남도,함안군,5-9세,2508,1247,1261
202104,48730,경상남도,함안군,5-9세,2494,1237,1257
202105,48730,경상남도,함안군,5-9세,2472,1236,1236
202106,48730,경상남도,함안군,5-9세,2455,1225,1230
202007,48730,경상남도,함안군,10-14세,2985,1560,1425
202008,48730,경상남도,함안군,10-14세,2986,1559,1427
202009,48730,경상남도,함안군,10-14세,2996,1569,1427
202010,48730,경상남도,함안군,10-14세,3000,1571,1429
202011,48730,경상남도,함안군,10-14세,3010,1574,1436
202012,48730,경상남도,함안군,10-14세,3019,1585,1434
202101,48730,경상남도,함안군,10-14세,3024,1591,1433
202102,48730,경상남도,함안군,10-14세,3015,1582,1433
202103,48730,경상남도,함안군,10-14세,3017,1578,1439
202104,48730,경상남도,함안군,10-14세,3002,1568,1434
202105,48730,경상남도,함안군,10-14세,3006,1559,1447
202106,48730,경상남도,함안군,10-14세,3005,1552,1453
202007,48730,경상남도,함안군,15-19세,3006,1637,1369
202008,48730,경상남도,함안군,15-19세,3025,1641,1384
202009,48730,경상남도,함안군,15-19세,3010,1628,1382
202010,48730,경상남도,함안군,15-19세,2990,1610,1380
202011,48730,경상남도,함안군,15-19세,2966,1603,1363
202012,48730,경상남도,함안군,15-19세,2920,1575,1345
202101,48730,경상남도,함안군,15-19세,2950,1597,1353
202102,48730,경상남도,함안군,15-19세,2946,1605,1341
202103,48730,경상남도,함안군,15-19세,2904,1577,1327
202104,48730,경상남도,함안군,15-19세,2883,1567,1316
202105,48730,경상남도,함안군,15-19세,2860,1546,1314
202106,48730,경상남도,함안군,15-19세,2852,1542,1310
202007,48730,경상남도,함안군,20-24세,2959,1696,1263
202008,48730,경상남도,함안군,20-24세,2945,1705,1240
202009,48730,경상남도,함안군,20-24세,2955,1706,1249
202010,48730,경상남도,함안군,20-24세,2964,1708,1256
202011,48730,경상남도,함안군,20-24세,2955,1692,1263
202012,48730,경상남도,함안군,20-24세,2957,1693,1264
202101,48730,경상남도,함안군,20-24세,2916,1661,1255
202102,48730,경상남도,함안군,20-24세,2870,1639,1231
202103,48730,경상남도,함안군,20-24세,2833,1624,1209
202104,48730,경상남도,함안군,20-24세,2832,1628,1204
202105,48730,경상남도,함안군,20-24세,2800,1610,1190
202106,48730,경상남도,함안군,20-24세,2784,1601,1183
202007,48730,경상남도,함안군,25-29세,2597,1523,1074
202008,48730,경상남도,함안군,25-29세,2562,1506,1056
202009,48730,경상남도,함안군,25-29세,2542,1491,1051
202010,48730,경상남도,함안군,25-29세,2549,1502,1047
202011,48730,경상남도,함안군,25-29세,2573,1518,1055
202012,48730,경상남도,함안군,25-29세,2566,1528,1038
202101,48730,경상남도,함안군,25-29세,2559,1535,1024
202102,48730,경상남도,함안군,25-29세,2542,1515,1027
202103,48730,경상남도,함안군,25-29세,2540,1519,1021
202104,48730,경상남도,함안군,25-29세,2506,1501,1005
202105,48730,경상남도,함안군,25-29세,2492,1492,1000
202106,48730,경상남도,함안군,25-29세,2482,1479,1003
202007,48730,경상남도,함안군,30-34세,2423,1253,1170
202008,48730,경상남도,함안군,30-34세,2409,1243,1166
202009,48730,경상남도,함안군,30-34세,2385,1234,1151
202010,48730,경상남도,함안군,30-34세,2361,1224,1137
202011,48730,경상남도,함안군,30-34세,2358,1237,1121
202012,48730,경상남도,함안군,30-34세,2342,1231,1111
202101,48730,경상남도,함안군,30-34세,2315,1213,1102
202102,48730,경상남도,함안군,30-34세,2295,1213,1082
202103,48730,경상남도,함안군,30-34세,2268,1194,1074
202104,48730,경상남도,함안군,30-34세,2246,1190,1056
202105,48730,경상남도,함안군,30-34세,2224,1180,1044
202106,48730,경상남도,함안군,30-34세,2207,1167,1040
202007,48730,경상남도,함안군,35-39세,3475,1750,1725
202008,48730,경상남도,함안군,35-39세,3432,1731,1701
202009,48730,경상남도,함안군,35-39세,3386,1705,1681
202010,48730,경상남도,함안군,35-39세,3360,1688,1672
202011,48730,경상남도,함안군,35-39세,3301,1649,1652
202012,48730,경상남도,함안군,35-39세,3273,1633,1640
202101,48730,경상남도,함안군,35-39세,3220,1607,1613
202102,48730,경상남도,함안군,35-39세,3161,1581,1580
202103,48730,경상남도,함안군,35-39세,3117,1557,1560
202104,48730,경상남도,함안군,35-39세,3089,1539,1550
202105,48730,경상남도,함안군,35-39세,3064,1525,1539
202106,48730,경상남도,함안군,35-39세,3030,1510,1520
202007,48730,경상남도,함안군,40-44세,4293,2272,2021
202008,48730,경상남도,함안군,40-44세,4285,2259,2026
202009,48730,경상남도,함안군,40-44세,4292,2262,2030
202010,48730,경상남도,함안군,40-44세,4286,2260,2026
202011,48730,경상남도,함안군,40-44세,4314,2268,2046
202012,48730,경상남도,함안군,40-44세,4318,2274,2044
202101,48730,경상남도,함안군,40-44세,4298,2256,2042
202102,48730,경상남도,함안군,40-44세,4290,2256,2034
202103,48730,경상남도,함안군,40-44세,4246,2225,2021
202104,48730,경상남도,함안군,40-44세,4235,2217,2018
202105,48730,경상남도,함안군,40-44세,4211,2216,1995
202106,48730,경상남도,함안군,40-44세,4203,2216,1987
202007,48730,경상남도,함안군,45-49세,5215,2897,2318
202008,48730,경상남도,함안군,45-49세,5186,2882,2304
202009,48730,경상남도,함안군,45-49세,5155,2877,2278
202010,48730,경상남도,함안군,45-49세,5143,2865,2278
202011,48730,경상남도,함안군,45-49세,5104,2846,2258
202012,48730,경상남도,함안군,45-49세,5068,2809,2259
202101,48730,경상남도,함안군,45-49세,5056,2807,2249
202102,48730,경상남도,함안군,45-49세,5041,2784,2257
202103,48730,경상남도,함안군,45-49세,4992,2763,2229
202104,48730,경상남도,함안군,45-49세,4958,2747,2211
202105,48730,경상남도,함안군,45-49세,4902,2706,2196
202106,48730,경상남도,함안군,45-49세,4881,2692,2189
202007,48730,경상남도,함안군,50-54세,5508,3066,2442
202008,48730,경상남도,함안군,50-54세,5514,3069,2445
202009,48730,경상남도,함안군,50-54세,5524,3071,2453
202010,48730,경상남도,함안군,50-54세,5515,3091,2424
202011,48730,경상남도,함안군,50-54세,5525,3101,2424
202012,48730,경상남도,함안군,50-54세,5523,3112,2411
202101,48730,경상남도,함안군,50-54세,5519,3108,2411
202102,48730,경상남도,함안군,50-54세,5501,3094,2407
202103,48730,경상남도,함안군,50-54세,5488,3077,2411
202104,48730,경상남도,함안군,50-54세,5469,3066,2403
202105,48730,경상남도,함안군,50-54세,5441,3057,2384
202106,48730,경상남도,함안군,50-54세,5455,3061,2394
202007,48730,경상남도,함안군,55-59세,5868,3176,2692
202008,48730,경상남도,함안군,55-59세,5838,3156,2682
202009,48730,경상남도,함안군,55-59세,5831,3148,2683
202010,48730,경상남도,함안군,55-59세,5803,3124,2679
202011,48730,경상남도,함안군,55-59세,5761,3079,2682
202012,48730,경상남도,함안군,55-59세,5746,3073,2673
202101,48730,경상남도,함안군,55-59세,5691,3051,2640
202102,48730,경상남도,함안군,55-59세,5694,3063,2631
202103,48730,경상남도,함안군,55-59세,5708,3077,2631
202104,48730,경상남도,함안군,55-59세,5678,3076,2602
202105,48730,경상남도,함안군,55-59세,5645,3068,2577
202106,48730,경상남도,함안군,55-59세,5600,3052,2548
202007,48730,경상남도,함안군,60-64세,6130,3227,2903
202008,48730,경상남도,함안군,60-64세,6156,3245,2911
202009,48730,경상남도,함안군,60-64세,6185,3263,2922
202010,48730,경상남도,함안군,60-64세,6218,3273,2945
202011,48730,경상남도,함안군,60-64세,6233,3293,2940
202012,48730,경상남도,함안군,60-64세,6266,3311,2955
202101,48730,경상남도,함안군,60-64세,6289,3316,2973
202102,48730,경상남도,함안군,60-64세,6313,3332,2981
202103,48730,경상남도,함안군,60-64세,6347,3357,2990
202104,48730,경상남도,함안군,60-64세,6379,3371,3008
202105,48730,경상남도,함안군,60-64세,6377,3368,3009
202106,48730,경상남도,함안군,60-64세,6425,3392,3033
202007,48730,경상남도,함안군,65-69세,4588,2310,2278
202008,48730,경상남도,함안군,65-69세,4632,2333,2299
202009,48730,경상남도,함안군,65-69세,4669,2358,2311
202010,48730,경상남도,함안군,65-69세,4697,2379,2318
202011,48730,경상남도,함안군,65-69세,4718,2386,2332
202012,48730,경상남도,함안군,65-69세,4760,2410,2350
202101,48730,경상남도,함안군,65-69세,4832,2439,2393
202102,48730,경상남도,함안군,65-69세,4877,2456,2421
202103,48730,경상남도,함안군,65-69세,4905,2472,2433
202104,48730,경상남도,함안군,65-69세,4957,2512,2445
202105,48730,경상남도,함안군,65-69세,4985,2536,2449
202106,48730,경상남도,함안군,65-69세,5009,2548,2461
202007,48730,경상남도,함안군,70-74세,3506,1704,1802
202008,48730,경상남도,함안군,70-74세,3517,1714,1803
202009,48730,경상남도,함안군,70-74세,3541,1733,1808
202010,48730,경상남도,함안군,70-74세,3560,1741,1819
202011,48730,경상남도,함안군,70-74세,3597,1768,1829
202012,48730,경상남도,함안군,70-74세,3642,1790,1852
202101,48730,경상남도,함안군,70-74세,3671,1807,1864
202102,48730,경상남도,함안군,70-74세,3694,1825,1869
202103,48730,경상남도,함안군,70-74세,3701,1831,1870
202104,48730,경상남도,함안군,70-74세,3722,1839,1883
202105,48730,경상남도,함안군,70-74세,3719,1842,1877
202106,48730,경상남도,함안군,70-74세,3725,1851,1874
202007,48730,경상남도,함안군,75-79세,3200,1200,2000
202008,48730,경상남도,함안군,75-79세,3190,1203,1987
202009,48730,경상남도,함안군,75-79세,3159,1189,1970
202010,48730,경상남도,함안군,75-79세,3131,1181,1950
202011,48730,경상남도,함안군,75-79세,3097,1171,1926
202012,48730,경상남도,함안군,75-79세,3051,1161,1890
202101,48730,경상남도,함안군,75-79세,3003,1151,1852
202102,48730,경상남도,함안군,75-79세,2952,1134,1818
202103,48730,경상남도,함안군,75-79세,2950,1133,1817
202104,48730,경상남도,함안군,75-79세,2932,1137,1795
202105,48730,경상남도,함안군,75-79세,2925,1138,1787
202106,48730,경상남도,함안군,75-79세,2920,1139,1781
202007,48730,경상남도,함안군,80-84세,2556,846,1710
202008,48730,경상남도,함안군,80-84세,2570,845,1725
202009,48730,경상남도,함안군,80-84세,2576,851,1725
202010,48730,경상남도,함안군,80-84세,2578,841,1737
202011,48730,경상남도,함안군,80-84세,2591,839,1752
202012,48730,경상남도,함안군,80-84세,2616,842,1774
202101,48730,경상남도,함안군,80-84세,2632,846,1786
202102,48730,경상남도,함안군,80-84세,2650,852,1798
202103,48730,경상남도,함안군,80-84세,2678,870,1808
202104,48730,경상남도,함안군,80-84세,2687,864,1823
202105,48730,경상남도,함안군,80-84세,2687,857,1830
202106,48730,경상남도,함안군,80-84세,2686,856,1830
202007,48730,경상남도,함안군,85-89세,1434,356,1078
202008,48730,경상남도,함안군,85-89세,1438,359,1079
202009,48730,경상남도,함안군,85-89세,1447,359,1088
202010,48730,경상남도,함안군,85-89세,1457,365,1092
202011,48730,경상남도,함안군,85-89세,1453,368,1085
202012,48730,경상남도,함안군,85-89세,1457,374,1083
202101,48730,경상남도,함안군,85-89세,1478,379,1099
202102,48730,경상남도,함안군,85-89세,1500,388,1112
202103,48730,경상남도,함안군,85-89세,1500,387,1113
202104,48730,경상남도,함안군,85-89세,1518,399,1119
202105,48730,경상남도,함안군,85-89세,1504,400,1104
202106,48730,경상남도,함안군,85-89세,1504,403,1101
202007,48730,경상남도,함안군,90-94세,464,95,369
202008,48730,경상남도,함안군,90-94세,461,96,365
202009,48730,경상남도,함안군,90-94세,470,96,374
202010,48730,경상남도,함안군,90-94세,469,96,373
202011,48730,경상남도,함안군,90-94세,476,96,380
202012,48730,경상남도,함안군,90-94세,477,94,383
202101,48730,경상남도,함안군,90-94세,480,92,388
202102,48730,경상남도,함안군,90-94세,479,92,387
202103,48730,경상남도,함안군,90-94세,483,95,388
202104,48730,경상남도,함안군,90-94세,502,97,405
202105,48730,경상남도,함안군,90-94세,499,91,408
202106,48730,경상남도,함안군,90-94세,502,92,410
202007,48730,경상남도,함안군,95-99세,70,17,53
202008,48730,경상남도,함안군,95-99세,71,15,56
202009,48730,경상남도,함안군,95-99세,72,15,57
202010,48730,경상남도,함안군,95-99세,68,14,54
202011,48730,경상남도,함안군,95-99세,67,14,53
202012,48730,경상남도,함안군,95-99세,69,15,54
202101,48730,경상남도,함안군,95-99세,71,17,54
202102,48730,경상남도,함안군,95-99세,75,16,59
202103,48730,경상남도,함안군,95-99세,80,17,63
202104,48730,경상남도,함안군,95-99세,81,16,65
202105,48730,경상남도,함안군,95-99세,76,15,61
202106,48730,경상남도,함안군,95-99세,80,17,63
202007,48730,경상남도,함안군,100+,11,3,8
202008,48730,경상남도,함안군,100+,11,3,8
202009,48730,경상남도,함안군,100+,11,3,8
202010,48730,경상남도,함안군,100+,13,4,9
202011,48730,경상남도,함안군,100+,13,4,9
202012,48730,경상남도,함안군,100+,14,4,10
202101,48730,경상남도,함안군,100+,14,4,10
202102,48730,경상남도,함안군,100+,14,5,9
202103,48730,경상남도,함안군,100+,14,5,9
202104,48730,경상남도,함안군,100+,13,4,9
202105,48730,경상남도,함안군,100+,9,3,6
202106,48730,경상남도,함안군,100+,8,3,5
202007,48740,경상남도,창녕군,0-4세,1515,787,728
202008,48740,경상남도,창녕군,0-4세,1499,784,715
202009,48740,경상남도,창녕군,0-4세,1469,765,704
202010,48740,경상남도,창녕군,0-4세,1449,754,695
202011,48740,경상남도,창녕군,0-4세,1411,737,674
202012,48740,경상남도,창녕군,0-4세,1383,725,658
202101,48740,경상남도,창녕군,0-4세,1365,718,647
202102,48740,경상남도,창녕군,0-4세,1343,703,640
202103,48740,경상남도,창녕군,0-4세,1308,685,623
202104,48740,경상남도,창녕군,0-4세,1301,681,620
202105,48740,경상남도,창녕군,0-4세,1301,681,620
202106,48740,경상남도,창녕군,0-4세,1276,667,609
202007,48740,경상남도,창녕군,5-9세,1888,976,912
202008,48740,경상남도,창녕군,5-9세,1881,972,909
202009,48740,경상남도,창녕군,5-9세,1880,968,912
202010,48740,경상남도,창녕군,5-9세,1867,968,899
202011,48740,경상남도,창녕군,5-9세,1840,953,887
202012,48740,경상남도,창녕군,5-9세,1830,945,885
202101,48740,경상남도,창녕군,5-9세,1827,943,884
202102,48740,경상남도,창녕군,5-9세,1835,946,889
202103,48740,경상남도,창녕군,5-9세,1827,944,883
202104,48740,경상남도,창녕군,5-9세,1816,939,877
202105,48740,경상남도,창녕군,5-9세,1798,930,868
202106,48740,경상남도,창녕군,5-9세,1784,921,863
202007,48740,경상남도,창녕군,10-14세,1876,1017,859
202008,48740,경상남도,창녕군,10-14세,1878,1012,866
202009,48740,경상남도,창녕군,10-14세,1874,1009,865
202010,48740,경상남도,창녕군,10-14세,1889,1014,875
202011,48740,경상남도,창녕군,10-14세,1883,1012,871
202012,48740,경상남도,창녕군,10-14세,1897,1021,876
202101,48740,경상남도,창녕군,10-14세,1920,1033,887
202102,48740,경상남도,창녕군,10-14세,1921,1047,874
202103,48740,경상남도,창녕군,10-14세,1911,1041,870
202104,48740,경상남도,창녕군,10-14세,1905,1036,869
202105,48740,경상남도,창녕군,10-14세,1922,1044,878
202106,48740,경상남도,창녕군,10-14세,1931,1046,885
202007,48740,경상남도,창녕군,15-19세,2326,1255,1071
202008,48740,경상남도,창녕군,15-19세,2314,1251,1063
202009,48740,경상남도,창녕군,15-19세,2271,1229,1042
202010,48740,경상남도,창녕군,15-19세,2255,1224,1031
202011,48740,경상남도,창녕군,15-19세,2249,1217,1032
202012,48740,경상남도,창녕군,15-19세,2221,1199,1022
202101,48740,경상남도,창녕군,15-19세,2320,1243,1077
202102,48740,경상남도,창녕군,15-19세,2311,1254,1057
202103,48740,경상남도,창녕군,15-19세,2277,1241,1036
202104,48740,경상남도,창녕군,15-19세,2244,1214,1030
202105,48740,경상남도,창녕군,15-19세,2236,1200,1036
202106,48740,경상남도,창녕군,15-19세,2230,1199,1031
202007,48740,경상남도,창녕군,20-24세,2596,1487,1109
202008,48740,경상남도,창녕군,20-24세,2561,1465,1096
202009,48740,경상남도,창녕군,20-24세,2557,1456,1101
202010,48740,경상남도,창녕군,20-24세,2553,1457,1096
202011,48740,경상남도,창녕군,20-24세,2551,1451,1100
202012,48740,경상남도,창녕군,20-24세,2515,1444,1071
202101,48740,경상남도,창녕군,20-24세,2464,1417,1047
202102,48740,경상남도,창녕군,20-24세,2459,1411,1048
202103,48740,경상남도,창녕군,20-24세,2409,1381,1028
202104,48740,경상남도,창녕군,20-24세,2404,1377,1027
202105,48740,경상남도,창녕군,20-24세,2398,1380,1018
202106,48740,경상남도,창녕군,20-24세,2396,1372,1024
202007,48740,경상남도,창녕군,25-29세,2423,1402,1021
202008,48740,경상남도,창녕군,25-29세,2420,1406,1014
202009,48740,경상남도,창녕군,25-29세,2389,1397,992
202010,48740,경상남도,창녕군,25-29세,2402,1393,1009
202011,48740,경상남도,창녕군,25-29세,2409,1408,1001
202012,48740,경상남도,창녕군,25-29세,2414,1393,1021
202101,48740,경상남도,창녕군,25-29세,2406,1381,1025
202102,48740,경상남도,창녕군,25-29세,2373,1363,1010
202103,48740,경상남도,창녕군,25-29세,2354,1362,992
202104,48740,경상남도,창녕군,25-29세,2333,1354,979
202105,48740,경상남도,창녕군,25-29세,2332,1364,968
202106,48740,경상남도,창녕군,25-29세,2300,1338,962
202007,48740,경상남도,창녕군,30-34세,2305,1323,982
202008,48740,경상남도,창녕군,30-34세,2294,1313,981
202009,48740,경상남도,창녕군,30-34세,2304,1316,988
202010,48740,경상남도,창녕군,30-34세,2317,1319,998
202011,48740,경상남도,창녕군,30-34세,2277,1290,987
202012,48740,경상남도,창녕군,30-34세,2263,1292,971
202101,48740,경상남도,창녕군,30-34세,2267,1299,968
202102,48740,경상남도,창녕군,30-34세,2246,1285,961
202103,48740,경상남도,창녕군,30-34세,2242,1281,961
202104,48740,경상남도,창녕군,30-34세,2221,1270,951
202105,48740,경상남도,창녕군,30-34세,2199,1255,944
202106,48740,경상남도,창녕군,30-34세,2198,1254,944
202007,48740,경상남도,창녕군,35-39세,2961,1580,1381
202008,48740,경상남도,창녕군,35-39세,2946,1566,1380
202009,48740,경상남도,창녕군,35-39세,2894,1537,1357
202010,48740,경상남도,창녕군,35-39세,2876,1532,1344
202011,48740,경상남도,창녕군,35-39세,2843,1509,1334
202012,48740,경상남도,창녕군,35-39세,2834,1488,1346
202101,48740,경상남도,창녕군,35-39세,2828,1498,1330
202102,48740,경상남도,창녕군,35-39세,2840,1514,1326
202103,48740,경상남도,창녕군,35-39세,2754,1472,1282
202104,48740,경상남도,창녕군,35-39세,2738,1468,1270
202105,48740,경상남도,창녕군,35-39세,2733,1463,1270
202106,48740,경상남도,창녕군,35-39세,2701,1437,1264
202007,48740,경상남도,창녕군,40-44세,3184,1772,1412
202008,48740,경상남도,창녕군,40-44세,3174,1765,1409
202009,48740,경상남도,창녕군,40-44세,3199,1784,1415
202010,48740,경상남도,창녕군,40-44세,3221,1789,1432
202011,48740,경상남도,창녕군,40-44세,3205,1784,1421
202012,48740,경상남도,창녕군,40-44세,3192,1788,1404
202101,48740,경상남도,창녕군,40-44세,3182,1769,1413
202102,48740,경상남도,창녕군,40-44세,3176,1756,1420
202103,48740,경상남도,창녕군,40-44세,3193,1761,1432
202104,48740,경상남도,창녕군,40-44세,3186,1765,1421
202105,48740,경상남도,창녕군,40-44세,3190,1762,1428
202106,48740,경상남도,창녕군,40-44세,3225,1779,1446
202007,48740,경상남도,창녕군,45-49세,3980,2225,1755
202008,48740,경상남도,창녕군,45-49세,3977,2217,1760
202009,48740,경상남도,창녕군,45-49세,3938,2184,1754
202010,48740,경상남도,창녕군,45-49세,3926,2181,1745
202011,48740,경상남도,창녕군,45-49세,3911,2175,1736
202012,48740,경상남도,창녕군,45-49세,3916,2174,1742
202101,48740,경상남도,창녕군,45-49세,3879,2157,1722
202102,48740,경상남도,창녕군,45-49세,3879,2163,1716
202103,48740,경상남도,창녕군,45-49세,3852,2156,1696
202104,48740,경상남도,창녕군,45-49세,3821,2137,1684
202105,48740,경상남도,창녕군,45-49세,3778,2104,1674
202106,48740,경상남도,창녕군,45-49세,3732,2092,1640
202007,48740,경상남도,창녕군,50-54세,5045,2822,2223
202008,48740,경상남도,창녕군,50-54세,5058,2830,2228
202009,48740,경상남도,창녕군,50-54세,5038,2822,2216
202010,48740,경상남도,창녕군,50-54세,5055,2820,2235
202011,48740,경상남도,창녕군,50-54세,5031,2808,2223
202012,48740,경상남도,창녕군,50-54세,5000,2786,2214
202101,48740,경상남도,창녕군,50-54세,5007,2807,2200
202102,48740,경상남도,창녕군,50-54세,4994,2789,2205
202103,48740,경상남도,창녕군,50-54세,4952,2761,2191
202104,48740,경상남도,창녕군,50-54세,4928,2754,2174
202105,48740,경상남도,창녕군,50-54세,4956,2775,2181
202106,48740,경상남도,창녕군,50-54세,4948,2766,2182
202007,48740,경상남도,창녕군,55-59세,6034,3035,2999
202008,48740,경상남도,창녕군,55-59세,6000,3031,2969
202009,48740,경상남도,창녕군,55-59세,5999,3038,2961
202010,48740,경상남도,창녕군,55-59세,5960,3012,2948
202011,48740,경상남도,창녕군,55-59세,5934,3010,2924
202012,48740,경상남도,창녕군,55-59세,5913,3017,2896
202101,48740,경상남도,창녕군,55-59세,5854,2983,2871
202102,48740,경상남도,창녕군,55-59세,5861,3007,2854
202103,48740,경상남도,창녕군,55-59세,5860,3026,2834
202104,48740,경상남도,창녕군,55-59세,5852,3033,2819
202105,48740,경상남도,창녕군,55-59세,5805,3010,2795
202106,48740,경상남도,창녕군,55-59세,5739,2984,2755
202007,48740,경상남도,창녕군,60-64세,6708,3409,3299
202008,48740,경상남도,창녕군,60-64세,6739,3419,3320
202009,48740,경상남도,창녕군,60-64세,6741,3415,3326
202010,48740,경상남도,창녕군,60-64세,6778,3458,3320
202011,48740,경상남도,창녕군,60-64세,6800,3466,3334
202012,48740,경상남도,창녕군,60-64세,6818,3468,3350
202101,48740,경상남도,창녕군,60-64세,6851,3480,3371
202102,48740,경상남도,창녕군,60-64세,6858,3465,3393
202103,48740,경상남도,창녕군,60-64세,6870,3452,3418
202104,48740,경상남도,창녕군,60-64세,6875,3448,3427
202105,48740,경상남도,창녕군,60-64세,6960,3500,3460
202106,48740,경상남도,창녕군,60-64세,6988,3519,3469
202007,48740,경상남도,창녕군,65-69세,5113,2510,2603
202008,48740,경상남도,창녕군,65-69세,5121,2512,2609
202009,48740,경상남도,창녕군,65-69세,5177,2535,2642
202010,48740,경상남도,창녕군,65-69세,5248,2569,2679
202011,48740,경상남도,창녕군,65-69세,5295,2581,2714
202012,48740,경상남도,창녕군,65-69세,5353,2622,2731
202101,48740,경상남도,창녕군,65-69세,5369,2629,2740
202102,48740,경상남도,창녕군,65-69세,5405,2645,2760
202103,48740,경상남도,창녕군,65-69세,5442,2679,2763
202104,48740,경상남도,창녕군,65-69세,5473,2698,2775
202105,48740,경상남도,창녕군,65-69세,5488,2702,2786
202106,48740,경상남도,창녕군,65-69세,5494,2710,2784
202007,48740,경상남도,창녕군,70-74세,4097,1956,2141
202008,48740,경상남도,창녕군,70-74세,4142,1977,2165
202009,48740,경상남도,창녕군,70-74세,4177,1998,2179
202010,48740,경상남도,창녕군,70-74세,4224,2014,2210
202011,48740,경상남도,창녕군,70-74세,4252,2037,2215
202012,48740,경상남도,창녕군,70-74세,4270,2045,2225
202101,48740,경상남도,창녕군,70-74세,4315,2075,2240
202102,48740,경상남도,창녕군,70-74세,4326,2089,2237
202103,48740,경상남도,창녕군,70-74세,4312,2082,2230
202104,48740,경상남도,창녕군,70-74세,4353,2090,2263
202105,48740,경상남도,창녕군,70-74세,4361,2100,2261
202106,48740,경상남도,창녕군,70-74세,4373,2102,2271
202007,48740,경상남도,창녕군,75-79세,3989,1502,2487
202008,48740,경상남도,창녕군,75-79세,3968,1502,2466
202009,48740,경상남도,창녕군,75-79세,3937,1484,2453
202010,48740,경상남도,창녕군,75-79세,3905,1481,2424
202011,48740,경상남도,창녕군,75-79세,3862,1467,2395
202012,48740,경상남도,창녕군,75-79세,3816,1454,2362
202101,48740,경상남도,창녕군,75-79세,3763,1433,2330
202102,48740,경상남도,창녕군,75-79세,3712,1420,2292
202103,48740,경상남도,창녕군,75-79세,3741,1439,2302
202104,48740,경상남도,창녕군,75-79세,3698,1422,2276
202105,48740,경상남도,창녕군,75-79세,3697,1425,2272
202106,48740,경상남도,창녕군,75-79세,3651,1401,2250
202007,48740,경상남도,창녕군,80-84세,3190,1026,2164
202008,48740,경상남도,창녕군,80-84세,3192,1024,2168
202009,48740,경상남도,창녕군,80-84세,3193,1025,2168
202010,48740,경상남도,창녕군,80-84세,3191,1020,2171
202011,48740,경상남도,창녕군,80-84세,3189,1018,2171
202012,48740,경상남도,창녕군,80-84세,3181,1019,2162
202101,48740,경상남도,창녕군,80-84세,3183,1023,2160
202102,48740,경상남도,창녕군,80-84세,3219,1034,2185
202103,48740,경상남도,창녕군,80-84세,3234,1051,2183
202104,48740,경상남도,창녕군,80-84세,3261,1080,2181
202105,48740,경상남도,창녕군,80-84세,3272,1079,2193
202106,48740,경상남도,창녕군,80-84세,3265,1083,2182
202007,48740,경상남도,창녕군,85-89세,1747,449,1298
202008,48740,경상남도,창녕군,85-89세,1753,448,1305
202009,48740,경상남도,창녕군,85-89세,1765,459,1306
202010,48740,경상남도,창녕군,85-89세,1768,457,1311
202011,48740,경상남도,창녕군,85-89세,1777,459,1318
202012,48740,경상남도,창녕군,85-89세,1797,463,1334
202101,48740,경상남도,창녕군,85-89세,1816,473,1343
202102,48740,경상남도,창녕군,85-89세,1836,474,1362
202103,48740,경상남도,창녕군,85-89세,1846,477,1369
202104,48740,경상남도,창녕군,85-89세,1850,475,1375
202105,48740,경상남도,창녕군,85-89세,1846,474,1372
202106,48740,경상남도,창녕군,85-89세,1836,463,1373
202007,48740,경상남도,창녕군,90-94세,559,98,461
202008,48740,경상남도,창녕군,90-94세,565,101,464
202009,48740,경상남도,창녕군,90-94세,568,102,466
202010,48740,경상남도,창녕군,90-94세,567,101,466
202011,48740,경상남도,창녕군,90-94세,571,101,470
202012,48740,경상남도,창녕군,90-94세,577,98,479
202101,48740,경상남도,창녕군,90-94세,576,96,480
202102,48740,경상남도,창녕군,90-94세,581,97,484
202103,48740,경상남도,창녕군,90-94세,591,99,492
202104,48740,경상남도,창녕군,90-94세,592,97,495
202105,48740,경상남도,창녕군,90-94세,594,103,491
202106,48740,경상남도,창녕군,90-94세,583,104,479
202007,48740,경상남도,창녕군,95-99세,81,8,73
202008,48740,경상남도,창녕군,95-99세,80,8,72
202009,48740,경상남도,창녕군,95-99세,79,8,71
202010,48740,경상남도,창녕군,95-99세,81,9,72
202011,48740,경상남도,창녕군,95-99세,81,10,71
202012,48740,경상남도,창녕군,95-99세,82,9,73
202101,48740,경상남도,창녕군,95-99세,84,9,75
202102,48740,경상남도,창녕군,95-99세,82,9,73
202103,48740,경상남도,창녕군,95-99세,83,9,74
202104,48740,경상남도,창녕군,95-99세,86,11,75
202105,48740,경상남도,창녕군,95-99세,92,12,80
202106,48740,경상남도,창녕군,95-99세,90,10,80
202007,48740,경상남도,창녕군,100+,29,2,27
202008,48740,경상남도,창녕군,100+,28,2,26
202009,48740,경상남도,창녕군,100+,29,2,27
202010,48740,경상남도,창녕군,100+,29,2,27
202011,48740,경상남도,창녕군,100+,29,2,27
202012,48740,경상남도,창녕군,100+,29,2,27
202101,48740,경상남도,창녕군,100+,29,2,27
202102,48740,경상남도,창녕군,100+,29,2,27
202103,48740,경상남도,창녕군,100+,14,0,14
202104,48740,경상남도,창녕군,100+,14,0,14
202105,48740,경상남도,창녕군,100+,14,0,14
202106,48740,경상남도,창녕군,100+,14,0,14
202007,48820,경상남도,고성군,0-4세,957,502,455
202008,48820,경상남도,고성군,0-4세,932,492,440
202009,48820,경상남도,고성군,0-4세,925,494,431
202010,48820,경상남도,고성군,0-4세,906,485,421
202011,48820,경상남도,고성군,0-4세,880,468,412
202012,48820,경상남도,고성군,0-4세,870,459,411
202101,48820,경상남도,고성군,0-4세,865,455,410
202102,48820,경상남도,고성군,0-4세,852,445,407
202103,48820,경상남도,고성군,0-4세,842,439,403
202104,48820,경상남도,고성군,0-4세,818,426,392
202105,48820,경상남도,고성군,0-4세,803,411,392
202106,48820,경상남도,고성군,0-4세,799,408,391
202007,48820,경상남도,고성군,5-9세,1756,868,888
202008,48820,경상남도,고성군,5-9세,1761,874,887
202009,48820,경상남도,고성군,5-9세,1751,864,887
202010,48820,경상남도,고성군,5-9세,1741,858,883
202011,48820,경상남도,고성군,5-9세,1712,847,865
202012,48820,경상남도,고성군,5-9세,1700,842,858
202101,48820,경상남도,고성군,5-9세,1682,830,852
202102,48820,경상남도,고성군,5-9세,1667,824,843
202103,48820,경상남도,고성군,5-9세,1653,821,832
202104,48820,경상남도,고성군,5-9세,1641,810,831
202105,48820,경상남도,고성군,5-9세,1626,806,820
202106,48820,경상남도,고성군,5-9세,1610,797,813
202007,48820,경상남도,고성군,10-14세,1899,1026,873
202008,48820,경상남도,고성군,10-14세,1888,1019,869
202009,48820,경상남도,고성군,10-14세,1878,1018,860
202010,48820,경상남도,고성군,10-14세,1888,1025,863
202011,48820,경상남도,고성군,10-14세,1910,1036,874
202012,48820,경상남도,고성군,10-14세,1906,1035,871
202101,48820,경상남도,고성군,10-14세,1904,1041,863
202102,48820,경상남도,고성군,10-14세,1915,1048,867
202103,48820,경상남도,고성군,10-14세,1918,1048,870
202104,48820,경상남도,고성군,10-14세,1914,1050,864
202105,48820,경상남도,고성군,10-14세,1920,1052,868
202106,48820,경상남도,고성군,10-14세,1932,1061,871
202007,48820,경상남도,고성군,15-19세,2224,1225,999
202008,48820,경상남도,고성군,15-19세,2195,1198,997
202009,48820,경상남도,고성군,15-19세,2195,1195,1000
202010,48820,경상남도,고성군,15-19세,2199,1198,1001
202011,48820,경상남도,고성군,15-19세,2238,1228,1010
202012,48820,경상남도,고성군,15-19세,2251,1234,1017
202101,48820,경상남도,고성군,15-19세,2253,1239,1014
202102,48820,경상남도,고성군,15-19세,2215,1217,998
202103,48820,경상남도,고성군,15-19세,2241,1228,1013
202104,48820,경상남도,고성군,15-19세,2252,1232,1020
202105,48820,경상남도,고성군,15-19세,2239,1223,1016
202106,48820,경상남도,고성군,15-19세,2219,1210,1009
202007,48820,경상남도,고성군,20-24세,2210,1288,922
202008,48820,경상남도,고성군,20-24세,2210,1288,922
202009,48820,경상남도,고성군,20-24세,2194,1273,921
202010,48820,경상남도,고성군,20-24세,2188,1266,922
202011,48820,경상남도,고성군,20-24세,2173,1261,912
202012,48820,경상남도,고성군,20-24세,2156,1257,899
202101,48820,경상남도,고성군,20-24세,2136,1238,898
202102,48820,경상남도,고성군,20-24세,2114,1220,894
202103,48820,경상남도,고성군,20-24세,2082,1213,869
202104,48820,경상남도,고성군,20-24세,2071,1215,856
202105,48820,경상남도,고성군,20-24세,2072,1223,849
202106,48820,경상남도,고성군,20-24세,2072,1225,847
202007,48820,경상남도,고성군,25-29세,1764,1059,705
202008,48820,경상남도,고성군,25-29세,1756,1054,702
202009,48820,경상남도,고성군,25-29세,1756,1052,704
202010,48820,경상남도,고성군,25-29세,1760,1056,704
202011,48820,경상남도,고성군,25-29세,1760,1053,707
202012,48820,경상남도,고성군,25-29세,1750,1036,714
202101,48820,경상남도,고성군,25-29세,1767,1046,721
202102,48820,경상남도,고성군,25-29세,1765,1048,717
202103,48820,경상남도,고성군,25-29세,1756,1042,714
202104,48820,경상남도,고성군,25-29세,1746,1036,710
202105,48820,경상남도,고성군,25-29세,1745,1031,714
202106,48820,경상남도,고성군,25-29세,1743,1023,720
202007,48820,경상남도,고성군,30-34세,1593,900,693
202008,48820,경상남도,고성군,30-34세,1594,900,694
202009,48820,경상남도,고성군,30-34세,1566,881,685
202010,48820,경상남도,고성군,30-34세,1549,872,677
202011,48820,경상남도,고성군,30-34세,1543,869,674
202012,48820,경상남도,고성군,30-34세,1539,871,668
202101,48820,경상남도,고성군,30-34세,1523,858,665
202102,48820,경상남도,고성군,30-34세,1489,840,649
202103,48820,경상남도,고성군,30-34세,1485,842,643
202104,48820,경상남도,고성군,30-34세,1497,849,648
202105,48820,경상남도,고성군,30-34세,1481,836,645
202106,48820,경상남도,고성군,30-34세,1475,840,635
202007,48820,경상남도,고성군,35-39세,2490,1344,1146
202008,48820,경상남도,고성군,35-39세,2445,1315,1130
202009,48820,경상남도,고성군,35-39세,2406,1300,1106
202010,48820,경상남도,고성군,35-39세,2380,1280,1100
202011,48820,경상남도,고성군,35-39세,2346,1269,1077
202012,48820,경상남도,고성군,35-39세,2311,1254,1057
202101,48820,경상남도,고성군,35-39세,2303,1246,1057
202102,48820,경상남도,고성군,35-39세,2274,1227,1047
202103,48820,경상남도,고성군,35-39세,2234,1208,1026
202104,48820,경상남도,고성군,35-39세,2197,1192,1005
202105,48820,경상남도,고성군,35-39세,2184,1190,994
202106,48820,경상남도,고성군,35-39세,2166,1175,991
202007,48820,경상남도,고성군,40-44세,2780,1565,1215
202008,48820,경상남도,고성군,40-44세,2781,1559,1222
202009,48820,경상남도,고성군,40-44세,2799,1566,1233
202010,48820,경상남도,고성군,40-44세,2797,1562,1235
202011,48820,경상남도,고성군,40-44세,2786,1555,1231
202012,48820,경상남도,고성군,40-44세,2777,1542,1235
202101,48820,경상남도,고성군,40-44세,2759,1536,1223
202102,48820,경상남도,고성군,40-44세,2748,1522,1226
202103,48820,경상남도,고성군,40-44세,2727,1516,1211
202104,48820,경상남도,고성군,40-44세,2741,1523,1218
202105,48820,경상남도,고성군,40-44세,2745,1523,1222
202106,48820,경상남도,고성군,40-44세,2750,1532,1218
202007,48820,경상남도,고성군,45-49세,3776,2104,1672
202008,48820,경상남도,고성군,45-49세,3742,2090,1652
202009,48820,경상남도,고성군,45-49세,3696,2055,1641
202010,48820,경상남도,고성군,45-49세,3632,2017,1615
202011,48820,경상남도,고성군,45-49세,3628,2016,1612
202012,48820,경상남도,고성군,45-49세,3597,2009,1588
202101,48820,경상남도,고성군,45-49세,3574,1982,1592
202102,48820,경상남도,고성군,45-49세,3564,1989,1575
202103,48820,경상남도,고성군,45-49세,3512,1956,1556
202104,48820,경상남도,고성군,45-49세,3500,1941,1559
202105,48820,경상남도,고성군,45-49세,3461,1924,1537
202106,48820,경상남도,고성군,45-49세,3435,1906,1529
202007,48820,경상남도,고성군,50-54세,4324,2447,1877
202008,48820,경상남도,고성군,50-54세,4335,2454,1881
202009,48820,경상남도,고성군,50-54세,4357,2474,1883
202010,48820,경상남도,고성군,50-54세,4379,2483,1896
202011,48820,경상남도,고성군,50-54세,4386,2480,1906
202012,48820,경상남도,고성군,50-54세,4378,2470,1908
202101,48820,경상남도,고성군,50-54세,4406,2489,1917
202102,48820,경상남도,고성군,50-54세,4389,2470,1919
202103,48820,경상남도,고성군,50-54세,4352,2459,1893
202104,48820,경상남도,고성군,50-54세,4346,2453,1893
202105,48820,경상남도,고성군,50-54세,4380,2468,1912
202106,48820,경상남도,고성군,50-54세,4368,2452,1916
202007,48820,경상남도,고성군,55-59세,4898,2550,2348
202008,48820,경상남도,고성군,55-59세,4879,2535,2344
202009,48820,경상남도,고성군,55-59세,4827,2525,2302
202010,48820,경상남도,고성군,55-59세,4795,2508,2287
202011,48820,경상남도,고성군,55-59세,4771,2508,2263
202012,48820,경상남도,고성군,55-59세,4757,2506,2251
202101,48820,경상남도,고성군,55-59세,4730,2488,2242
202102,48820,경상남도,고성군,55-59세,4734,2500,2234
202103,48820,경상남도,고성군,55-59세,4658,2459,2199
202104,48820,경상남도,고성군,55-59세,4639,2451,2188
202105,48820,경상남도,고성군,55-59세,4606,2435,2171
202106,48820,경상남도,고성군,55-59세,4576,2426,2150
202007,48820,경상남도,고성군,60-64세,5122,2620,2502
202008,48820,경상남도,고성군,60-64세,5134,2636,2498
202009,48820,경상남도,고성군,60-64세,5185,2653,2532
202010,48820,경상남도,고성군,60-64세,5228,2675,2553
202011,48820,경상남도,고성군,60-64세,5246,2685,2561
202012,48820,경상남도,고성군,60-64세,5274,2695,2579
202101,48820,경상남도,고성군,60-64세,5315,2723,2592
202102,48820,경상남도,고성군,60-64세,5357,2741,2616
202103,48820,경상남도,고성군,60-64세,5382,2770,2612
202104,48820,경상남도,고성군,60-64세,5412,2779,2633
202105,48820,경상남도,고성군,60-64세,5440,2794,2646
202106,48820,경상남도,고성군,60-64세,5483,2814,2669
202007,48820,경상남도,고성군,65-69세,4334,2103,2231
202008,48820,경상남도,고성군,65-69세,4371,2112,2259
202009,48820,경상남도,고성군,65-69세,4386,2123,2263
202010,48820,경상남도,고성군,65-69세,4411,2137,2274
202011,48820,경상남도,고성군,65-69세,4436,2145,2291
202012,48820,경상남도,고성군,65-69세,4461,2165,2296
202101,48820,경상남도,고성군,65-69세,4483,2181,2302
202102,48820,경상남도,고성군,65-69세,4484,2171,2313
202103,48820,경상남도,고성군,65-69세,4499,2179,2320
202104,48820,경상남도,고성군,65-69세,4515,2188,2327
202105,48820,경상남도,고성군,65-69세,4535,2196,2339
202106,48820,경상남도,고성군,65-69세,4562,2221,2341
202007,48820,경상남도,고성군,70-74세,3573,1700,1873
202008,48820,경상남도,고성군,70-74세,3566,1703,1863
202009,48820,경상남도,고성군,70-74세,3582,1705,1877
202010,48820,경상남도,고성군,70-74세,3589,1710,1879
202011,48820,경상남도,고성군,70-74세,3604,1716,1888
202012,48820,경상남도,고성군,70-74세,3634,1727,1907
202101,48820,경상남도,고성군,70-74세,3680,1751,1929
202102,48820,경상남도,고성군,70-74세,3716,1781,1935
202103,48820,경상남도,고성군,70-74세,3712,1785,1927
202104,48820,경상남도,고성군,70-74세,3743,1805,1938
202105,48820,경상남도,고성군,70-74세,3748,1807,1941
202106,48820,경상남도,고성군,70-74세,3741,1804,1937
202007,48820,경상남도,고성군,75-79세,3250,1284,1966
202008,48820,경상남도,고성군,75-79세,3236,1276,1960
202009,48820,경상남도,고성군,75-79세,3207,1270,1937
202010,48820,경상남도,고성군,75-79세,3184,1263,1921
202011,48820,경상남도,고성군,75-79세,3139,1241,1898
202012,48820,경상남도,고성군,75-79세,3106,1234,1872
202101,48820,경상남도,고성군,75-79세,3078,1226,1852
202102,48820,경상남도,고성군,75-79세,3070,1218,1852
202103,48820,경상남도,고성군,75-79세,3057,1217,1840
202104,48820,경상남도,고성군,75-79세,3026,1207,1819
202105,48820,경상남도,고성군,75-79세,3020,1205,1815
202106,48820,경상남도,고성군,75-79세,3007,1197,1810
202007,48820,경상남도,고성군,80-84세,2646,885,1761
202008,48820,경상남도,고성군,80-84세,2641,885,1756
202009,48820,경상남도,고성군,80-84세,2649,888,1761
202010,48820,경상남도,고성군,80-84세,2650,885,1765
202011,48820,경상남도,고성군,80-84세,2668,892,1776
202012,48820,경상남도,고성군,80-84세,2654,895,1759
202101,48820,경상남도,고성군,80-84세,2659,895,1764
202102,48820,경상남도,고성군,80-84세,2642,890,1752
202103,48820,경상남도,고성군,80-84세,2640,893,1747
202104,48820,경상남도,고성군,80-84세,2653,902,1751
202105,48820,경상남도,고성군,80-84세,2651,898,1753
202106,48820,경상남도,고성군,80-84세,2660,902,1758
202007,48820,경상남도,고성군,85-89세,1516,384,1132
202008,48820,경상남도,고성군,85-89세,1532,387,1145
202009,48820,경상남도,고성군,85-89세,1539,389,1150
202010,48820,경상남도,고성군,85-89세,1558,395,1163
202011,48820,경상남도,고성군,85-89세,1565,401,1164
202012,48820,경상남도,고성군,85-89세,1588,407,1181
202101,48820,경상남도,고성군,85-89세,1600,418,1182
202102,48820,경상남도,고성군,85-89세,1622,432,1190
202103,48820,경상남도,고성군,85-89세,1618,426,1192
202104,48820,경상남도,고성군,85-89세,1633,430,1203
202105,48820,경상남도,고성군,85-89세,1659,439,1220
202106,48820,경상남도,고성군,85-89세,1665,441,1224
202007,48820,경상남도,고성군,90-94세,525,100,425
202008,48820,경상남도,고성군,90-94세,531,102,429
202009,48820,경상남도,고성군,90-94세,541,105,436
202010,48820,경상남도,고성군,90-94세,540,107,433
202011,48820,경상남도,고성군,90-94세,546,108,438
202012,48820,경상남도,고성군,90-94세,544,104,440
202101,48820,경상남도,고성군,90-94세,546,103,443
202102,48820,경상남도,고성군,90-94세,552,106,446
202103,48820,경상남도,고성군,90-94세,557,104,453
202104,48820,경상남도,고성군,90-94세,551,98,453
202105,48820,경상남도,고성군,90-94세,557,100,457
202106,48820,경상남도,고성군,90-94세,553,101,452
202007,48820,경상남도,고성군,95-99세,83,13,70
202008,48820,경상남도,고성군,95-99세,84,12,72
202009,48820,경상남도,고성군,95-99세,82,13,69
202010,48820,경상남도,고성군,95-99세,85,13,72
202011,48820,경상남도,고성군,95-99세,87,13,74
202012,48820,경상남도,고성군,95-99세,88,14,74
202101,48820,경상남도,고성군,95-99세,89,14,75
202102,48820,경상남도,고성군,95-99세,93,14,79
202103,48820,경상남도,고성군,95-99세,96,15,81
202104,48820,경상남도,고성군,95-99세,100,15,85
202105,48820,경상남도,고성군,95-99세,100,15,85
202106,48820,경상남도,고성군,95-99세,102,14,88
202007,48820,경상남도,고성군,100+,17,4,13
202008,48820,경상남도,고성군,100+,17,4,13
202009,48820,경상남도,고성군,100+,18,4,14
202010,48820,경상남도,고성군,100+,18,4,14
202011,48820,경상남도,고성군,100+,18,4,14
202012,48820,경상남도,고성군,100+,20,4,16
202101,48820,경상남도,고성군,100+,20,4,16
202102,48820,경상남도,고성군,100+,21,4,17
202103,48820,경상남도,고성군,100+,14,1,13
202104,48820,경상남도,고성군,100+,14,1,13
202105,48820,경상남도,고성군,100+,15,2,13
202106,48820,경상남도,고성군,100+,15,2,13
202007,48840,경상남도,남해군,0-4세,611,312,299
202008,48840,경상남도,남해군,0-4세,611,308,303
202009,48840,경상남도,남해군,0-4세,606,306,300
202010,48840,경상남도,남해군,0-4세,600,304,296
202011,48840,경상남도,남해군,0-4세,608,305,303
202012,48840,경상남도,남해군,0-4세,606,311,295
202101,48840,경상남도,남해군,0-4세,597,302,295
202102,48840,경상남도,남해군,0-4세,596,304,292
202103,48840,경상남도,남해군,0-4세,590,294,296
202104,48840,경상남도,남해군,0-4세,583,289,294
202105,48840,경상남도,남해군,0-4세,590,298,292
202106,48840,경상남도,남해군,0-4세,581,292,289
202007,48840,경상남도,남해군,5-9세,983,541,442
202008,48840,경상남도,남해군,5-9세,979,540,439
202009,48840,경상남도,남해군,5-9세,970,531,439
202010,48840,경상남도,남해군,5-9세,969,530,439
202011,48840,경상남도,남해군,5-9세,979,532,447
202012,48840,경상남도,남해군,5-9세,985,530,455
202101,48840,경상남도,남해군,5-9세,989,533,456
202102,48840,경상남도,남해군,5-9세,990,532,458
202103,48840,경상남도,남해군,5-9세,989,528,461
202104,48840,경상남도,남해군,5-9세,978,522,456
202105,48840,경상남도,남해군,5-9세,961,511,450
202106,48840,경상남도,남해군,5-9세,960,505,455
202007,48840,경상남도,남해군,10-14세,1286,682,604
202008,48840,경상남도,남해군,10-14세,1287,679,608
202009,48840,경상남도,남해군,10-14세,1287,684,603
202010,48840,경상남도,남해군,10-14세,1302,704,598
202011,48840,경상남도,남해군,10-14세,1297,703,594
202012,48840,경상남도,남해군,10-14세,1298,707,591
202101,48840,경상남도,남해군,10-14세,1302,717,585
202102,48840,경상남도,남해군,10-14세,1318,728,590
202103,48840,경상남도,남해군,10-14세,1313,729,584
202104,48840,경상남도,남해군,10-14세,1321,737,584
202105,48840,경상남도,남해군,10-14세,1325,742,583
202106,48840,경상남도,남해군,10-14세,1321,741,580
202007,48840,경상남도,남해군,15-19세,1683,905,778
202008,48840,경상남도,남해군,15-19세,1655,882,773
202009,48840,경상남도,남해군,15-19세,1647,873,774
202010,48840,경상남도,남해군,15-19세,1638,863,775
202011,48840,경상남도,남해군,15-19세,1687,896,791
202012,48840,경상남도,남해군,15-19세,1639,863,776
202101,48840,경상남도,남해군,15-19세,1617,851,766
202102,48840,경상남도,남해군,15-19세,1585,835,750
202103,48840,경상남도,남해군,15-19세,1621,858,763
202104,48840,경상남도,남해군,15-19세,1630,874,756
202105,48840,경상남도,남해군,15-19세,1596,854,742
202106,48840,경상남도,남해군,15-19세,1592,854,738
202007,48840,경상남도,남해군,20-24세,1893,1156,737
202008,48840,경상남도,남해군,20-24세,1895,1169,726
202009,48840,경상남도,남해군,20-24세,1890,1168,722
202010,48840,경상남도,남해군,20-24세,1890,1163,727
202011,48840,경상남도,남해군,20-24세,1946,1202,744
202012,48840,경상남도,남해군,20-24세,1952,1207,745
202101,48840,경상남도,남해군,20-24세,1928,1195,733
202102,48840,경상남도,남해군,20-24세,1884,1174,710
202103,48840,경상남도,남해군,20-24세,1851,1147,704
202104,48840,경상남도,남해군,20-24세,1850,1152,698
202105,48840,경상남도,남해군,20-24세,1858,1155,703
202106,48840,경상남도,남해군,20-24세,1841,1146,695
202007,48840,경상남도,남해군,25-29세,1382,835,547
202008,48840,경상남도,남해군,25-29세,1381,836,545
202009,48840,경상남도,남해군,25-29세,1365,831,534
202010,48840,경상남도,남해군,25-29세,1353,828,525
202011,48840,경상남도,남해군,25-29세,1355,831,524
202012,48840,경상남도,남해군,25-29세,1362,833,529
202101,48840,경상남도,남해군,25-29세,1338,815,523
202102,48840,경상남도,남해군,25-29세,1337,815,522
202103,48840,경상남도,남해군,25-29세,1343,818,525
202104,48840,경상남도,남해군,25-29세,1351,824,527
202105,48840,경상남도,남해군,25-29세,1337,822,515
202106,48840,경상남도,남해군,25-29세,1345,823,522
202007,48840,경상남도,남해군,30-34세,1091,592,499
202008,48840,경상남도,남해군,30-34세,1077,582,495
202009,48840,경상남도,남해군,30-34세,1080,576,504
202010,48840,경상남도,남해군,30-34세,1085,572,513
202011,48840,경상남도,남해군,30-34세,1089,580,509
202012,48840,경상남도,남해군,30-34세,1079,576,503
202101,48840,경상남도,남해군,30-34세,1075,571,504
202102,48840,경상남도,남해군,30-34세,1073,567,506
202103,48840,경상남도,남해군,30-34세,1063,562,501
202104,48840,경상남도,남해군,30-34세,1069,562,507
202105,48840,경상남도,남해군,30-34세,1075,564,511
202106,48840,경상남도,남해군,30-34세,1070,564,506
202007,48840,경상남도,남해군,35-39세,1424,722,702
202008,48840,경상남도,남해군,35-39세,1418,725,693
202009,48840,경상남도,남해군,35-39세,1406,723,683
202010,48840,경상남도,남해군,35-39세,1398,715,683
202011,48840,경상남도,남해군,35-39세,1391,710,681
202012,48840,경상남도,남해군,35-39세,1388,703,685
202101,48840,경상남도,남해군,35-39세,1372,700,672
202102,48840,경상남도,남해군,35-39세,1357,690,667
202103,48840,경상남도,남해군,35-39세,1341,685,656
202104,48840,경상남도,남해군,35-39세,1334,683,651
202105,48840,경상남도,남해군,35-39세,1324,680,644
202106,48840,경상남도,남해군,35-39세,1312,676,636
202007,48840,경상남도,남해군,40-44세,1825,966,859
202008,48840,경상남도,남해군,40-44세,1814,953,861
202009,48840,경상남도,남해군,40-44세,1817,954,863
202010,48840,경상남도,남해군,40-44세,1829,961,868
202011,48840,경상남도,남해군,40-44세,1851,972,879
202012,48840,경상남도,남해군,40-44세,1827,951,876
202101,48840,경상남도,남해군,40-44세,1824,954,870
202102,48840,경상남도,남해군,40-44세,1829,963,866
202103,48840,경상남도,남해군,40-44세,1810,964,846
202104,48840,경상남도,남해군,40-44세,1806,958,848
202105,48840,경상남도,남해군,40-44세,1803,957,846
202106,48840,경상남도,남해군,40-44세,1811,960,851
202007,48840,경상남도,남해군,45-49세,2843,1567,1276
202008,48840,경상남도,남해군,45-49세,2826,1557,1269
202009,48840,경상남도,남해군,45-49세,2791,1531,1260
202010,48840,경상남도,남해군,45-49세,2776,1523,1253
202011,48840,경상남도,남해군,45-49세,2766,1517,1249
202012,48840,경상남도,남해군,45-49세,2769,1521,1248
202101,48840,경상남도,남해군,45-49세,2753,1504,1249
202102,48840,경상남도,남해군,45-49세,2752,1491,1261
202103,48840,경상남도,남해군,45-49세,2731,1466,1265
202104,48840,경상남도,남해군,45-49세,2704,1463,1241
202105,48840,경상남도,남해군,45-49세,2703,1459,1244
202106,48840,경상남도,남해군,45-49세,2696,1453,1243
202007,48840,경상남도,남해군,50-54세,3295,1821,1474
202008,48840,경상남도,남해군,50-54세,3313,1833,1480
202009,48840,경상남도,남해군,50-54세,3305,1844,1461
202010,48840,경상남도,남해군,50-54세,3305,1846,1459
202011,48840,경상남도,남해군,50-54세,3306,1841,1465
202012,48840,경상남도,남해군,50-54세,3274,1822,1452
202101,48840,경상남도,남해군,50-54세,3284,1831,1453
202102,48840,경상남도,남해군,50-54세,3274,1838,1436
202103,48840,경상남도,남해군,50-54세,3245,1834,1411
202104,48840,경상남도,남해군,50-54세,3229,1825,1404
202105,48840,경상남도,남해군,50-54세,3234,1822,1412
202106,48840,경상남도,남해군,50-54세,3251,1833,1418
202007,48840,경상남도,남해군,55-59세,4156,2132,2024
202008,48840,경상남도,남해군,55-59세,4122,2098,2024
202009,48840,경상남도,남해군,55-59세,4093,2073,2020
202010,48840,경상남도,남해군,55-59세,4085,2074,2011
202011,48840,경상남도,남해군,55-59세,4070,2080,1990
202012,48840,경상남도,남해군,55-59세,4071,2088,1983
202101,48840,경상남도,남해군,55-59세,4013,2068,1945
202102,48840,경상남도,남해군,55-59세,4003,2069,1934
202103,48840,경상남도,남해군,55-59세,3979,2057,1922
202104,48840,경상남도,남해군,55-59세,3952,2044,1908
202105,48840,경상남도,남해군,55-59세,3920,2042,1878
202106,48840,경상남도,남해군,55-59세,3878,2019,1859
202007,48840,경상남도,남해군,60-64세,4361,2170,2191
202008,48840,경상남도,남해군,60-64세,4387,2194,2193
202009,48840,경상남도,남해군,60-64세,4397,2211,2186
202010,48840,경상남도,남해군,60-64세,4413,2224,2189
202011,48840,경상남도,남해군,60-64세,4437,2236,2201
202012,48840,경상남도,남해군,60-64세,4450,2242,2208
202101,48840,경상남도,남해군,60-64세,4462,2235,2227
202102,48840,경상남도,남해군,60-64세,4489,2249,2240
202103,48840,경상남도,남해군,60-64세,4520,2255,2265
202104,48840,경상남도,남해군,60-64세,4537,2274,2263
202105,48840,경상남도,남해군,60-64세,4583,2302,2281
202106,48840,경상남도,남해군,60-64세,4617,2323,2294
202007,48840,경상남도,남해군,65-69세,3710,1756,1954
202008,48840,경상남도,남해군,65-69세,3750,1787,1963
202009,48840,경상남도,남해군,65-69세,3803,1805,1998
202010,48840,경상남도,남해군,65-69세,3839,1816,2023
202011,48840,경상남도,남해군,65-69세,3840,1811,2029
202012,48840,경상남도,남해군,65-69세,3864,1829,2035
202101,48840,경상남도,남해군,65-69세,3898,1843,2055
202102,48840,경상남도,남해군,65-69세,3898,1843,2055
202103,48840,경상남도,남해군,65-69세,3896,1856,2040
202104,48840,경상남도,남해군,65-69세,3889,1840,2049
202105,48840,경상남도,남해군,65-69세,3888,1840,2048
202106,48840,경상남도,남해군,65-69세,3887,1849,2038
202007,48840,경상남도,남해군,70-74세,3501,1671,1830
202008,48840,경상남도,남해군,70-74세,3492,1663,1829
202009,48840,경상남도,남해군,70-74세,3479,1651,1828
202010,48840,경상남도,남해군,70-74세,3477,1652,1825
202011,48840,경상남도,남해군,70-74세,3507,1672,1835
202012,48840,경상남도,남해군,70-74세,3532,1675,1857
202101,48840,경상남도,남해군,70-74세,3574,1704,1870
202102,48840,경상남도,남해군,70-74세,3580,1703,1877
202103,48840,경상남도,남해군,70-74세,3581,1696,1885
202104,48840,경상남도,남해군,70-74세,3617,1723,1894
202105,48840,경상남도,남해군,70-74세,3631,1726,1905
202106,48840,경상남도,남해군,70-74세,3638,1725,1913
202007,48840,경상남도,남해군,75-79세,3317,1292,2025
202008,48840,경상남도,남해군,75-79세,3299,1285,2014
202009,48840,경상남도,남해군,75-79세,3271,1271,2000
202010,48840,경상남도,남해군,75-79세,3243,1262,1981
202011,48840,경상남도,남해군,75-79세,3196,1252,1944
202012,48840,경상남도,남해군,75-79세,3141,1230,1911
202101,48840,경상남도,남해군,75-79세,3096,1217,1879
202102,48840,경상남도,남해군,75-79세,3057,1206,1851
202103,48840,경상남도,남해군,75-79세,3051,1216,1835
202104,48840,경상남도,남해군,75-79세,3017,1205,1812
202105,48840,경상남도,남해군,75-79세,3023,1215,1808
202106,48840,경상남도,남해군,75-79세,3012,1203,1809
202007,48840,경상남도,남해군,80-84세,2934,973,1961
202008,48840,경상남도,남해군,80-84세,2932,977,1955
202009,48840,경상남도,남해군,80-84세,2934,989,1945
202010,48840,경상남도,남해군,80-84세,2939,988,1951
202011,48840,경상남도,남해군,80-84세,2960,987,1973
202012,48840,경상남도,남해군,80-84세,2974,996,1978
202101,48840,경상남도,남해군,80-84세,2960,994,1966
202102,48840,경상남도,남해군,80-84세,2971,999,1972
202103,48840,경상남도,남해군,80-84세,2981,1007,1974
202104,48840,경상남도,남해군,80-84세,3009,1023,1986
202105,48840,경상남도,남해군,80-84세,3007,1023,1984
202106,48840,경상남도,남해군,80-84세,2996,1027,1969
202007,48840,경상남도,남해군,85-89세,1888,471,1417
202008,48840,경상남도,남해군,85-89세,1902,470,1432
202009,48840,경상남도,남해군,85-89세,1900,471,1429
202010,48840,경상남도,남해군,85-89세,1909,472,1437
202011,48840,경상남도,남해군,85-89세,1905,481,1424
202012,48840,경상남도,남해군,85-89세,1901,473,1428
202101,48840,경상남도,남해군,85-89세,1914,474,1440
202102,48840,경상남도,남해군,85-89세,1926,478,1448
202103,48840,경상남도,남해군,85-89세,1927,479,1448
202104,48840,경상남도,남해군,85-89세,1929,481,1448
202105,48840,경상남도,남해군,85-89세,1925,485,1440
202106,48840,경상남도,남해군,85-89세,1929,482,1447
202007,48840,경상남도,남해군,90-94세,676,135,541
202008,48840,경상남도,남해군,90-94세,672,135,537
202009,48840,경상남도,남해군,90-94세,675,136,539
202010,48840,경상남도,남해군,90-94세,669,136,533
202011,48840,경상남도,남해군,90-94세,666,136,530
202012,48840,경상남도,남해군,90-94세,669,133,536
202101,48840,경상남도,남해군,90-94세,678,135,543
202102,48840,경상남도,남해군,90-94세,691,131,560
202103,48840,경상남도,남해군,90-94세,699,129,570
202104,48840,경상남도,남해군,90-94세,701,131,570
202105,48840,경상남도,남해군,90-94세,719,131,588
202106,48840,경상남도,남해군,90-94세,729,137,592
202007,48840,경상남도,남해군,95-99세,145,11,134
202008,48840,경상남도,남해군,95-99세,151,13,138
202009,48840,경상남도,남해군,95-99세,156,12,144
202010,48840,경상남도,남해군,95-99세,156,12,144
202011,48840,경상남도,남해군,95-99세,160,11,149
202012,48840,경상남도,남해군,95-99세,161,15,146
202101,48840,경상남도,남해군,95-99세,164,16,148
202102,48840,경상남도,남해군,95-99세,164,17,147
202103,48840,경상남도,남해군,95-99세,162,18,144
202104,48840,경상남도,남해군,95-99세,167,18,149
202105,48840,경상남도,남해군,95-99세,174,20,154
202106,48840,경상남도,남해군,95-99세,170,20,150
202007,48840,경상남도,남해군,100+,17,1,16
202008,48840,경상남도,남해군,100+,17,1,16
202009,48840,경상남도,남해군,100+,17,1,16
202010,48840,경상남도,남해군,100+,18,1,17
202011,48840,경상남도,남해군,100+,17,2,15
202012,48840,경상남도,남해군,100+,16,2,14
202101,48840,경상남도,남해군,100+,17,2,15
202102,48840,경상남도,남해군,100+,20,2,18
202103,48840,경상남도,남해군,100+,16,1,15
202104,48840,경상남도,남해군,100+,15,1,14
202105,48840,경상남도,남해군,100+,14,1,13
202106,48840,경상남도,남해군,100+,14,1,13
202007,48850,경상남도,하동군,0-4세,830,405,425
202008,48850,경상남도,하동군,0-4세,820,399,421
202009,48850,경상남도,하동군,0-4세,819,392,427
202010,48850,경상남도,하동군,0-4세,801,382,419
202011,48850,경상남도,하동군,0-4세,786,378,408
202012,48850,경상남도,하동군,0-4세,772,372,400
202101,48850,경상남도,하동군,0-4세,762,370,392
202102,48850,경상남도,하동군,0-4세,752,365,387
202103,48850,경상남도,하동군,0-4세,754,366,388
202104,48850,경상남도,하동군,0-4세,740,367,373
202105,48850,경상남도,하동군,0-4세,731,362,369
202106,48850,경상남도,하동군,0-4세,718,362,356
202007,48850,경상남도,하동군,5-9세,1155,634,521
202008,48850,경상남도,하동군,5-9세,1149,640,509
202009,48850,경상남도,하동군,5-9세,1124,628,496
202010,48850,경상남도,하동군,5-9세,1104,615,489
202011,48850,경상남도,하동군,5-9세,1076,593,483
202012,48850,경상남도,하동군,5-9세,1057,582,475
202101,48850,경상남도,하동군,5-9세,1041,569,472
202102,48850,경상남도,하동군,5-9세,1033,561,472
202103,48850,경상남도,하동군,5-9세,1030,556,474
202104,48850,경상남도,하동군,5-9세,1015,547,468
202105,48850,경상남도,하동군,5-9세,1007,541,466
202106,48850,경상남도,하동군,5-9세,992,530,462
202007,48850,경상남도,하동군,10-14세,1358,716,642
202008,48850,경상남도,하동군,10-14세,1349,712,637
202009,48850,경상남도,하동군,10-14세,1357,723,634
202010,48850,경상남도,하동군,10-14세,1380,741,639
202011,48850,경상남도,하동군,10-14세,1374,740,634
202012,48850,경상남도,하동군,10-14세,1367,732,635
202101,48850,경상남도,하동군,10-14세,1368,733,635
202102,48850,경상남도,하동군,10-14세,1360,739,621
202103,48850,경상남도,하동군,10-14세,1350,732,618
202104,48850,경상남도,하동군,10-14세,1350,730,620
202105,48850,경상남도,하동군,10-14세,1344,725,619
202106,48850,경상남도,하동군,10-14세,1341,723,618
202007,48850,경상남도,하동군,15-19세,1585,855,730
202008,48850,경상남도,하동군,15-19세,1565,834,731
202009,48850,경상남도,하동군,15-19세,1555,824,731
202010,48850,경상남도,하동군,15-19세,1533,812,721
202011,48850,경상남도,하동군,15-19세,1522,802,720
202012,48850,경상남도,하동군,15-19세,1516,814,702
202101,48850,경상남도,하동군,15-19세,1503,808,695
202102,48850,경상남도,하동군,15-19세,1485,796,689
202103,48850,경상남도,하동군,15-19세,1459,796,663
202104,48850,경상남도,하동군,15-19세,1438,785,653
202105,48850,경상남도,하동군,15-19세,1429,782,647
202106,48850,경상남도,하동군,15-19세,1418,774,644
202007,48850,경상남도,하동군,20-24세,2037,1216,821
202008,48850,경상남도,하동군,20-24세,2012,1212,800
202009,48850,경상남도,하동군,20-24세,1979,1195,784
202010,48850,경상남도,하동군,20-24세,1958,1183,775
202011,48850,경상남도,하동군,20-24세,1937,1165,772
202012,48850,경상남도,하동군,20-24세,1921,1150,771
202101,48850,경상남도,하동군,20-24세,1899,1140,759
202102,48850,경상남도,하동군,20-24세,1867,1125,742
202103,48850,경상남도,하동군,20-24세,1841,1114,727
202104,48850,경상남도,하동군,20-24세,1837,1103,734
202105,48850,경상남도,하동군,20-24세,1819,1092,727
202106,48850,경상남도,하동군,20-24세,1815,1085,730
202007,48850,경상남도,하동군,25-29세,1584,930,654
202008,48850,경상남도,하동군,25-29세,1571,926,645
202009,48850,경상남도,하동군,25-29세,1547,913,634
202010,48850,경상남도,하동군,25-29세,1552,929,623
202011,48850,경상남도,하동군,25-29세,1557,932,625
202012,48850,경상남도,하동군,25-29세,1539,914,625
202101,48850,경상남도,하동군,25-29세,1526,908,618
202102,48850,경상남도,하동군,25-29세,1493,890,603
202103,48850,경상남도,하동군,25-29세,1473,868,605
202104,48850,경상남도,하동군,25-29세,1459,863,596
202105,48850,경상남도,하동군,25-29세,1444,854,590
202106,48850,경상남도,하동군,25-29세,1436,860,576
202007,48850,경상남도,하동군,30-34세,1317,756,561
202008,48850,경상남도,하동군,30-34세,1306,758,548
202009,48850,경상남도,하동군,30-34세,1302,754,548
202010,48850,경상남도,하동군,30-34세,1299,749,550
202011,48850,경상남도,하동군,30-34세,1289,750,539
202012,48850,경상남도,하동군,30-34세,1285,755,530
202101,48850,경상남도,하동군,30-34세,1272,744,528
202102,48850,경상남도,하동군,30-34세,1257,727,530
202103,48850,경상남도,하동군,30-34세,1268,737,531
202104,48850,경상남도,하동군,30-34세,1269,735,534
202105,48850,경상남도,하동군,30-34세,1265,729,536
202106,48850,경상남도,하동군,30-34세,1265,726,539
202007,48850,경상남도,하동군,35-39세,1579,850,729
202008,48850,경상남도,하동군,35-39세,1560,832,728
202009,48850,경상남도,하동군,35-39세,1537,818,719
202010,48850,경상남도,하동군,35-39세,1522,809,713
202011,48850,경상남도,하동군,35-39세,1498,799,699
202012,48850,경상남도,하동군,35-39세,1499,799,700
202101,48850,경상남도,하동군,35-39세,1479,780,699
202102,48850,경상남도,하동군,35-39세,1473,783,690
202103,48850,경상남도,하동군,35-39세,1450,773,677
202104,48850,경상남도,하동군,35-39세,1444,768,676
202105,48850,경상남도,하동군,35-39세,1417,751,666
202106,48850,경상남도,하동군,35-39세,1388,737,651
202007,48850,경상남도,하동군,40-44세,2027,1114,913
202008,48850,경상남도,하동군,40-44세,2018,1118,900
202009,48850,경상남도,하동군,40-44세,2011,1119,892
202010,48850,경상남도,하동군,40-44세,1996,1115,881
202011,48850,경상남도,하동군,40-44세,1985,1105,880
202012,48850,경상남도,하동군,40-44세,1957,1088,869
202101,48850,경상남도,하동군,40-44세,1939,1080,859
202102,48850,경상남도,하동군,40-44세,1915,1064,851
202103,48850,경상남도,하동군,40-44세,1897,1047,850
202104,48850,경상남도,하동군,40-44세,1879,1036,843
202105,48850,경상남도,하동군,40-44세,1875,1036,839
202106,48850,경상남도,하동군,40-44세,1863,1027,836
202007,48850,경상남도,하동군,45-49세,3170,1789,1381
202008,48850,경상남도,하동군,45-49세,3132,1757,1375
202009,48850,경상남도,하동군,45-49세,3078,1730,1348
202010,48850,경상남도,하동군,45-49세,3043,1702,1341
202011,48850,경상남도,하동군,45-49세,3028,1699,1329
202012,48850,경상남도,하동군,45-49세,3013,1695,1318
202101,48850,경상남도,하동군,45-49세,3000,1683,1317
202102,48850,경상남도,하동군,45-49세,2970,1663,1307
202103,48850,경상남도,하동군,45-49세,2954,1649,1305
202104,48850,경상남도,하동군,45-49세,2946,1640,1306
202105,48850,경상남도,하동군,45-49세,2924,1631,1293
202106,48850,경상남도,하동군,45-49세,2911,1628,1283
202007,48850,경상남도,하동군,50-54세,3998,2245,1753
202008,48850,경상남도,하동군,50-54세,4008,2251,1757
202009,48850,경상남도,하동군,50-54세,4042,2276,1766
202010,48850,경상남도,하동군,50-54세,4034,2291,1743
202011,48850,경상남도,하동군,50-54세,4005,2263,1742
202012,48850,경상남도,하동군,50-54세,3993,2253,1740
202101,48850,경상남도,하동군,50-54세,3986,2253,1733
202102,48850,경상남도,하동군,50-54세,3948,2244,1704
202103,48850,경상남도,하동군,50-54세,3911,2222,1689
202104,48850,경상남도,하동군,50-54세,3900,2213,1687
202105,48850,경상남도,하동군,50-54세,3901,2208,1693
202106,48850,경상남도,하동군,50-54세,3903,2217,1686
202007,48850,경상남도,하동군,55-59세,4577,2416,2161
202008,48850,경상남도,하동군,55-59세,4555,2408,2147
202009,48850,경상남도,하동군,55-59세,4511,2388,2123
202010,48850,경상남도,하동군,55-59세,4471,2361,2110
202011,48850,경상남도,하동군,55-59세,4466,2356,2110
202012,48850,경상남도,하동군,55-59세,4436,2344,2092
202101,48850,경상남도,하동군,55-59세,4408,2328,2080
202102,48850,경상남도,하동군,55-59세,4392,2330,2062
202103,48850,경상남도,하동군,55-59세,4357,2330,2027
202104,48850,경상남도,하동군,55-59세,4333,2333,2000
202105,48850,경상남도,하동군,55-59세,4292,2303,1989
202106,48850,경상남도,하동군,55-59세,4230,2266,1964
202007,48850,경상남도,하동군,60-64세,4836,2575,2261
202008,48850,경상남도,하동군,60-64세,4822,2571,2251
202009,48850,경상남도,하동군,60-64세,4855,2591,2264
202010,48850,경상남도,하동군,60-64세,4882,2610,2272
202011,48850,경상남도,하동군,60-64세,4918,2633,2285
202012,48850,경상남도,하동군,60-64세,4940,2640,2300
202101,48850,경상남도,하동군,60-64세,4967,2650,2317
202102,48850,경상남도,하동군,60-64세,4993,2654,2339
202103,48850,경상남도,하동군,60-64세,5047,2669,2378
202104,48850,경상남도,하동군,60-64세,5087,2680,2407
202105,48850,경상남도,하동군,60-64세,5126,2709,2417
202106,48850,경상남도,하동군,60-64세,5132,2708,2424
202007,48850,경상남도,하동군,65-69세,3829,1893,1936
202008,48850,경상남도,하동군,65-69세,3891,1925,1966
202009,48850,경상남도,하동군,65-69세,3912,1942,1970
202010,48850,경상남도,하동군,65-69세,3951,1962,1989
202011,48850,경상남도,하동군,65-69세,3957,1973,1984
202012,48850,경상남도,하동군,65-69세,3981,1995,1986
202101,48850,경상남도,하동군,65-69세,3993,2010,1983
202102,48850,경상남도,하동군,65-69세,4017,2019,1998
202103,48850,경상남도,하동군,65-69세,4053,2043,2010
202104,48850,경상남도,하동군,65-69세,4064,2057,2007
202105,48850,경상남도,하동군,65-69세,4059,2061,1998
202106,48850,경상남도,하동군,65-69세,4054,2069,1985
202007,48850,경상남도,하동군,70-74세,3246,1510,1736
202008,48850,경상남도,하동군,70-74세,3235,1506,1729
202009,48850,경상남도,하동군,70-74세,3242,1513,1729
202010,48850,경상남도,하동군,70-74세,3262,1528,1734
202011,48850,경상남도,하동군,70-74세,3270,1531,1739
202012,48850,경상남도,하동군,70-74세,3280,1534,1746
202101,48850,경상남도,하동군,70-74세,3302,1544,1758
202102,48850,경상남도,하동군,70-74세,3336,1565,1771
202103,48850,경상남도,하동군,70-74세,3337,1566,1771
202104,48850,경상남도,하동군,70-74세,3367,1583,1784
202105,48850,경상남도,하동군,70-74세,3396,1600,1796
202106,48850,경상남도,하동군,70-74세,3407,1610,1797
202007,48850,경상남도,하동군,75-79세,3201,1245,1956
202008,48850,경상남도,하동군,75-79세,3182,1234,1948
202009,48850,경상남도,하동군,75-79세,3157,1231,1926
202010,48850,경상남도,하동군,75-79세,3134,1224,1910
202011,48850,경상남도,하동군,75-79세,3109,1228,1881
202012,48850,경상남도,하동군,75-79세,3092,1222,1870
202101,48850,경상남도,하동군,75-79세,3067,1214,1853
202102,48850,경상남도,하동군,75-79세,3021,1199,1822
202103,48850,경상남도,하동군,75-79세,3009,1191,1818
202104,48850,경상남도,하동군,75-79세,2971,1170,1801
202105,48850,경상남도,하동군,75-79세,2955,1168,1787
202106,48850,경상남도,하동군,75-79세,2953,1166,1787
202007,48850,경상남도,하동군,80-84세,2774,910,1864
202008,48850,경상남도,하동군,80-84세,2764,908,1856
202009,48850,경상남도,하동군,80-84세,2772,910,1862
202010,48850,경상남도,하동군,80-84세,2782,911,1871
202011,48850,경상남도,하동군,80-84세,2795,906,1889
202012,48850,경상남도,하동군,80-84세,2785,905,1880
202101,48850,경상남도,하동군,80-84세,2771,912,1859
202102,48850,경상남도,하동군,80-84세,2764,915,1849
202103,48850,경상남도,하동군,80-84세,2766,924,1842
202104,48850,경상남도,하동군,80-84세,2776,934,1842
202105,48850,경상남도,하동군,80-84세,2770,932,1838
202106,48850,경상남도,하동군,80-84세,2774,931,1843
202007,48850,경상남도,하동군,85-89세,1587,415,1172
202008,48850,경상남도,하동군,85-89세,1587,418,1169
202009,48850,경상남도,하동군,85-89세,1589,413,1176
202010,48850,경상남도,하동군,85-89세,1586,412,1174
202011,48850,경상남도,하동군,85-89세,1595,414,1181
202012,48850,경상남도,하동군,85-89세,1599,411,1188
202101,48850,경상남도,하동군,85-89세,1623,411,1212
202102,48850,경상남도,하동군,85-89세,1639,417,1222
202103,48850,경상남도,하동군,85-89세,1642,421,1221
202104,48850,경상남도,하동군,85-89세,1644,421,1223
202105,48850,경상남도,하동군,85-89세,1666,428,1238
202106,48850,경상남도,하동군,85-89세,1671,434,1237
202007,48850,경상남도,하동군,90-94세,590,129,461
202008,48850,경상남도,하동군,90-94세,601,133,468
202009,48850,경상남도,하동군,90-94세,609,136,473
202010,48850,경상남도,하동군,90-94세,604,135,469
202011,48850,경상남도,하동군,90-94세,611,138,473
202012,48850,경상남도,하동군,90-94세,619,143,476
202101,48850,경상남도,하동군,90-94세,630,145,485
202102,48850,경상남도,하동군,90-94세,639,142,497
202103,48850,경상남도,하동군,90-94세,645,143,502
202104,48850,경상남도,하동군,90-94세,656,148,508
202105,48850,경상남도,하동군,90-94세,652,147,505
202106,48850,경상남도,하동군,90-94세,645,141,504
202007,48850,경상남도,하동군,95-99세,108,14,94
202008,48850,경상남도,하동군,95-99세,106,12,94
202009,48850,경상남도,하동군,95-99세,111,12,99
202010,48850,경상남도,하동군,95-99세,116,13,103
202011,48850,경상남도,하동군,95-99세,110,13,97
202012,48850,경상남도,하동군,95-99세,111,12,99
202101,48850,경상남도,하동군,95-99세,114,13,101
202102,48850,경상남도,하동군,95-99세,118,14,104
202103,48850,경상남도,하동군,95-99세,125,14,111
202104,48850,경상남도,하동군,95-99세,131,15,116
202105,48850,경상남도,하동군,95-99세,132,16,116
202106,48850,경상남도,하동군,95-99세,132,17,115
202007,48850,경상남도,하동군,100+,24,4,20
202008,48850,경상남도,하동군,100+,24,4,20
202009,48850,경상남도,하동군,100+,23,4,19
202010,48850,경상남도,하동군,100+,23,4,19
202011,48850,경상남도,하동군,100+,23,4,19
202012,48850,경상남도,하동군,100+,23,4,19
202101,48850,경상남도,하동군,100+,23,4,19
202102,48850,경상남도,하동군,100+,22,5,17
202103,48850,경상남도,하동군,100+,20,5,15
202104,48850,경상남도,하동군,100+,20,5,15
202105,48850,경상남도,하동군,100+,19,5,14
202106,48850,경상남도,하동군,100+,17,4,13
202007,48860,경상남도,산청군,0-4세,648,330,318
202008,48860,경상남도,산청군,0-4세,638,324,314
202009,48860,경상남도,산청군,0-4세,619,313,306
202010,48860,경상남도,산청군,0-4세,595,299,296
202011,48860,경상남도,산청군,0-4세,582,288,294
202012,48860,경상남도,산청군,0-4세,573,282,291
202101,48860,경상남도,산청군,0-4세,574,285,289
202102,48860,경상남도,산청군,0-4세,571,281,290
202103,48860,경상남도,산청군,0-4세,568,281,287
202104,48860,경상남도,산청군,0-4세,559,277,282
202105,48860,경상남도,산청군,0-4세,551,273,278
202106,48860,경상남도,산청군,0-4세,536,266,270
202007,48860,경상남도,산청군,5-9세,770,416,354
202008,48860,경상남도,산청군,5-9세,770,420,350
202009,48860,경상남도,산청군,5-9세,769,423,346
202010,48860,경상남도,산청군,5-9세,769,425,344
202011,48860,경상남도,산청군,5-9세,766,425,341
202012,48860,경상남도,산청군,5-9세,756,415,341
202101,48860,경상남도,산청군,5-9세,742,411,331
202102,48860,경상남도,산청군,5-9세,730,403,327
202103,48860,경상남도,산청군,5-9세,727,403,324
202104,48860,경상남도,산청군,5-9세,722,394,328
202105,48860,경상남도,산청군,5-9세,717,388,329
202106,48860,경상남도,산청군,5-9세,714,386,328
202007,48860,경상남도,산청군,10-14세,1019,562,457
202008,48860,경상남도,산청군,10-14세,1020,560,460
202009,48860,경상남도,산청군,10-14세,1012,557,455
202010,48860,경상남도,산청군,10-14세,1006,553,453
202011,48860,경상남도,산청군,10-14세,992,543,449
202012,48860,경상남도,산청군,10-14세,998,552,446
202101,48860,경상남도,산청군,10-14세,978,542,436
202102,48860,경상남도,산청군,10-14세,988,550,438
202103,48860,경상남도,산청군,10-14세,1006,562,444
202104,48860,경상남도,산청군,10-14세,1004,563,441
202105,48860,경상남도,산청군,10-14세,1004,560,444
202106,48860,경상남도,산청군,10-14세,997,556,441
202007,48860,경상남도,산청군,15-19세,1123,595,528
202008,48860,경상남도,산청군,15-19세,1110,589,521
202009,48860,경상남도,산청군,15-19세,1102,581,521
202010,48860,경상남도,산청군,15-19세,1090,573,517
202011,48860,경상남도,산청군,15-19세,1084,568,516
202012,48860,경상남도,산청군,15-19세,1090,567,523
202101,48860,경상남도,산청군,15-19세,1086,561,525
202102,48860,경상남도,산청군,15-19세,1078,558,520
202103,48860,경상남도,산청군,15-19세,1079,560,519
202104,48860,경상남도,산청군,15-19세,1065,553,512
202105,48860,경상남도,산청군,15-19세,1056,548,508
202106,48860,경상남도,산청군,15-19세,1052,549,503
202007,48860,경상남도,산청군,20-24세,1376,771,605
202008,48860,경상남도,산청군,20-24세,1383,774,609
202009,48860,경상남도,산청군,20-24세,1366,758,608
202010,48860,경상남도,산청군,20-24세,1366,758,608
202011,48860,경상남도,산청군,20-24세,1366,756,610
202012,48860,경상남도,산청군,20-24세,1370,754,616
202101,48860,경상남도,산청군,20-24세,1361,761,600
202102,48860,경상남도,산청군,20-24세,1347,760,587
202103,48860,경상남도,산청군,20-24세,1325,749,576
202104,48860,경상남도,산청군,20-24세,1301,732,569
202105,48860,경상남도,산청군,20-24세,1295,721,574
202106,48860,경상남도,산청군,20-24세,1295,721,574
202007,48860,경상남도,산청군,25-29세,1116,651,465
202008,48860,경상남도,산청군,25-29세,1109,645,464
202009,48860,경상남도,산청군,25-29세,1098,648,450
202010,48860,경상남도,산청군,25-29세,1092,647,445
202011,48860,경상남도,산청군,25-29세,1098,656,442
202012,48860,경상남도,산청군,25-29세,1099,648,451
202101,48860,경상남도,산청군,25-29세,1098,638,460
202102,48860,경상남도,산청군,25-29세,1075,626,449
202103,48860,경상남도,산청군,25-29세,1066,621,445
202104,48860,경상남도,산청군,25-29세,1074,627,447
202105,48860,경상남도,산청군,25-29세,1071,622,449
202106,48860,경상남도,산청군,25-29세,1054,617,437
202007,48860,경상남도,산청군,30-34세,1008,543,465
202008,48860,경상남도,산청군,30-34세,994,533,461
202009,48860,경상남도,산청군,30-34세,988,530,458
202010,48860,경상남도,산청군,30-34세,985,522,463
202011,48860,경상남도,산청군,30-34세,984,518,466
202012,48860,경상남도,산청군,30-34세,965,514,451
202101,48860,경상남도,산청군,30-34세,957,510,447
202102,48860,경상남도,산청군,30-34세,957,510,447
202103,48860,경상남도,산청군,30-34세,947,504,443
202104,48860,경상남도,산청군,30-34세,943,501,442
202105,48860,경상남도,산청군,30-34세,949,503,446
202106,48860,경상남도,산청군,30-34세,947,503,444
202007,48860,경상남도,산청군,35-39세,1247,681,566
202008,48860,경상남도,산청군,35-39세,1225,667,558
202009,48860,경상남도,산청군,35-39세,1204,658,546
202010,48860,경상남도,산청군,35-39세,1194,657,537
202011,48860,경상남도,산청군,35-39세,1166,635,531
202012,48860,경상남도,산청군,35-39세,1162,628,534
202101,48860,경상남도,산청군,35-39세,1159,632,527
202102,48860,경상남도,산청군,35-39세,1140,615,525
202103,48860,경상남도,산청군,35-39세,1141,615,526
202104,48860,경상남도,산청군,35-39세,1136,607,529
202105,48860,경상남도,산청군,35-39세,1117,598,519
202106,48860,경상남도,산청군,35-39세,1102,589,513
202007,48860,경상남도,산청군,40-44세,1423,765,658
202008,48860,경상남도,산청군,40-44세,1431,778,653
202009,48860,경상남도,산청군,40-44세,1436,776,660
202010,48860,경상남도,산청군,40-44세,1442,780,662
202011,48860,경상남도,산청군,40-44세,1457,797,660
202012,48860,경상남도,산청군,40-44세,1445,793,652
202101,48860,경상남도,산청군,40-44세,1439,785,654
202102,48860,경상남도,산청군,40-44세,1441,788,653
202103,48860,경상남도,산청군,40-44세,1421,776,645
202104,48860,경상남도,산청군,40-44세,1426,783,643
202105,48860,경상남도,산청군,40-44세,1417,780,637
202106,48860,경상남도,산청군,40-44세,1420,777,643
202007,48860,경상남도,산청군,45-49세,2138,1213,925
202008,48860,경상남도,산청군,45-49세,2142,1214,928
202009,48860,경상남도,산청군,45-49세,2125,1211,914
202010,48860,경상남도,산청군,45-49세,2107,1204,903
202011,48860,경상남도,산청군,45-49세,2091,1191,900
202012,48860,경상남도,산청군,45-49세,2064,1160,904
202101,48860,경상남도,산청군,45-49세,2047,1147,900
202102,48860,경상남도,산청군,45-49세,2045,1139,906
202103,48860,경상남도,산청군,45-49세,2015,1121,894
202104,48860,경상남도,산청군,45-49세,2004,1113,891
202105,48860,경상남도,산청군,45-49세,1989,1103,886
202106,48860,경상남도,산청군,45-49세,1973,1097,876
202007,48860,경상남도,산청군,50-54세,3072,1689,1383
202008,48860,경상남도,산청군,50-54세,3074,1689,1385
202009,48860,경상남도,산청군,50-54세,3058,1677,1381
202010,48860,경상남도,산청군,50-54세,3055,1670,1385
202011,48860,경상남도,산청군,50-54세,3044,1667,1377
202012,48860,경상남도,산청군,50-54세,3050,1672,1378
202101,48860,경상남도,산청군,50-54세,3032,1651,1381
202102,48860,경상남도,산청군,50-54세,3022,1655,1367
202103,48860,경상남도,산청군,50-54세,2986,1639,1347
202104,48860,경상남도,산청군,50-54세,2956,1625,1331
202105,48860,경상남도,산청군,50-54세,2972,1625,1347
202106,48860,경상남도,산청군,50-54세,2985,1632,1353
202007,48860,경상남도,산청군,55-59세,3599,1887,1712
202008,48860,경상남도,산청군,55-59세,3573,1878,1695
202009,48860,경상남도,산청군,55-59세,3544,1877,1667
202010,48860,경상남도,산청군,55-59세,3523,1872,1651
202011,48860,경상남도,산청군,55-59세,3514,1872,1642
202012,48860,경상남도,산청군,55-59세,3479,1851,1628
202101,48860,경상남도,산청군,55-59세,3472,1861,1611
202102,48860,경상남도,산청군,55-59세,3452,1848,1604
202103,48860,경상남도,산청군,55-59세,3413,1838,1575
202104,48860,경상남도,산청군,55-59세,3416,1837,1579
202105,48860,경상남도,산청군,55-59세,3390,1840,1550
202106,48860,경상남도,산청군,55-59세,3359,1819,1540
202007,48860,경상남도,산청군,60-64세,3873,2002,1871
202008,48860,경상남도,산청군,60-64세,3873,1994,1879
202009,48860,경상남도,산청군,60-64세,3891,1995,1896
202010,48860,경상남도,산청군,60-64세,3912,2011,1901
202011,48860,경상남도,산청군,60-64세,3933,2025,1908
202012,48860,경상남도,산청군,60-64세,3973,2054,1919
202101,48860,경상남도,산청군,60-64세,4005,2067,1938
202102,48860,경상남도,산청군,60-64세,4057,2101,1956
202103,48860,경상남도,산청군,60-64세,4095,2120,1975
202104,48860,경상남도,산청군,60-64세,4123,2137,1986
202105,48860,경상남도,산청군,60-64세,4123,2137,1986
202106,48860,경상남도,산청군,60-64세,4137,2145,1992
202007,48860,경상남도,산청군,65-69세,3189,1637,1552
202008,48860,경상남도,산청군,65-69세,3233,1659,1574
202009,48860,경상남도,산청군,65-69세,3263,1687,1576
202010,48860,경상남도,산청군,65-69세,3281,1697,1584
202011,48860,경상남도,산청군,65-69세,3295,1699,1596
202012,48860,경상남도,산청군,65-69세,3307,1711,1596
202101,48860,경상남도,산청군,65-69세,3337,1724,1613
202102,48860,경상남도,산청군,65-69세,3346,1726,1620
202103,48860,경상남도,산청군,65-69세,3384,1748,1636
202104,48860,경상남도,산청군,65-69세,3423,1767,1656
202105,48860,경상남도,산청군,65-69세,3466,1788,1678
202106,48860,경상남도,산청군,65-69세,3473,1803,1670
202007,48860,경상남도,산청군,70-74세,2638,1292,1346
202008,48860,경상남도,산청군,70-74세,2635,1295,1340
202009,48860,경상남도,산청군,70-74세,2647,1297,1350
202010,48860,경상남도,산청군,70-74세,2666,1301,1365
202011,48860,경상남도,산청군,70-74세,2683,1313,1370
202012,48860,경상남도,산청군,70-74세,2714,1331,1383
202101,48860,경상남도,산청군,70-74세,2724,1335,1389
202102,48860,경상남도,산청군,70-74세,2729,1345,1384
202103,48860,경상남도,산청군,70-74세,2731,1349,1382
202104,48860,경상남도,산청군,70-74세,2739,1365,1374
202105,48860,경상남도,산청군,70-74세,2734,1359,1375
202106,48860,경상남도,산청군,70-74세,2755,1368,1387
202007,48860,경상남도,산청군,75-79세,2695,1015,1680
202008,48860,경상남도,산청군,75-79세,2682,1011,1671
202009,48860,경상남도,산청군,75-79세,2665,1014,1651
202010,48860,경상남도,산청군,75-79세,2639,1005,1634
202011,48860,경상남도,산청군,75-79세,2625,1000,1625
202012,48860,경상남도,산청군,75-79세,2590,991,1599
202101,48860,경상남도,산청군,75-79세,2548,982,1566
202102,48860,경상남도,산청군,75-79세,2529,974,1555
202103,48860,경상남도,산청군,75-79세,2501,965,1536
202104,48860,경상남도,산청군,75-79세,2488,956,1532
202105,48860,경상남도,산청군,75-79세,2468,948,1520
202106,48860,경상남도,산청군,75-79세,2444,945,1499
202007,48860,경상남도,산청군,80-84세,2343,744,1599
202008,48860,경상남도,산청군,80-84세,2327,737,1590
202009,48860,경상남도,산청군,80-84세,2323,736,1587
202010,48860,경상남도,산청군,80-84세,2327,743,1584
202011,48860,경상남도,산청군,80-84세,2328,742,1586
202012,48860,경상남도,산청군,80-84세,2321,739,1582
202101,48860,경상남도,산청군,80-84세,2324,739,1585
202102,48860,경상남도,산청군,80-84세,2330,740,1590
202103,48860,경상남도,산청군,80-84세,2322,742,1580
202104,48860,경상남도,산청군,80-84세,2305,742,1563
202105,48860,경상남도,산청군,80-84세,2316,748,1568
202106,48860,경상남도,산청군,80-84세,2325,746,1579
202007,48860,경상남도,산청군,85-89세,1277,312,965
202008,48860,경상남도,산청군,85-89세,1299,322,977
202009,48860,경상남도,산청군,85-89세,1306,327,979
202010,48860,경상남도,산청군,85-89세,1313,327,986
202011,48860,경상남도,산청군,85-89세,1323,329,994
202012,48860,경상남도,산청군,85-89세,1340,337,1003
202101,48860,경상남도,산청군,85-89세,1359,344,1015
202102,48860,경상남도,산청군,85-89세,1370,353,1017
202103,48860,경상남도,산청군,85-89세,1376,353,1023
202104,48860,경상남도,산청군,85-89세,1398,356,1042
202105,48860,경상남도,산청군,85-89세,1413,358,1055
202106,48860,경상남도,산청군,85-89세,1421,356,1065
202007,48860,경상남도,산청군,90-94세,420,87,333
202008,48860,경상남도,산청군,90-94세,427,90,337
202009,48860,경상남도,산청군,90-94세,436,90,346
202010,48860,경상남도,산청군,90-94세,434,91,343
202011,48860,경상남도,산청군,90-94세,442,90,352
202012,48860,경상남도,산청군,90-94세,440,88,352
202101,48860,경상남도,산청군,90-94세,444,88,356
202102,48860,경상남도,산청군,90-94세,456,89,367
202103,48860,경상남도,산청군,90-94세,464,91,373
202104,48860,경상남도,산청군,90-94세,464,92,372
202105,48860,경상남도,산청군,90-94세,468,95,373
202106,48860,경상남도,산청군,90-94세,477,97,380
202007,48860,경상남도,산청군,95-99세,104,22,82
202008,48860,경상남도,산청군,95-99세,106,22,84
202009,48860,경상남도,산청군,95-99세,107,22,85
202010,48860,경상남도,산청군,95-99세,106,22,84
202011,48860,경상남도,산청군,95-99세,104,21,83
202012,48860,경상남도,산청군,95-99세,103,21,82
202101,48860,경상남도,산청군,95-99세,105,20,85
202102,48860,경상남도,산청군,95-99세,105,19,86
202103,48860,경상남도,산청군,95-99세,105,19,86
202104,48860,경상남도,산청군,95-99세,108,19,89
202105,48860,경상남도,산청군,95-99세,110,20,90
202106,48860,경상남도,산청군,95-99세,106,18,88
202007,48860,경상남도,산청군,100+,19,2,17
202008,48860,경상남도,산청군,100+,20,2,18
202009,48860,경상남도,산청군,100+,19,2,17
202010,48860,경상남도,산청군,100+,19,2,17
202011,48860,경상남도,산청군,100+,18,2,16
202012,48860,경상남도,산청군,100+,18,2,16
202101,48860,경상남도,산청군,100+,18,2,16
202102,48860,경상남도,산청군,100+,20,2,18
202103,48860,경상남도,산청군,100+,14,2,12
202104,48860,경상남도,산청군,100+,14,2,12
202105,48860,경상남도,산청군,100+,15,2,13
202106,48860,경상남도,산청군,100+,15,2,13
202007,48870,경상남도,함양군,0-4세,750,363,387
202008,48870,경상남도,함양군,0-4세,743,365,378
202009,48870,경상남도,함양군,0-4세,729,356,373
202010,48870,경상남도,함양군,0-4세,724,355,369
202011,48870,경상남도,함양군,0-4세,711,352,359
202012,48870,경상남도,함양군,0-4세,710,351,359
202101,48870,경상남도,함양군,0-4세,708,347,361
202102,48870,경상남도,함양군,0-4세,700,346,354
202103,48870,경상남도,함양군,0-4세,697,346,351
202104,48870,경상남도,함양군,0-4세,691,343,348
202105,48870,경상남도,함양군,0-4세,688,343,345
202106,48870,경상남도,함양군,0-4세,692,343,349
202007,48870,경상남도,함양군,5-9세,1116,584,532
202008,48870,경상남도,함양군,5-9세,1112,577,535
202009,48870,경상남도,함양군,5-9세,1113,573,540
202010,48870,경상남도,함양군,5-9세,1106,564,542
202011,48870,경상남도,함양군,5-9세,1099,556,543
202012,48870,경상남도,함양군,5-9세,1094,552,542
202101,48870,경상남도,함양군,5-9세,1077,543,534
202102,48870,경상남도,함양군,5-9세,1066,538,528
202103,48870,경상남도,함양군,5-9세,1069,539,530
202104,48870,경상남도,함양군,5-9세,1067,542,525
202105,48870,경상남도,함양군,5-9세,1069,547,522
202106,48870,경상남도,함양군,5-9세,1059,543,516
202007,48870,경상남도,함양군,10-14세,1412,730,682
202008,48870,경상남도,함양군,10-14세,1409,729,680
202009,48870,경상남도,함양군,10-14세,1408,736,672
202010,48870,경상남도,함양군,10-14세,1409,739,670
202011,48870,경상남도,함양군,10-14세,1411,740,671
202012,48870,경상남도,함양군,10-14세,1403,736,667
202101,48870,경상남도,함양군,10-14세,1399,731,668
202102,48870,경상남도,함양군,10-14세,1416,739,677
202103,48870,경상남도,함양군,10-14세,1418,736,682
202104,48870,경상남도,함양군,10-14세,1403,731,672
202105,48870,경상남도,함양군,10-14세,1393,726,667
202106,48870,경상남도,함양군,10-14세,1389,724,665
202007,48870,경상남도,함양군,15-19세,1598,825,773
202008,48870,경상남도,함양군,15-19세,1591,825,766
202009,48870,경상남도,함양군,15-19세,1581,821,760
202010,48870,경상남도,함양군,15-19세,1581,820,761
202011,48870,경상남도,함양군,15-19세,1562,809,753
202012,48870,경상남도,함양군,15-19세,1568,815,753
202101,48870,경상남도,함양군,15-19세,1558,815,743
202102,48870,경상남도,함양군,15-19세,1578,829,749
202103,48870,경상남도,함양군,15-19세,1550,809,741
202104,48870,경상남도,함양군,15-19세,1531,794,737
202105,48870,경상남도,함양군,15-19세,1518,787,731
202106,48870,경상남도,함양군,15-19세,1507,778,729
202007,48870,경상남도,함양군,20-24세,1781,1010,771
202008,48870,경상남도,함양군,20-24세,1751,990,761
202009,48870,경상남도,함양군,20-24세,1734,986,748
202010,48870,경상남도,함양군,20-24세,1737,993,744
202011,48870,경상남도,함양군,20-24세,1735,992,743
202012,48870,경상남도,함양군,20-24세,1717,976,741
202101,48870,경상남도,함양군,20-24세,1716,971,745
202102,48870,경상남도,함양군,20-24세,1701,954,747
202103,48870,경상남도,함양군,20-24세,1689,954,735
202104,48870,경상남도,함양군,20-24세,1695,957,738
202105,48870,경상남도,함양군,20-24세,1679,943,736
202106,48870,경상남도,함양군,20-24세,1664,938,726
202007,48870,경상남도,함양군,25-29세,1398,797,601
202008,48870,경상남도,함양군,25-29세,1389,798,591
202009,48870,경상남도,함양군,25-29세,1385,801,584
202010,48870,경상남도,함양군,25-29세,1387,797,590
202011,48870,경상남도,함양군,25-29세,1377,788,589
202012,48870,경상남도,함양군,25-29세,1379,783,596
202101,48870,경상남도,함양군,25-29세,1369,779,590
202102,48870,경상남도,함양군,25-29세,1367,782,585
202103,48870,경상남도,함양군,25-29세,1378,790,588
202104,48870,경상남도,함양군,25-29세,1388,792,596
202105,48870,경상남도,함양군,25-29세,1389,792,597
202106,48870,경상남도,함양군,25-29세,1377,786,591
202007,48870,경상남도,함양군,30-34세,1119,598,521
202008,48870,경상남도,함양군,30-34세,1127,603,524
202009,48870,경상남도,함양군,30-34세,1113,598,515
202010,48870,경상남도,함양군,30-34세,1109,591,518
202011,48870,경상남도,함양군,30-34세,1099,590,509
202012,48870,경상남도,함양군,30-34세,1105,595,510
202101,48870,경상남도,함양군,30-34세,1112,601,511
202102,48870,경상남도,함양군,30-34세,1116,600,516
202103,48870,경상남도,함양군,30-34세,1104,589,515
202104,48870,경상남도,함양군,30-34세,1104,588,516
202105,48870,경상남도,함양군,30-34세,1109,597,512
202106,48870,경상남도,함양군,30-34세,1103,587,516
202007,48870,경상남도,함양군,35-39세,1572,804,768
202008,48870,경상남도,함양군,35-39세,1556,796,760
202009,48870,경상남도,함양군,35-39세,1551,789,762
202010,48870,경상남도,함양군,35-39세,1531,781,750
202011,48870,경상남도,함양군,35-39세,1530,779,751
202012,48870,경상남도,함양군,35-39세,1521,771,750
202101,48870,경상남도,함양군,35-39세,1503,760,743
202102,48870,경상남도,함양군,35-39세,1491,751,740
202103,48870,경상남도,함양군,35-39세,1491,749,742
202104,48870,경상남도,함양군,35-39세,1477,740,737
202105,48870,경상남도,함양군,35-39세,1447,720,727
202106,48870,경상남도,함양군,35-39세,1433,720,713
202007,48870,경상남도,함양군,40-44세,1805,944,861
202008,48870,경상남도,함양군,40-44세,1800,937,863
202009,48870,경상남도,함양군,40-44세,1793,932,861
202010,48870,경상남도,함양군,40-44세,1793,926,867
202011,48870,경상남도,함양군,40-44세,1791,925,866
202012,48870,경상남도,함양군,40-44세,1782,926,856
202101,48870,경상남도,함양군,40-44세,1767,918,849
202102,48870,경상남도,함양군,40-44세,1747,914,833
202103,48870,경상남도,함양군,40-44세,1749,915,834
202104,48870,경상남도,함양군,40-44세,1754,921,833
202105,48870,경상남도,함양군,40-44세,1762,926,836
202106,48870,경상남도,함양군,40-44세,1777,929,848
202007,48870,경상남도,함양군,45-49세,2686,1518,1168
202008,48870,경상남도,함양군,45-49세,2680,1516,1164
202009,48870,경상남도,함양군,45-49세,2660,1505,1155
202010,48870,경상남도,함양군,45-49세,2645,1497,1148
202011,48870,경상남도,함양군,45-49세,2629,1490,1139
202012,48870,경상남도,함양군,45-49세,2605,1480,1125
202101,48870,경상남도,함양군,45-49세,2589,1468,1121
202102,48870,경상남도,함양군,45-49세,2590,1457,1133
202103,48870,경상남도,함양군,45-49세,2574,1450,1124
202104,48870,경상남도,함양군,45-49세,2563,1444,1119
202105,48870,경상남도,함양군,45-49세,2514,1415,1099
202106,48870,경상남도,함양군,45-49세,2495,1410,1085
202007,48870,경상남도,함양군,50-54세,3332,1779,1553
202008,48870,경상남도,함양군,50-54세,3321,1767,1554
202009,48870,경상남도,함양군,50-54세,3320,1770,1550
202010,48870,경상남도,함양군,50-54세,3332,1776,1556
202011,48870,경상남도,함양군,50-54세,3331,1774,1557
202012,48870,경상남도,함양군,50-54세,3338,1777,1561
202101,48870,경상남도,함양군,50-54세,3316,1771,1545
202102,48870,경상남도,함양군,50-54세,3298,1765,1533
202103,48870,경상남도,함양군,50-54세,3292,1764,1528
202104,48870,경상남도,함양군,50-54세,3284,1757,1527
202105,48870,경상남도,함양군,50-54세,3287,1765,1522
202106,48870,경상남도,함양군,50-54세,3283,1765,1518
202007,48870,경상남도,함양군,55-59세,3640,1907,1733
202008,48870,경상남도,함양군,55-59세,3653,1927,1726
202009,48870,경상남도,함양군,55-59세,3643,1920,1723
202010,48870,경상남도,함양군,55-59세,3632,1920,1712
202011,48870,경상남도,함양군,55-59세,3625,1922,1703
202012,48870,경상남도,함양군,55-59세,3603,1914,1689
202101,48870,경상남도,함양군,55-59세,3572,1897,1675
202102,48870,경상남도,함양군,55-59세,3567,1897,1670
202103,48870,경상남도,함양군,55-59세,3519,1886,1633
202104,48870,경상남도,함양군,55-59세,3517,1893,1624
202105,48870,경상남도,함양군,55-59세,3498,1893,1605
202106,48870,경상남도,함양군,55-59세,3471,1871,1600
202007,48870,경상남도,함양군,60-64세,4011,1994,2017
202008,48870,경상남도,함양군,60-64세,3995,1978,2017
202009,48870,경상남도,함양군,60-64세,3990,1984,2006
202010,48870,경상남도,함양군,60-64세,4002,1991,2011
202011,48870,경상남도,함양군,60-64세,4006,2004,2002
202012,48870,경상남도,함양군,60-64세,4028,2017,2011
202101,48870,경상남도,함양군,60-64세,4042,2023,2019
202102,48870,경상남도,함양군,60-64세,4077,2048,2029
202103,48870,경상남도,함양군,60-64세,4132,2073,2059
202104,48870,경상남도,함양군,60-64세,4138,2078,2060
202105,48870,경상남도,함양군,60-64세,4146,2081,2065
202106,48870,경상남도,함양군,60-64세,4168,2101,2067
202007,48870,경상남도,함양군,65-69세,3105,1546,1559
202008,48870,경상남도,함양군,65-69세,3156,1576,1580
202009,48870,경상남도,함양군,65-69세,3196,1591,1605
202010,48870,경상남도,함양군,65-69세,3209,1596,1613
202011,48870,경상남도,함양군,65-69세,3236,1600,1636
202012,48870,경상남도,함양군,65-69세,3266,1613,1653
202101,48870,경상남도,함양군,65-69세,3292,1621,1671
202102,48870,경상남도,함양군,65-69세,3322,1641,1681
202103,48870,경상남도,함양군,65-69세,3355,1658,1697
202104,48870,경상남도,함양군,65-69세,3397,1687,1710
202105,48870,경상남도,함양군,65-69세,3403,1692,1711
202106,48870,경상남도,함양군,65-69세,3419,1699,1720
202007,48870,경상남도,함양군,70-74세,2727,1218,1509
202008,48870,경상남도,함양군,70-74세,2734,1221,1513
202009,48870,경상남도,함양군,70-74세,2731,1221,1510
202010,48870,경상남도,함양군,70-74세,2750,1237,1513
202011,48870,경상남도,함양군,70-74세,2780,1254,1526
202012,48870,경상남도,함양군,70-74세,2813,1274,1539
202101,48870,경상남도,함양군,70-74세,2840,1285,1555
202102,48870,경상남도,함양군,70-74세,2850,1286,1564
202103,48870,경상남도,함양군,70-74세,2862,1297,1565
202104,48870,경상남도,함양군,70-74세,2876,1297,1579
202105,48870,경상남도,함양군,70-74세,2865,1293,1572
202106,48870,경상남도,함양군,70-74세,2865,1297,1568
202007,48870,경상남도,함양군,75-79세,2848,1043,1805
202008,48870,경상남도,함양군,75-79세,2829,1035,1794
202009,48870,경상남도,함양군,75-79세,2801,1018,1783
202010,48870,경상남도,함양군,75-79세,2771,1006,1765
202011,48870,경상남도,함양군,75-79세,2728,991,1737
202012,48870,경상남도,함양군,75-79세,2703,985,1718
202101,48870,경상남도,함양군,75-79세,2680,987,1693
202102,48870,경상남도,함양군,75-79세,2669,985,1684
202103,48870,경상남도,함양군,75-79세,2649,978,1671
202104,48870,경상남도,함양군,75-79세,2625,971,1654
202105,48870,경상남도,함양군,75-79세,2592,961,1631
202106,48870,경상남도,함양군,75-79세,2580,959,1621
202007,48870,경상남도,함양군,80-84세,2520,856,1664
202008,48870,경상남도,함양군,80-84세,2529,857,1672
202009,48870,경상남도,함양군,80-84세,2530,862,1668
202010,48870,경상남도,함양군,80-84세,2535,865,1670
202011,48870,경상남도,함양군,80-84세,2535,867,1668
202012,48870,경상남도,함양군,80-84세,2516,866,1650
202101,48870,경상남도,함양군,80-84세,2520,862,1658
202102,48870,경상남도,함양군,80-84세,2507,854,1653
202103,48870,경상남도,함양군,80-84세,2493,852,1641
202104,48870,경상남도,함양군,80-84세,2509,857,1652
202105,48870,경상남도,함양군,80-84세,2513,860,1653
202106,48870,경상남도,함양군,80-84세,2519,862,1657
202007,48870,경상남도,함양군,85-89세,1275,290,985
202008,48870,경상남도,함양군,85-89세,1281,286,995
202009,48870,경상남도,함양군,85-89세,1288,289,999
202010,48870,경상남도,함양군,85-89세,1292,295,997
202011,48870,경상남도,함양군,85-89세,1293,292,1001
202012,48870,경상남도,함양군,85-89세,1322,299,1023
202101,48870,경상남도,함양군,85-89세,1333,303,1030
202102,48870,경상남도,함양군,85-89세,1353,313,1040
202103,48870,경상남도,함양군,85-89세,1375,311,1064
202104,48870,경상남도,함양군,85-89세,1371,309,1062
202105,48870,경상남도,함양군,85-89세,1373,313,1060
202106,48870,경상남도,함양군,85-89세,1378,311,1067
202007,48870,경상남도,함양군,90-94세,440,92,348
202008,48870,경상남도,함양군,90-94세,442,94,348
202009,48870,경상남도,함양군,90-94세,441,97,344
202010,48870,경상남도,함양군,90-94세,452,93,359
202011,48870,경상남도,함양군,90-94세,455,95,360
202012,48870,경상남도,함양군,90-94세,461,93,368
202101,48870,경상남도,함양군,90-94세,471,96,375
202102,48870,경상남도,함양군,90-94세,477,96,381
202103,48870,경상남도,함양군,90-94세,481,100,381
202104,48870,경상남도,함양군,90-94세,484,99,385
202105,48870,경상남도,함양군,90-94세,488,102,386
202106,48870,경상남도,함양군,90-94세,486,100,386
202007,48870,경상남도,함양군,95-99세,108,22,86
202008,48870,경상남도,함양군,95-99세,107,21,86
202009,48870,경상남도,함양군,95-99세,112,23,89
202010,48870,경상남도,함양군,95-99세,113,22,91
202011,48870,경상남도,함양군,95-99세,111,21,90
202012,48870,경상남도,함양군,95-99세,113,22,91
202101,48870,경상남도,함양군,95-99세,118,23,95
202102,48870,경상남도,함양군,95-99세,121,24,97
202103,48870,경상남도,함양군,95-99세,117,21,96
202104,48870,경상남도,함양군,95-99세,115,21,94
202105,48870,경상남도,함양군,95-99세,110,19,91
202106,48870,경상남도,함양군,95-99세,112,21,91
202007,48870,경상남도,함양군,100+,31,7,24
202008,48870,경상남도,함양군,100+,31,7,24
202009,48870,경상남도,함양군,100+,31,7,24
202010,48870,경상남도,함양군,100+,31,7,24
202011,48870,경상남도,함양군,100+,32,8,24
202012,48870,경상남도,함양군,100+,33,8,25
202101,48870,경상남도,함양군,100+,31,8,23
202102,48870,경상남도,함양군,100+,31,8,23
202103,48870,경상남도,함양군,100+,20,3,17
202104,48870,경상남도,함양군,100+,19,3,16
202105,48870,경상남도,함양군,100+,17,3,14
202106,48870,경상남도,함양군,100+,16,2,14
202007,48880,경상남도,거창군,0-4세,1482,770,712
202008,48880,경상남도,거창군,0-4세,1486,777,709
202009,48880,경상남도,거창군,0-4세,1475,770,705
202010,48880,경상남도,거창군,0-4세,1450,759,691
202011,48880,경상남도,거창군,0-4세,1458,760,698
202012,48880,경상남도,거창군,0-4세,1443,753,690
202101,48880,경상남도,거창군,0-4세,1433,750,683
202102,48880,경상남도,거창군,0-4세,1424,744,680
202103,48880,경상남도,거창군,0-4세,1423,743,680
202104,48880,경상남도,거창군,0-4세,1410,735,675
202105,48880,경상남도,거창군,0-4세,1393,726,667
202106,48880,경상남도,거창군,0-4세,1377,721,656
202007,48880,경상남도,거창군,5-9세,2357,1212,1145
202008,48880,경상남도,거창군,5-9세,2328,1194,1134
202009,48880,경상남도,거창군,5-9세,2308,1184,1124
202010,48880,경상남도,거창군,5-9세,2321,1185,1136
202011,48880,경상남도,거창군,5-9세,2311,1180,1131
202012,48880,경상남도,거창군,5-9세,2318,1187,1131
202101,48880,경상남도,거창군,5-9세,2314,1179,1135
202102,48880,경상남도,거창군,5-9세,2319,1174,1145
202103,48880,경상남도,거창군,5-9세,2314,1177,1137
202104,48880,경상남도,거창군,5-9세,2301,1180,1121
202105,48880,경상남도,거창군,5-9세,2286,1174,1112
202106,48880,경상남도,거창군,5-9세,2279,1172,1107
202007,48880,경상남도,거창군,10-14세,2564,1329,1235
202008,48880,경상남도,거창군,10-14세,2572,1327,1245
202009,48880,경상남도,거창군,10-14세,2577,1332,1245
202010,48880,경상남도,거창군,10-14세,2583,1343,1240
202011,48880,경상남도,거창군,10-14세,2581,1339,1242
202012,48880,경상남도,거창군,10-14세,2584,1342,1242
202101,48880,경상남도,거창군,10-14세,2599,1345,1254
202102,48880,경상남도,거창군,10-14세,2604,1353,1251
202103,48880,경상남도,거창군,10-14세,2620,1361,1259
202104,48880,경상남도,거창군,10-14세,2621,1364,1257
202105,48880,경상남도,거창군,10-14세,2624,1366,1258
202106,48880,경상남도,거창군,10-14세,2628,1374,1254
202007,48880,경상남도,거창군,15-19세,3090,1708,1382
202008,48880,경상남도,거창군,15-19세,3068,1688,1380
202009,48880,경상남도,거창군,15-19세,3087,1691,1396
202010,48880,경상남도,거창군,15-19세,3064,1679,1385
202011,48880,경상남도,거창군,15-19세,3032,1659,1373
202012,48880,경상남도,거창군,15-19세,3136,1730,1406
202101,48880,경상남도,거창군,15-19세,3144,1741,1403
202102,48880,경상남도,거창군,15-19세,3168,1763,1405
202103,48880,경상남도,거창군,15-19세,3322,1861,1461
202104,48880,경상남도,거창군,15-19세,3303,1850,1453
202105,48880,경상남도,거창군,15-19세,3268,1831,1437
202106,48880,경상남도,거창군,15-19세,3261,1819,1442
202007,48880,경상남도,거창군,20-24세,3536,2091,1445
202008,48880,경상남도,거창군,20-24세,3487,2062,1425
202009,48880,경상남도,거창군,20-24세,3507,2071,1436
202010,48880,경상남도,거창군,20-24세,3505,2076,1429
202011,48880,경상남도,거창군,20-24세,3515,2101,1414
202012,48880,경상남도,거창군,20-24세,3492,2087,1405
202101,48880,경상남도,거창군,20-24세,3438,2043,1395
202102,48880,경상남도,거창군,20-24세,3405,2022,1383
202103,48880,경상남도,거창군,20-24세,3457,2088,1369
202104,48880,경상남도,거창군,20-24세,3461,2094,1367
202105,48880,경상남도,거창군,20-24세,3435,2084,1351
202106,48880,경상남도,거창군,20-24세,3404,2071,1333
202007,48880,경상남도,거창군,25-29세,2444,1417,1027
202008,48880,경상남도,거창군,25-29세,2444,1416,1028
202009,48880,경상남도,거창군,25-29세,2447,1414,1033
202010,48880,경상남도,거창군,25-29세,2461,1425,1036
202011,48880,경상남도,거창군,25-29세,2461,1410,1051
202012,48880,경상남도,거창군,25-29세,2459,1415,1044
202101,48880,경상남도,거창군,25-29세,2468,1431,1037
202102,48880,경상남도,거창군,25-29세,2482,1443,1039
202103,48880,경상남도,거창군,25-29세,2530,1475,1055
202104,48880,경상남도,거창군,25-29세,2536,1485,1051
202105,48880,경상남도,거창군,25-29세,2520,1477,1043
202106,48880,경상남도,거창군,25-29세,2506,1467,1039
202007,48880,경상남도,거창군,30-34세,2231,1198,1033
202008,48880,경상남도,거창군,30-34세,2216,1199,1017
202009,48880,경상남도,거창군,30-34세,2210,1200,1010
202010,48880,경상남도,거창군,30-34세,2209,1199,1010
202011,48880,경상남도,거창군,30-34세,2206,1206,1000
202012,48880,경상남도,거창군,30-34세,2189,1195,994
202101,48880,경상남도,거창군,30-34세,2169,1185,984
202102,48880,경상남도,거창군,30-34세,2138,1172,966
202103,48880,경상남도,거창군,30-34세,2135,1164,971
202104,48880,경상남도,거창군,30-34세,2115,1152,963
202105,48880,경상남도,거창군,30-34세,2130,1149,981
202106,48880,경상남도,거창군,30-34세,2113,1143,970
202007,48880,경상남도,거창군,35-39세,2904,1426,1478
202008,48880,경상남도,거창군,35-39세,2888,1424,1464
202009,48880,경상남도,거창군,35-39세,2852,1396,1456
202010,48880,경상남도,거창군,35-39세,2847,1395,1452
202011,48880,경상남도,거창군,35-39세,2823,1381,1442
202012,48880,경상남도,거창군,35-39세,2819,1383,1436
202101,48880,경상남도,거창군,35-39세,2817,1384,1433
202102,48880,경상남도,거창군,35-39세,2823,1381,1442
202103,48880,경상남도,거창군,35-39세,2819,1390,1429
202104,48880,경상남도,거창군,35-39세,2815,1394,1421
202105,48880,경상남도,거창군,35-39세,2782,1386,1396
202106,48880,경상남도,거창군,35-39세,2758,1370,1388
202007,48880,경상남도,거창군,40-44세,3374,1698,1676
202008,48880,경상남도,거창군,40-44세,3362,1682,1680
202009,48880,경상남도,거창군,40-44세,3384,1687,1697
202010,48880,경상남도,거창군,40-44세,3381,1689,1692
202011,48880,경상남도,거창군,40-44세,3372,1680,1692
202012,48880,경상남도,거창군,40-44세,3393,1697,1696
202101,48880,경상남도,거창군,40-44세,3384,1697,1687
202102,48880,경상남도,거창군,40-44세,3386,1697,1689
202103,48880,경상남도,거창군,40-44세,3360,1683,1677
202104,48880,경상남도,거창군,40-44세,3360,1683,1677
202105,48880,경상남도,거창군,40-44세,3348,1676,1672
202106,48880,경상남도,거창군,40-44세,3371,1689,1682
202007,48880,경상남도,거창군,45-49세,4518,2380,2138
202008,48880,경상남도,거창군,45-49세,4475,2357,2118
202009,48880,경상남도,거창군,45-49세,4398,2318,2080
202010,48880,경상남도,거창군,45-49세,4372,2295,2077
202011,48880,경상남도,거창군,45-49세,4366,2294,2072
202012,48880,경상남도,거창군,45-49세,4346,2277,2069
202101,48880,경상남도,거창군,45-49세,4331,2256,2075
202102,48880,경상남도,거창군,45-49세,4351,2262,2089
202103,48880,경상남도,거창군,45-49세,4333,2239,2094
202104,48880,경상남도,거창군,45-49세,4343,2238,2105
202105,48880,경상남도,거창군,45-49세,4275,2194,2081
202106,48880,경상남도,거창군,45-49세,4243,2175,2068
202007,48880,경상남도,거창군,50-54세,5129,2655,2474
202008,48880,경상남도,거창군,50-54세,5157,2674,2483
202009,48880,경상남도,거창군,50-54세,5179,2684,2495
202010,48880,경상남도,거창군,50-54세,5207,2710,2497
202011,48880,경상남도,거창군,50-54세,5211,2706,2505
202012,48880,경상남도,거창군,50-54세,5181,2685,2496
202101,48880,경상남도,거창군,50-54세,5196,2702,2494
202102,48880,경상남도,거창군,50-54세,5181,2695,2486
202103,48880,경상남도,거창군,50-54세,5179,2705,2474
202104,48880,경상남도,거창군,50-54세,5159,2704,2455
202105,48880,경상남도,거창군,50-54세,5168,2716,2452
202106,48880,경상남도,거창군,50-54세,5187,2725,2462
202007,48880,경상남도,거창군,55-59세,5461,2793,2668
202008,48880,경상남도,거창군,55-59세,5455,2797,2658
202009,48880,경상남도,거창군,55-59세,5428,2794,2634
202010,48880,경상남도,거창군,55-59세,5403,2770,2633
202011,48880,경상남도,거창군,55-59세,5383,2778,2605
202012,48880,경상남도,거창군,55-59세,5400,2799,2601
202101,48880,경상남도,거창군,55-59세,5356,2767,2589
202102,48880,경상남도,거창군,55-59세,5343,2754,2589
202103,48880,경상남도,거창군,55-59세,5256,2720,2536
202104,48880,경상남도,거창군,55-59세,5244,2714,2530
202105,48880,경상남도,거창군,55-59세,5195,2708,2487
202106,48880,경상남도,거창군,55-59세,5161,2688,2473
202007,48880,경상남도,거창군,60-64세,5572,2775,2797
202008,48880,경상남도,거창군,60-64세,5587,2774,2813
202009,48880,경상남도,거창군,60-64세,5647,2797,2850
202010,48880,경상남도,거창군,60-64세,5657,2807,2850
202011,48880,경상남도,거창군,60-64세,5681,2810,2871
202012,48880,경상남도,거창군,60-64세,5716,2824,2892
202101,48880,경상남도,거창군,60-64세,5739,2838,2901
202102,48880,경상남도,거창군,60-64세,5792,2881,2911
202103,48880,경상남도,거창군,60-64세,5901,2934,2967
202104,48880,경상남도,거창군,60-64세,5936,2955,2981
202105,48880,경상남도,거창군,60-64세,5935,2945,2990
202106,48880,경상남도,거창군,60-64세,5958,2955,3003
202007,48880,경상남도,거창군,65-69세,4286,2045,2241
202008,48880,경상남도,거창군,65-69세,4304,2058,2246
202009,48880,경상남도,거창군,65-69세,4328,2073,2255
202010,48880,경상남도,거창군,65-69세,4366,2092,2274
202011,48880,경상남도,거창군,65-69세,4386,2101,2285
202012,48880,경상남도,거창군,65-69세,4433,2129,2304
202101,48880,경상남도,거창군,65-69세,4457,2141,2316
202102,48880,경상남도,거창군,65-69세,4489,2147,2342
202103,48880,경상남도,거창군,65-69세,4547,2180,2367
202104,48880,경상남도,거창군,65-69세,4589,2196,2393
202105,48880,경상남도,거창군,65-69세,4620,2214,2406
202106,48880,경상남도,거창군,65-69세,4645,2234,2411
202007,48880,경상남도,거창군,70-74세,3609,1610,1999
202008,48880,경상남도,거창군,70-74세,3618,1614,2004
202009,48880,경상남도,거창군,70-74세,3615,1613,2002
202010,48880,경상남도,거창군,70-74세,3620,1622,1998
202011,48880,경상남도,거창군,70-74세,3630,1622,2008
202012,48880,경상남도,거창군,70-74세,3634,1627,2007
202101,48880,경상남도,거창군,70-74세,3651,1635,2016
202102,48880,경상남도,거창군,70-74세,3674,1644,2030
202103,48880,경상남도,거창군,70-74세,3678,1641,2037
202104,48880,경상남도,거창군,70-74세,3680,1646,2034
202105,48880,경상남도,거창군,70-74세,3675,1643,2032
202106,48880,경상남도,거창군,70-74세,3695,1659,2036
202007,48880,경상남도,거창군,75-79세,3501,1314,2187
202008,48880,경상남도,거창군,75-79세,3483,1306,2177
202009,48880,경상남도,거창군,75-79세,3459,1300,2159
202010,48880,경상남도,거창군,75-79세,3432,1286,2146
202011,48880,경상남도,거창군,75-79세,3403,1277,2126
202012,48880,경상남도,거창군,75-79세,3354,1259,2095
202101,48880,경상남도,거창군,75-79세,3333,1254,2079
202102,48880,경상남도,거창군,75-79세,3302,1246,2056
202103,48880,경상남도,거창군,75-79세,3289,1250,2039
202104,48880,경상남도,거창군,75-79세,3286,1250,2036
202105,48880,경상남도,거창군,75-79세,3272,1245,2027
202106,48880,경상남도,거창군,75-79세,3241,1219,2022
202007,48880,경상남도,거창군,80-84세,3140,1026,2114
202008,48880,경상남도,거창군,80-84세,3149,1032,2117
202009,48880,경상남도,거창군,80-84세,3156,1033,2123
202010,48880,경상남도,거창군,80-84세,3165,1033,2132
202011,48880,경상남도,거창군,80-84세,3169,1037,2132
202012,48880,경상남도,거창군,80-84세,3160,1045,2115
202101,48880,경상남도,거창군,80-84세,3168,1052,2116
202102,48880,경상남도,거창군,80-84세,3178,1061,2117
202103,48880,경상남도,거창군,80-84세,3173,1055,2118
202104,48880,경상남도,거창군,80-84세,3161,1047,2114
202105,48880,경상남도,거창군,80-84세,3151,1044,2107
202106,48880,경상남도,거창군,80-84세,3161,1054,2107
202007,48880,경상남도,거창군,85-89세,1658,476,1182
202008,48880,경상남도,거창군,85-89세,1661,477,1184
202009,48880,경상남도,거창군,85-89세,1657,475,1182
202010,48880,경상남도,거창군,85-89세,1666,476,1190
202011,48880,경상남도,거창군,85-89세,1664,479,1185
202012,48880,경상남도,거창군,85-89세,1676,477,1199
202101,48880,경상남도,거창군,85-89세,1702,484,1218
202102,48880,경상남도,거창군,85-89세,1719,482,1237
202103,48880,경상남도,거창군,85-89세,1747,485,1262
202104,48880,경상남도,거창군,85-89세,1765,496,1269
202105,48880,경상남도,거창군,85-89세,1779,501,1278
202106,48880,경상남도,거창군,85-89세,1772,498,1274
202007,48880,경상남도,거창군,90-94세,565,119,446
202008,48880,경상남도,거창군,90-94세,572,120,452
202009,48880,경상남도,거창군,90-94세,583,125,458
202010,48880,경상남도,거창군,90-94세,588,129,459
202011,48880,경상남도,거창군,90-94세,596,131,465
202012,48880,경상남도,거창군,90-94세,607,134,473
202101,48880,경상남도,거창군,90-94세,609,136,473
202102,48880,경상남도,거창군,90-94세,616,141,475
202103,48880,경상남도,거창군,90-94세,622,142,480
202104,48880,경상남도,거창군,90-94세,630,142,488
202105,48880,경상남도,거창군,90-94세,635,141,494
202106,48880,경상남도,거창군,90-94세,643,147,496
202007,48880,경상남도,거창군,95-99세,116,27,89
202008,48880,경상남도,거창군,95-99세,116,26,90
202009,48880,경상남도,거창군,95-99세,116,26,90
202010,48880,경상남도,거창군,95-99세,120,26,94
202011,48880,경상남도,거창군,95-99세,118,26,92
202012,48880,경상남도,거창군,95-99세,120,27,93
202101,48880,경상남도,거창군,95-99세,124,28,96
202102,48880,경상남도,거창군,95-99세,127,28,99
202103,48880,경상남도,거창군,95-99세,132,27,105
202104,48880,경상남도,거창군,95-99세,139,30,109
202105,48880,경상남도,거창군,95-99세,131,30,101
202106,48880,경상남도,거창군,95-99세,128,29,99
202007,48880,경상남도,거창군,100+,41,9,32
202008,48880,경상남도,거창군,100+,40,9,31
202009,48880,경상남도,거창군,100+,42,10,32
202010,48880,경상남도,거창군,100+,42,10,32
202011,48880,경상남도,거창군,100+,43,10,33
202012,48880,경상남도,거창군,100+,42,10,32
202101,48880,경상남도,거창군,100+,42,10,32
202102,48880,경상남도,거창군,100+,43,10,33
202103,48880,경상남도,거창군,100+,23,6,17
202104,48880,경상남도,거창군,100+,23,6,17
202105,48880,경상남도,거창군,100+,24,5,19
202106,48880,경상남도,거창군,100+,24,5,19
202007,48890,경상남도,합천군,0-4세,663,344,319
202008,48890,경상남도,합천군,0-4세,664,345,319
202009,48890,경상남도,합천군,0-4세,666,346,320
202010,48890,경상남도,합천군,0-4세,648,336,312
202011,48890,경상남도,합천군,0-4세,640,333,307
202012,48890,경상남도,합천군,0-4세,646,341,305
202101,48890,경상남도,합천군,0-4세,632,332,300
202102,48890,경상남도,합천군,0-4세,626,327,299
202103,48890,경상남도,합천군,0-4세,620,325,295
202104,48890,경상남도,합천군,0-4세,622,327,295
202105,48890,경상남도,합천군,0-4세,617,321,296
202106,48890,경상남도,합천군,0-4세,599,309,290
202007,48890,경상남도,합천군,5-9세,1007,518,489
202008,48890,경상남도,합천군,5-9세,998,516,482
202009,48890,경상남도,합천군,5-9세,989,511,478
202010,48890,경상남도,합천군,5-9세,982,507,475
202011,48890,경상남도,합천군,5-9세,972,503,469
202012,48890,경상남도,합천군,5-9세,953,491,462
202101,48890,경상남도,합천군,5-9세,948,493,455
202102,48890,경상남도,합천군,5-9세,941,488,453
202103,48890,경상남도,합천군,5-9세,939,489,450
202104,48890,경상남도,합천군,5-9세,928,485,443
202105,48890,경상남도,합천군,5-9세,923,480,443
202106,48890,경상남도,합천군,5-9세,923,481,442
202007,48890,경상남도,합천군,10-14세,1161,608,553
202008,48890,경상남도,합천군,10-14세,1148,602,546
202009,48890,경상남도,합천군,10-14세,1142,598,544
202010,48890,경상남도,합천군,10-14세,1147,604,543
202011,48890,경상남도,합천군,10-14세,1149,601,548
202012,48890,경상남도,합천군,10-14세,1138,597,541
202101,48890,경상남도,합천군,10-14세,1143,595,548
202102,48890,경상남도,합천군,10-14세,1144,594,550
202103,48890,경상남도,합천군,10-14세,1137,591,546
202104,48890,경상남도,합천군,10-14세,1148,599,549
202105,48890,경상남도,합천군,10-14세,1134,593,541
202106,48890,경상남도,합천군,10-14세,1129,587,542
202007,48890,경상남도,합천군,15-19세,1340,692,648
202008,48890,경상남도,합천군,15-19세,1323,677,646
202009,48890,경상남도,합천군,15-19세,1314,670,644
202010,48890,경상남도,합천군,15-19세,1324,688,636
202011,48890,경상남도,합천군,15-19세,1319,689,630
202012,48890,경상남도,합천군,15-19세,1319,688,631
202101,48890,경상남도,합천군,15-19세,1290,673,617
202102,48890,경상남도,합천군,15-19세,1273,670,603
202103,48890,경상남도,합천군,15-19세,1254,662,592
202104,48890,경상남도,합천군,15-19세,1223,643,580
202105,48890,경상남도,합천군,15-19세,1212,640,572
202106,48890,경상남도,합천군,15-19세,1216,641,575
202007,48890,경상남도,합천군,20-24세,1749,990,759
202008,48890,경상남도,합천군,20-24세,1727,984,743
202009,48890,경상남도,합천군,20-24세,1717,983,734
202010,48890,경상남도,합천군,20-24세,1714,977,737
202011,48890,경상남도,합천군,20-24세,1694,953,741
202012,48890,경상남도,합천군,20-24세,1685,946,739
202101,48890,경상남도,합천군,20-24세,1665,938,727
202102,48890,경상남도,합천군,20-24세,1636,915,721
202103,48890,경상남도,합천군,20-24세,1612,904,708
202104,48890,경상남도,합천군,20-24세,1618,905,713
202105,48890,경상남도,합천군,20-24세,1597,894,703
202106,48890,경상남도,합천군,20-24세,1577,888,689
202007,48890,경상남도,합천군,25-29세,1355,797,558
202008,48890,경상남도,합천군,25-29세,1346,796,550
202009,48890,경상남도,합천군,25-29세,1348,795,553
202010,48890,경상남도,합천군,25-29세,1351,797,554
202011,48890,경상남도,합천군,25-29세,1357,799,558
202012,48890,경상남도,합천군,25-29세,1358,810,548
202101,48890,경상남도,합천군,25-29세,1365,809,556
202102,48890,경상남도,합천군,25-29세,1342,795,547
202103,48890,경상남도,합천군,25-29세,1342,792,550
202104,48890,경상남도,합천군,25-29세,1345,795,550
202105,48890,경상남도,합천군,25-29세,1353,801,552
202106,48890,경상남도,합천군,25-29세,1367,817,550
202007,48890,경상남도,합천군,30-34세,1150,652,498
202008,48890,경상남도,합천군,30-34세,1143,649,494
202009,48890,경상남도,합천군,30-34세,1125,641,484
202010,48890,경상남도,합천군,30-34세,1105,622,483
202011,48890,경상남도,합천군,30-34세,1099,624,475
202012,48890,경상남도,합천군,30-34세,1088,622,466
202101,48890,경상남도,합천군,30-34세,1067,601,466
202102,48890,경상남도,합천군,30-34세,1071,608,463
202103,48890,경상남도,합천군,30-34세,1061,603,458
202104,48890,경상남도,합천군,30-34세,1057,599,458
202105,48890,경상남도,합천군,30-34세,1060,596,464
202106,48890,경상남도,합천군,30-34세,1037,582,455
202007,48890,경상남도,합천군,35-39세,1532,833,699
202008,48890,경상남도,합천군,35-39세,1521,824,697
202009,48890,경상남도,합천군,35-39세,1517,819,698
202010,48890,경상남도,합천군,35-39세,1503,810,693
202011,48890,경상남도,합천군,35-39세,1474,796,678
202012,48890,경상남도,합천군,35-39세,1465,796,669
202101,48890,경상남도,합천군,35-39세,1460,809,651
202102,48890,경상남도,합천군,35-39세,1434,792,642
202103,48890,경상남도,합천군,35-39세,1428,792,636
202104,48890,경상남도,합천군,35-39세,1415,785,630
202105,48890,경상남도,합천군,35-39세,1404,780,624
202106,48890,경상남도,합천군,35-39세,1390,776,614
202007,48890,경상남도,합천군,40-44세,1808,994,814
202008,48890,경상남도,합천군,40-44세,1804,996,808
202009,48890,경상남도,합천군,40-44세,1792,992,800
202010,48890,경상남도,합천군,40-44세,1810,1004,806
202011,48890,경상남도,합천군,40-44세,1801,997,804
202012,48890,경상남도,합천군,40-44세,1795,989,806
202101,48890,경상남도,합천군,40-44세,1770,970,800
202102,48890,경상남도,합천군,40-44세,1763,965,798
202103,48890,경상남도,합천군,40-44세,1743,956,787
202104,48890,경상남도,합천군,40-44세,1742,961,781
202105,48890,경상남도,합천군,40-44세,1742,964,778
202106,48890,경상남도,합천군,40-44세,1752,964,788
202007,48890,경상남도,합천군,45-49세,2603,1523,1080
202008,48890,경상남도,합천군,45-49세,2579,1511,1068
202009,48890,경상남도,합천군,45-49세,2555,1489,1066
202010,48890,경상남도,합천군,45-49세,2536,1470,1066
202011,48890,경상남도,합천군,45-49세,2519,1460,1059
202012,48890,경상남도,합천군,45-49세,2488,1454,1034
202101,48890,경상남도,합천군,45-49세,2481,1448,1033
202102,48890,경상남도,합천군,45-49세,2455,1433,1022
202103,48890,경상남도,합천군,45-49세,2435,1427,1008
202104,48890,경상남도,합천군,45-49세,2430,1420,1010
202105,48890,경상남도,합천군,45-49세,2396,1391,1005
202106,48890,경상남도,합천군,45-49세,2371,1377,994
202007,48890,경상남도,합천군,50-54세,3508,1963,1545
202008,48890,경상남도,합천군,50-54세,3485,1953,1532
202009,48890,경상남도,합천군,50-54세,3471,1953,1518
202010,48890,경상남도,합천군,50-54세,3467,1956,1511
202011,48890,경상남도,합천군,50-54세,3452,1946,1506
202012,48890,경상남도,합천군,50-54세,3425,1928,1497
202101,48890,경상남도,합천군,50-54세,3414,1916,1498
202102,48890,경상남도,합천군,50-54세,3411,1918,1493
202103,48890,경상남도,합천군,50-54세,3381,1905,1476
202104,48890,경상남도,합천군,50-54세,3368,1885,1483
202105,48890,경상남도,합천군,50-54세,3383,1906,1477
202106,48890,경상남도,합천군,50-54세,3378,1897,1481
202007,48890,경상남도,합천군,55-59세,4370,2353,2017
202008,48890,경상남도,합천군,55-59세,4323,2319,2004
202009,48890,경상남도,합천군,55-59세,4291,2306,1985
202010,48890,경상남도,합천군,55-59세,4285,2308,1977
202011,48890,경상남도,합천군,55-59세,4264,2299,1965
202012,48890,경상남도,합천군,55-59세,4259,2302,1957
202101,48890,경상남도,합천군,55-59세,4216,2281,1935
202102,48890,경상남도,합천군,55-59세,4179,2255,1924
202103,48890,경상남도,합천군,55-59세,4104,2239,1865
202104,48890,경상남도,합천군,55-59세,4055,2223,1832
202105,48890,경상남도,합천군,55-59세,4015,2212,1803
202106,48890,경상남도,합천군,55-59세,3979,2199,1780
202007,48890,경상남도,합천군,60-64세,4831,2482,2349
202008,48890,경상남도,합천군,60-64세,4863,2512,2351
202009,48890,경상남도,합천군,60-64세,4875,2521,2354
202010,48890,경상남도,합천군,60-64세,4887,2530,2357
202011,48890,경상남도,합천군,60-64세,4918,2548,2370
202012,48890,경상남도,합천군,60-64세,4956,2568,2388
202101,48890,경상남도,합천군,60-64세,4983,2577,2406
202102,48890,경상남도,합천군,60-64세,5043,2611,2432
202103,48890,경상남도,합천군,60-64세,5092,2634,2458
202104,48890,경상남도,합천군,60-64세,5161,2674,2487
202105,48890,경상남도,합천군,60-64세,5198,2688,2510
202106,48890,경상남도,합천군,60-64세,5230,2695,2535
202007,48890,경상남도,합천군,65-69세,3982,1955,2027
202008,48890,경상남도,합천군,65-69세,3994,1952,2042
202009,48890,경상남도,합천군,65-69세,4029,1966,2063
202010,48890,경상남도,합천군,65-69세,4057,1976,2081
202011,48890,경상남도,합천군,65-69세,4099,2002,2097
202012,48890,경상남도,합천군,65-69세,4103,2013,2090
202101,48890,경상남도,합천군,65-69세,4120,2030,2090
202102,48890,경상남도,합천군,65-69세,4132,2038,2094
202103,48890,경상남도,합천군,65-69세,4177,2064,2113
202104,48890,경상남도,합천군,65-69세,4203,2085,2118
202105,48890,경상남도,합천군,65-69세,4239,2113,2126
202106,48890,경상남도,합천군,65-69세,4230,2120,2110
202007,48890,경상남도,합천군,70-74세,3548,1583,1965
202008,48890,경상남도,합천군,70-74세,3567,1601,1966
202009,48890,경상남도,합천군,70-74세,3565,1605,1960
202010,48890,경상남도,합천군,70-74세,3575,1611,1964
202011,48890,경상남도,합천군,70-74세,3572,1603,1969
202012,48890,경상남도,합천군,70-74세,3589,1603,1986
202101,48890,경상남도,합천군,70-74세,3600,1612,1988
202102,48890,경상남도,합천군,70-74세,3625,1630,1995
202103,48890,경상남도,합천군,70-74세,3627,1653,1974
202104,48890,경상남도,합천군,70-74세,3646,1656,1990
202105,48890,경상남도,합천군,70-74세,3663,1665,1998
202106,48890,경상남도,합천군,70-74세,3701,1677,2024
202007,48890,경상남도,합천군,75-79세,3819,1380,2439
202008,48890,경상남도,합천군,75-79세,3787,1374,2413
202009,48890,경상남도,합천군,75-79세,3739,1354,2385
202010,48890,경상남도,합천군,75-79세,3710,1350,2360
202011,48890,경상남도,합천군,75-79세,3677,1340,2337
202012,48890,경상남도,합천군,75-79세,3624,1333,2291
202101,48890,경상남도,합천군,75-79세,3577,1314,2263
202102,48890,경상남도,합천군,75-79세,3525,1295,2230
202103,48890,경상남도,합천군,75-79세,3502,1288,2214
202104,48890,경상남도,합천군,75-79세,3461,1274,2187
202105,48890,경상남도,합천군,75-79세,3432,1261,2171
202106,48890,경상남도,합천군,75-79세,3399,1254,2145
202007,48890,경상남도,합천군,80-84세,3404,1092,2312
202008,48890,경상남도,합천군,80-84세,3417,1092,2325
202009,48890,경상남도,합천군,80-84세,3433,1100,2333
202010,48890,경상남도,합천군,80-84세,3437,1096,2341
202011,48890,경상남도,합천군,80-84세,3439,1095,2344
202012,48890,경상남도,합천군,80-84세,3451,1092,2359
202101,48890,경상남도,합천군,80-84세,3470,1106,2364
202102,48890,경상남도,합천군,80-84세,3476,1107,2369
202103,48890,경상남도,합천군,80-84세,3463,1095,2368
202104,48890,경상남도,합천군,80-84세,3470,1106,2364
202105,48890,경상남도,합천군,80-84세,3464,1111,2353
202106,48890,경상남도,합천군,80-84세,3455,1108,2347
202007,48890,경상남도,합천군,85-89세,1901,468,1433
202008,48890,경상남도,합천군,85-89세,1897,472,1425
202009,48890,경상남도,합천군,85-89세,1903,475,1428
202010,48890,경상남도,합천군,85-89세,1914,478,1436
202011,48890,경상남도,합천군,85-89세,1916,486,1430
202012,48890,경상남도,합천군,85-89세,1931,496,1435
202101,48890,경상남도,합천군,85-89세,1932,493,1439
202102,48890,경상남도,합천군,85-89세,1974,509,1465
202103,48890,경상남도,합천군,85-89세,1981,511,1470
202104,48890,경상남도,합천군,85-89세,1982,508,1474
202105,48890,경상남도,합천군,85-89세,1998,510,1488
202106,48890,경상남도,합천군,85-89세,1997,511,1486
202007,48890,경상남도,합천군,90-94세,549,123,426
202008,48890,경상남도,합천군,90-94세,554,115,439
202009,48890,경상남도,합천군,90-94세,571,119,452
202010,48890,경상남도,합천군,90-94세,567,119,448
202011,48890,경상남도,합천군,90-94세,576,118,458
202012,48890,경상남도,합천군,90-94세,581,121,460
202101,48890,경상남도,합천군,90-94세,584,122,462
202102,48890,경상남도,합천군,90-94세,594,123,471
202103,48890,경상남도,합천군,90-94세,589,124,465
202104,48890,경상남도,합천군,90-94세,596,127,469
202105,48890,경상남도,합천군,90-94세,585,124,461
202106,48890,경상남도,합천군,90-94세,587,124,463
202007,48890,경상남도,합천군,95-99세,119,14,105
202008,48890,경상남도,합천군,95-99세,119,15,104
202009,48890,경상남도,합천군,95-99세,115,14,101
202010,48890,경상남도,합천군,95-99세,115,13,102
202011,48890,경상남도,합천군,95-99세,112,14,98
202012,48890,경상남도,합천군,95-99세,112,15,97
202101,48890,경상남도,합천군,95-99세,115,14,101
202102,48890,경상남도,합천군,95-99세,120,14,106
202103,48890,경상남도,합천군,95-99세,118,15,103
202104,48890,경상남도,합천군,95-99세,117,15,102
202105,48890,경상남도,합천군,95-99세,123,15,108
202106,48890,경상남도,합천군,95-99세,119,15,104
202007,48890,경상남도,합천군,100+,35,4,31
202008,48890,경상남도,합천군,100+,36,4,32
202009,48890,경상남도,합천군,100+,38,4,34
202010,48890,경상남도,합천군,100+,38,4,34
202011,48890,경상남도,합천군,100+,39,4,35
202012,48890,경상남도,합천군,100+,40,4,36
202101,48890,경상남도,합천군,100+,39,4,35
202102,48890,경상남도,합천군,100+,39,4,35
202103,48890,경상남도,합천군,100+,30,3,27
202104,48890,경상남도,합천군,100+,30,3,27
202105,48890,경상남도,합천군,100+,30,3,27
202106,48890,경상남도,합천군,100+,29,2,27
202007,50110,제주특별자치도,제주시,0-4세,19808,10234,9574
202008,50110,제주특별자치도,제주시,0-4세,19691,10161,9530
202009,50110,제주특별자치도,제주시,0-4세,19554,10076,9478
202010,50110,제주특별자치도,제주시,0-4세,19346,9936,9410
202011,50110,제주특별자치도,제주시,0-4세,19214,9855,9359
202012,50110,제주특별자치도,제주시,0-4세,19099,9792,9307
202101,50110,제주특별자치도,제주시,0-4세,18877,9689,9188
202102,50110,제주특별자치도,제주시,0-4세,18784,9657,9127
202103,50110,제주특별자치도,제주시,0-4세,18697,9601,9096
202104,50110,제주특별자치도,제주시,0-4세,18587,9522,9065
202105,50110,제주특별자치도,제주시,0-4세,18402,9420,8982
202106,50110,제주특별자치도,제주시,0-4세,18352,9398,8954
202007,50110,제주특별자치도,제주시,5-9세,26740,13656,13084
202008,50110,제주특별자치도,제주시,5-9세,26730,13650,13080
202009,50110,제주특별자치도,제주시,5-9세,26728,13666,13062
202010,50110,제주특별자치도,제주시,5-9세,26735,13709,13026
202011,50110,제주특별자치도,제주시,5-9세,26662,13682,12980
202012,50110,제주특별자치도,제주시,5-9세,26625,13684,12941
202101,50110,제주특별자치도,제주시,5-9세,26595,13674,12921
202102,50110,제주특별자치도,제주시,5-9세,26685,13689,12996
202103,50110,제주특별자치도,제주시,5-9세,26660,13691,12969
202104,50110,제주특별자치도,제주시,5-9세,26618,13682,12936
202105,50110,제주특별자치도,제주시,5-9세,26573,13654,12919
202106,50110,제주특별자치도,제주시,5-9세,26531,13625,12906
202007,50110,제주특별자치도,제주시,10-14세,26097,13575,12522
202008,50110,제주특별자치도,제주시,10-14세,26208,13634,12574
202009,50110,제주특별자치도,제주시,10-14세,26231,13622,12609
202010,50110,제주특별자치도,제주시,10-14세,26306,13640,12666
202011,50110,제주특별자치도,제주시,10-14세,26417,13700,12717
202012,50110,제주특별자치도,제주시,10-14세,26518,13749,12769
202101,50110,제주특별자치도,제주시,10-14세,26546,13728,12818
202102,50110,제주특별자치도,제주시,10-14세,26583,13749,12834
202103,50110,제주특별자치도,제주시,10-14세,26661,13792,12869
202104,50110,제주특별자치도,제주시,10-14세,26713,13825,12888
202105,50110,제주특별자치도,제주시,10-14세,26815,13907,12908
202106,50110,제주특별자치도,제주시,10-14세,26862,13932,12930
202007,50110,제주특별자치도,제주시,15-19세,27361,14439,12922
202008,50110,제주특별자치도,제주시,15-19세,27220,14359,12861
202009,50110,제주특별자치도,제주시,15-19세,27085,14307,12778
202010,50110,제주특별자치도,제주시,15-19세,26985,14249,12736
202011,50110,제주특별자치도,제주시,15-19세,26828,14160,12668
202012,50110,제주특별자치도,제주시,15-19세,26756,14120,12636
202101,50110,제주특별자치도,제주시,15-19세,26602,14040,12562
202102,50110,제주특별자치도,제주시,15-19세,26491,14007,12484
202103,50110,제주특별자치도,제주시,15-19세,26273,13898,12375
202104,50110,제주특별자치도,제주시,15-19세,26165,13807,12358
202105,50110,제주특별자치도,제주시,15-19세,25997,13718,12279
202106,50110,제주특별자치도,제주시,15-19세,25945,13695,12250
202007,50110,제주특별자치도,제주시,20-24세,31713,16834,14879
202008,50110,제주특별자치도,제주시,20-24세,31616,16766,14850
202009,50110,제주특별자치도,제주시,20-24세,31680,16783,14897
202010,50110,제주특별자치도,제주시,20-24세,31762,16822,14940
202011,50110,제주특별자치도,제주시,20-24세,31755,16804,14951
202012,50110,제주특별자치도,제주시,20-24세,31765,16799,14966
202101,50110,제주특별자치도,제주시,20-24세,31680,16764,14916
202102,50110,제주특별자치도,제주시,20-24세,31491,16669,14822
202103,50110,제주특별자치도,제주시,20-24세,31322,16564,14758
202104,50110,제주특별자치도,제주시,20-24세,31340,16574,14766
202105,50110,제주특별자치도,제주시,20-24세,31312,16560,14752
202106,50110,제주특별자치도,제주시,20-24세,31175,16474,14701
202007,50110,제주특별자치도,제주시,25-29세,31032,16302,14730
202008,50110,제주특별자치도,제주시,25-29세,31160,16400,14760
202009,50110,제주특별자치도,제주시,25-29세,31251,16433,14818
202010,50110,제주특별자치도,제주시,25-29세,31479,16531,14948
202011,50110,제주특별자치도,제주시,25-29세,31621,16578,15043
202012,50110,제주특별자치도,제주시,25-29세,31831,16654,15177
202101,50110,제주특별자치도,제주시,25-29세,31821,16652,15169
202102,50110,제주특별자치도,제주시,25-29세,31756,16571,15185
202103,50110,제주특별자치도,제주시,25-29세,31821,16636,15185
202104,50110,제주특별자치도,제주시,25-29세,31817,16664,15153
202105,50110,제주특별자치도,제주시,25-29세,31894,16677,15217
202106,50110,제주특별자치도,제주시,25-29세,31944,16701,15243
202007,50110,제주특별자치도,제주시,30-34세,26971,13719,13252
202008,50110,제주특별자치도,제주시,30-34세,27008,13734,13274
202009,50110,제주특별자치도,제주시,30-34세,27008,13717,13291
202010,50110,제주특별자치도,제주시,30-34세,26916,13681,13235
202011,50110,제주특별자치도,제주시,30-34세,26864,13687,13177
202012,50110,제주특별자치도,제주시,30-34세,26860,13738,13122
202101,50110,제주특별자치도,제주시,30-34세,26904,13711,13193
202102,50110,제주특별자치도,제주시,30-34세,26937,13720,13217
202103,50110,제주특별자치도,제주시,30-34세,26962,13710,13252
202104,50110,제주특별자치도,제주시,30-34세,27095,13744,13351
202105,50110,제주특별자치도,제주시,30-34세,27156,13777,13379
202106,50110,제주특별자치도,제주시,30-34세,27226,13815,13411
202007,50110,제주특별자치도,제주시,35-39세,36571,18459,18112
202008,50110,제주특별자치도,제주시,35-39세,36409,18378,18031
202009,50110,제주특별자치도,제주시,35-39세,36223,18263,17960
202010,50110,제주특별자치도,제주시,35-39세,36055,18171,17884
202011,50110,제주특별자치도,제주시,35-39세,35919,18101,17818
202012,50110,제주특별자치도,제주시,35-39세,35826,18033,17793
202101,50110,제주특별자치도,제주시,35-39세,35598,17921,17677
202102,50110,제주특별자치도,제주시,35-39세,35457,17838,17619
202103,50110,제주특별자치도,제주시,35-39세,35230,17746,17484
202104,50110,제주특별자치도,제주시,35-39세,35060,17659,17401
202105,50110,제주특별자치도,제주시,35-39세,34851,17547,17304
202106,50110,제주특별자치도,제주시,35-39세,34729,17488,17241
202007,50110,제주특별자치도,제주시,40-44세,38150,19391,18759
202008,50110,제주특별자치도,제주시,40-44세,38229,19441,18788
202009,50110,제주특별자치도,제주시,40-44세,38424,19538,18886
202010,50110,제주특별자치도,제주시,40-44세,38568,19617,18951
202011,50110,제주특별자치도,제주시,40-44세,38633,19625,19008
202012,50110,제주특별자치도,제주시,40-44세,38692,19656,19036
202101,50110,제주특별자치도,제주시,40-44세,38696,19636,19060
202102,50110,제주특별자치도,제주시,40-44세,38945,19715,19230
202103,50110,제주특별자치도,제주시,40-44세,39070,19765,19305
202104,50110,제주특별자치도,제주시,40-44세,39184,19769,19415
202105,50110,제주특별자치도,제주시,40-44세,39365,19880,19485
202106,50110,제주특별자치도,제주시,40-44세,39444,19920,19524
202007,50110,제주특별자치도,제주시,45-49세,44982,22923,22059
202008,50110,제주특별자치도,제주시,45-49세,44870,22839,22031
202009,50110,제주특별자치도,제주시,45-49세,44617,22720,21897
202010,50110,제주특별자치도,제주시,45-49세,44455,22642,21813
202011,50110,제주특별자치도,제주시,45-49세,44334,22589,21745
202012,50110,제주특별자치도,제주시,45-49세,44220,22541,21679
202101,50110,제주특별자치도,제주시,45-49세,44127,22518,21609
202102,50110,제주특별자치도,제주시,45-49세,43976,22453,21523
202103,50110,제주특별자치도,제주시,45-49세,43745,22314,21431
202104,50110,제주특별자치도,제주시,45-49세,43727,22323,21404
202105,50110,제주특별자치도,제주시,45-49세,43268,22058,21210
202106,50110,제주특별자치도,제주시,45-49세,43027,21930,21097
202007,50110,제주특별자치도,제주시,50-54세,42440,22034,20406
202008,50110,제주특별자치도,제주시,50-54세,42633,22133,20500
202009,50110,제주특별자치도,제주시,50-54세,42661,22072,20589
202010,50110,제주특별자치도,제주시,50-54세,42809,22128,20681
202011,50110,제주특별자치도,제주시,50-54세,42847,22140,20707
202012,50110,제주특별자치도,제주시,50-54세,42818,22080,20738
202101,50110,제주특별자치도,제주시,50-54세,42969,22123,20846
202102,50110,제주특별자치도,제주시,50-54세,43088,22155,20933
202103,50110,제주특별자치도,제주시,50-54세,42848,22054,20794
202104,50110,제주특별자치도,제주시,50-54세,42883,22086,20797
202105,50110,제주특별자치도,제주시,50-54세,43323,22295,21028
202106,50110,제주특별자치도,제주시,50-54세,43534,22400,21134
202007,50110,제주특별자치도,제주시,55-59세,37738,19250,18488
202008,50110,제주특별자치도,제주시,55-59세,37684,19206,18478
202009,50110,제주특별자치도,제주시,55-59세,37763,19306,18457
202010,50110,제주특별자치도,제주시,55-59세,37784,19314,18470
202011,50110,제주특별자치도,제주시,55-59세,37828,19316,18512
202012,50110,제주특별자치도,제주시,55-59세,37935,19369,18566
202101,50110,제주특별자치도,제주시,55-59세,37894,19374,18520
202102,50110,제주특별자치도,제주시,55-59세,37982,19436,18546
202103,50110,제주특별자치도,제주시,55-59세,38166,19568,18598
202104,50110,제주특별자치도,제주시,55-59세,38212,19603,18609
202105,50110,제주특별자치도,제주시,55-59세,38224,19647,18577
202106,50110,제주특별자치도,제주시,55-59세,38199,19629,18570
202007,50110,제주특별자치도,제주시,60-64세,31998,16045,15953
202008,50110,제주특별자치도,제주시,60-64세,32249,16197,16052
202009,50110,제주특별자치도,제주시,60-64세,32398,16240,16158
202010,50110,제주특별자치도,제주시,60-64세,32564,16324,16240
202011,50110,제주특별자치도,제주시,60-64세,32650,16358,16292
202012,50110,제주특별자치도,제주시,60-64세,32801,16426,16375
202101,50110,제주특별자치도,제주시,60-64세,33004,16524,16480
202102,50110,제주특별자치도,제주시,60-64세,33165,16605,16560
202103,50110,제주특별자치도,제주시,60-64세,33139,16625,16514
202104,50110,제주특별자치도,제주시,60-64세,33291,16680,16611
202105,50110,제주특별자치도,제주시,60-64세,33414,16729,16685
202106,50110,제주특별자치도,제주시,60-64세,33597,16850,16747
202007,50110,제주특별자치도,제주시,65-69세,21304,10311,10993
202008,50110,제주특별자치도,제주시,65-69세,21476,10391,11085
202009,50110,제주특별자치도,제주시,65-69세,21631,10476,11155
202010,50110,제주특별자치도,제주시,65-69세,21851,10582,11269
202011,50110,제주특별자치도,제주시,65-69세,22002,10661,11341
202012,50110,제주특별자치도,제주시,65-69세,22077,10723,11354
202101,50110,제주특별자치도,제주시,65-69세,22187,10773,11414
202102,50110,제주특별자치도,제주시,65-69세,22322,10853,11469
202103,50110,제주특별자치도,제주시,65-69세,22468,10932,11536
202104,50110,제주특별자치도,제주시,65-69세,22633,11022,11611
202105,50110,제주특별자치도,제주시,65-69세,22823,11114,11709
202106,50110,제주특별자치도,제주시,65-69세,22992,11177,11815
202007,50110,제주특별자치도,제주시,70-74세,16521,7697,8824
202008,50110,제주특별자치도,제주시,70-74세,16546,7695,8851
202009,50110,제주특별자치도,제주시,70-74세,16631,7740,8891
202010,50110,제주특별자치도,제주시,70-74세,16736,7778,8958
202011,50110,제주특별자치도,제주시,70-74세,16837,7826,9011
202012,50110,제주특별자치도,제주시,70-74세,16937,7870,9067
202101,50110,제주특별자치도,제주시,70-74세,17002,7911,9091
202102,50110,제주특별자치도,제주시,70-74세,17016,7908,9108
202103,50110,제주특별자치도,제주시,70-74세,16958,7882,9076
202104,50110,제주특별자치도,제주시,70-74세,16965,7881,9084
202105,50110,제주특별자치도,제주시,70-74세,16955,7880,9075
202106,50110,제주특별자치도,제주시,70-74세,16906,7860,9046
202007,50110,제주특별자치도,제주시,75-79세,13219,5714,7505
202008,50110,제주특별자치도,제주시,75-79세,13236,5741,7495
202009,50110,제주특별자치도,제주시,75-79세,13238,5745,7493
202010,50110,제주특별자치도,제주시,75-79세,13196,5759,7437
202011,50110,제주특별자치도,제주시,75-79세,13182,5756,7426
202012,50110,제주특별자치도,제주시,75-79세,13153,5733,7420
202101,50110,제주특별자치도,제주시,75-79세,13167,5752,7415
202102,50110,제주특별자치도,제주시,75-79세,13183,5758,7425
202103,50110,제주특별자치도,제주시,75-79세,13132,5727,7405
202104,50110,제주특별자치도,제주시,75-79세,13159,5735,7424
202105,50110,제주특별자치도,제주시,75-79세,13212,5760,7452
202106,50110,제주특별자치도,제주시,75-79세,13241,5779,7462
202007,50110,제주특별자치도,제주시,80-84세,9671,3516,6155
202008,50110,제주특별자치도,제주시,80-84세,9701,3528,6173
202009,50110,제주특별자치도,제주시,80-84세,9727,3545,6182
202010,50110,제주특별자치도,제주시,80-84세,9800,3562,6238
202011,50110,제주특별자치도,제주시,80-84세,9824,3574,6250
202012,50110,제주특별자치도,제주시,80-84세,9830,3580,6250
202101,50110,제주특별자치도,제주시,80-84세,9892,3615,6277
202102,50110,제주특별자치도,제주시,80-84세,9939,3637,6302
202103,50110,제주특별자치도,제주시,80-84세,9863,3619,6244
202104,50110,제주특별자치도,제주시,80-84세,9849,3628,6221
202105,50110,제주특별자치도,제주시,80-84세,9910,3661,6249
202106,50110,제주특별자치도,제주시,80-84세,10017,3702,6315
202007,50110,제주특별자치도,제주시,85-89세,5582,1522,4060
202008,50110,제주특별자치도,제주시,85-89세,5613,1543,4070
202009,50110,제주특별자치도,제주시,85-89세,5659,1564,4095
202010,50110,제주특별자치도,제주시,85-89세,5661,1553,4108
202011,50110,제주특별자치도,제주시,85-89세,5695,1575,4120
202012,50110,제주특별자치도,제주시,85-89세,5747,1614,4133
202101,50110,제주특별자치도,제주시,85-89세,5809,1638,4171
202102,50110,제주특별자치도,제주시,85-89세,5859,1657,4202
202103,50110,제주특별자치도,제주시,85-89세,5911,1660,4251
202104,50110,제주특별자치도,제주시,85-89세,5951,1665,4286
202105,50110,제주특별자치도,제주시,85-89세,5961,1662,4299
202106,50110,제주특별자치도,제주시,85-89세,5961,1669,4292
202007,50110,제주특별자치도,제주시,90-94세,1997,315,1682
202008,50110,제주특별자치도,제주시,90-94세,2019,321,1698
202009,50110,제주특별자치도,제주시,90-94세,2050,323,1727
202010,50110,제주특별자치도,제주시,90-94세,2062,327,1735
202011,50110,제주특별자치도,제주시,90-94세,2084,333,1751
202012,50110,제주특별자치도,제주시,90-94세,2103,340,1763
202101,50110,제주특별자치도,제주시,90-94세,2101,344,1757
202102,50110,제주특별자치도,제주시,90-94세,2111,354,1757
202103,50110,제주특별자치도,제주시,90-94세,2116,356,1760
202104,50110,제주특별자치도,제주시,90-94세,2115,358,1757
202105,50110,제주특별자치도,제주시,90-94세,2129,366,1763
202106,50110,제주특별자치도,제주시,90-94세,2146,372,1774
202007,50110,제주특별자치도,제주시,95-99세,700,60,640
202008,50110,제주특별자치도,제주시,95-99세,701,61,640
202009,50110,제주특별자치도,제주시,95-99세,704,61,643
202010,50110,제주특별자치도,제주시,95-99세,691,60,631
202011,50110,제주특별자치도,제주시,95-99세,685,60,625
202012,50110,제주특별자치도,제주시,95-99세,675,60,615
202101,50110,제주특별자치도,제주시,95-99세,677,59,618
202102,50110,제주특별자치도,제주시,95-99세,682,58,624
202103,50110,제주특별자치도,제주시,95-99세,669,52,617
202104,50110,제주특별자치도,제주시,95-99세,674,49,625
202105,50110,제주특별자치도,제주시,95-99세,668,50,618
202106,50110,제주특별자치도,제주시,95-99세,668,50,618
202007,50110,제주특별자치도,제주시,100+,177,27,150
202008,50110,제주특별자치도,제주시,100+,185,28,157
202009,50110,제주특별자치도,제주시,100+,183,27,156
202010,50110,제주특별자치도,제주시,100+,188,27,161
202011,50110,제주특별자치도,제주시,100+,191,27,164
202012,50110,제주특별자치도,제주시,100+,198,27,171
202101,50110,제주특별자치도,제주시,100+,198,28,170
202102,50110,제주특별자치도,제주시,100+,201,29,172
202103,50110,제주특별자치도,제주시,100+,132,11,121
202104,50110,제주특별자치도,제주시,100+,130,11,119
202105,50110,제주특별자치도,제주시,100+,131,11,120
202106,50110,제주특별자치도,제주시,100+,131,10,121
202007,50130,제주특별자치도,서귀포시,0-4세,6163,3173,2990
202008,50130,제주특별자치도,서귀포시,0-4세,6118,3152,2966
202009,50130,제주특별자치도,서귀포시,0-4세,6104,3136,2968
202010,50130,제주특별자치도,서귀포시,0-4세,6014,3100,2914
202011,50130,제주특별자치도,서귀포시,0-4세,5960,3066,2894
202012,50130,제주특별자치도,서귀포시,0-4세,5919,3054,2865
202101,50130,제주특별자치도,서귀포시,0-4세,5877,3038,2839
202102,50130,제주특별자치도,서귀포시,0-4세,5838,3021,2817
202103,50130,제주특별자치도,서귀포시,0-4세,5797,3009,2788
202104,50130,제주특별자치도,서귀포시,0-4세,5800,3031,2769
202105,50130,제주특별자치도,서귀포시,0-4세,5760,3016,2744
202106,50130,제주특별자치도,서귀포시,0-4세,5741,3018,2723
202007,50130,제주특별자치도,서귀포시,5-9세,8664,4441,4223
202008,50130,제주특별자치도,서귀포시,5-9세,8679,4451,4228
202009,50130,제주특별자치도,서귀포시,5-9세,8639,4437,4202
202010,50130,제주특별자치도,서귀포시,5-9세,8671,4447,4224
202011,50130,제주특별자치도,서귀포시,5-9세,8692,4456,4236
202012,50130,제주특별자치도,서귀포시,5-9세,8654,4438,4216
202101,50130,제주특별자치도,서귀포시,5-9세,8632,4432,4200
202102,50130,제주특별자치도,서귀포시,5-9세,8715,4486,4229
202103,50130,제주특별자치도,서귀포시,5-9세,8742,4511,4231
202104,50130,제주특별자치도,서귀포시,5-9세,8726,4492,4234
202105,50130,제주특별자치도,서귀포시,5-9세,8707,4473,4234
202106,50130,제주특별자치도,서귀포시,5-9세,8729,4480,4249
202007,50130,제주특별자치도,서귀포시,10-14세,8732,4530,4202
202008,50130,제주특별자치도,서귀포시,10-14세,8782,4555,4227
202009,50130,제주특별자치도,서귀포시,10-14세,8849,4583,4266
202010,50130,제주특별자치도,서귀포시,10-14세,8898,4602,4296
202011,50130,제주특별자치도,서귀포시,10-14세,8941,4624,4317
202012,50130,제주특별자치도,서귀포시,10-14세,8974,4632,4342
202101,50130,제주특별자치도,서귀포시,10-14세,9043,4664,4379
202102,50130,제주특별자치도,서귀포시,10-14세,9120,4713,4407
202103,50130,제주특별자치도,서귀포시,10-14세,9160,4715,4445
202104,50130,제주특별자치도,서귀포시,10-14세,9229,4759,4470
202105,50130,제주특별자치도,서귀포시,10-14세,9239,4760,4479
202106,50130,제주특별자치도,서귀포시,10-14세,9211,4743,4468
202007,50130,제주특별자치도,서귀포시,15-19세,8617,4547,4070
202008,50130,제주특별자치도,서귀포시,15-19세,8599,4542,4057
202009,50130,제주특별자치도,서귀포시,15-19세,8555,4523,4032
202010,50130,제주특별자치도,서귀포시,15-19세,8491,4502,3989
202011,50130,제주특별자치도,서귀포시,15-19세,8442,4485,3957
202012,50130,제주특별자치도,서귀포시,15-19세,8413,4467,3946
202101,50130,제주특별자치도,서귀포시,15-19세,8413,4462,3951
202102,50130,제주특별자치도,서귀포시,15-19세,8340,4429,3911
202103,50130,제주특별자치도,서귀포시,15-19세,8267,4414,3853
202104,50130,제주특별자치도,서귀포시,15-19세,8206,4385,3821
202105,50130,제주특별자치도,서귀포시,15-19세,8171,4372,3799
202106,50130,제주특별자치도,서귀포시,15-19세,8188,4379,3809
202007,50130,제주특별자치도,서귀포시,20-24세,9759,5275,4484
202008,50130,제주특별자치도,서귀포시,20-24세,9766,5274,4492
202009,50130,제주특별자치도,서귀포시,20-24세,9714,5243,4471
202010,50130,제주특별자치도,서귀포시,20-24세,9734,5250,4484
202011,50130,제주특별자치도,서귀포시,20-24세,9762,5261,4501
202012,50130,제주특별자치도,서귀포시,20-24세,9731,5225,4506
202101,50130,제주특별자치도,서귀포시,20-24세,9691,5202,4489
202102,50130,제주특별자치도,서귀포시,20-24세,9646,5179,4467
202103,50130,제주특별자치도,서귀포시,20-24세,9585,5124,4461
202104,50130,제주특별자치도,서귀포시,20-24세,9586,5128,4458
202105,50130,제주특별자치도,서귀포시,20-24세,9584,5135,4449
202106,50130,제주특별자치도,서귀포시,20-24세,9559,5148,4411
202007,50130,제주특별자치도,서귀포시,25-29세,9233,4878,4355
202008,50130,제주특별자치도,서귀포시,25-29세,9248,4884,4364
202009,50130,제주특별자치도,서귀포시,25-29세,9292,4937,4355
202010,50130,제주특별자치도,서귀포시,25-29세,9313,4947,4366
202011,50130,제주특별자치도,서귀포시,25-29세,9329,4968,4361
202012,50130,제주특별자치도,서귀포시,25-29세,9419,5030,4389
202101,50130,제주특별자치도,서귀포시,25-29세,9386,5037,4349
202102,50130,제주특별자치도,서귀포시,25-29세,9315,5004,4311
202103,50130,제주특별자치도,서귀포시,25-29세,9317,5007,4310
202104,50130,제주특별자치도,서귀포시,25-29세,9318,5020,4298
202105,50130,제주특별자치도,서귀포시,25-29세,9326,5014,4312
202106,50130,제주특별자치도,서귀포시,25-29세,9328,5013,4315
202007,50130,제주특별자치도,서귀포시,30-34세,8250,4225,4025
202008,50130,제주특별자치도,서귀포시,30-34세,8214,4195,4019
202009,50130,제주특별자치도,서귀포시,30-34세,8205,4182,4023
202010,50130,제주특별자치도,서귀포시,30-34세,8185,4179,4006
202011,50130,제주특별자치도,서귀포시,30-34세,8216,4199,4017
202012,50130,제주특별자치도,서귀포시,30-34세,8185,4187,3998
202101,50130,제주특별자치도,서귀포시,30-34세,8164,4140,4024
202102,50130,제주특별자치도,서귀포시,30-34세,8181,4165,4016
202103,50130,제주특별자치도,서귀포시,30-34세,8201,4158,4043
202104,50130,제주특별자치도,서귀포시,30-34세,8218,4165,4053
202105,50130,제주특별자치도,서귀포시,30-34세,8264,4185,4079
202106,50130,제주특별자치도,서귀포시,30-34세,8302,4228,4074
202007,50130,제주특별자치도,서귀포시,35-39세,11805,5919,5886
202008,50130,제주특별자치도,서귀포시,35-39세,11778,5899,5879
202009,50130,제주특별자치도,서귀포시,35-39세,11753,5913,5840
202010,50130,제주특별자치도,서귀포시,35-39세,11710,5881,5829
202011,50130,제주특별자치도,서귀포시,35-39세,11702,5868,5834
202012,50130,제주특별자치도,서귀포시,35-39세,11684,5830,5854
202101,50130,제주특별자치도,서귀포시,35-39세,11591,5767,5824
202102,50130,제주특별자치도,서귀포시,35-39세,11534,5720,5814
202103,50130,제주특별자치도,서귀포시,35-39세,11484,5709,5775
202104,50130,제주특별자치도,서귀포시,35-39세,11413,5673,5740
202105,50130,제주특별자치도,서귀포시,35-39세,11342,5629,5713
202106,50130,제주특별자치도,서귀포시,35-39세,11280,5564,5716
202007,50130,제주특별자치도,서귀포시,40-44세,13340,6960,6380
202008,50130,제주특별자치도,서귀포시,40-44세,13362,6950,6412
202009,50130,제주특별자치도,서귀포시,40-44세,13355,6905,6450
202010,50130,제주특별자치도,서귀포시,40-44세,13423,6939,6484
202011,50130,제주특별자치도,서귀포시,40-44세,13479,6957,6522
202012,50130,제주특별자치도,서귀포시,40-44세,13491,6983,6508
202101,50130,제주특별자치도,서귀포시,40-44세,13498,6987,6511
202102,50130,제주특별자치도,서귀포시,40-44세,13589,7014,6575
202103,50130,제주특별자치도,서귀포시,40-44세,13588,6993,6595
202104,50130,제주특별자치도,서귀포시,40-44세,13615,7014,6601
202105,50130,제주특별자치도,서귀포시,40-44세,13713,7054,6659
202106,50130,제주특별자치도,서귀포시,40-44세,13816,7109,6707
202007,50130,제주특별자치도,서귀포시,45-49세,16147,8880,7267
202008,50130,제주특별자치도,서귀포시,45-49세,16133,8874,7259
202009,50130,제주특별자치도,서귀포시,45-49세,16112,8870,7242
202010,50130,제주특별자치도,서귀포시,45-49세,16040,8830,7210
202011,50130,제주특별자치도,서귀포시,45-49세,15982,8793,7189
202012,50130,제주특별자치도,서귀포시,45-49세,15973,8789,7184
202101,50130,제주특별자치도,서귀포시,45-49세,15947,8761,7186
202102,50130,제주특별자치도,서귀포시,45-49세,15953,8706,7247
202103,50130,제주특별자치도,서귀포시,45-49세,15857,8661,7196
202104,50130,제주특별자치도,서귀포시,45-49세,15842,8626,7216
202105,50130,제주특별자치도,서귀포시,45-49세,15730,8559,7171
202106,50130,제주특별자치도,서귀포시,45-49세,15631,8514,7117
202007,50130,제주특별자치도,서귀포시,50-54세,16090,8706,7384
202008,50130,제주특별자치도,서귀포시,50-54세,16049,8685,7364
202009,50130,제주특별자치도,서귀포시,50-54세,16087,8703,7384
202010,50130,제주특별자치도,서귀포시,50-54세,16131,8707,7424
202011,50130,제주특별자치도,서귀포시,50-54세,16165,8734,7431
202012,50130,제주특별자치도,서귀포시,50-54세,16218,8761,7457
202101,50130,제주특별자치도,서귀포시,50-54세,16320,8842,7478
202102,50130,제주특별자치도,서귀포시,50-54세,16393,8913,7480
202103,50130,제주특별자치도,서귀포시,50-54세,16278,8853,7425
202104,50130,제주특별자치도,서귀포시,50-54세,16331,8882,7449
202105,50130,제주특별자치도,서귀포시,50-54세,16409,8917,7492
202106,50130,제주특별자치도,서귀포시,50-54세,16491,8950,7541
202007,50130,제주특별자치도,서귀포시,55-59세,15445,8134,7311
202008,50130,제주특별자치도,서귀포시,55-59세,15431,8127,7304
202009,50130,제주특별자치도,서귀포시,55-59세,15435,8133,7302
202010,50130,제주특별자치도,서귀포시,55-59세,15395,8119,7276
202011,50130,제주특별자치도,서귀포시,55-59세,15407,8127,7280
202012,50130,제주특별자치도,서귀포시,55-59세,15430,8136,7294
202101,50130,제주특별자치도,서귀포시,55-59세,15378,8124,7254
202102,50130,제주특별자치도,서귀포시,55-59세,15365,8101,7264
202103,50130,제주특별자치도,서귀포시,55-59세,15440,8164,7276
202104,50130,제주특별자치도,서귀포시,55-59세,15465,8180,7285
202105,50130,제주특별자치도,서귀포시,55-59세,15497,8200,7297
202106,50130,제주특별자치도,서귀포시,55-59세,15451,8173,7278
202007,50130,제주특별자치도,서귀포시,60-64세,14156,7175,6981
202008,50130,제주특별자치도,서귀포시,60-64세,14269,7229,7040
202009,50130,제주특별자치도,서귀포시,60-64세,14353,7281,7072
202010,50130,제주특별자치도,서귀포시,60-64세,14484,7358,7126
202011,50130,제주특별자치도,서귀포시,60-64세,14566,7399,7167
202012,50130,제주특별자치도,서귀포시,60-64세,14644,7437,7207
202101,50130,제주특별자치도,서귀포시,60-64세,14724,7461,7263
202102,50130,제주특별자치도,서귀포시,60-64세,14771,7490,7281
202103,50130,제주특별자치도,서귀포시,60-64세,14763,7495,7268
202104,50130,제주특별자치도,서귀포시,60-64세,14781,7523,7258
202105,50130,제주특별자치도,서귀포시,60-64세,14839,7556,7283
202106,50130,제주특별자치도,서귀포시,60-64세,14883,7563,7320
202007,50130,제주특별자치도,서귀포시,65-69세,9940,4831,5109
202008,50130,제주특별자치도,서귀포시,65-69세,10014,4863,5151
202009,50130,제주특별자치도,서귀포시,65-69세,10087,4907,5180
202010,50130,제주특별자치도,서귀포시,65-69세,10143,4925,5218
202011,50130,제주특별자치도,서귀포시,65-69세,10169,4926,5243
202012,50130,제주특별자치도,서귀포시,65-69세,10239,4969,5270
202101,50130,제주특별자치도,서귀포시,65-69세,10321,5025,5296
202102,50130,제주특별자치도,서귀포시,65-69세,10361,5049,5312
202103,50130,제주특별자치도,서귀포시,65-69세,10439,5079,5360
202104,50130,제주특별자치도,서귀포시,65-69세,10564,5137,5427
202105,50130,제주특별자치도,서귀포시,65-69세,10631,5170,5461
202106,50130,제주특별자치도,서귀포시,65-69세,10727,5220,5507
202007,50130,제주특별자치도,서귀포시,70-74세,8357,3971,4386
202008,50130,제주특별자치도,서귀포시,70-74세,8365,3971,4394
202009,50130,제주특별자치도,서귀포시,70-74세,8404,3980,4424
202010,50130,제주특별자치도,서귀포시,70-74세,8440,4008,4432
202011,50130,제주특별자치도,서귀포시,70-74세,8495,4044,4451
202012,50130,제주특별자치도,서귀포시,70-74세,8515,4051,4464
202101,50130,제주특별자치도,서귀포시,70-74세,8549,4064,4485
202102,50130,제주특별자치도,서귀포시,70-74세,8568,4078,4490
202103,50130,제주특별자치도,서귀포시,70-74세,8522,4058,4464
202104,50130,제주특별자치도,서귀포시,70-74세,8481,4039,4442
202105,50130,제주특별자치도,서귀포시,70-74세,8501,4046,4455
202106,50130,제주특별자치도,서귀포시,70-74세,8499,4053,4446
202007,50130,제주특별자치도,서귀포시,75-79세,7017,3010,4007
202008,50130,제주특별자치도,서귀포시,75-79세,7039,3033,4006
202009,50130,제주특별자치도,서귀포시,75-79세,7032,3037,3995
202010,50130,제주특별자치도,서귀포시,75-79세,7016,3034,3982
202011,50130,제주특별자치도,서귀포시,75-79세,6996,3035,3961
202012,50130,제주특별자치도,서귀포시,75-79세,6986,3040,3946
202101,50130,제주특별자치도,서귀포시,75-79세,6969,3030,3939
202102,50130,제주특별자치도,서귀포시,75-79세,6925,3012,3913
202103,50130,제주특별자치도,서귀포시,75-79세,6892,3001,3891
202104,50130,제주특별자치도,서귀포시,75-79세,6890,3010,3880
202105,50130,제주특별자치도,서귀포시,75-79세,6882,3020,3862
202106,50130,제주특별자치도,서귀포시,75-79세,6884,3019,3865
202007,50130,제주특별자치도,서귀포시,80-84세,5126,1909,3217
202008,50130,제주특별자치도,서귀포시,80-84세,5167,1931,3236
202009,50130,제주특별자치도,서귀포시,80-84세,5154,1922,3232
202010,50130,제주특별자치도,서귀포시,80-84세,5167,1920,3247
202011,50130,제주특별자치도,서귀포시,80-84세,5188,1922,3266
202012,50130,제주특별자치도,서귀포시,80-84세,5187,1925,3262
202101,50130,제주특별자치도,서귀포시,80-84세,5232,1956,3276
202102,50130,제주특별자치도,서귀포시,80-84세,5282,1976,3306
202103,50130,제주특별자치도,서귀포시,80-84세,5268,1965,3303
202104,50130,제주특별자치도,서귀포시,80-84세,5288,1975,3313
202105,50130,제주특별자치도,서귀포시,80-84세,5302,1974,3328
202106,50130,제주특별자치도,서귀포시,80-84세,5358,2003,3355
202007,50130,제주특별자치도,서귀포시,85-89세,2988,807,2181
202008,50130,제주특별자치도,서귀포시,85-89세,3000,805,2195
202009,50130,제주특별자치도,서귀포시,85-89세,3027,816,2211
202010,50130,제주특별자치도,서귀포시,85-89세,3054,824,2230
202011,50130,제주특별자치도,서귀포시,85-89세,3080,836,2244
202012,50130,제주특별자치도,서귀포시,85-89세,3128,856,2272
202101,50130,제주특별자치도,서귀포시,85-89세,3136,873,2263
202102,50130,제주특별자치도,서귀포시,85-89세,3174,883,2291
202103,50130,제주특별자치도,서귀포시,85-89세,3194,897,2297
202104,50130,제주특별자치도,서귀포시,85-89세,3208,902,2306
202105,50130,제주특별자치도,서귀포시,85-89세,3233,918,2315
202106,50130,제주특별자치도,서귀포시,85-89세,3234,913,2321
202007,50130,제주특별자치도,서귀포시,90-94세,886,145,741
202008,50130,제주특별자치도,서귀포시,90-94세,901,148,753
202009,50130,제주특별자치도,서귀포시,90-94세,915,152,763
202010,50130,제주특별자치도,서귀포시,90-94세,915,159,756
202011,50130,제주특별자치도,서귀포시,90-94세,929,157,772
202012,50130,제주특별자치도,서귀포시,90-94세,954,162,792
202101,50130,제주특별자치도,서귀포시,90-94세,968,164,804
202102,50130,제주특별자치도,서귀포시,90-94세,986,166,820
202103,50130,제주특별자치도,서귀포시,90-94세,983,154,829
202104,50130,제주특별자치도,서귀포시,90-94세,1002,157,845
202105,50130,제주특별자치도,서귀포시,90-94세,1010,156,854
202106,50130,제주특별자치도,서귀포시,90-94세,1004,160,844
202007,50130,제주특별자치도,서귀포시,95-99세,325,36,289
202008,50130,제주특별자치도,서귀포시,95-99세,323,35,288
202009,50130,제주특별자치도,서귀포시,95-99세,327,35,292
202010,50130,제주특별자치도,서귀포시,95-99세,334,34,300
202011,50130,제주특별자치도,서귀포시,95-99세,331,35,296
202012,50130,제주특별자치도,서귀포시,95-99세,327,36,291
202101,50130,제주특별자치도,서귀포시,95-99세,330,37,293
202102,50130,제주특별자치도,서귀포시,95-99세,325,37,288
202103,50130,제주특별자치도,서귀포시,95-99세,291,32,259
202104,50130,제주특별자치도,서귀포시,95-99세,287,33,254
202105,50130,제주특별자치도,서귀포시,95-99세,283,35,248
202106,50130,제주특별자치도,서귀포시,95-99세,281,36,245
202007,50130,제주특별자치도,서귀포시,100+,101,12,89
202008,50130,제주특별자치도,서귀포시,100+,103,13,90
202009,50130,제주특별자치도,서귀포시,100+,103,13,90
202010,50130,제주특별자치도,서귀포시,100+,99,13,86
202011,50130,제주특별자치도,서귀포시,100+,98,13,85
202012,50130,제주특별자치도,서귀포시,100+,98,13,85
202101,50130,제주특별자치도,서귀포시,100+,100,13,87
202102,50130,제주특별자치도,서귀포시,100+,103,13,90
202103,50130,제주특별자치도,서귀포시,100+,63,4,59
202104,50130,제주특별자치도,서귀포시,100+,66,4,62
202105,50130,제주특별자치도,서귀포시,100+,71,4,67
202106,50130,제주특별자치도,서귀포시,100+,69,4,65
